State,City,Population,None,High School,Associates,Bachelors,Graduate,Total
Alabama,Movico,170,26,92,9,0,17,144
Alabama,Pell City,13312,1220,3089,3126,938,642,9015
Alabama,Pelham,22346,1182,3144,5295,3740,1861,15222
Alabama,Parrish,1086,171,270,219,22,9,691
Alabama,Panola,32,13,8,0,0,0,21
Alabama,Paint Rock,208,31,63,33,10,1,138
Alabama,Ozark,14786,1847,3329,3661,1078,640,10555
Alabama,Oxford,21243,2365,4582,4746,1758,847,14298
Alabama,Owens Cross Roads,1667,161,351,363,272,62,1209
Alabama,Our Town,490,105,207,102,61,15,490
Alabama,Orrville,110,26,42,15,5,3,91
Alabama,Orange Beach,5682,341,1103,1594,1021,564,4623
Alabama,Pennington,218,47,49,49,5,6,156
Alabama,Opp,6665,1003,1390,1521,381,152,4447
Alabama,Onycha,197,47,37,22,9,4,119
Alabama,Oneonta,6633,1235,1351,1506,364,283,4739
Alabama,Ohatchee,962,132,285,233,40,42,732
Alabama,Odenville,3663,597,847,748,170,164,2526
Alabama,Oakman,659,134,172,129,27,20,482
Alabama,Oak Hill,11,8,0,2,0,1,11
Alabama,Oak Grove,564,110,155,108,18,17,408
Alabama,Notasulga,974,117,193,191,64,42,607
Alabama,Northport,24339,1607,4521,4467,3640,2178,16413
Alabama,North Johns,179,32,55,38,2,4,131
Alabama,North Courtland,710,145,234,105,12,9,505
Alabama,Opelika,28544,3139,5625,5467,2974,2069,19274
Alabama,Newville,509,99,181,62,18,6,366
Alabama,Penton,236,104,65,30,14,0,213
Alabama,Boykin,67,31,11,10,15,0,67
Alabama,Phil Campbell,1149,155,324,161,61,20,721
Alabama,Phenix City,36639,3449,6512,8021,2829,1862,22673
Alabama,Petrey,42,5,29,3,0,0,37
Alabama,Peterman,120,3,86,6,6,6,107
Alabama,Perdido Beach,599,71,125,168,92,61,517
Alabama,Perdido,554,89,154,118,53,0,414
Alabama,Camden,2721,284,655,424,190,100,1653
Alabama,Calvert,394,166,49,0,0,0,215
Alabama,Calera,12593,910,1871,2532,2131,935,8379
Alabama,Butler,2360,338,521,597,186,66,1708
Alabama,Bucks,50,0,0,50,0,0,50
Alabama,Bon Secour,648,128,326,135,21,0,610
Alabama,Brundidge,2189,327,599,327,134,46,1433
Alabama,Brookwood,1932,197,468,333,114,56,1168
Alabama,Brookside,1258,202,353,293,81,20,949
Alabama,Brook Highland,7032,182,571,1437,1725,923,4838
Alabama,Bristow Cove,531,118,100,105,0,15,338
Alabama,Brilliant,908,153,251,179,28,23,634
Alabama,Brighton,2904,429,729,698,79,73,2008
Alabama,Bridgeport,2300,388,628,395,67,66,1544
Alabama,Brewton,5424,597,1483,989,456,327,3852
Alabama,Brent,4898,956,1559,986,98,53,3652
Alabama,Brantleyville,1111,99,264,222,61,19,665
Alabama,Brantley,971,150,211,109,86,46,602
Alabama,Broomtown,160,51,55,26,19,0,151
Alabama,New Union,1088,88,159,264,11,27,549
Alabama,Newton,1709,218,425,466,78,47,1234
Alabama,New Site,767,103,250,133,66,22,574
Alabama,Bessemer,27043,3376,6485,6056,1685,614,18216
Alabama,Berry,1392,338,354,215,54,15,976
Alabama,Benton,49,0,6,17,7,5,35
Alabama,Belle Fontaine,539,23,101,103,57,0,284
Alabama,Bellamy,816,84,301,173,66,0,624
Alabama,Belk,289,63,61,34,13,3,174
Alabama,Belgreen,66,7,21,21,5,0,54
Alabama,Beaverton,273,24,128,30,10,6,198
Alabama,Beatrice,294,21,78,75,4,14,192
Alabama,Bear Creek,1296,205,387,236,45,8,881
Alabama,Bayou La Batre,2634,646,423,397,78,11,1555
Alabama,Billingsley,176,29,39,25,6,2,101
Alabama,Bay Minette,8843,1167,1863,1633,636,282,5581
Alabama,Ballplay,1535,211,420,338,92,8,1069
Alabama,Bakerhill,209,43,61,42,3,7,156
Alabama,Baileyton,909,155,211,172,47,28,613
Alabama,Babbie,687,88,174,166,33,7,468
Alabama,Axis,911,131,176,235,83,28,653
Alabama,Avon,594,62,169,82,30,18,361
Alabama,Autaugaville,1119,223,272,195,57,27,774
Alabama,Auburn,58693,1511,3449,5635,8451,7559,26605
Alabama,Attalla,5965,1004,1478,1239,269,192,4182
Alabama,Atmore,10072,1895,2942,1669,472,226,7204
Alabama,Athens,23938,2724,4887,4573,2874,1318,16376
Alabama,Banks,136,27,37,13,12,11,100
Alabama,Birmingham,212211,21241,40435,46363,21377,13196,142612
Alabama,Black,157,11,58,29,9,3,110
Alabama,Blountsville,1967,308,390,322,77,46,1143
Alabama,New Market,1410,118,348,233,139,62,900
Alabama,New Hope,2803,284,592,649,224,58,1807
Alabama,New Brockton,1346,172,282,304,79,16,853
Alabama,Newbern,160,32,59,26,6,3,126
Alabama,Needham,108,14,41,14,12,5,86
Alabama,Nectar,281,41,67,74,4,3,189
Alabama,Nauvoo,171,38,46,27,5,0,116
Alabama,Natural Bridge,43,12,11,10,2,0,35
Alabama,Napier Field,414,53,106,98,7,4,268
Alabama,Nances Creek,292,42,77,43,27,12,201
Alabama,Nanafalia,64,3,24,14,9,0,50
Alabama,Myrtlewood,157,36,48,42,4,1,131
Alabama,Muscle Shoals,13492,1039,2623,2978,1448,1109,9197
Alabama,Munford,1443,115,340,360,72,21,908
Alabama,Mulga,922,178,257,169,26,6,636
Alabama,Eufaula,12809,1559,3059,2330,845,637,8430
Alabama,Mount Vernon,1482,207,555,240,41,37,1080
Alabama,Mount Olive CDP (Jefferson County),4100,213,989,1053,355,225,2835
Alabama,Mount Olive CDP (Coosa County),300,21,108,37,0,0,166
Alabama,Mountain Brook,20518,61,321,1659,5689,5569,13299
Alabama,Bon Air,103,9,38,12,0,4,63
Alabama,Boligee,640,62,158,23,20,46,309
Alabama,Boaz,9673,1348,1605,1703,732,372,5760
Alabama,Blue Springs,99,3,28,25,11,1,68
Alabama,Blue Ridge,1461,23,171,292,266,209,961
Alabama,Pickensville,661,152,221,80,35,18,506
Alabama,Piedmont,4767,758,1122,1043,178,171,3272
Alabama,Pike Road,7178,199,643,1224,1546,1138,4750
Alabama,Pinckard,460,38,124,130,29,11,332
Alabama,St. Stephens,580,56,286,110,22,0,474
Alabama,St. Florian,418,28,113,96,77,22,336
Alabama,Rutledge,342,80,82,59,29,15,265
Alabama,Russellville,9824,1838,2198,1197,443,237,5913
Alabama,Rosa,385,50,95,83,23,17,268
Alabama,Rogersville,1099,128,248,190,106,37,709
Alabama,Rockville,34,6,0,0,5,6,17
Alabama,Rock Mills,648,135,112,130,71,8,456
Alabama,Rockford,620,149,137,148,11,27,472
Alabama,Rock Creek,1336,147,416,305,82,42,992
Alabama,Robertsdale,5656,748,1394,1088,324,163,3717
Alabama,Saks,10826,1485,2262,2054,788,343,6932
Alabama,Roanoke,6013,944,1258,1332,383,228,4145
Alabama,Riverside,2296,216,462,584,260,135,1657
Alabama,River Falls,721,174,175,98,35,10,492
Alabama,Ridgeville,117,28,34,24,5,1,92
Alabama,Repton,130,37,34,15,2,0,88
Alabama,Rehobeth,1602,162,345,334,146,85,1072
Alabama,Reform,2012,253,494,367,55,61,1230
Alabama,Reeltown,425,74,83,136,38,13,344
Alabama,Reece City,793,80,240,188,35,12,555
Alabama,Redstone Arsenal,1657,39,40,324,133,114,650
Alabama,Red Level,364,59,99,81,29,15,283
Alabama,Redland,4331,245,750,916,693,394,2998
Alabama,Riverview,138,24,46,24,3,1,98
Alabama,Samson,2103,448,452,318,62,25,1305
Alabama,Sand Rock,590,82,144,131,31,39,427
Alabama,Sanford,212,43,47,44,16,10,160
Alabama,South Vinemont,545,78,151,97,32,16,374
Alabama,Southside,8514,569,1557,2263,890,575,5854
Alabama,Somerville,691,111,145,164,55,40,515
Alabama,Snead,765,110,215,172,41,19,557
Alabama,Smoke Rise,2443,116,620,464,324,64,1588
Alabama,Smiths Station,5165,656,804,1152,596,117,3325
Alabama,Slocomb,1880,324,383,417,164,33,1321
Alabama,Skyline,1048,172,309,183,27,8,699
Alabama,Sipsey,473,62,140,154,6,6,368
Alabama,Sims Chapel,163,0,52,31,0,0,83
Alabama,Silverhill,654,54,180,182,53,38,507
Alabama,Silas,680,151,143,125,16,9,444
Alabama,Shorter,436,99,87,87,25,15,313
Alabama,Shoal Creek,1481,4,70,218,455,286,1033
Alabama,Shiloh,350,58,81,63,32,4,238
Alabama,Shelby,1364,207,467,229,73,7,983
Alabama,Sheffield,9074,1332,2224,1729,764,434,6483
Alabama,Semmes,3583,485,727,678,185,65,2140
Alabama,Selmont-West Selmont,2574,311,680,358,61,10,1420
Alabama,Selma,19987,2794,4063,3639,1199,899,12594
Alabama,Section,811,131,191,158,62,19,561
Alabama,Scottsboro,14775,1921,3913,2751,1150,840,10575
Alabama,Satsuma,6152,359,1875,1549,316,260,4359
Alabama,Sardis City,1654,134,400,462,113,75,1184
Alabama,Saraland,13715,1380,3603,2658,1280,532,9453
Alabama,Red Bay,3143,473,884,490,155,66,2068
Alabama,Ashville,2342,321,515,490,73,32,1431
Alabama,Ray,480,63,202,103,0,0,368
Alabama,Rainsville,4992,610,1188,1282,189,180,3449
Alabama,Dothan,67708,6298,13529,14672,7342,3958,45799
Alabama,Double Springs,1180,220,381,191,31,39,862
Alabama,Douglas,1024,123,233,181,29,5,571
Alabama,Dozier,307,42,77,52,18,12,201
Alabama,Dunnavant,984,149,185,205,55,27,621
Alabama,Dutton,331,18,101,57,6,10,192
Alabama,East Brewton,2508,266,777,471,82,27,1623
Alabama,East Point,151,13,19,67,52,0,151
Alabama,Eclectic,912,94,223,201,56,20,594
Alabama,Edgewater,905,84,146,274,14,10,528
Alabama,Edwardsville,137,13,33,41,12,1,100
Alabama,Dora,2295,258,504,514,124,60,1460
Alabama,Egypt,1254,125,274,328,95,8,830
Alabama,Elberta,1506,149,345,311,158,83,1046
Alabama,Eldridge,204,32,25,62,9,0,128
Alabama,Elkmont,430,68,115,66,37,26,312
Alabama,Pleasant Groves,560,57,230,65,16,13,381
Alabama,Pleasant Grove,10270,629,2367,2657,1072,351,7076
Alabama,Pisgah,717,105,135,174,47,31,492
Alabama,Pinson,7448,372,1767,2064,780,452,5435
Alabama,Pine Ridge,235,64,27,45,4,1,141
Alabama,Pine Level,4552,276,1294,925,243,164,2902
Alabama,Pine Hill,929,60,235,183,39,31,548
Alabama,Pine Apple,138,20,17,29,38,4,108
Alabama,Elba,3919,599,868,721,284,120,2592
Alabama,Dodge City,714,91,187,148,58,12,496
Alabama,Detroit,215,57,59,30,14,2,162
Alabama,Demopolis,7249,501,1709,1364,643,389,4606
Alabama,Rainbow City,9608,490,1835,2509,1007,679,6520
Alabama,Ragland,1802,314,575,220,57,36,1202
Alabama,Putnam,100,22,20,28,5,6,81
Alabama,Providence,268,20,107,65,8,10,210
Alabama,Prichard,22439,2995,5461,4112,840,545,13953
Alabama,Priceville,2943,175,568,586,352,266,1947
Alabama,Prattville,34706,2267,6803,6606,3958,2881,22515
Alabama,Powell,1037,295,222,193,37,14,761
Alabama,Pollard,236,23,56,30,14,7,130
Alabama,Point Clear,2495,183,476,226,395,405,1685
Alabama,Crossville,2312,432,552,306,81,86,1457
Alabama,Cuba,509,26,164,32,86,23,331
Alabama,Cullman,15014,1505,2767,3589,1244,1125,10230
Alabama,Cullomburg,117,5,44,17,10,0,76
Alabama,Cusseta,151,15,36,27,6,8,92
Alabama,Dadeville,3181,610,927,428,193,163,2321
Alabama,Daleville,5188,491,906,1444,340,162,3343
Alabama,Daphne,23559,682,3159,6036,4362,2019,16258
Alabama,Dauphin Island,1319,41,271,322,217,127,978
Alabama,Daviston,271,24,72,66,22,13,197
Alabama,Dayton,25,0,0,7,1,5,13
Alabama,Deatsville,1218,27,194,324,110,67,722
Alabama,Decatur,55598,6569,10365,11626,6497,2956,38013
Alabama,Deer Park,203,21,95,32,5,0,153
Alabama,Delta,259,26,81,78,0,15,200
Alabama,Ranburne,441,43,144,93,17,22,319
Alabama,Ashland,2667,396,459,733,83,118,1789
Alabama,Ashford,2316,262,600,449,201,74,1586
Alabama,Arley,476,70,138,122,18,12,360
Alabama,Hanceville,3195,489,821,707,122,55,2194
Alabama,Hammondville,587,105,147,116,19,25,412
Alabama,Hamilton,6814,791,1449,1784,344,214,4582
Alabama,Haleyville,4068,841,892,797,239,98,2867
Alabama,Haleburg,96,15,21,20,15,4,75
Alabama,Hackneyville,381,17,160,83,81,7,348
Alabama,Hackleburg,1444,218,341,307,38,23,927
Alabama,Gu-Win,126,11,43,27,2,3,86
Alabama,Gurley,691,124,167,126,48,21,486
Alabama,Guntersville,8326,1001,1747,1689,866,619,5922
Alabama,Gulf Shores,10703,559,2166,2706,1666,759,7856
Alabama,Harpersville,1711,214,416,287,146,47,1110
Alabama,Gulfcrest,207,17,65,38,13,0,133
Alabama,Grove Hill,1716,163,534,238,115,100,1150
Alabama,Elmore,1671,281,402,203,40,28,954
Alabama,Emelle,38,6,15,3,5,0,29
Alabama,Emerald Mountain,2895,164,219,671,414,343,1811
Alabama,Enterprise,27785,1980,4805,5985,3513,2012,18295
Alabama,Epes,137,21,35,37,3,18,114
Alabama,Grimes,570,63,175,120,40,9,407
Alabama,Greenville,7912,1118,1877,1187,502,490,5174
Alabama,Greensboro,2485,415,760,308,103,72,1658
Alabama,Graysville,2149,317,717,408,90,40,1572
Alabama,Grayson Valley,5160,360,1065,1493,527,310,3755
Alabama,Guin,2351,437,599,591,107,43,1777
Alabama,Hartford,2645,534,626,442,140,76,1818
Alabama,Hartselle,14455,789,3228,3240,1579,944,9780
Alabama,Harvest,5226,308,736,1294,633,298,3269
Alabama,Hoover,83547,2779,6754,15976,19336,12644,57489
Alabama,Homewood,25535,978,1918,3110,4868,4080,14954
Alabama,Holtville,4263,417,1013,979,339,148,2896
Alabama,Holt,3652,536,872,543,150,46,2147
Alabama,Hollywood,971,220,358,170,19,0,767
Alabama,Holly Pond,1084,67,231,301,76,23,698
Alabama,Hollis Crossroads,714,146,136,176,13,40,511
Alabama,Hollins,930,185,229,134,33,0,581
Alabama,Hokes Bluff,4314,344,1057,1249,421,121,3192
Alabama,Hodges,308,62,62,56,17,5,202
Alabama,Hobson City,998,148,197,271,29,7,652
Alabama,Hobson,77,28,20,0,0,29,77
Alabama,Hissop,772,174,228,162,63,37,664
Alabama,Hillsboro,562,107,189,76,36,14,422
Alabama,Highland Lakes,4864,82,527,841,1102,889,3441
Alabama,Highland Lake,393,18,92,86,73,46,315
Alabama,Henagar,2253,445,611,453,24,42,1575
Alabama,Helena,17589,255,1975,3431,3911,1604,11176
Alabama,Heflin,3504,595,827,595,164,136,2317
Alabama,Heath,338,42,62,77,28,4,213
Alabama,Headland,4685,358,982,1024,303,336,3003
Alabama,Hazel Green,3266,265,837,663,377,106,2248
Alabama,Hayneville,984,178,257,151,31,20,637
Alabama,Hayden,1186,144,292,280,104,48,868
Alabama,Hatton,144,17,36,43,5,0,101
Alabama,Grant,956,64,191,178,96,62,591
Alabama,Horn Hill,254,58,48,60,6,0,172
Alabama,Grand Bay,3501,350,1005,691,164,70,2280
Alabama,Goshen,356,60,69,54,16,9,208
Alabama,Fort Rucker,4895,26,236,1082,556,203,2103
Alabama,Fort Payne,14112,3016,2789,2320,665,547,9337
Alabama,Fort Deposit,1482,255,321,155,101,32,864
Alabama,Forkland,767,112,158,126,27,9,432
Alabama,Forestdale,9716,441,1926,2668,1196,524,6755
Alabama,Foley,16345,1014,3914,4082,1844,1144,11998
Alabama,Florence,39855,4001,7349,7399,4136,2819,25704
Alabama,Florala,1863,283,491,534,61,19,1388
Alabama,Flomaton,1670,250,455,224,149,25,1103
Alabama,Five Points,181,43,51,7,11,1,113
Alabama,Fitzpatrick,84,33,19,24,8,0,84
Alabama,Franklin,243,21,28,38,33,20,140
Alabama,Fayetteville,1257,251,233,231,38,44,797
Alabama,Faunsdale,53,6,18,5,9,4,42
Alabama,Falkville,1226,334,335,202,37,49,957
Alabama,Fairview,483,59,117,114,20,17,327
Alabama,Fairhope,17309,554,2004,3511,3464,2520,12053
Alabama,Fairford,85,36,49,0,0,0,85
Alabama,Fairfield,10987,779,2055,2911,946,348,7039
Alabama,Excel,1019,96,241,209,82,60,688
Alabama,Evergreen,3842,504,1202,587,48,80,2421
Alabama,Eva,552,33,151,117,31,42,374
Alabama,Eutaw,2834,571,577,696,226,63,2133
Alabama,Eunola,421,14,197,134,0,14,359
Alabama,Fayette,4523,614,1003,715,336,269,2937
Alabama,Fredonia,385,31,81,109,31,21,273
Alabama,Frisco City,1272,206,473,157,40,31,907
Alabama,Fruitdale,209,6,76,7,0,0,89
Alabama,Gordonville,278,50,76,62,18,3,209
Alabama,Gordon,275,67,94,32,6,3,202
Alabama,Gordo,1680,239,546,264,115,58,1222
Alabama,Goodwater,1537,314,441,298,40,11,1104
Alabama,Good Hope,2232,191,492,488,127,118,1416
Alabama,Goldville,43,4,9,6,8,3,30
Alabama,Glenwood,228,25,60,55,12,12,164
Alabama,Glencoe,5139,543,1195,1596,430,275,4039
Alabama,Glen Allen,513,89,118,140,24,8,379
Alabama,Gilbertown,191,21,54,37,18,0,130
Alabama,Geraldine,883,87,212,154,53,45,551
Alabama,Georgiana,1710,348,522,251,40,44,1205
Alabama,Geneva,4469,662,1177,789,346,42,3016
Alabama,Geiger,262,46,62,25,21,6,160
Alabama,Gaylesville,187,30,46,45,10,8,139
Alabama,Gardendale,13763,777,3377,3140,1694,933,9921
Alabama,Garden City,374,62,148,72,22,3,307
Alabama,Gantt,180,19,46,47,14,6,132
Alabama,Gallant,742,84,131,224,66,10,515
Alabama,Gainesville,171,24,38,21,6,14,103
Alabama,Gadsden,36455,5351,7644,8005,2370,1288,24658
Alabama,Fyffe,1358,140,310,307,54,50,861
Alabama,Fultondale,8733,919,1691,2037,1059,476,6182
Alabama,Fulton,211,36,74,33,3,4,150
Alabama,Fruithurst,266,48,94,45,8,3,198
Alabama,Graham,332,46,40,39,41,11,177
Alabama,Spanish Fort,7578,219,1017,1360,2012,574,5182
Alabama,Hueytown,15894,1420,3705,3878,927,596,10526
Alabama,Huntsville,185594,12235,25523,37971,30585,19166,125480
Alabama,Margaret,4487,167,868,752,284,142,2213
Alabama,Marbury,1419,141,380,283,0,69,873
Alabama,Maplesville,815,121,234,117,44,16,532
Alabama,Malvern,1816,314,495,296,76,26,1207
Alabama,Malcolm,168,9,52,30,0,0,91
Alabama,Magnolia Springs,752,66,142,170,160,70,608
Alabama,Madrid,355,74,97,49,27,5,252
Alabama,Madison,45590,1286,3848,8071,10484,6390,30079
Alabama,McMullen,5,3,0,0,2,0,5
Alabama,McKenzie,551,92,153,91,35,5,376
Alabama,McIntosh,422,10,82,99,41,7,239
Alabama,Marion,3551,313,629,441,166,134,1683
Alabama,Macedonia,165,24,60,45,0,0,129
Alabama,Lynn,563,104,154,120,26,8,412
Alabama,Luverne,2825,435,660,519,243,113,1970
Alabama,Loxley,1886,177,411,391,173,51,1203
Alabama,Lowndesboro,118,9,9,42,18,14,92
Alabama,Louisville,440,116,83,78,24,37,338
Alabama,Lookout Mountain,1152,156,279,301,92,55,883
Alabama,Locust Fork,1441,169,359,335,63,10,936
Alabama,Lockhart,443,54,110,102,18,19,303
Alabama,Loachapoka,217,16,40,59,27,11,153
Alabama,Livingston,3466,209,449,369,239,230,1496
Alabama,Littleville,1029,132,345,221,12,14,724
Alabama,McDonald Chapel,530,122,98,75,12,0,307
Alabama,Maytown,359,32,120,86,28,9,275
Alabama,Meadowbrook,8752,360,655,1488,2407,1105,6015
Alabama,Megargel,64,30,16,0,18,0,64
Alabama,Ariton,702,119,155,109,12,19,414
Alabama,Moundville,2183,332,426,431,169,105,1463
Alabama,Moulton,3386,517,1134,473,290,66,2480
Alabama,Mosses,1036,279,289,99,21,16,704
Alabama,Morrison Crossroads,190,11,52,94,21,0,178
Alabama,Morris,1737,183,365,404,180,79,1211
Alabama,Mooresville,78,11,2,10,28,14,65
Alabama,Moores Mill,6591,389,1157,1693,649,425,4313
Alabama,Moody,12292,1027,2154,3469,1269,547,8466
Alabama,Montgomery,202967,18808,33469,37149,24917,15214,129557
Alabama,Montevallo,6549,477,1162,964,545,409,3557
Alabama,Monroeville,6265,677,1422,1124,411,189,3823
Alabama,Mobile,194669,16893,36550,40142,22628,12342,128555
Alabama,Minor,1334,104,441,257,77,56,935
Alabama,Millry,565,50,171,95,19,24,359
Alabama,Millport,1070,160,324,172,82,46,784
Alabama,Millerville,216,46,83,28,0,0,157
Alabama,Millbrook,14983,841,3195,3243,1626,784,9689
Alabama,Mignon,1088,189,343,210,10,10,762
Alabama,Midway,583,139,128,48,13,5,333
Alabama,Midland City,2151,279,438,439,153,41,1350
Alabama,Midfield,5284,330,1235,1245,385,162,3357
Alabama,Meridianville,6270,604,1168,1590,744,396,4502
Alabama,Mentone,390,41,91,106,50,39,327
Alabama,Memphis,38,24,4,0,6,0,34
Alabama,Lisman,613,125,96,110,21,29,381
Alabama,Huguley,2373,341,727,426,86,68,1648
Alabama,Lipscomb,2275,425,512,453,50,27,1467
Alabama,Linden,2123,204,693,369,205,113,1584
Alabama,Ardmore,1419,218,407,227,65,60,977
Alabama,Argo,4146,365,950,1068,232,310,2925
Alabama,Lakeview,133,6,34,30,3,5,78
Alabama,La Fayette,2989,637,898,356,150,63,2104
Alabama,Ladonia,2840,305,815,656,125,51,1952
Alabama,Kinston,563,112,148,54,45,8,367
Alabama,Kinsey,2275,344,482,459,97,48,1430
Alabama,Kimberly,2799,193,641,579,271,140,1824
Alabama,Killen,1177,106,258,262,128,67,821
Alabama,Kennedy,412,58,127,117,12,19,333
Alabama,Kellyton,248,45,79,18,1,14,157
Alabama,Arab,8282,696,1706,1914,841,448,5605
Alabama,Kansas,186,41,42,36,0,3,122
Alabama,Jemison,2627,378,761,380,85,99,1703
Alabama,Jasper,14186,1408,3197,3092,1077,832,9606
Alabama,Jacksonville,12372,725,1561,2193,1176,921,6576
Alabama,Jacksons' Gap,932,217,241,162,32,7,659
Alabama,Jackson,5055,470,1511,819,305,203,3308
Alabama,Ivalee,690,121,189,156,38,22,526
Alabama,Irondale,12398,1167,2476,2703,1807,1115,9268
Alabama,Indian Springs Village,2505,50,221,467,576,503,1817
Alabama,Ider,887,116,294,139,29,18,596
Alabama,Hytop,422,78,141,37,8,1,265
Alabama,Hurtsboro,487,89,141,88,42,0,360
Alabama,Joppa,263,80,35,57,0,73,245
Alabama,Anniston,22626,3222,4946,4424,1869,1525,15986
Alabama,Anderson,253,29,92,65,10,7,203
Alabama,Andalusia,9058,1143,1959,1805,740,412,6059
Alabama,Lincoln,6391,586,1689,1598,524,296,4693
Alabama,Lillian,1256,30,208,517,87,43,885
Alabama,Libertyville,146,25,49,17,12,7,110
Alabama,Lexington,667,60,233,132,22,17,464
Alabama,Level Plains,2181,130,492,671,151,48,1492
Alabama,Lester,143,11,52,26,5,6,100
Alabama,Leroy,779,4,240,189,110,25,568
Alabama,Leighton,859,174,260,131,28,27,620
Alabama,Leesburg,1055,149,298,247,47,22,763
Alabama,Leeds,11881,1033,2668,2458,1294,587,8040
Alabama,Langston,211,24,55,43,20,19,161
Alabama,Lanett,6457,975,1694,1047,365,191,4272
Alabama,Lake View,2417,69,585,567,309,80,1610
Alabama,Abanda,52,41,0,11,0,0,52
Alabama,Abbeville,2646,607,647,450,133,128,1965
Alabama,Adamsville,4454,649,1088,886,283,177,3083
Alabama,Addison,682,92,182,146,43,31,494
Alabama,Akron,293,61,88,36,4,5,194
Alabama,Alabaster,31905,2183,4906,6371,4672,2281,20413
Alabama,Albertville,21406,3734,4678,3522,1179,577,13690
Alabama,Alexander City,14787,2124,3185,2935,1029,430,9703
Alabama,Alexandria,3912,308,966,937,381,149,2741
Alabama,Aliceville,3727,577,940,498,168,61,2244
Alabama,Allgood,803,236,137,57,22,3,455
Alabama,Altoona,808,189,225,123,18,16,571
Alabama,Lineville,2549,369,617,520,74,79,1659
Alabama,Spring Garden,179,0,72,25,17,0,114
Alabama,Ethelsville,99,14,34,14,5,5,72
Alabama,Castleberry,543,105,160,127,39,5,436
Alabama,Chatom,1006,194,218,211,98,86,807
Alabama,Chelsea,11386,481,1528,2083,2585,716,7393
Alabama,Cherokee,850,108,194,165,62,35,564
Alabama,Chickasaw,6005,730,1376,1111,218,188,3623
Alabama,Childersburg,5105,721,1284,1056,203,134,3398
Alabama,Choccolocco,2279,178,408,618,232,246,1682
Alabama,Chunchula,136,12,70,54,0,0,136
Alabama,Citronelle,3886,465,1179,666,268,81,2659
Alabama,Clanton,8715,1481,2235,1607,679,391,6393
Alabama,Clay,9682,548,2305,2479,1250,455,7037
Alabama,Clayhatchee,441,49,95,134,34,21,333
Alabama,Clayton,2947,959,716,455,103,41,2274
Alabama,Cleveland,1206,208,322,200,33,50,813
Alabama,Clio,856,226,166,172,29,19,612
Alabama,Coaling,1808,138,469,363,143,54,1167
Alabama,Coats Bend,1842,110,481,481,109,32,1213
Alabama,Coffeeville,383,65,101,46,11,7,230
Alabama,Coker,819,62,298,138,50,25,573
Alabama,Collinsville,2104,578,330,215,62,20,1205
Alabama,Colony,345,51,82,72,8,9,222
Alabama,Columbia,680,104,171,178,35,7,495
Alabama,Columbiana,4176,800,1254,583,314,171,3122
Alabama,Concord,2044,129,635,552,134,33,1483
Alabama,Coosada,1374,146,327,195,145,119,932
Alabama,Cordova,2074,307,663,504,26,22,1522
Alabama,Cottondale,3702,607,785,737,166,128,2423
Alabama,Cottonwood,1438,234,412,271,43,29,989
Alabama,County Line,187,26,84,43,5,3,161
Alabama,Courtland,592,78,164,116,19,6,383
Alabama,Centreville,2719,356,872,480,129,103,1940
Alabama,Centre,3570,618,882,788,225,144,2657
Alabama,Camp Hill,1051,146,297,96,63,22,624
Alabama,Carbon Hill,1739,407,435,235,35,63,1175
Alabama,West End-Cobb Town,3790,824,934,676,86,63,2583
Alabama,West Jefferson,442,33,121,98,19,12,283
Alabama,Westover,1239,126,270,231,126,101,854
Alabama,West Point,626,61,181,175,28,19,464
Alabama,White Hall,832,181,137,170,51,3,542
Alabama,Whatley,0,0,0,0,0,0,0
Alabama,White Plains,908,27,287,191,86,35,626
Alabama,Wetumpka,7406,807,1853,1739,462,502,5363
Alabama,York,2652,417,711,427,153,116,1824
Alabama,Sterrett,575,175,186,88,24,14,487
Alabama,Steele,945,156,274,232,39,33,734
Alabama,Stapleton,1360,159,451,287,81,20,998
Alabama,Standing Rock,48,17,20,7,0,0,44
Alabama,Spruce Pine,146,29,0,57,0,38,124
Alabama,Cowarts,2071,196,563,442,153,42,1396
Alabama,Yellow Bluff,186,41,47,13,7,0,108
Alabama,Woodstock,1766,126,577,309,125,61,1198
Alabama,Woodland,222,21,45,56,20,12,154
Alabama,Whitesboro,2139,202,506,472,70,42,1292
Alabama,Wilsonville,2163,179,576,492,160,80,1487
Alabama,Wilton,584,56,141,116,45,5,363
Alabama,Winfield,4345,412,924,1049,509,219,3113
Alabama,Center Point,16797,1314,3339,3801,1256,506,10216
Alabama,Cedar Bluff,2017,300,396,427,112,122,1357
Alabama,Catherine,20,0,10,10,0,0,20
Alabama,Carrollton,922,181,194,179,48,22,624
Alabama,Carolina,285,26,89,70,20,8,213
Alabama,Carlton,74,17,57,0,0,0,74
Alabama,Carlisle-Rockledge,2910,493,702,560,28,50,1833
Alabama,Cardiff,30,6,5,5,3,3,22
Alabama,Woodville,763,113,238,119,20,16,506
Alabama,Creola,1842,192,450,398,163,28,1231
Alabama,Coffee Springs,264,42,57,68,16,8,191
Alabama,Tuscumbia,8537,824,2080,1798,837,421,5960
Alabama,Tuscaloosa,94865,6596,13862,13620,10415,7589,52082
Alabama,Vernon,2202,274,592,373,134,72,1445
Alabama,Tuskegee,9218,782,1150,1602,692,541,4767
Alabama,Twin,415,71,142,73,6,25,317
Alabama,Underwood-Petersville,3425,515,904,584,124,123,2250
Alabama,Union,269,50,87,48,12,13,210
Alabama,Union Grove,81,5,25,20,7,3,60
Alabama,Union Springs,3915,1130,660,441,113,289,2633
Alabama,Uniontown,2841,521,510,336,131,41,1539
Alabama,Uriah,278,43,100,66,28,28,265
Alabama,West Blocton,1359,184,333,290,60,49,916
Alabama,Weogufka,292,70,52,38,0,0,160
Alabama,Wedowee,714,171,229,87,57,27,571
Alabama,Webb,1287,210,435,232,37,41,955
Alabama,Trussville,20351,521,3436,4449,3624,1957,13987
Alabama,Weaver,3072,361,627,909,243,104,2244
Alabama,Waterloo,143,28,26,34,16,2,106
Alabama,Warrior,3191,306,1069,817,68,71,2331
Alabama,Valley,9444,952,2351,2137,626,224,6290
Alabama,Valley Grande,3912,361,815,900,271,221,2568
Alabama,Valley Head,587,108,163,125,30,18,444
Alabama,Walnut Grove,910,167,172,135,44,11,529
Alabama,Vance,1302,108,365,251,125,48,897
Alabama,Waldo,246,44,97,25,10,6,182
Alabama,Wadley,809,92,126,82,33,19,352
Alabama,Vredenburgh,154,30,62,21,0,0,113
Alabama,Vinegar Bend,214,43,19,30,29,0,121
Alabama,Vincent,2032,319,579,415,89,16,1418
Alabama,Vina,335,105,76,55,10,0,246
Alabama,Vandiver,1020,182,353,148,28,45,756
Alabama,Waverly,266,56,58,44,17,41,216
Alabama,Troy,18696,1588,2875,2005,1956,1347,9771
Alabama,Vestavia Hills,34116,652,2340,5143,8363,7346,23844
Alabama,Triana,578,79,152,95,77,22,425
Alabama,Springville,4174,254,1115,683,534,278,2864
Alabama,Stevenson,2194,250,612,354,118,28,1362
Alabama,Stewartville,1956,371,591,343,45,63,1413
Alabama,Stockton,748,46,61,221,62,141,531
Alabama,Sulligent,1956,368,555,336,84,71,1414
Alabama,Sumiton,2689,261,545,673,163,108,1750
Alabama,Summerdale,986,97,214,242,81,28,662
Alabama,Susan Moore,731,128,173,163,23,24,511
Alabama,Sweet Water,304,14,52,49,62,9,186
Alabama,Sylacauga,12749,1437,2849,2518,949,479,8232
Alabama,Trinity,2239,98,540,602,218,104,1562
Alabama,Sylvan Springs,1729,172,556,442,91,51,1312
Alabama,Talladega,15931,2861,4091,2563,731,729,10975
Alabama,Talladega Springs,224,28,53,45,9,6,141
Alabama,Sylvania,2119,215,551,383,96,67,1312
Alabama,Tarrant,6278,931,1656,1338,289,139,4353
Alabama,Taylor,2880,277,596,562,152,106,1693
Alabama,Theodore,5942,562,1531,1189,407,157,3846
Alabama,Trafford,601,82,237,80,21,8,428
Alabama,Thomaston,268,21,76,61,26,13,197
Alabama,Thomasville,4099,539,829,1074,432,194,3068
Alabama,Toxey,182,16,47,32,13,3,111
Alabama,Town Creek,998,107,287,156,56,32,638
Alabama,Tallassee,5380,403,1537,1092,341,253,3626
Alabama,Tillmans Corner,19065,2183,4529,3605,1394,484,12195
Alabama,Thorsby,2140,277,526,359,216,56,1434
Alabama,Tibbie,24,0,0,11,7,0,18
Alabama,Tidmore Bend,1170,163,309,285,74,9,840
Alaska,Toksook Bay,549,69,126,62,13,13,283
Alaska,Tonsina,30,0,0,30,0,0,30
Alaska,Tolsona,0,0,0,0,0,0,0
Alaska,Teller,165,32,48,12,0,0,92
Alaska,Tenakee Springs,150,5,41,43,29,5,123
Alaska,Tetlin,121,10,21,26,0,1,58
Alaska,Tok,1331,76,253,401,63,48,841
Alaska,Thorne Bay,566,17,139,145,68,41,410
Alaska,Togiak,787,97,152,114,19,10,392
Alaska,Tazlina,358,23,94,79,20,17,233
Alaska,Mekoryuk,174,23,65,23,3,2,116
Alaska,South Naknek,63,13,16,22,2,2,55
Alaska,Tanana,277,26,93,49,17,2,187
Alaska,Mentasta Lake,157,26,52,9,0,0,87
Alaska,Mertarvik,0,0,0,0,0,0,0
Alaska,Trapper Creek,432,17,103,128,29,23,300
Alaska,Meadow Lakes,7424,453,1857,1840,441,136,4727
Alaska,Marshall,350,24,91,55,2,0,172
Alaska,Manokotak,691,50,193,100,33,24,400
Alaska,Manley Hot Springs,84,8,29,17,6,0,60
Alaska,Soldotna,4409,183,732,1216,403,304,2838
Alaska,Mendeltna,22,0,0,0,0,15,15
Alaska,South Van Horn,581,74,194,107,36,2,413
Alaska,Stebbins,547,66,102,80,3,6,257
Alaska,Steele Creek,6272,207,812,1679,1010,686,4394
Alaska,Sterling,6054,228,1554,1689,362,302,4135
Alaska,Stevens Village,25,4,16,0,0,0,20
Alaska,Stony River,40,8,6,2,0,0,16
Alaska,Sunrise,15,0,0,6,9,0,15
Alaska,Susitna,0,0,0,0,0,0,0
Alaska,Susitna North,1404,125,335,367,145,134,1106
Alaska,Sutton-Alpine,1602,181,399,488,67,31,1166
Alaska,Takotna,49,5,8,16,0,0,29
Alaska,Talkeetna,616,56,114,158,98,52,478
Alaska,Tanacross,127,18,45,24,0,0,87
Alaska,Tanaina,9640,431,1733,2289,759,385,5597
Alaska,Tatitlek,86,7,23,14,7,0,51
Alaska,Haines,1955,65,387,490,285,177,1404
Alaska,Salcha,984,14,95,246,156,52,563
Alaska,Gulkana,115,6,36,17,6,3,68
Alaska,Evansville,16,3,0,6,5,0,14
Alaska,Eureka Roadhouse,0,0,0,0,0,0,0
Alaska,Ester,3008,93,366,807,314,295,1875
Alaska,Emmonak,835,71,212,129,15,15,442
Alaska,Elim,328,23,92,55,4,2,176
Alaska,Elfin Cove,24,0,9,7,3,0,19
Alaska,Ekwok,78,15,16,10,0,0,41
Alaska,Eielson AFB,2630,36,111,587,149,168,1051
Alaska,Egegik,68,5,40,9,2,0,56
Alaska,Eek,455,63,88,46,3,1,201
Alaska,Excursion Inlet,40,4,0,14,4,8,30
Alaska,Edna Bay,0,0,0,0,0,0,0
Alaska,Eagle,89,5,25,16,7,1,54
Alaska,Dry Creek,84,0,12,21,8,4,45
Alaska,Dot Lake Village,54,13,15,9,0,0,37
Alaska,Dot Lake,0,0,0,0,0,0,0
Alaska,Diomede,43,8,8,6,0,0,22
Alaska,Metlakatla,1661,94,438,419,63,32,1046
Alaska,Dillingham,2307,90,459,522,224,103,1398
Alaska,Diamond Ridge,1140,24,178,265,212,125,804
Alaska,Deltana,2311,89,513,630,117,92,1441
Alaska,Delta Junction,1045,30,162,286,136,45,659
Alaska,Eagle Village,17,3,5,9,0,0,17
Alaska,Gustavus,496,19,75,125,146,71,436
Alaska,Fairbanks,32193,1588,4896,7269,3051,1279,18083
Alaska,Farmers Loop,4149,31,480,1194,612,476,2793
Alaska,Grayling,171,24,43,12,2,0,81
Alaska,Goodnews Bay,230,48,56,12,0,0,116
Alaska,Golovin,132,7,27,34,5,0,73
Alaska,Goldstream,3862,73,311,860,598,885,2727
Alaska,Glennallen,366,11,51,22,38,74,196
Alaska,Glacier View,249,18,29,77,43,16,183
Alaska,Gateway,5610,143,880,1578,657,385,3643
Alaska,Game Creek,36,0,0,7,7,0,14
Alaska,Gambell,718,113,186,80,22,8,409
Alaska,Galena,554,48,86,112,67,40,353
Alaska,False Pass,37,0,9,17,2,3,31
Alaska,Gakona,205,7,14,27,41,9,98
Alaska,Fritz Creek,1910,102,306,512,297,185,1402
Alaska,Fox River,649,162,45,27,27,0,261
Alaska,Fox,558,0,92,166,161,32,451
Alaska,Four Mile Road,10,5,0,5,0,0,10
Alaska,Fort Yukon,555,78,131,103,12,17,341
Alaska,Fort Greely,391,0,48,63,34,10,155
Alaska,Flat,0,0,0,0,0,0,0
Alaska,Fishhook,5323,182,1040,1064,727,278,3291
Alaska,Ferry,6,0,0,6,0,0,6
Alaska,Farm Loop,1081,56,193,287,100,97,733
Alaska,Funny River,776,35,165,248,108,56,612
Alaska,Minto,257,34,87,24,4,3,152
Alaska,Old Harbor,249,45,49,66,5,4,169
Alaska,Moose Pass,428,19,196,67,21,17,320
Alaska,Anchorage municip,299107,13276,45700,67484,39642,23198,189300
Alaska,Anchor Point,1951,91,448,668,193,73,1473
Alaska,Anderson,201,2,31,73,23,15,144
Alaska,Angoon,382,36,107,78,23,26,270
Alaska,Aniak,525,51,134,71,35,23,314
Alaska,Anvik,87,3,21,22,4,2,52
Alaska,Arctic Village,138,21,21,27,2,13,84
Alaska,Atka,66,6,31,14,0,6,57
Alaska,Atmautluak,258,39,67,23,2,0,131
Alaska,Atqasuk,159,21,39,20,7,0,87
Alaska,Attu Station,16,0,0,5,0,0,5
Alaska,Badger,21197,477,3829,5376,2231,650,12563
Alaska,Barrow,4293,351,861,760,184,121,2277
Alaska,Bear Creek,1824,90,534,302,261,8,1195
Alaska,Beaver,60,16,18,19,0,0,53
Alaska,Beluga,6,2,2,2,0,0,6
Alaska,Bethel,6370,537,1395,999,545,313,3789
Alaska,Bettles,22,0,8,8,0,6,22
Alaska,Big Delta,539,9,209,94,51,12,375
Alaska,Big Lake,3815,238,874,968,301,108,2489
Alaska,Birch Creek,1,1,0,0,0,0,1
Alaska,Akiak,399,38,91,64,3,7,203
Alaska,Akiachak,562,69,114,92,21,0,296
Alaska,Anaktuvuk Pass,247,22,65,20,0,8,115
Alaska,Akhiok,84,18,12,16,2,0,48
Alaska,Ambler,280,33,80,38,3,1,155
Alaska,Aleneva,59,17,0,0,0,0,17
Alaska,Port Alexander,31,0,6,10,4,0,20
Alaska,Northway Village,92,23,38,1,0,0,62
Alaska,Northway Junction,64,2,15,8,5,0,30
Alaska,Northway,131,11,23,22,24,0,80
Alaska,Port Alsworth,147,4,10,36,24,1,75
Alaska,Port Clarence,40,0,8,0,0,0,8
Alaska,Port Graham,206,8,76,26,7,1,118
Alaska,Port Heiden,81,5,25,13,6,1,50
Alaska,Port Lions,231,25,69,62,7,4,167
Alaska,Port Protection,82,0,24,28,19,11,82
Alaska,Primrose,73,0,32,35,6,0,73
Alaska,Prudhoe Bay,2724,91,807,1180,379,60,2517
Alaska,Quinhagak,661,117,169,51,12,2,351
Alaska,Rampart,7,7,0,0,0,0,7
Alaska,Red Devil,22,5,5,5,0,0,15
Alaska,Red Dog Mine,81,7,4,54,4,8,77
Alaska,Ridgeway,2195,55,347,682,274,180,1538
Alaska,Ruby,202,19,56,29,4,5,113
Alaska,Russian Mission,410,41,74,40,9,8,172
Alaska,St. George,53,4,32,8,1,0,45
Alaska,Alatna,1,0,1,0,0,0,1
Alaska,Alcan Border,51,0,0,7,0,7,14
Alaska,Aleknagik,199,21,51,47,8,4,131
Alaska,Allakaket,77,13,17,11,3,4,48
Alaska,Nuiqsut,345,57,68,33,3,3,164
Alaska,Nulato,285,30,82,47,5,10,174
Alaska,Nunam Iqua,129,29,29,11,4,4,77
Alaska,Noatak,443,33,147,37,0,1,218
Alaska,Ninilchik,728,32,212,206,87,44,581
Alaska,Nikolski,37,2,15,6,3,0,26
Alaska,Nikolai,113,19,43,18,0,0,80
Alaska,Nikolaevsk,234,25,52,70,14,3,164
Alaska,Nikiski,4549,263,1229,1220,408,145,3265
Alaska,Nightmute,259,45,59,24,3,3,134
Alaska,Newtok,388,48,94,31,2,0,175
Alaska,New Stuyahok,609,71,149,68,6,1,295
Alaska,Newhalen,159,5,30,20,9,5,69
Alaska,New Allakaket,67,10,10,16,0,0,36
Alaska,Nenana,406,62,84,120,27,1,294
Alaska,Nelson Lagoon,42,17,15,6,2,0,40
Alaska,Nelchina,170,14,42,25,0,0,81
Alaska,Naukati Bay,32,8,19,0,0,0,27
Alaska,Napaskiak,408,47,87,54,3,5,196
Alaska,Napakiak,352,45,86,33,0,0,164
Alaska,Nanwalek,238,2,48,40,7,4,101
Alaska,Naknek,567,25,108,168,66,21,388
Alaska,Nabesna,0,0,0,0,0,0,0
Alaska,Mud Bay,167,7,12,24,76,33,152
Alaska,Mountain Village,749,74,160,91,7,1,333
Alaska,Mosquito Lake,126,12,66,27,10,0,115
Alaska,Nome,3773,165,776,780,390,118,2229
Alaska,Nondalton,182,15,50,30,3,0,98
Alaska,Noorvik,608,71,161,49,3,3,287
Alaska,North Pole,2265,107,350,557,204,141,1359
Alaska,Nunapitchuk,554,63,125,49,2,0,239
Alaska,Deering,144,10,50,15,5,3,83
Alaska,Oscarville,22,4,2,2,2,0,10
Alaska,Ouzinkie,230,30,39,51,2,7,129
Alaska,Palmer,6449,329,1215,1444,533,264,3785
Alaska,Paxson,38,0,22,0,11,0,33
Alaska,Pedro Bay,12,1,2,5,3,0,11
Alaska,Pelican,79,13,25,17,6,0,61
Alaska,Perryville,98,13,26,5,0,2,46
Alaska,Petersburg,3024,131,618,769,398,122,2038
Alaska,Petersville,0,0,0,0,0,0,0
Alaska,Moose Creek,728,53,77,123,41,74,368
Alaska,Pilot Point,53,10,12,8,0,2,32
Alaska,Pitkas Point,136,15,35,15,2,0,67
Alaska,Platinum,42,7,13,1,0,0,21
Alaska,Pleasant Valley,168,0,20,82,22,0,124
Alaska,Point Baker,41,0,14,27,0,0,41
Alaska,Point Hope,562,48,128,102,11,4,293
Alaska,Point Lay,285,28,50,28,7,2,115
Alaska,Point MacKenzie,466,41,180,130,15,8,374
Alaska,Point Possession,0,0,0,0,0,0,0
Alaska,Pope-Vannoy Landing,0,0,0,0,0,0,0
Alaska,Portage Creek,0,0,0,0,0,0,0
Alaska,Adak,122,5,38,25,3,5,76
Alaska,Pilot Station,582,77,147,52,5,0,281
Alaska,Crown Point,132,0,29,5,57,0,91
Alaska,Central,58,8,19,8,10,0,45
Alaska,Craig,1231,92,321,247,129,71,860
Alaska,Halibut Cove,23,0,0,7,3,12,22
Alaska,Happy Valley,607,42,223,161,53,9,488
Alaska,Harding-Birch Lakes,142,6,28,39,22,15,110
Alaska,Healy,1120,46,172,270,152,78,718
Alaska,Healy Lake,0,0,0,0,0,0,0
Alaska,Hobart Bay,0,0,0,0,0,0,0
Alaska,Hollis,124,11,34,32,16,12,105
Alaska,Holy Cross,214,17,68,34,1,2,122
Alaska,Homer,5324,142,826,1386,699,448,3501
Alaska,Yakutat,597,24,150,151,52,15,392
Alaska,Hoonah,821,71,220,205,46,35,577
Alaska,Hope,50,0,41,5,0,0,46
Alaska,Houston,1977,128,485,532,111,52,1308
Alaska,Hughes,62,2,17,8,0,0,27
Alaska,Huslia,420,14,86,87,14,3,204
Alaska,Hydaburg,277,19,99,54,13,6,191
Alaska,Hyder,13,6,0,7,0,0,13
Alaska,Igiugig,49,3,8,18,2,0,31
Alaska,Iliamna,78,6,13,26,2,6,53
Alaska,Ivanof Bay,0,0,0,0,0,0,0
Alaska,Hooper Bay,1140,117,244,99,8,0,468
Alaska,Wrangell city and borough,2387,179,647,631,262,99,1818
Alaska,Womens Bay,852,34,145,234,132,27,572
Alaska,Wiseman,11,0,7,0,0,0,7
Alaska,Tuntutuliak,466,78,79,54,5,1,217
Alaska,Tununak,294,30,81,47,5,1,164
Alaska,Twin Hills,95,14,25,16,0,0,55
Alaska,Two Rivers,238,0,13,23,94,47,177
Alaska,Tyonek,214,8,74,28,7,2,119
Alaska,Ugashik,19,0,10,3,0,6,19
Alaska,Unalakleet,710,32,193,162,56,28,471
Alaska,Unalaska,4619,540,1077,1053,352,125,3147
Alaska,Upper Kalskag,284,32,66,35,1,3,137
Alaska,Valdez,3979,101,655,1166,497,167,2586
Alaska,Venetie,177,44,54,19,0,0,117
Alaska,Wainwright,458,46,117,74,2,0,239
Alaska,Wales,155,18,44,16,4,0,82
Alaska,Wasilla,8676,426,1598,2262,600,285,5171
Alaska,Whale Pass,16,0,16,0,0,0,16
Alaska,White Mountain,179,15,41,36,6,5,103
Alaska,Whitestone,195,53,15,71,19,18,176
Alaska,Whitestone Logging Camp,0,0,0,0,0,0,0
Alaska,Whittier,295,17,53,77,32,12,191
Alaska,Willow,2085,156,462,534,271,68,1491
Alaska,Willow Creek,8,0,0,8,0,0,8
Alaska,Juneau city and borough,32531,1157,4702,7831,5455,3124,22269
Alaska,Kachemak,551,32,66,168,106,59,431
Alaska,Kake,628,59,182,131,21,21,414
Alaska,Kaktovik,155,19,37,24,1,0,81
Alaska,Kotzebue,3283,321,643,575,220,113,1872
Alaska,Koyuk,272,22,55,43,3,2,125
Alaska,Koyukuk,80,9,32,6,2,2,51
Alaska,Kupreanof,40,0,9,6,6,4,25
Alaska,Kwethluk,824,87,157,111,6,0,361
Alaska,Kwigillingok,331,35,75,50,5,0,165
Alaska,Lake Louise,45,12,18,15,0,0,45
Alaska,Lake Minchumina,21,2,0,8,3,4,17
Alaska,Lakes,9028,284,1641,2662,711,501,5799
Alaska,Larsen Bay,61,10,12,19,3,3,47
Alaska,Lazy Mountain,1637,27,211,398,175,124,935
Alaska,Levelock,114,5,23,15,0,1,44
Alaska,Lime Village,7,5,0,0,2,0,7
Alaska,Livengood,10,0,0,10,0,0,10
Alaska,Loring,0,0,0,0,0,0,0
Alaska,Lowell Point,141,0,80,61,0,0,141
Alaska,Lower Kalskag,317,38,115,21,0,3,177
Alaska,Lutak,13,0,13,0,0,0,13
Alaska,McCarthy,107,11,0,10,22,0,43
Alaska,McGrath,346,13,83,69,28,12,205
Alaska,McKinley Park,514,10,63,113,138,22,346
Alaska,Kotlik,643,84,167,51,6,17,325
Alaska,Tuluksak,436,54,124,30,3,0,211
Alaska,Kongiganak,408,41,111,44,3,0,199
Alaska,Kokhanok,145,13,36,20,11,4,84
Alaska,Kalifornsky,7965,182,1582,2141,761,296,4962
Alaska,Kaltag,192,18,78,28,2,6,132
Alaska,Karluk,44,3,10,7,0,0,20
Alaska,Kasaan,71,4,14,21,0,2,41
Alaska,Kasigluk,599,92,138,57,1,0,288
Alaska,Kasilof,388,0,84,81,40,38,243
Alaska,Kenai,7463,509,1796,1550,576,523,4954
Alaska,Kenny Lake,128,0,45,11,15,8,79
Alaska,Ketchikan,8197,551,1786,1919,843,372,5471
Alaska,Kiana,380,52,103,41,14,8,218
Alaska,King Cove,1074,108,348,235,133,26,850
Alaska,King Salmon,340,14,75,78,20,19,206
Alaska,Kipnuk,686,83,199,64,5,0,351
Alaska,Kivalina,576,95,123,46,4,0,268
Alaska,Klawock,792,75,294,132,28,14,543
Alaska,Klukwan,66,7,15,14,11,5,52
Alaska,Knik-Fairview,16017,872,3441,3791,1219,616,9939
Alaska,Knik River,765,37,156,220,75,42,530
Alaska,Kobuk,159,17,34,8,0,2,61
Alaska,Kodiak,6293,507,1176,1381,741,130,3935
Alaska,Kodiak Station,1398,20,95,397,144,53,709
Alaska,Koliganek,129,15,22,22,4,3,66
Alaska,Crooked Creek,98,10,21,13,8,0,52
Alaska,Akutan,899,208,271,206,85,0,770
Alaska,Cantwell,209,8,59,59,24,9,159
Alaska,Shaktoolik,223,25,78,17,9,0,129
Alaska,Shishmaref,573,58,146,72,4,8,288
Alaska,Shungnak,342,50,88,25,0,0,163
Alaska,Silver Springs,168,11,16,35,35,21,118
Alaska,Sitka city and borough,8943,446,1362,2441,1155,769,6173
Alaska,Skagway,957,21,221,249,202,64,757
Alaska,Skwentna,42,0,15,18,0,0,33
Alaska,Slana,84,14,17,0,21,0,52
Alaska,Sleetmute,96,11,15,8,5,6,45
Alaska,Chiniak,23,0,9,14,0,0,23
Alaska,Chignik Lake,70,14,14,12,2,2,44
Alaska,Shageluk,43,4,13,9,4,1,31
Alaska,Chignik Lagoon,73,8,19,13,7,3,50
Alaska,Chicken,0,0,0,0,0,0,0
Alaska,Chickaloon,284,20,54,104,33,31,242
Alaska,Chevak,1082,90,275,131,25,3,524
Alaska,Chenega,66,0,29,8,8,0,45
Alaska,Chena Ridge,5473,131,572,1124,1160,801,3788
Alaska,Chefornak,516,59,117,49,2,3,230
Alaska,Brevig Mission,442,42,105,43,1,0,191
Alaska,Buckland,596,33,138,45,17,6,239
Alaska,Buffalo Soapstone,827,44,138,133,102,39,456
Alaska,Butte,3854,143,739,968,421,218,2489
Alaska,Chase,23,8,15,0,0,0,23
Alaska,Chignik,70,0,19,22,0,4,45
Alaska,Seward,2710,130,981,686,250,71,2118
Alaska,Seldovia Village,174,11,27,73,20,17,148
Alaska,Seldovia,243,9,44,81,30,36,200
Alaska,Covenant Life,105,0,15,9,57,7,88
Alaska,Cordova,2621,161,464,605,461,222,1913
Alaska,Copper Center,405,38,77,99,14,22,250
Alaska,Cooper Landing,457,17,73,47,122,105,364
Alaska,College,14675,483,1857,3360,2016,1681,9397
Alaska,Coldfoot,10,3,4,3,0,0,10
Alaska,Cold Bay,46,1,19,13,5,2,40
Alaska,Cohoe,1577,52,354,382,144,110,1042
Alaska,Coffman Cove,150,11,70,36,18,0,135
Alaska,Clark's Point,56,8,12,11,0,0,31
Alaska,Clam Gulch,182,19,22,48,11,21,121
Alaska,Circle,118,32,18,17,3,0,70
Alaska,Chuathbaluk,116,4,32,4,10,0,50
Alaska,Chitina,80,8,6,27,5,0,46
Alaska,Chistochina,59,8,24,5,2,1,40
Alaska,Chisana,0,0,0,0,0,0,0
Alaska,St. Mary's,583,52,129,102,43,0,326
Alaska,St. Michael,396,36,95,32,8,2,173
Alaska,St. Paul,576,70,200,75,21,24,390
Alaska,Salamatof,1110,98,341,282,37,26,784
Alaska,Sand Point,1188,119,322,234,79,17,771
Alaska,Savoonga,883,156,179,56,8,5,404
Alaska,Saxman,401,38,133,87,25,12,295
Alaska,Scammon Bay,488,48,95,41,4,3,191
Alaska,Selawik,794,121,173,52,6,6,358
Alaska,Alakanuk,777,110,151,53,3,1,318
Alaska,Chalkyitsik,101,6,24,18,3,2,53
Arizona,Houck,1152,246,300,158,9,11,724
Arizona,Central Heights-Midland City,3030,586,588,591,161,185,2111
Arizona,Cornville,2708,396,707,669,235,262,2269
Arizona,Corona de Tucson,7023,173,706,2056,928,515,4378
Arizona,Cottonwood,178,16,34,34,10,10,104
Arizona,Cottonwood,11493,1282,2428,3203,1129,442,8484
Arizona,Cowlic,90,0,8,9,0,0,17
Arizona,Crozier,24,3,11,7,1,0,22
Arizona,Crystal Beach,160,36,47,61,9,0,153
Arizona,Cutter,64,0,0,34,13,0,47
Arizona,Dateland,249,26,77,40,11,9,163
Arizona,Deer Creek,204,14,58,53,30,3,158
Arizona,Jakes Corner,41,12,0,29,0,0,41
Arizona,Indian Wells,212,40,47,33,1,0,121
Arizona,Icehouse Canyon,736,55,138,214,20,34,461
Arizona,Haigler Creek,27,0,15,12,0,0,27
Arizona,Haivana Nakya,203,35,20,21,7,0,83
Arizona,Hard Rock,80,13,9,13,0,8,43
Arizona,Hayden,600,67,157,182,12,0,418
Arizona,Heber-Overgaard,2594,426,546,578,262,35,1847
Arizona,Hunter Creek,0,0,0,0,0,0,0
Arizona,Hondah,1118,105,162,213,62,25,567
Arizona,Hotevilla-Bacavi,1091,102,279,243,28,38,690
Arizona,Cornfields,300,55,39,38,34,2,168
Arizona,Cordes Lakes,2642,430,752,699,167,75,2123
Arizona,Copper Hill,18,0,0,18,0,0,18
Arizona,Coolidge,11973,1493,2517,2869,570,286,7735
Arizona,Chandler,250202,13687,27841,54128,41095,25055,161806
Arizona,Charco,16,10,6,0,0,0,16
Arizona,Chiawuli Tak,42,0,17,0,0,0,17
Arizona,Chilchinbito,839,90,170,95,27,0,382
Arizona,Chinle,4947,413,611,1040,183,203,2450
Arizona,Chino Valley,10961,1040,2367,3340,880,382,8009
Arizona,Chloride,182,6,79,58,17,4,164
Arizona,Christopher Creek,37,0,5,32,0,0,37
Arizona,Chuichu,221,68,49,49,0,0,166
Arizona,Cibecue,1848,396,296,226,15,15,948
Arizona,Huachuca City,2160,134,455,544,106,40,1279
Arizona,Cibola,393,142,108,21,0,10,281
Arizona,Citrus Park,4451,210,681,1320,633,301,3145
Arizona,Clacks Canyon,113,0,10,48,23,0,81
Arizona,Clarkdale,4132,183,915,1565,457,316,3436
Arizona,Claypool,1843,250,346,503,74,34,1207
Arizona,Clay Springs,503,36,72,101,0,0,209
Arizona,Clifton,3500,347,700,707,153,50,1957
Arizona,Colorado City,4808,943,267,327,104,18,1659
Arizona,Comobabi,49,8,0,10,0,0,18
Arizona,Concho,238,27,33,66,0,0,126
Arizona,Congress,1255,114,245,538,148,38,1083
Arizona,Cienega Springs,1798,190,436,625,112,31,1394
Arizona,Holbrook,4993,372,1085,1279,316,184,3236
Arizona,Bylas,1834,241,386,225,17,0,869
Arizona,Yucca,69,11,25,25,0,0,61
Arizona,Mammoth,1532,350,276,278,24,30,958
Arizona,Maish Vaya,133,21,33,26,3,0,83
Arizona,McNeal,274,9,57,69,43,18,196
Arizona,McNary,634,60,102,114,6,12,294
Arizona,McConnico,0,0,0,0,0,0,0
Arizona,Lupton,3,0,0,3,0,0,3
Arizona,Many Farms,1667,160,252,268,107,84,871
Arizona,Lukachukai,1803,216,269,327,35,24,871
Arizona,Lower Santan Village,688,156,177,45,0,0,378
Arizona,Littletown,436,34,121,76,36,0,267
Arizona,Littlefield,228,21,0,129,0,0,150
Arizona,Litchfield Park,5253,226,573,1433,729,922,3883
Arizona,Linden,2536,131,441,881,213,64,1730
Arizona,Leupp,1059,149,145,246,47,25,612
Arizona,Low Mountain,750,138,106,147,6,10,407
Arizona,Marana,38280,1514,4804,9063,6752,3696,25829
Arizona,Maricopa,45748,2463,7998,11741,5118,2377,29697
Arizona,Maricopa Colony,746,96,44,119,17,35,311
Arizona,Morenci,1649,53,284,448,105,35,925
Arizona,Mojave Ranch Estates,41,4,11,9,3,0,27
Arizona,Mohave Valley,2983,347,884,712,110,15,2068
Arizona,Moenkopi,1114,65,381,227,39,17,729
Arizona,Moccasin,55,5,27,0,0,23,55
Arizona,Miracle Valley,515,97,31,187,18,0,333
Arizona,Miami,2052,303,473,414,62,80,1332
Arizona,Mesquite Creek,508,74,179,171,20,12,456
Arizona,Mescal,1652,162,254,616,197,78,1307
Arizona,Mesa del Caballo,705,69,163,140,28,40,440
Arizona,Mesa,458860,37456,78688,109856,49290,25526,300816
Arizona,Meadview,677,72,245,259,60,41,677
Arizona,Mead Ranch,28,0,3,3,10,0,16
Arizona,Mayer,1269,99,351,401,54,14,919
Arizona,Martinez Lake,54,0,18,9,7,9,43
Arizona,LeChee,1542,163,290,307,23,22,805
Arizona,Youngtown,6405,724,1416,1487,402,155,4184
Arizona,Lazy Y U,648,12,66,192,84,7,361
Arizona,Lake of the Woods,4363,643,579,1079,387,217,2905
Arizona,Jerome,388,10,61,109,97,44,321
Arizona,Jeddito,311,31,43,48,11,4,137
Arizona,Morristown,97,3,50,30,8,6,97
Arizona,Hackberry,94,10,36,37,3,0,86
Arizona,Mountainaire,1219,44,117,263,280,156,860
Arizona,Munds Park,660,0,46,200,236,117,599
Arizona,Joseph City,1184,48,172,306,41,5,572
Arizona,Naco,1013,144,182,103,44,43,516
Arizona,Nelson,520,42,92,91,13,19,257
Arizona,New Kingman-Butler,11859,1815,2999,3022,332,154,8322
Arizona,New River,15289,542,2774,4998,2296,852,11462
Arizona,Nogales,20601,4471,3208,2602,1196,493,11970
Arizona,Nolic,0,0,0,0,0,0,0
Arizona,Yuma,93812,12601,14442,19424,5911,3582,55960
Arizona,Nazlini,483,67,99,79,4,0,249
Arizona,Kachina Village,2638,86,337,737,525,232,1917
Arizona,Kaibab,147,22,15,43,0,0,80
Arizona,Kaibito,1611,255,283,190,23,6,757
Arizona,Lake Montezuma,5970,683,1045,1761,515,481,4485
Arizona,Lake Havasu City,53010,4669,14738,15726,3368,2254,40755
Arizona,Kykotsmovi Village,843,17,211,220,73,10,531
Arizona,Ko Vaya,24,0,5,8,3,0,16
Arizona,Komatke,1458,247,214,107,22,5,595
Arizona,Kohls Ranch,103,0,36,58,0,9,103
Arizona,Kohatk,21,21,0,0,0,0,21
Arizona,Klagetoh,291,40,56,62,12,0,170
Arizona,Kino Springs,247,12,30,50,16,19,127
Arizona,Kingman,28511,2648,7020,7719,1756,1173,20316
Arizona,Kearny,2312,183,635,559,76,38,1491
Arizona,Keams Canyon,203,44,17,63,11,17,152
Arizona,Kayenta,4702,336,900,714,291,292,2533
Arizona,Katherine,103,6,19,76,0,0,101
Arizona,Kaka,123,28,43,5,0,0,76
Arizona,La Paz Valley,469,105,238,126,0,0,469
Arizona,Gu Oidak,123,22,35,28,0,17,102
Arizona,Cameron,1199,184,275,146,12,20,637
Arizona,Greer,46,0,0,23,23,0,46
Arizona,Verde Village,12532,1212,2424,3537,846,544,8563
Arizona,Vernon,36,0,0,0,36,0,36
Arizona,Vicksburg,1043,291,286,172,50,20,819
Arizona,Village of Oak Creek (Big Park),6336,313,1076,1893,1701,679,5662
Arizona,Wagon Wheel,1340,115,230,436,134,121,1036
Arizona,Wahak Hotrontk,126,6,32,15,4,0,57
Arizona,Wall Lane,775,239,56,61,40,0,396
Arizona,Walnut Creek,465,17,160,221,13,0,411
Arizona,Ventana,96,8,28,0,0,0,36
Arizona,Washington Park,124,0,74,50,0,0,124
Arizona,Wellton Hills,229,0,97,76,13,0,186
Arizona,Wenden,470,153,94,65,28,4,344
Arizona,Wet Camp Village,333,101,35,24,2,0,162
Arizona,Wheatfields,821,105,216,161,14,11,507
Arizona,Whetstone,2926,230,388,1041,296,107,2062
Arizona,Whispering Pines,198,0,87,34,16,0,137
Arizona,Whitecone,930,187,121,183,7,11,509
Arizona,White Hills,379,82,119,136,9,0,346
Arizona,Wellton,2942,388,963,829,204,149,2533
Arizona,Valle Vista,1988,123,464,499,264,162,1512
Arizona,Valle,310,62,5,24,0,0,91
Arizona,Valentine,68,32,3,14,0,2,51
Arizona,Tonto Village,165,0,20,75,30,6,131
Arizona,Topawa,268,26,44,64,7,0,141
Arizona,Topock,14,0,0,14,0,0,14
Arizona,Top-of-the-World,217,48,45,52,18,8,171
Arizona,Toyei,0,0,0,0,0,0,0
Arizona,Truxton,191,19,53,36,2,0,110
Arizona,Tsaile,1198,94,88,188,56,25,451
Arizona,Tubac,1249,9,107,347,343,327,1133
Arizona,Tuba City,9772,641,1820,1958,496,470,5385
Arizona,Tucson,528374,52021,78903,114642,49462,33485,328513
Arizona,Tucson Estates,12079,1105,2806,3836,1004,526,9277
Arizona,Tumacacori-Carmen,420,46,112,68,30,54,310
Arizona,Turkey Creek,405,52,47,69,5,0,173
Arizona,Tusayan,355,32,85,124,47,0,288
Arizona,Upper Santan Village,470,77,99,26,0,0,202
Arizona,Utting,120,66,18,9,9,0,102
Arizona,Vail,11143,347,1351,3015,1590,701,7004
Arizona,Vaiva Vo,36,6,6,0,0,0,12
Arizona,Valencia West,10331,1100,1787,2557,540,291,6275
Arizona,White Mountain Lake,2241,319,554,511,61,35,1480
Arizona,Whiteriver,4766,639,964,647,40,18,2308
Arizona,Why,184,15,14,118,20,5,172
Arizona,Wickenburg,6620,542,1548,2001,809,378,5278
Arizona,Peach Springs,1010,145,168,183,19,9,524
Arizona,Peeples Valley,523,22,144,156,32,25,379
Arizona,Peoria,163664,8324,27558,41525,20189,11278,108874
Arizona,Peridot,1687,218,381,157,30,42,828
Arizona,Phoenix,1514208,183605,225881,286957,164015,89935,950393
Arizona,Picacho,296,78,85,60,17,3,243
Arizona,Guadalupe,6012,1345,1118,856,141,6,3466
Arizona,Pima,2440,164,365,585,157,78,1349
Arizona,Pimaco Two,435,62,175,185,13,0,435
Arizona,Pinal,486,54,95,67,48,19,283
Arizona,Pine,1147,60,211,381,273,172,1097
Arizona,Pinedale,588,33,76,95,20,37,261
Arizona,Pine Lake,73,0,0,57,0,0,57
Arizona,Pinetop Country Club,1635,39,142,512,403,310,1406
Arizona,Six Shooter Canyon,985,83,185,286,44,58,656
Arizona,Snowflake,5604,285,667,1617,358,116,3043
Arizona,So-Hi,197,34,81,44,0,38,197
Arizona,Solomon,260,56,77,49,9,0,191
Arizona,Somerton,14845,3821,1657,1742,292,280,7792
Arizona,Payson,15248,1442,3459,4642,1657,1124,12324
Arizona,Sierra Vista Southeast,15128,585,2152,4713,2080,1443,10973
Arizona,Paulden,4277,505,790,1761,211,52,3319
Arizona,Parks,1462,44,328,540,171,76,1159
Arizona,Wide Ruins,125,67,13,9,0,24,113
Arizona,Wikieup,150,49,23,34,9,0,115
Arizona,Wilhoit,912,146,187,368,31,2,734
Arizona,Willcox,3639,344,913,819,81,99,2256
Arizona,Williams,3065,224,596,734,264,144,1962
Arizona,Williamson,5531,247,651,1988,921,713,4520
Arizona,Willow Canyon,0,0,0,0,0,0,0
Arizona,Willow Valley,872,113,409,196,46,11,775
Arizona,Window Rock,3255,400,708,761,146,147,2162
Arizona,Winkelman,327,34,53,117,11,5,220
Arizona,Winslow,9530,1229,1636,2552,338,259,6014
Arizona,Winslow West,518,91,38,39,16,25,209
Arizona,Wintersburg,97,0,52,0,0,0,52
Arizona,Wittmann,456,12,203,54,0,0,269
Arizona,Woodruff,132,0,38,31,63,0,132
Arizona,Yarnell,543,46,180,211,55,29,521
Arizona,York,881,21,324,170,34,8,557
Arizona,Young,456,35,151,153,60,12,411
Arizona,Cactus Flats,1356,59,343,433,61,0,896
Arizona,Patagonia,708,78,115,202,96,90,581
Arizona,Sierra Vista,44892,1876,4869,12497,5380,2961,27583
Arizona,Show Low,10768,844,2302,3008,872,425,7451
Arizona,Shonto,546,71,110,78,22,32,313
Arizona,Salome,1421,251,330,225,139,55,1000
Arizona,San Carlos,4314,746,826,597,9,42,2220
Arizona,Sanders,606,85,55,78,7,4,229
Arizona,San Jose,728,89,120,137,11,0,357
Arizona,Burnside,543,57,107,80,16,11,271
Arizona,Bullhead City,39424,5041,10110,10304,2377,1267,29099
Arizona,Buckshot,14,7,7,0,0,0,14
Arizona,Buckeye,57165,5549,9911,14220,4378,1342,35400
Arizona,Bryce,72,0,0,11,7,0,18
Arizona,Brenda,429,95,160,135,9,30,429
Arizona,Bowie,366,125,87,79,4,5,300
Arizona,Bouse,711,97,345,140,16,39,637
Arizona,Bluewater,710,115,189,174,51,52,581
Arizona,Blackwater,1247,207,275,147,12,0,641
Arizona,Black Canyon City,2325,185,786,724,165,66,1926
Arizona,Bitter Springs,443,98,96,49,0,0,243
Arizona,Bisbee,5415,514,953,1390,743,442,4042
Arizona,Beyerville,286,48,22,34,3,3,110
Arizona,Benson,5013,463,1061,1527,364,430,3845
Arizona,St. Michaels,1483,145,373,313,70,106,1007
Arizona,Beaver Valley,175,16,59,90,0,10,175
Arizona,St. Johns,633,79,74,113,35,19,320
Arizona,Parker Strip,572,33,190,203,101,24,551
Arizona,Tolleson,6806,1516,1238,926,262,92,4034
Arizona,Tombstone,1510,129,351,512,121,21,1134
Arizona,Tonalea,331,63,40,53,15,13,184
Arizona,Tonopah,19,0,0,19,0,0,19
Arizona,Tonto Basin,1394,98,378,583,78,90,1227
Arizona,North Fork,1701,163,287,412,101,43,1006
Arizona,Nutrioso,74,0,46,28,0,0,74
Arizona,Oak Springs,83,9,8,20,0,3,40
Arizona,Oatman,120,71,17,16,16,0,120
Arizona,Oljato-Monument Valley,250,20,53,58,0,0,131
Arizona,Oracle,3756,385,852,1029,239,304,2809
Arizona,Orange Grove Mobile Manor,685,376,45,8,6,0,435
Arizona,Oro Valley,41965,809,4682,10002,9016,6844,31353
Arizona,Oxbow Estates,103,0,37,22,23,10,92
Arizona,Padre Ranchitos,142,33,0,36,0,0,69
Arizona,Page,7429,587,1211,1734,727,220,4479
Arizona,Palominas,453,0,67,64,8,0,139
Arizona,Paradise Valley,13477,263,929,1690,3287,4066,10235
Arizona,Parker,3068,374,627,702,125,77,1905
Arizona,St. Johns,3512,352,602,1151,129,73,2307
Arizona,Sonoita,958,21,91,208,248,237,805
Arizona,Beaver Dam,1622,363,546,371,64,0,1344
Arizona,Bagdad,1913,137,428,342,121,4,1032
Arizona,Aguila,1066,478,133,36,0,0,647
Arizona,San Luis,30658,9620,1936,3635,1225,152,16568
Arizona,San Manuel,4028,316,797,1038,123,199,2473
Arizona,San Miguel,253,7,41,75,0,10,133
Arizona,San Simon,131,0,34,58,0,0,92
Arizona,Santa Cruz,0,0,0,0,0,0,0
Arizona,San Tan Valley,87923,4869,13633,21459,7032,2859,49852
Arizona,Santa Rosa,562,82,125,79,14,0,300
Arizona,Sawmill,633,102,161,61,20,7,351
Arizona,Scenic,1699,194,581,189,0,110,1074
Arizona,Scottsdale,227471,6675,22966,49869,56968,37066,173544
Arizona,Seba Dalkai,115,44,16,20,3,2,85
Arizona,Second Mesa,1296,129,375,159,23,41,727
Arizona,Sedona,10204,385,1344,2749,2437,1805,8720
Arizona,Sehili,119,16,21,41,0,0,78
Arizona,Seligman,457,56,100,136,31,12,335
Arizona,Sells,2160,238,501,404,33,27,1203
Arizona,Seven Mile,831,111,177,175,23,0,486
Arizona,Shongopovi,997,94,161,240,6,0,501
Arizona,Ajo,3886,548,960,772,286,175,2741
Arizona,Bear Flat,9,0,0,4,0,5,9
Arizona,Ak Chin,33,0,13,5,0,0,18
Arizona,Alamo Lake,4,0,2,2,0,0,4
Arizona,Aztec,2,0,0,2,0,0,2
Arizona,Avra Valley,4736,472,1305,1425,332,164,3698
Arizona,Avondale,78872,9515,11397,15849,5857,2772,45390
Arizona,Avenue B and C,3798,1086,417,560,70,33,2166
Arizona,Ash Fork,650,91,68,93,19,18,289
Arizona,Arlington,77,21,2,36,0,2,61
Arizona,Arizona Village,929,168,259,131,33,17,608
Arizona,Arizona City,8969,517,2001,2202,492,141,5353
Arizona,Arivaca Junction,868,111,53,218,89,34,505
Arizona,Arivaca,587,54,166,118,104,118,560
Arizona,Apache Junction,36586,4009,9514,10467,2406,1210,27606
Arizona,Anthem,22995,478,2323,5314,4450,1869,14434
Arizona,Antares,113,43,35,25,7,0,110
Arizona,Anegam,79,9,25,11,4,0,49
Arizona,Amado,165,43,22,21,26,31,143
Arizona,Alpine,95,13,30,52,0,0,95
Arizona,Ali Molina,131,10,9,9,9,0,37
Arizona,Ali Chukson,108,19,25,0,0,0,44
Arizona,Ali Chuk,149,19,70,19,0,0,108
Arizona,Ak-Chin Village,1193,260,237,125,13,12,647
Arizona,South Komelik,73,0,39,23,0,0,62
Arizona,Picture Rocks,8666,646,2133,2282,662,517,6240
Arizona,Springerville,1995,216,311,486,158,34,1205
Arizona,East Fork,709,245,122,47,0,0,414
Arizona,Rock House,14,0,6,8,0,0,14
Arizona,Rock Point,525,93,95,75,9,18,290
Arizona,Roosevelt,61,7,16,29,9,0,61
Arizona,Rough Rock,553,33,109,97,19,28,286
Arizona,Round Rock,882,142,143,115,23,15,438
Arizona,Round Valley,599,28,186,117,58,53,442
Arizona,Rye,88,39,18,1,1,19,78
Arizona,Sacate Village,135,16,14,14,0,0,44
Arizona,Sacaton,2667,480,645,576,59,9,1769
Arizona,Sacaton Flats Village,422,67,44,124,22,0,257
Arizona,Saddlebrooke,9790,97,1419,2833,2378,2408,9135
Arizona,Safford,9636,779,1728,2705,527,296,6035
Arizona,Sahuarita,25430,871,3216,6569,3740,1833,16229
Arizona,St. David,1564,61,124,433,242,102,962
Arizona,Cactus Forest,518,0,200,86,8,0,294
Arizona,Campo Bonito,18,0,0,18,0,0,18
Arizona,Camp Verde,11008,1322,2763,2776,941,416,8218
Arizona,Cane Beds,569,0,159,79,0,0,238
Arizona,Canyon Day,1310,186,218,269,19,6,698
Arizona,Carefree,3491,20,470,771,1220,850,3331
Arizona,Carrizo,208,59,33,34,0,0,126
Arizona,Casa Blanca,1623,341,302,230,59,6,938
Arizona,Casa Grande,49796,4422,10029,12322,3735,1899,32407
Arizona,Casas Adobes,68862,3439,9796,17678,9716,6894,47523
Arizona,Eagar,4930,306,794,1137,411,179,2827
Arizona,Duncan,683,135,165,157,25,3,485
Arizona,Dudleyville,336,13,112,131,0,0,256
Arizona,Drysdale,223,107,21,0,0,0,128
Arizona,Tempe,169816,8224,16638,32663,24863,16565,98953
Arizona,Thatcher,4935,147,576,1052,303,308,2386
Arizona,Theba,102,47,4,4,2,0,57
Arizona,Three Points,5033,937,1106,1153,246,215,3657
Arizona,Tolani Lake,344,58,51,75,0,0,184
Arizona,Pinetop-Lakeside,4306,238,897,1270,332,548,3285
Arizona,Pinion Pines,248,0,109,103,36,0,248
Arizona,Pinon,836,133,113,124,37,70,477
Arizona,Pirtleville,1794,634,219,229,22,0,1104
Arizona,Pisinemo,447,73,122,20,5,0,220
Arizona,South Tucson,5686,1383,1192,809,46,0,3430
Arizona,Prescott,40700,2267,5394,11821,7075,5108,31665
Arizona,Catalina,7456,503,1521,2018,783,455,5280
Arizona,Prescott Valley,40258,3426,8230,10690,3701,1643,27690
Arizona,Queen Creek,30143,653,2838,6482,4268,2198,16439
Arizona,Queen Valley,689,31,295,268,45,32,671
Arizona,Rainbow City,1102,197,270,104,0,0,571
Arizona,Rancho Mesa Verde,619,270,15,21,0,0,306
Arizona,Red Mesa,222,31,50,61,7,15,164
Arizona,Red Rock CDP (Apache County),223,36,81,19,0,4,140
Arizona,Red Rock CDP (Pinal County),2169,88,303,494,255,57,1197
Arizona,Rillito,297,56,46,22,0,0,124
Arizona,Rincon Valley,5103,162,631,842,986,705,3326
Arizona,Rio Rico,18760,2638,2866,3234,1849,597,11184
Arizona,Rio Verde,2114,47,392,520,765,390,2114
Arizona,Dripping Springs,103,12,25,38,10,10,95
Arizona,Quartzsite,3665,696,1483,1096,214,168,3657
Arizona,Catalina Foothills,50940,809,3947,9566,11916,13357,39595
Arizona,Cave Creek,5122,140,653,1349,1155,844,4141
Arizona,Cedar Creek,416,58,47,75,0,16,196
Arizona,Fort Mohave,13686,1497,4154,3975,863,417,10906
Arizona,Fort Thomas,481,16,131,69,30,0,246
Arizona,Fortuna Foothills,27487,2908,6765,8004,2594,1419,21690
Arizona,Fort Valley,1105,23,122,154,184,276,759
Arizona,Fountain Hills,23322,662,3581,6216,5401,3419,19279
Arizona,Franklin,34,0,0,18,4,0,22
Arizona,Fredonia,1688,136,284,422,78,49,969
Arizona,Freedom Acres,57,20,0,16,17,0,53
Arizona,Gadsden,579,182,63,56,11,4,316
Arizona,Ganado,1007,136,149,223,65,40,613
Arizona,Geronimo Estates,160,0,8,53,0,10,71
Arizona,Gila Bend,1725,376,221,225,135,11,968
Arizona,Fort Defiance,4005,312,1176,726,124,48,2386
Arizona,Gila Crossing,748,156,104,101,33,2,396
Arizona,Gisela,652,52,109,180,55,4,400
Arizona,Glendale,234844,23947,40325,50243,20875,10716,146106
Arizona,Globe,7430,867,1507,1948,483,286,5091
Arizona,Gold Canyon,9597,323,2010,2859,2024,1298,8514
Arizona,Golden Shores,1460,245,370,390,48,57,1110
Arizona,Golden Valley,8946,1282,2768,2335,445,129,6959
Arizona,Goodyear,72880,3879,11300,20043,8455,5547,49224
Arizona,Goodyear Village,407,60,162,51,0,0,273
Arizona,Grand Canyon Village,1504,100,306,512,151,119,1188
Arizona,Grand Canyon West,0,0,0,0,0,0,0
Arizona,Greasewood,519,72,71,113,16,9,281
Arizona,Green Valley,22419,777,5039,7330,5270,3459,21875
Arizona,Gilbert,230781,6165,23197,52879,38805,19044,140090
Arizona,Tees Toh,445,82,79,91,14,4,270
Arizona,Fort Apache,135,15,0,37,27,5,84
Arizona,Flowing Springs,61,14,10,6,17,14,61
Arizona,Centennial Park,1411,62,59,124,54,15,314
Arizona,Central,406,32,76,107,39,17,271
Arizona,Drexel Heights,28233,3619,5938,5772,1467,511,17307
Arizona,Dragoon,108,18,22,15,34,19,108
Arizona,Douglas,16911,3545,3221,4449,703,257,12175
Arizona,Donovan Estates,1313,299,216,189,7,4,715
Arizona,Doney Park,5944,663,713,1324,722,473,3895
Arizona,Dolan Springs,2050,375,482,746,166,10,1779
Arizona,Dilkon,1268,176,218,220,22,29,665
Arizona,Dewey-Humboldt,3928,340,747,1604,261,127,3079
Arizona,Desert Hills,2602,503,687,692,160,79,2121
Arizona,Dennehotso,752,110,207,93,15,4,429
Arizona,Flowing Wells,16078,1748,3760,4232,1019,447,11206
Arizona,Del Muerto,411,156,91,16,0,0,263
Arizona,East Verde Estates,232,9,141,30,0,0,180
Arizona,Ehrenberg,979,136,186,249,61,18,650
Arizona,El Capitan,131,9,36,19,14,0,78
Arizona,Elephant Head,650,16,139,205,75,37,472
Arizona,Elfrida,383,73,82,81,2,2,240
Arizona,Elgin,184,0,37,32,28,33,130
Arizona,El Mirage,33010,3247,6718,6360,1808,794,18927
Arizona,Eloy,16954,4343,3680,3162,609,329,12123
Arizona,El Prado Estates,415,130,30,35,5,0,200
Arizona,First Mesa,1739,159,455,322,80,8,1024
Arizona,Flagstaff,68375,3036,5565,11110,8597,6620,34928
Arizona,Florence,30770,5929,7194,8348,1651,1201,24323
Arizona,East Globe,143,26,14,7,13,39,99
Arizona,Teec Nos Pos,643,82,109,153,20,17,381
Arizona,Poston,370,79,80,27,0,0,186
Arizona,Steamboat,270,59,37,60,10,0,166
Arizona,Swift Trail Junction,3323,214,978,1073,95,61,2421
Arizona,Sweet Water Village,372,48,159,0,0,0,207
Arizona,Surprise,123813,5883,21713,32879,14892,8065,83432
Arizona,Superior,2868,390,818,626,112,38,1984
Arizona,Supai,10,0,10,0,0,0,10
Arizona,Sunwest,3,0,3,0,0,0,3
Arizona,Sun Valley,280,44,75,92,42,16,269
Arizona,Tacna,706,101,139,136,23,27,426
Arizona,Sun Lakes,14378,669,3414,4885,3206,1992,14166
Arizona,Sun City West,24338,1429,6360,8302,5097,3049,24237
Arizona,Sun City,39111,3470,13224,13478,5166,3233,38571
Arizona,Summit,5097,1286,798,514,125,22,2745
Arizona,Summerhaven,151,0,0,48,16,0,64
Arizona,Spring Valley,1470,149,425,358,196,10,1138
Arizona,Stanfield,232,59,148,25,0,0,232
Arizona,Star Valley,2090,158,330,945,158,82,1673
Arizona,Sunizona,200,29,43,68,12,10,162
Arizona,Tanque Verde,16748,458,1924,4024,3526,3107,13039
Arizona,Tat Momoli,50,50,0,0,0,0,50
Arizona,Taylor,4118,420,612,985,422,195,2634
Arizona,Strawberry,430,27,123,125,80,46,401
Arizona,Stotonic Village,466,112,129,47,12,12,312
Arkansas,Belleville,359,68,91,49,13,2,223
Arkansas,Reader,18,10,0,8,0,0,18
Arkansas,Quitman,806,105,207,129,35,37,513
Arkansas,Sulphur Springs,1065,84,441,258,50,15,848
Arkansas,Summit,507,110,180,72,13,3,378
Arkansas,Sunset,171,33,37,16,1,0,87
Arkansas,Sweet Home,579,78,203,41,81,10,413
Arkansas,Ben Lomond,108,27,38,10,6,10,91
Arkansas,Bauxite,546,85,155,105,10,2,357
Arkansas,Benton,32725,2835,6340,6672,3844,2070,21761
Arkansas,Beaver,80,5,17,28,4,6,60
Arkansas,Beebe,7851,762,1817,1338,324,414,4655
Arkansas,Beedeville,137,22,39,12,0,3,76
Arkansas,Bella Vista,27606,1132,5718,7162,4809,2649,21470
Arkansas,Bellefonte,513,61,136,93,25,10,325
Arkansas,Bay,1973,198,567,437,114,66,1382
Arkansas,Bearden,934,89,315,114,51,20,589
Arkansas,Almyra,345,18,102,69,18,3,210
Arkansas,Warren,5852,975,1652,856,439,101,4023
Arkansas,Tuckerman,2257,376,651,416,121,18,1582
Arkansas,Trumann,7179,1072,1798,1222,448,168,4708
Arkansas,Traskwood,401,32,143,84,14,7,280
Arkansas,Tontitown,2625,83,677,507,336,213,1816
Arkansas,Tollette,325,35,92,93,21,12,253
Arkansas,Tinsman,37,9,15,3,5,0,32
Arkansas,Tull,631,49,189,99,49,30,416
Arkansas,Tillar,248,33,72,44,11,1,161
Arkansas,Texarkana,30127,3049,7558,6582,2283,927,20399
Arkansas,Taylor,610,94,132,102,46,21,395
Arkansas,Swifton,687,68,276,55,39,15,453
Arkansas,Ravenden Springs,223,82,78,20,0,0,180
Arkansas,Ravenden,444,89,170,94,3,4,360
Arkansas,Ratcliff,183,24,65,47,7,1,144
Arkansas,Thornton,592,77,150,111,43,8,389
Arkansas,Tumbling Shoals,1148,109,301,347,47,32,836
Arkansas,Tupelo,179,33,46,27,27,5,138
Arkansas,Turrell,430,108,133,55,14,0,310
Arkansas,Ward,4478,531,1020,755,420,82,2808
Arkansas,Walnut Ridge,4755,477,1376,844,356,186,3239
Arkansas,Waldron,3505,606,766,505,178,68,2123
Arkansas,Waldo,1279,193,412,115,50,23,793
Arkansas,Waldenburg,88,29,32,9,3,5,78
Arkansas,Wabbaseka,262,44,96,36,5,10,191
Arkansas,Viola,386,35,88,76,12,10,221
Arkansas,Vilonia,4214,139,796,929,480,273,2617
Arkansas,Victoria,48,15,4,7,0,0,26
Arkansas,Vandervoort,80,12,5,15,3,2,37
Arkansas,Van Buren,22992,1991,4994,4655,1861,732,14233
Arkansas,Valley Springs,214,16,45,48,3,18,130
Arkansas,Ulm,213,10,66,34,15,4,129
Arkansas,Tyronza,1003,85,380,168,27,4,664
Arkansas,Twin Groves,385,54,132,80,14,12,292
Arkansas,Rector,2016,205,562,375,138,26,1306
Arkansas,Redfield,1598,113,331,316,121,55,936
Arkansas,Reed,130,51,15,19,1,5,91
Arkansas,Reyno,417,67,120,101,10,17,315
Arkansas,Avoca,619,44,175,111,28,9,367
Arkansas,Bald Knob,2902,529,819,401,157,123,2029
Arkansas,Banks,129,17,31,36,10,0,94
Arkansas,Barling,4738,647,1463,1147,258,26,3541
Arkansas,Bassett,193,35,38,12,6,6,97
Arkansas,Batesville,10479,1064,2493,1700,990,657,6904
Arkansas,Searcy,23782,1393,4084,3691,2497,1796,13461
Arkansas,Sedgwick,147,19,41,36,6,0,102
Arkansas,Shannon Hills,3497,228,752,840,401,226,2447
Arkansas,Sheridan,4763,291,1072,780,607,275,3025
Arkansas,Sherrill,84,9,31,5,2,0,47
Arkansas,Sherwood,30210,1247,6010,6548,4353,2135,20293
Arkansas,Shirley,342,29,135,49,26,4,243
Arkansas,Sidney,181,12,48,43,7,1,111
Arkansas,Siloam Springs,15832,1924,2849,2233,1296,592,8894
Arkansas,Avilla,812,57,220,276,87,14,654
Arkansas,Austin,2823,67,425,791,273,67,1623
Arkansas,Augusta,2420,465,684,317,149,55,1670
Arkansas,Aubrey,175,44,72,21,0,5,142
Arkansas,Alma,5537,406,1426,1164,415,177,3588
Arkansas,Allport,228,24,42,47,10,0,123
Arkansas,Alicia,142,20,45,23,8,0,96
Arkansas,Alexander,2809,357,652,426,145,52,1632
Arkansas,Adona,132,19,45,12,6,10,92
Arkansas,Altheimer,957,132,276,193,56,4,661
Arkansas,Altus,861,109,249,174,28,5,565
Arkansas,Smackover,1764,149,535,360,187,36,1267
Arkansas,Amagon,88,19,36,19,0,0,74
Arkansas,Anthonyville,237,98,58,21,5,3,185
Arkansas,Antoine,92,16,35,15,8,1,75
Arkansas,Arkadelphia,10721,695,1225,1289,865,846,4920
Arkansas,Arkansas City,534,87,167,47,24,8,333
Arkansas,Ashdown,4565,373,1218,1343,171,48,3153
Arkansas,Ash Flat,1087,213,298,256,42,14,823
Arkansas,Atkins,3042,405,514,769,256,44,1988
Arkansas,Amity,768,49,258,97,37,38,479
Arkansas,Smithville,98,7,45,9,8,2,71
Arkansas,South Lead Hill,117,3,36,34,2,3,78
Arkansas,Southside,2517,270,601,617,93,50,1631
Arkansas,St. Joe,151,22,38,24,7,3,94
Arkansas,St. Francis,194,19,53,59,0,4,135
Arkansas,St. Charles,294,54,101,48,30,7,240
Arkansas,Rye,156,22,16,10,15,0,63
Arkansas,Russellville,28738,3010,4429,4440,2761,1438,16078
Arkansas,Russell,220,37,70,37,11,1,156
Arkansas,Rudy,94,9,29,19,0,0,57
Arkansas,St. Paul,106,23,27,7,12,14,83
Arkansas,Rosston,454,23,92,77,12,6,210
Arkansas,Rondo,257,67,40,49,9,2,167
Arkansas,Roland,548,48,201,165,38,8,460
Arkansas,Rogers,60384,6604,11100,8853,6960,3679,37196
Arkansas,Roe,110,16,26,37,3,1,83
Arkansas,Rockwell,3763,146,586,1001,633,278,2644
Arkansas,Rockport,913,97,247,158,67,25,594
Arkansas,Rison,1175,153,258,223,41,25,700
Arkansas,Rose Bud,498,72,115,110,20,20,337
Arkansas,Alpena,443,55,147,67,5,1,275
Arkansas,Salem,1763,268,474,363,57,45,1207
Arkansas,Salesville,409,42,86,140,30,13,311
Arkansas,Sparkman,413,106,137,37,17,10,307
Arkansas,Springdale,75088,12315,13081,9530,5859,2750,43535
Arkansas,Springtown,90,7,40,21,4,2,74
Arkansas,Stamps,1840,213,669,287,81,11,1261
Arkansas,Star City,2362,285,691,341,172,42,1531
Arkansas,Staves,180,23,66,47,0,0,136
Arkansas,Stephens,1012,117,291,189,33,12,642
Arkansas,Salem,2621,122,691,753,200,89,1855
Arkansas,Strawberry,409,39,121,65,9,17,251
Arkansas,Stuttgart,9195,1082,2481,1678,435,330,6006
Arkansas,Subiaco,534,34,120,62,30,25,271
Arkansas,Success,119,28,41,10,3,1,83
Arkansas,Sulphur Rock,398,39,105,56,41,7,248
Arkansas,Sulphur Springs,377,41,92,75,34,10,252
Arkansas,Scranton,198,14,60,34,16,1,125
Arkansas,Scott,29,0,6,0,23,0,29
Arkansas,Strong,426,81,170,38,21,6,316
Arkansas,Pyatt,196,22,40,32,25,0,119
Arkansas,Hensley,30,13,5,12,0,0,30
Arkansas,Prattsville,418,27,122,81,18,10,258
Arkansas,Earle,2134,369,430,357,72,59,1287
Arkansas,Dyess,397,66,88,41,15,0,210
Arkansas,Dyer,725,58,200,164,65,48,535
Arkansas,Dumas,4482,693,1153,771,162,142,2921
Arkansas,Dover,1413,138,357,340,76,20,931
Arkansas,Donaldson,304,28,113,48,12,8,209
Arkansas,Montrose,360,47,78,54,14,6,199
Arkansas,Moorefield,202,12,42,46,26,15,141
Arkansas,Moro,266,33,68,53,10,8,172
Arkansas,Morrilton,6746,838,1370,1105,483,449,4245
Arkansas,Morrison Bluff,55,3,13,14,6,2,38
Arkansas,Mountainburg,531,54,103,137,27,6,327
Arkansas,Mountain Home,12309,1118,3055,3289,1400,451,9313
Arkansas,Mountain Pine,816,162,190,164,7,6,529
Arkansas,Mountain View,2817,690,703,577,143,85,2198
Arkansas,Mount Ida,1191,143,294,284,92,33,846
Arkansas,Mount Pleasant,360,34,142,71,29,6,282
Arkansas,Mount Vernon,164,10,60,31,4,0,105
Arkansas,Mulberry,1703,204,461,407,72,24,1168
Arkansas,Murfreesboro,1639,247,436,285,59,75,1102
Arkansas,Nashville,4558,834,782,889,256,132,2893
Arkansas,East Camden,1070,64,202,222,56,28,572
Arkansas,East End,7248,702,2148,1310,515,212,4887
Arkansas,Edmondson,265,61,55,31,25,15,187
Arkansas,Egypt,111,11,33,17,4,1,66
Arkansas,Fordyce,4174,436,1404,451,286,140,2717
Arkansas,Flippin,1516,215,497,235,98,6,1051
Arkansas,Fisher,342,42,112,57,11,2,224
Arkansas,Fifty-Six,204,21,67,61,2,5,156
Arkansas,Felsenthal,69,5,33,9,6,13,66
Arkansas,Fayetteville,79037,3675,8076,11964,11074,9637,44426
Arkansas,Farmington,6336,298,1148,1337,800,282,3865
Arkansas,Fargo,120,5,17,40,6,6,74
Arkansas,Fairfield Bay,2382,117,649,768,335,141,2010
Arkansas,Everton,207,49,47,43,8,4,151
Arkansas,Natural Steps,372,7,109,119,56,16,307
Arkansas,Evening Shade,465,64,157,101,5,22,349
Arkansas,Eudora,2132,293,766,249,93,16,1417
Arkansas,Etowah,321,60,69,54,17,2,202
Arkansas,Enola,407,48,112,65,13,14,252
Arkansas,England,2794,295,644,511,138,79,1667
Arkansas,Emmet,584,58,147,77,15,8,305
Arkansas,Emerson,319,17,88,62,7,4,178
Arkansas,Elm Springs,2136,252,481,272,290,153,1448
Arkansas,Elkins,2832,207,616,742,201,90,1856
Arkansas,El Dorado,18480,2428,3813,3451,1652,786,12130
Arkansas,Elaine,722,109,132,135,34,7,417
Arkansas,Eureka Springs,2054,140,502,520,313,208,1683
Arkansas,Newark,1470,216,346,282,53,23,920
Arkansas,New Blaine,179,17,37,63,6,0,123
Arkansas,New Edinburg,399,22,79,38,68,0,207
Arkansas,Parkdale,287,56,59,39,10,0,164
Arkansas,Parkin,907,197,321,101,38,7,664
Arkansas,Patmos,82,3,29,16,12,0,60
Arkansas,Patterson,459,82,149,36,3,2,272
Arkansas,Peach Orchard,98,21,29,18,4,1,73
Arkansas,Pea Ridge,5046,252,1721,990,210,163,3336
Arkansas,Perla,321,24,96,49,15,8,192
Arkansas,Perry,265,53,74,49,2,4,182
Arkansas,Perrytown,342,31,80,66,32,4,213
Arkansas,Perryville,1636,138,429,294,41,67,969
Arkansas,Paris,3482,558,1073,659,222,60,2572
Arkansas,Piggott,3713,509,1073,687,171,67,2507
Arkansas,Pine Bluff,46228,4394,10798,8464,3442,1856,28954
Arkansas,Prescott,3221,409,784,558,304,98,2153
Arkansas,Piney,4073,447,1000,1180,266,106,2999
Arkansas,Plainview,553,106,197,55,11,14,383
Arkansas,Pleasant Plains,324,46,113,52,7,10,228
Arkansas,Plumerville,1052,69,350,194,61,36,710
Arkansas,Pocahontas,6516,540,1630,1574,466,201,4411
Arkansas,Pollard,208,31,77,20,7,7,142
Arkansas,Portia,591,144,164,93,21,6,428
Arkansas,Portland,427,47,115,111,34,22,329
Arkansas,Pindall,147,22,51,42,0,0,115
Arkansas,Foreman,1242,149,337,157,148,58,849
Arkansas,Paragould,27228,2826,7305,4722,1785,1105,17743
Arkansas,Palestine,688,135,166,120,20,13,454
Arkansas,Newport,7782,1297,2338,1502,411,221,5769
Arkansas,Nimmons,47,15,16,6,0,0,37
Arkansas,Norfork,545,81,114,131,42,33,401
Arkansas,Norman,329,83,64,65,16,4,232
Arkansas,Norphlet,835,54,181,143,37,86,501
Arkansas,North Crossett,2898,269,918,666,166,60,2079
Arkansas,North Little Rock,65538,5089,12072,13730,7436,3756,42083
Arkansas,Oak Grove,425,95,134,81,6,0,316
Arkansas,Oak Grove Heights,902,77,292,125,57,14,565
Arkansas,Oakhaven,59,4,4,29,4,6,47
Arkansas,Pangburn,643,76,167,120,19,21,403
Arkansas,Oden,240,6,55,45,22,16,144
Arkansas,Oil Trough,250,9,72,58,4,1,144
Arkansas,O'Kean,194,36,64,36,10,0,146
Arkansas,Okolona,139,23,40,40,5,5,113
Arkansas,Ola,1284,231,257,318,52,34,892
Arkansas,Omaha,198,26,50,37,4,1,118
Arkansas,Oppelo,826,61,237,185,40,10,533
Arkansas,Osceola,7424,1058,1619,1415,310,146,4548
Arkansas,Oxford,636,113,167,146,10,26,462
Arkansas,Ozan,71,3,41,16,0,0,60
Arkansas,Ozark,3623,518,951,778,61,92,2400
Arkansas,Ogden,144,18,51,18,8,13,108
Arkansas,Forrest City,14999,2121,3792,3209,707,343,10172
Arkansas,Fort Smith,87603,11239,17236,17046,7594,3638,56753
Arkansas,Fouke,783,117,243,75,32,7,474
Arkansas,Highfill,635,56,186,87,73,40,442
Arkansas,Highland,999,93,277,184,62,75,691
Arkansas,Hindsville,36,11,12,2,9,0,34
Arkansas,Holiday Island,2596,97,514,964,319,208,2102
Arkansas,Holland,651,44,188,151,29,13,425
Arkansas,Holly Grove,677,104,173,93,29,12,411
Arkansas,Hope,10001,1955,1707,1714,434,194,6004
Arkansas,Horatio,1117,227,172,173,23,7,602
Arkansas,Horseshoe Bend,2178,257,710,654,105,50,1776
Arkansas,Horseshoe Lake,248,41,93,66,13,6,219
Arkansas,Higginson,768,93,193,155,49,12,502
Arkansas,Hot Springs,35539,3736,7520,8341,3273,2006,24876
Arkansas,Houston,265,22,119,43,3,0,187
Arkansas,Hoxie,2719,310,740,634,93,31,1808
Arkansas,Hughes,1700,253,402,241,46,7,949
Arkansas,Humnoke,225,32,63,29,8,2,134
Arkansas,Humphrey,489,60,167,108,15,2,352
Arkansas,Hunter,99,23,43,10,4,0,80
Arkansas,Huntington,609,106,142,120,5,0,373
Arkansas,Huntsville,2348,277,679,312,71,44,1383
Arkansas,Huttig,561,65,224,65,8,6,368
Arkansas,Imboden,565,46,185,113,45,24,413
Arkansas,Hot Springs Village,13477,477,2783,4610,2619,1949,12438
Arkansas,Jacksonport,134,40,49,15,2,0,106
Arkansas,Higden,137,13,22,32,22,13,102
Arkansas,Grubbs,465,67,185,59,2,4,317
Arkansas,Helena-West Helena,11546,1522,2158,2130,538,307,6655
Arkansas,Hector,517,99,120,82,22,17,340
Arkansas,Heber Springs,7187,584,1750,1540,766,341,4981
Arkansas,Hazen,1478,249,392,231,99,65,1036
Arkansas,Haynes,188,18,61,34,18,0,131
Arkansas,Havana,244,24,97,33,9,0,163
Arkansas,Hatfield,449,63,101,84,6,10,264
Arkansas,Haskell,4323,375,1219,905,327,93,2919
Arkansas,Hartman,594,56,197,69,25,2,349
Arkansas,Hartford,498,77,159,111,15,24,386
Arkansas,Hickory Ridge,233,44,89,13,5,4,155
Arkansas,Harrison,13131,1169,2622,3353,896,642,8682
Arkansas,Harrell,320,34,165,49,1,3,252
Arkansas,Hardy,702,157,188,144,8,12,509
Arkansas,Hampton,1340,181,457,259,60,35,992
Arkansas,Hamburg,2819,474,643,473,210,101,1901
Arkansas,Hagarville,265,40,55,36,46,23,200
Arkansas,Hackett,833,103,222,142,50,12,529
Arkansas,Guy,761,38,166,159,23,40,426
Arkansas,Gurdon,2206,224,627,329,127,18,1325
Arkansas,Gum Springs,141,8,25,27,35,3,98
Arkansas,Guion,112,24,26,16,0,4,70
Arkansas,Harrisburg,2329,310,685,362,66,20,1443
Arkansas,Pottsville,3030,250,704,631,198,112,1895
Arkansas,Jacksonville,28726,2401,5601,5881,2191,1051,17125
Arkansas,Jennette,130,38,33,25,5,1,102
Arkansas,Gosnell,3401,348,681,698,157,67,1951
Arkansas,Goshen,1525,36,125,364,288,165,978
Arkansas,Glenwood,2376,393,440,499,168,161,1661
Arkansas,Gilmore,233,97,39,26,22,1,185
Arkansas,Gillham,265,29,74,29,17,0,149
Arkansas,Gillett,682,89,169,147,38,31,474
Arkansas,Gilbert,32,2,5,8,11,5,31
Arkansas,Gibson,4417,212,959,1164,410,191,2936
Arkansas,Georgetown,83,17,38,10,0,0,65
Arkansas,Gentry,3336,347,893,591,196,180,2207
Arkansas,Gould,764,102,201,110,38,2,453
Arkansas,Gateway,406,53,139,53,12,3,260
Arkansas,Garner,179,41,47,37,4,0,129
Arkansas,Garland,321,41,99,65,4,1,210
Arkansas,Garfield,525,62,137,94,75,18,386
Arkansas,Fulton,184,39,41,36,4,0,120
Arkansas,Friendship,182,28,70,20,23,2,143
Arkansas,Fredonia (Biscoe),415,61,134,61,21,7,284
Arkansas,Franklin,197,27,57,61,6,11,162
Arkansas,Fourche,70,16,26,8,1,0,51
Arkansas,Fountain Lake,506,36,122,100,29,20,307
Arkansas,Fountain Hill,93,12,35,18,1,1,67
Arkansas,Gassville,2277,183,696,439,84,45,1447
Arkansas,Jasper,488,80,164,104,25,20,393
Arkansas,Grady,399,32,90,93,12,13,240
Arkansas,Gravette,3216,358,794,484,270,101,2007
Arkansas,Jericho,64,21,20,6,6,2,55
Arkansas,Jerome,49,9,10,6,3,0,28
Arkansas,Johnson,3552,375,484,446,511,320,2136
Arkansas,Joiner,514,126,136,34,13,2,311
Arkansas,Jonesboro,71576,4750,12810,13092,7989,5008,43649
Arkansas,Judsonia,2360,512,610,339,49,12,1522
Arkansas,Junction City,746,85,193,95,48,10,431
Arkansas,Keiser,600,71,150,96,13,4,334
Arkansas,Kensett,1832,500,422,187,9,9,1127
Arkansas,Keo,229,33,71,40,15,12,171
Arkansas,Grannis,600,109,167,102,41,13,432
Arkansas,Kibler,1043,141,353,192,65,20,771
Arkansas,Kirby,820,108,173,248,28,19,576
Arkansas,Knobel,236,44,76,35,6,0,161
Arkansas,Knoxville,805,118,180,137,80,10,525
Arkansas,Griffithville,156,45,57,21,5,3,131
Arkansas,Greers Ferry,857,131,309,194,57,3,694
Arkansas,Greenwood,9283,341,1586,2023,1057,355,5362
Arkansas,Greenway,208,49,54,23,3,3,132
Arkansas,Greenland,1496,89,363,359,139,92,1042
Arkansas,Green Forest,2775,663,556,301,64,30,1614
Arkansas,Greenbrier,5090,320,968,1212,385,146,3031
Arkansas,Kingsland,439,75,120,90,11,11,307
Arkansas,Monticello,9793,1032,1816,1583,714,462,5607
Arkansas,Pineville,420,51,96,87,6,4,244
Arkansas,Mansfield,1235,136,351,200,54,47,788
Arkansas,Lafe,448,61,174,74,9,18,336
Arkansas,LaGrange,60,28,24,5,2,1,60
Arkansas,Lake City,2315,273,629,384,140,85,1511
Arkansas,Lake Hamilton,1970,223,394,461,230,215,1523
Arkansas,Lakeview,867,52,249,302,79,29,711
Arkansas,Lake View,409,84,101,75,19,10,289
Arkansas,Lake Village,2398,335,591,382,198,69,1575
Arkansas,Lamar,1748,306,535,251,91,62,1245
Arkansas,Landmark,3171,326,972,744,183,60,2285
Arkansas,Lavaca,2562,268,526,494,211,97,1596
Arkansas,Leachville,1755,264,463,342,47,39,1155
Arkansas,Lead Hill,277,33,95,37,21,5,191
Arkansas,Leola,534,94,133,68,12,10,317
Arkansas,Lepanto,1955,305,593,303,58,14,1273
Arkansas,Leslie,529,96,133,71,16,8,324
Arkansas,Letona,286,39,80,44,7,2,172
Arkansas,Lewisville,1113,185,392,150,40,24,791
Arkansas,Lexa,389,57,69,62,5,5,198
Arkansas,Lincoln,2232,360,550,319,47,61,1337
Arkansas,Little Flock,2692,158,553,397,409,236,1753
Arkansas,Little Rock,196943,12275,30862,37370,31514,20605,132626
Arkansas,Zinc,69,13,32,13,0,0,58
Arkansas,Lockesburg,824,95,232,193,13,17,550
Arkansas,Yellville,1180,166,309,208,59,57,799
Arkansas,Wynne,8242,875,2255,1247,548,358,5283
Arkansas,Calico Rock,1464,269,505,264,88,29,1155
Arkansas,Cale,104,7,51,28,1,0,87
Arkansas,Caldwell,508,80,180,93,17,6,376
Arkansas,Whelen Springs,53,12,4,5,0,0,21
Arkansas,White Hall,5319,342,1116,1344,568,268,3638
Arkansas,Wickes,716,117,138,120,18,3,396
Arkansas,Widener,325,41,91,45,5,8,190
Arkansas,Wiederkehr Village,39,0,5,13,11,1,30
Arkansas,Williford,49,6,16,12,0,0,34
Arkansas,Willisville,190,13,46,48,15,14,136
Arkansas,Wilmar,362,30,110,64,20,12,236
Arkansas,Wilmot,517,47,135,72,21,19,294
Arkansas,Wilson,933,112,239,147,82,34,614
Arkansas,Wilton,303,61,96,61,15,4,237
Arkansas,Winchester,211,32,60,14,5,0,111
Arkansas,Winslow,356,51,99,56,16,25,247
Arkansas,Winthrop,131,19,25,35,2,1,82
Arkansas,Woodlawn,213,9,95,36,0,0,140
Arkansas,Woodson,455,77,211,13,33,35,369
Arkansas,Wooster,959,73,150,201,110,62,596
Arkansas,Wrightsville,1204,252,398,252,32,2,936
Arkansas,Yarborough Landing,495,84,205,61,27,0,377
Arkansas,Calion,464,120,161,62,19,2,364
Arkansas,London,995,182,218,196,72,54,722
Arkansas,Lonsdale,128,4,25,43,2,0,74
Arkansas,Maysville,108,0,42,0,0,0,42
Arkansas,Maynard,329,58,85,68,11,4,226
Arkansas,Mayflower,1975,270,533,511,140,40,1494
Arkansas,Maumelle,17695,361,1870,3597,3996,1984,11808
Arkansas,Marvell,1056,129,219,193,60,26,627
Arkansas,Marshall,1657,216,488,297,58,39,1098
Arkansas,Marmaduke,1132,120,337,219,31,14,721
Arkansas,Marked Tree,2520,475,615,470,132,61,1753
Arkansas,Marion,12328,804,2439,2352,1258,692,7545
Arkansas,Marie,48,19,9,12,2,0,42
Arkansas,Marianna,3927,691,851,564,178,69,2353
Arkansas,Hermitage,758,95,210,30,11,5,351
Arkansas,Manila,3275,414,827,641,176,89,2147
Arkansas,Mammoth Spring,981,106,322,211,48,6,693
Arkansas,Malvern,10770,1231,3439,2088,648,245,7651
Arkansas,Magnolia,11690,966,1974,1828,835,532,6135
Arkansas,Magnet Cove,298,23,118,74,0,83,298
Arkansas,Magness,215,21,45,22,7,3,98
Arkansas,Magazine,925,135,263,161,26,16,601
Arkansas,Madison,1004,128,304,169,30,9,640
Arkansas,McRae,740,126,202,131,23,7,489
Arkansas,Melbourne,1797,170,510,381,176,57,1294
Arkansas,Lonoke,4250,423,1093,911,231,103,2761
Arkansas,Mena,5692,460,1775,1425,281,170,4111
Arkansas,Midland,398,93,70,39,12,0,214
Arkansas,Lost Bridge Village,423,23,95,90,126,29,363
Arkansas,Louann,132,14,54,32,2,0,102
Arkansas,Lowell,8011,851,1491,993,1141,407,4883
Arkansas,Luxora,1007,156,239,114,7,17,533
Arkansas,Lynn,237,25,70,36,12,13,156
Arkansas,McAlmont,1504,278,484,296,105,0,1163
Arkansas,McCaskill,120,33,73,5,0,0,111
Arkansas,McCrory,1928,415,604,196,64,44,1323
Arkansas,Caddo Valley,641,24,99,156,83,41,403
Arkansas,McDougal,163,29,69,14,0,0,112
Arkansas,McGehee,4029,369,1001,691,217,142,2420
Arkansas,Cabot,25102,1200,4581,6228,2644,1167,15820
Arkansas,Burdette,180,25,63,35,11,0,134
Arkansas,Bull Shoals,2107,111,663,589,220,89,1672
Arkansas,Buckner,280,51,76,58,10,3,198
Arkansas,Monette,1537,211,433,379,108,34,1165
Arkansas,Mitchellville,389,87,99,70,10,8,274
Arkansas,Minturn,66,18,29,8,1,0,56
Arkansas,Mineral Springs,1092,143,264,237,66,12,722
Arkansas,Midway,374,31,115,56,33,18,253
Arkansas,Midway,1319,188,363,345,93,9,998
Arkansas,Menifee,344,16,121,59,20,3,219
Arkansas,Camden,11683,1387,2986,2071,799,454,7697
Arkansas,Cammack Village,1036,6,46,214,203,151,620
Arkansas,Campbell Station,249,26,82,49,10,4,171
Arkansas,Bradley,489,100,135,78,30,0,343
Arkansas,Branch,362,67,95,44,12,6,224
Arkansas,Briarcliff,240,22,53,74,15,4,168
Arkansas,Brinkley,3007,484,790,639,125,24,2062
Arkansas,Brookland,2503,358,577,416,124,49,1524
Arkansas,Bryant,19162,841,4072,4356,2429,1181,12879
Arkansas,Washington,182,22,78,44,9,3,156
Arkansas,Watson,163,36,48,32,10,1,127
Arkansas,Weiner,762,91,247,115,34,13,500
Arkansas,Weldon,77,18,29,7,2,0,56
Arkansas,West Crossett,1123,129,335,187,43,31,725
Arkansas,Western Grove,415,54,109,94,21,26,304
Arkansas,West Fork,2454,194,551,515,200,184,1644
Arkansas,West Memphis,25544,3129,6282,4475,1723,493,16102
Arkansas,West Point,210,19,91,16,4,1,131
Arkansas,Wheatley,260,26,85,63,17,4,195
Arkansas,Dierks,1155,175,307,161,36,22,701
Arkansas,Diaz,1414,189,365,219,91,25,889
Arkansas,Diamond City,911,177,291,193,41,29,731
Arkansas,DeWitt,3234,553,849,534,235,69,2240
Arkansas,De Valls Bluff,622,142,129,97,27,18,413
Arkansas,Bradford,812,130,256,91,25,45,547
Arkansas,Des Arc,1862,278,607,330,108,0,1323
Arkansas,Booneville,3936,461,1130,557,197,74,2419
Arkansas,Bonanza,637,102,160,151,35,16,464
Arkansas,Prairie Grove,4859,210,1016,1123,409,180,2938
Arkansas,Prairie Creek,2116,196,449,528,317,108,1598
Arkansas,Poyen,318,23,106,58,11,0,198
Arkansas,Powhatan,76,13,22,12,2,0,49
Arkansas,Bentonville,40368,1965,5995,6098,7194,4518,25770
Arkansas,Bergman,455,65,122,123,35,2,347
Arkansas,Berryville,5339,794,1483,543,274,114,3208
Arkansas,Bethel Heights,2776,259,587,319,202,57,1424
Arkansas,Bigelow,325,61,99,44,8,11,223
Arkansas,Big Flat,59,15,10,5,1,9,40
Arkansas,Biggers,278,56,59,70,11,10,206
Arkansas,Birdsong,41,12,7,7,0,4,30
Arkansas,Black Oak,267,32,64,57,2,6,161
Arkansas,Black Rock,642,101,192,133,24,3,453
Arkansas,Black Springs,35,10,10,0,1,2,23
Arkansas,Blevins,251,39,62,40,17,25,183
Arkansas,Blue Eye,39,20,4,0,0,0,24
Arkansas,Blue Mountain,94,17,14,36,0,1,68
Arkansas,Bluff City,101,22,36,29,0,1,88
Arkansas,Blytheville,15090,1625,3227,3076,846,797,9571
Arkansas,Bodcaw,172,30,37,24,14,3,108
Arkansas,Bono,2488,281,515,444,130,55,1425
Arkansas,Dermott,2787,513,864,406,112,21,1916
Arkansas,De Queen,6678,1747,1059,663,191,71,3731
Arkansas,Denning,161,22,60,41,1,0,124
Arkansas,Clarksville,9338,1234,2214,1074,744,380,5646
Arkansas,Clarkedale,445,23,58,79,59,21,240
Arkansas,Clarendon,1577,277,463,288,58,9,1095
Arkansas,Chidester,266,57,117,38,5,7,224
Arkansas,Chester,119,32,18,27,0,0,77
Arkansas,Cherry Valley,891,115,210,134,53,20,532
Arkansas,Cherokee Village,4581,302,1642,1002,289,69,3304
Arkansas,Cherokee City,83,0,24,8,0,0,32
Arkansas,Charleston,2638,175,736,582,162,80,1735
Arkansas,Central City,522,51,135,122,34,12,354
Arkansas,Centerton,10764,536,1547,1900,1710,524,6217
Arkansas,Center Ridge,514,47,180,41,62,12,342
Arkansas,Cedarville,1723,231,539,361,75,37,1243
Arkansas,Cave Springs,2475,126,412,448,426,207,1619
Arkansas,Cave City,2278,283,549,452,135,18,1437
Arkansas,Caulksville,203,26,47,55,31,10,169
Arkansas,Cash,348,77,103,44,11,1,236
Arkansas,Casa,208,27,75,35,8,0,145
Arkansas,Carthage,536,88,213,65,7,3,376
Arkansas,Carlisle,2084,255,554,384,311,64,1568
Arkansas,Caraway,1037,153,316,185,66,14,734
Arkansas,Clinton,2564,331,851,433,133,75,1823
Arkansas,Coal Hill,989,160,274,184,59,21,698
Arkansas,College City,427,4,11,26,6,39,86
Arkansas,College Station,617,215,160,122,25,12,534
Arkansas,Dennard,389,153,132,52,16,0,353
Arkansas,Dell,220,14,82,45,30,7,178
Arkansas,Delight,321,26,94,85,22,7,234
Arkansas,Delaplaine,62,5,16,22,9,0,52
Arkansas,Decatur,2306,485,431,194,78,28,1216
Arkansas,Datto,72,20,17,8,1,0,46
Arkansas,Dardanelle,4676,998,1044,662,320,53,3077
Arkansas,Danville,2242,426,423,159,104,54,1166
Arkansas,Damascus,497,25,89,126,39,18,297
Arkansas,Daisy,120,17,28,44,5,2,96
Arkansas,McNeil,514,37,153,80,10,1,281
Arkansas,Cushman,547,89,176,84,17,5,371
Arkansas,Crawfordsville,519,97,134,93,25,16,365
Arkansas,Coy,164,23,42,17,6,0,88
Arkansas,Cove,433,44,68,122,28,0,262
Arkansas,Cotton Plant,587,111,195,128,9,4,447
Arkansas,Cotter,954,58,274,239,86,30,687
Arkansas,Corning,3223,563,1176,429,169,109,2446
Arkansas,Corinth,57,3,15,17,17,0,52
Arkansas,Conway,63555,2521,8333,11441,8254,5003,35552
Arkansas,Concord,242,32,101,39,4,3,179
Arkansas,Colt,433,105,169,65,0,11,350
Arkansas,Crossett,5333,331,1353,1270,440,177,3571
Arkansas,McNab,49,5,24,5,0,0,34
California,Tipton,2787,897,244,229,4,0,1374
California,Atherton,7081,110,295,523,1803,2144,4875
California,Delleker,656,98,123,138,50,33,442
California,Delhi,10026,2536,1321,1447,304,91,5699
California,Delft Colony,132,12,15,20,15,0,62
California,Delano,52807,13899,8682,6079,1769,437,30866
California,Del Aire,10692,1379,1400,1981,1648,818,7226
California,Deer Park,1104,46,82,356,360,87,931
California,Day Valley,3836,304,303,770,826,517,2720
California,Davis,66510,1333,2658,5321,9897,14642,33851
California,Davenport,297,60,36,74,24,34,228
California,Darwin,24,0,0,18,6,0,24
California,Daphnedale Park,90,0,32,14,0,0,46
California,Three Rocks,212,131,32,0,0,0,163
California,Three Rivers,2185,35,409,692,386,321,1843
California,Thousand Palms,8222,1206,1479,2142,654,359,5840
California,Thousand Oaks,128565,6749,12674,25976,25340,17894,88633
California,Thornton,916,224,168,101,32,17,542
California,Agoura Hills,20697,707,2047,4279,4376,3023,14432
California,Agua Dulce,3567,89,637,1074,517,269,2586
California,Aguanga,766,120,196,269,16,33,634
California,Ahwahnee,1709,101,494,615,70,64,1344
California,Airport,1565,500,302,84,39,0,925
California,Del Mar,4269,44,191,679,1207,1510,3631
California,Alameda,76733,4863,7065,15775,17543,10882,56128
California,Del Monte Forest,5122,48,309,1007,1285,853,3502
California,Del Rey Oaks,1673,68,131,486,376,237,1298
California,Tobin,10,0,0,10,0,0,10
California,Tomales,208,0,57,99,0,52,208
California,Tonyville,572,186,65,9,0,0,260
California,Tooleville,391,228,17,49,0,0,294
California,Topanga,8419,152,733,1515,2117,1518,6035
California,Topaz,202,36,0,42,0,0,78
California,Toro Canyon,1580,61,127,431,320,218,1157
California,Torrance,147589,6844,18159,31567,31830,16146,104546
California,Tracy,85284,8522,13281,17573,8971,2887,51234
California,Tranquillity,691,184,114,96,19,9,422
California,Tiburon,9158,100,462,1387,2372,2486,6807
California,Desert View Highlands,2489,257,461,499,77,85,1379
California,Desert Shores,1383,505,136,150,34,0,825
California,Desert Palms,6826,106,1331,2438,1902,1049,6826
California,Desert Hot Springs,27912,5348,4667,4604,1243,713,16575
California,Desert Edge,4431,713,1205,1069,279,233,3499
California,Desert Center,207,25,66,45,13,0,149
California,Descanso,1355,87,177,488,175,96,1023
California,Derby Acres,320,55,64,75,18,2,214
California,Denair,5176,874,843,827,389,114,3047
California,Del Rio,1925,43,153,497,400,271,1364
California,Del Rey,1457,478,103,157,0,0,738
California,Atwater,28858,4592,4326,5556,1516,698,16688
California,Alamo,16301,163,698,2231,5102,2792,10986
California,Albion,303,11,35,84,22,21,173
California,Angwin,3522,186,170,575,533,330,1794
California,Antelope,47763,2513,8108,12022,4684,1373,28700
California,Antioch,107501,8884,19172,25768,10137,3656,67617
California,Anza,2771,268,627,915,56,48,1914
California,Apple Valley,71083,6358,13841,17550,4398,3348,45495
California,Aptos,6048,93,442,1130,1684,763,4112
California,Aptos Hills-Larkin Valley,2221,63,203,528,481,225,1500
California,Arbuckle,3360,765,442,503,137,22,1869
California,Arcadia,57564,3224,6543,9933,13200,7975,40875
California,Arcata,17752,694,1170,2547,2458,1713,8582
California,Timber Cove,127,7,43,28,30,15,123
California,Armona,3724,691,571,636,65,28,1991
California,Arnold,2554,167,505,822,520,135,2149
California,Aromas,2860,168,433,838,337,153,1929
California,Arroyo Grande,17720,759,2621,4780,2795,1528,12483
California,Artesia,16785,2656,2742,3067,2171,884,11520
California,Artois,225,20,50,18,5,0,93
California,Arvin,20328,6454,1649,1346,238,34,9721
California,Ashland,24226,3407,4137,4508,1999,522,14573
California,Aspen Springs,45,0,7,8,15,0,30
California,Atascadero,29084,1510,4145,8408,4226,2101,20390
California,Angels,3753,238,582,1164,449,262,2695
California,Albany,19249,458,745,2112,4355,5231,12901
California,Anderson,10122,963,1885,3118,321,153,6440
California,Anaheim,345578,53281,51454,61248,38932,15468,220383
California,Alderpoint,311,86,84,122,0,0,292
California,Alhambra,84782,11914,14040,15379,13654,6601,61588
California,Alhambra Valley,557,43,99,135,158,17,452
California,Aliso Viejo,49829,1189,3649,9423,12803,6000,33064
California,Alleghany,116,21,0,17,78,0,116
California,Allendale,1528,41,265,535,238,112,1191
California,Allensworth,565,164,44,53,0,0,261
California,Almanor,0,0,0,0,0,0,0
California,Alondra Park,7865,1105,1181,1484,904,325,4999
California,Alpaugh,1103,299,110,103,5,10,527
California,Alpine,14830,1018,2312,4209,1795,1149,10483
California,Alpine Village,116,9,6,50,14,14,93
California,Alta,455,17,80,173,41,28,339
California,Altadena,44621,3338,4439,9275,8522,6209,31783
California,Alta Sierra,6624,170,1180,2180,1064,575,5169
California,Alto,735,22,53,206,152,144,577
California,Alturas,2660,220,533,876,212,30,1871
California,Alum Rock,11051,2207,1995,1923,558,248,6931
California,Amador City,152,5,32,37,23,16,113
California,American Canyon,20271,1890,2369,4570,2709,1199,12737
California,Amesti,3274,530,459,597,197,93,1876
California,Anchor Bay,329,21,110,50,118,30,329
California,Arden-Arcade,93993,6408,12834,23023,14464,8435,65164
California,Smartsville,82,0,34,30,0,1,65
California,Auburn,13785,712,2116,3976,2131,1363,10298
California,Camp Pendleton South,11394,0,1194,1915,594,337,4040
California,Camp Pendleton North,7457,24,387,983,524,191,2109
California,Campo,2883,446,546,563,160,129,1844
California,Camp Nelson,101,0,13,67,0,21,101
California,Campbell,40688,1826,4463,8178,9655,5291,29413
California,Camino Tassajara,2247,35,82,125,590,501,1333
California,Camptonville,172,15,38,59,10,15,137
California,Camino,1905,74,264,684,207,125,1354
California,Cambrian Park,3363,203,633,716,576,321,2449
California,Cambria,6279,507,841,1445,1375,1000,5168
California,Camarillo,66445,3632,7593,16244,11541,7456,46466
California,Camanche Village,720,38,149,319,64,12,582
California,Camanche North Shore,696,81,56,302,77,19,535
California,Calwa,1282,251,159,271,0,0,681
California,Cameron Park,19437,940,2957,5388,2710,1216,13211
California,Calpine,207,0,147,28,22,10,207
California,San Diego Country Estates,10215,286,1545,3032,1555,674,7092
California,San Fernando,24296,6256,3979,3024,1452,353,15064
California,San Marcos,89578,10621,10572,18878,11791,5159,57021
California,San Luis Obispo,46337,1557,2790,7160,7199,4770,23476
California,San Lucas,384,101,66,54,6,0,227
California,San Lorenzo,24891,2980,4966,5126,2975,860,16907
California,San Leandro,88329,10913,16142,17425,12222,5370,62072
California,San Juan Capistrano,35897,3752,4860,7080,5482,2934,24108
California,San Dimas,34073,1889,4533,8885,5333,3178,23818
California,San Juan Bautista,2250,179,335,666,224,110,1514
California,San Joaquin,4008,1350,242,224,61,0,1877
California,San Jacinto,45977,7093,7987,9092,2322,973,27467
California,San Geronimo,599,0,87,51,146,159,443
California,Sanger,24700,5235,2828,4483,1369,530,14445
California,San Gabriel,40198,6413,7415,6499,6570,2378,29275
California,San Francisco,840763,85571,83938,135102,215189,139972,659772
California,San Jose,1000860,116024,120090,174746,158812,101583,671255
California,San Marino,13353,506,613,1561,3112,3481,9273
California,Calpella,419,69,68,98,42,9,286
California,Baldwin Park,76602,17786,15077,9331,4191,1173,47558
California,Bella Vista,2860,371,582,977,104,65,2099
California,Bell Canyon,2094,11,142,445,458,345,1401
California,Bellflower,77756,10567,13628,15153,5860,1989,47197
California,Bell Gardens,42842,13108,5756,3397,1000,260,23521
California,Belmont,26766,952,2119,4717,5386,5629,18803
California,Belvedere,1992,7,60,219,621,616,1523
California,Bell,35998,10958,4196,4165,1291,221,20831
California,Benbow,230,0,24,79,64,26,193
California,Benicia,27657,838,3118,6994,5236,3119,19305
California,Ben Lomond,6507,160,921,2121,1056,453,4711
California,Benton,333,12,30,147,34,10,233
California,Berkeley,117384,3152,5368,12701,23980,27797,72998
California,Bermuda Dunes,8219,549,1712,1320,1038,536,5155
California,Berry Creek,1325,196,411,407,73,23,1110
California,Bend,559,25,146,184,62,18,435
California,Bakersfield,363612,43363,54200,70590,29458,14857,212468
California,Belden,0,0,0,0,0,0,0
California,Beaumont,40899,3371,5940,9964,3542,2714,25531
California,Ballard,373,44,47,58,108,41,298
California,Ballico,315,52,81,57,10,8,208
California,Bangor,586,33,71,247,45,46,442
California,Banning,30515,4259,7081,6729,1938,1287,21294
California,Barstow,23281,2667,4347,4656,944,575,13189
California,Bass Lake,739,9,150,280,103,29,571
California,Beckwourth,238,32,38,93,46,29,238
California,Bay Point,22473,4210,3480,3500,1486,325,13001
California,Bayview CDP (Humboldt County),2548,451,464,658,178,71,1822
California,Beale AFB,1143,34,86,256,115,38,529
California,Bear Creek,167,78,40,28,0,0,146
California,Bear Valley CDP (Alpine County),25,0,3,5,11,0,19
California,Bear Valley CDP (Mariposa County),155,0,31,33,18,35,117
California,Bear Valley Springs,4661,127,717,1597,578,669,3688
California,Bayview CDP (Contra Costa County),1728,328,275,421,185,35,1244
California,San Martin,7170,1022,784,1923,667,487,4883
California,San Mateo,101335,8790,11546,19220,20220,13554,73330
California,San Miguel CDP (Contra Costa County),3366,17,203,526,828,778,2352
California,Carmel-by-the-Sea,3834,80,495,640,998,723,2936
California,Carlsbad,110830,3274,9069,23394,24459,17771,77967
California,Caribou,0,0,0,0,0,0,0
California,Capitola,10077,544,1461,2561,1620,1057,7243
California,Canyon Lake,10918,327,2307,3291,1375,684,7984
California,Canyondam,102,38,35,29,0,0,102
California,Carmel Valley Village,4302,254,349,1065,877,673,3218
California,Cantua Creek,529,222,52,13,0,0,287
California,Shandon,1227,230,216,316,53,16,831
California,Shafter,17513,3889,2834,1906,470,149,9248
California,Seville,545,154,62,31,2,1,250
California,Sereno del Mar,42,0,11,0,17,14,42
California,Sequoia Crest,27,0,0,14,13,0,27
California,Selma,24017,5289,3442,3925,955,308,13919
California,Canby,545,54,68,81,58,94,355
California,Seeley,1324,307,143,276,10,0,736
California,Carmet,15,0,0,0,15,0,15
California,Carnelian Bay,433,9,52,93,119,54,327
California,Castroville,6707,1893,903,534,99,104,3533
California,Castro Valley,62044,3437,9918,14244,10593,5772,43964
California,Castle Hill,1204,16,64,301,285,256,922
California,Castaic,19369,951,2277,4686,2834,1028,11776
California,Cassel,362,0,136,194,0,1,331
California,Caspar,801,18,94,216,219,85,632
California,Carmichael,63712,2973,9344,17891,8956,6094,45258
California,Casmalia,116,42,12,36,0,0,90
California,Casa Conejo,3358,198,566,962,329,198,2253
California,Caruthers,3128,804,382,380,31,47,1644
California,Cartago,39,0,34,0,5,0,39
California,Carson,92691,12789,13819,20732,11245,4029,62614
California,Carrick,67,0,12,40,0,0,52
California,Carpinteria,13449,2039,1820,2716,1976,1397,9948
California,Casa de Oro-Mount Helix,20222,1134,2820,4365,3267,2759,14345
California,Sebastopol,7583,377,1088,2096,1496,1001,6058
California,Seaside,33999,5101,4783,6534,3171,1464,21053
California,Searles Valley,1614,209,362,405,50,28,1054
California,Santa Maria,102618,24001,10826,15732,5258,2240,58057
California,Santa Margarita,1582,115,274,338,285,81,1093
California,Santa Fe Springs,17162,2563,3433,3493,1100,473,11062
California,Santa Cruz,62752,2476,4432,9810,9841,7882,34441
California,Santa Clarita,179950,12914,22839,43024,26063,12232,117072
California,Santa Clara,121374,6682,12156,18402,24154,20819,82213
California,Santa Monica,92169,3412,6852,14796,26802,20305,72167
California,Santa Barbara,90401,9783,8208,15830,16419,11339,61579
California,San Simeon,284,28,72,66,11,16,193
California,San Ramon,74571,1256,4218,10773,19187,12563,47997
California,San Rafael,58819,6003,6183,10445,11302,8486,42419
California,San Pasqual,2000,61,100,284,546,605,1596
California,San Pablo,29777,6710,4642,4659,1805,691,18507
California,San Miguel CDP (San Luis Obispo County),2461,438,391,449,142,14,1434
California,Santa Ana,333268,88765,44590,40260,16409,6531,196555
California,Santa Nella,1517,365,223,224,61,10,883
California,Santa Paula,30246,6450,3848,5225,1559,965,18047
California,Santa Rosa,172066,16844,23492,41257,23134,13124,117851
California,Sea Ranch,1068,18,52,270,299,418,1057
California,Seal Beach,24551,1044,3049,6897,5723,3668,20381
California,Seacliff,3256,128,332,906,596,374,2336
California,Scotts Valley,11780,252,1015,2602,2630,1150,7649
California,Scotia,814,27,196,201,21,2,447
California,Sausalito,7094,77,326,1372,2326,2061,6162
California,Sattley,40,0,14,26,0,0,40
California,Saticoy,1251,254,271,112,51,16,704
California,Saratoga,30817,392,1397,3365,7685,9357,22196
California,Saranap,5702,17,639,704,1627,984,3971
California,Santee,56255,2698,9544,15493,6804,3245,37784
California,Santa Ynez,4489,204,572,1224,1066,323,3389
California,Santa Venetia,5166,290,805,1058,1067,373,3593
California,Santa Susana,1071,7,167,450,223,37,884
California,Santa Rosa Valley,3550,92,310,592,886,589,2469
California,Bertsch-Oceanview,2516,361,295,601,229,94,1580
California,Cathedral City,53020,8418,9791,10159,3582,2108,34058
California,Bethel Island,2172,165,670,681,156,80,1752
California,Bieber,120,16,39,40,0,0,95
California,San Diego,1359791,115610,147066,255411,232401,158136,908624
California,Callender,1710,79,166,669,251,36,1201
California,Calistoga,5267,1081,520,1130,706,397,3834
California,Calipatria,7557,2227,1552,1310,106,24,5219
California,Calimesa,8269,723,2210,2351,571,342,6197
California,California Pines,335,11,56,91,36,10,204
California,Sand City,312,39,35,70,30,17,191
California,California Hot Springs,65,0,17,22,0,9,48
California,Calexico,39601,10160,3993,6056,2318,893,23420
California,Calabasas,24075,483,1925,3411,5135,5065,16019
California,Cabazon,3633,514,700,625,143,0,1982
California,Bystrom,3889,1321,493,442,18,4,2278
California,Byron,1325,251,227,345,63,43,929
California,Buttonwillow,1425,378,245,164,10,7,804
California,California City,13201,1768,2630,3265,598,351,8612
California,Butte Valley,498,26,87,149,140,35,437
California,San Clemente,65017,2095,5391,15803,13870,7176,44335
California,San Buenaventura (Ventura),108899,8191,14714,27571,15292,9477,75245
California,Sacramento,480566,52338,65532,102394,59846,34472,314582
California,St. Helena,5943,679,617,969,1428,661,4354
California,Salida,13501,1526,2884,2544,815,338,8107
California,Salinas,155366,36390,20171,22451,7674,3132,89818
California,Salmon Creek,44,0,9,27,0,8,44
California,Salton City,4782,935,936,776,222,95,2964
California,San Carlos,29454,551,2260,4980,7090,6215,21096
California,Salton Sea Beach,551,115,115,61,33,0,324
California,San Andreas,2706,271,546,690,262,211,1980
California,San Anselmo,12566,340,503,2150,3708,2342,9043
California,San Antonio Heights,2963,164,400,770,517,462,2313
California,San Ardo,746,240,66,50,12,6,374
California,San Bernardino,214112,38391,33561,34805,9467,4434,120658
California,San Bruno,42506,3340,6317,10348,7445,3411,30861
California,Samoa,268,28,66,40,42,10,186
California,Rutherford,232,30,50,47,11,0,138
California,Butte Meadows,27,0,14,13,0,0,27
California,Burnt Ranch,344,39,104,99,40,19,301
California,Brawley,25656,4511,3649,5081,1538,438,15217
California,Bradley,125,13,36,39,4,2,94
California,Bradbury,839,66,56,152,212,190,676
California,Boyes Hot Springs,7229,1257,880,1266,788,480,4671
California,Bowles,194,37,29,40,18,0,124
California,Boulevard,461,138,51,75,0,0,264
California,Brea,40931,2186,4144,9190,7764,4298,27582
California,Boulder Creek,4481,229,434,1515,898,449,3525
California,Borrego Springs,2518,423,516,519,273,183,1914
California,Boronda,1271,413,239,240,8,0,900
California,Boron,2326,291,536,493,116,30,1466
California,Bootjack,836,31,194,286,52,23,586
California,Boonville,721,157,95,177,52,24,505
California,Bonsall,3896,224,622,896,876,332,2950
California,Bostonia,16787,1968,3452,3792,996,235,10443
California,Butte Creek Canyon,938,22,193,194,203,149,761
California,Brentwood,55490,3312,7191,14469,7748,2581,35301
California,Bridgeport,909,215,75,323,46,40,699
California,Burney,3257,412,717,791,244,25,2189
California,Burlingame,29941,736,2993,5240,6914,5745,21628
California,Burbank,5736,605,946,1489,690,299,4029
California,Burbank,104725,8588,13762,24395,20424,8607,75776
California,Buena Vista,326,14,36,162,0,10,222
California,Buena Park,82683,9153,12448,16371,12534,3735,54241
California,Bret Harte,5188,1609,568,366,25,12,2580
California,Buellton,4977,383,804,1372,457,551,3567
California,Buck Meadows,52,0,19,0,8,5,32
California,Buckhorn,2179,185,610,790,188,73,1846
California,Brooktrails,3225,186,454,999,456,88,2183
California,Brookdale,2282,19,253,634,310,299,1515
California,Broadmoor,5409,536,896,1254,1154,265,4105
California,Brisbane,4496,211,611,974,1050,487,3333
California,Bucks Lake,16,0,9,0,7,0,16
California,Ruth,108,11,29,50,0,0,90
California,Running Springs,4793,179,638,1754,473,245,3289
California,Rowland Heights,50440,5697,7592,10044,9993,3283,36609
California,Blythe,19839,4423,4282,4551,724,481,14461
California,Bodega,212,30,9,118,27,0,184
California,Bodega Bay,671,60,78,149,111,181,579
California,Bodfish,2066,255,487,690,195,53,1680
California,Bolinas,1358,45,51,287,364,273,1020
California,Bombay Beach,250,29,100,54,25,0,208
California,Bluewater,179,5,75,89,5,5,179
California,Bonadelle Ranchos-Madera Ranchos,8866,528,1568,2349,993,394,5832
California,Bonny Doon,2947,119,304,775,664,468,2330
California,Richfield,214,3,37,67,15,20,142
California,Richgrove,2972,970,235,137,44,4,1390
California,Richmond,107597,16339,15334,21357,11842,6497,71369
California,Richvale,111,14,13,37,47,0,111
California,Ridgecrest,28489,1802,4497,6851,3404,1765,18319
California,Bonita,12931,1095,1916,2792,1931,1509,9243
California,Ridgemark,3499,77,537,1029,618,258,2519
California,Blue Lake,1310,64,292,290,256,63,965
California,Bloomfield,420,0,101,52,139,89,381
California,Big Bear City,13535,950,3027,3998,1041,362,9378
California,Big Bear Lake,5145,431,870,1546,607,312,3766
California,Big Bend,94,7,22,43,7,7,86
California,Big Creek,248,3,36,98,38,6,181
California,Biggs,1765,280,269,392,69,26,1036
California,Big Lagoon,92,0,4,27,12,43,86
California,Bloomington,24864,5977,3881,3707,808,146,14519
California,Big Pine,1661,113,367,485,103,112,1180
California,Biola,1151,312,89,108,18,5,532
California,Bishop,3839,383,940,649,427,298,2697
California,Blackhawk,9304,123,500,1170,2891,2155,6839
California,Blacklake,727,0,119,232,200,157,708
California,Black Point-Green Point,1250,32,96,225,380,196,929
California,Blairsden,55,0,17,21,17,0,55
California,Big River,1068,189,259,390,84,25,947
California,Rio Dell,3385,309,807,1048,252,31,2447
California,Rio del Mar,8964,177,722,2507,2051,1500,6957
California,Rio Linda,14688,1813,2874,3583,1131,226,9627
California,Romoland,1778,223,527,241,8,7,1006
California,Rosamond,19540,2326,3325,4555,874,478,11558
California,Rosedale,15509,782,2282,3846,1973,1151,10034
California,Rose Hills,3205,150,381,845,612,300,2288
California,Roseland,5594,1169,1057,790,222,214,3452
California,Rosemead,54615,13027,10549,8476,4967,1510,38529
California,Rollingwood,2847,751,448,511,112,46,1868
California,Rosemont,23515,1505,3373,6517,3051,983,15429
California,Ross,2306,76,47,157,675,571,1526
California,Rossmoor,10461,196,756,2184,2456,1690,7282
California,Rough and Ready,1581,141,282,465,151,37,1076
California,Round Mountain,113,11,28,18,7,9,73
California,Round Valley,485,85,113,142,55,25,420
California,Rouse,1820,529,227,168,15,0,939
California,Roseville,126327,4639,15285,33187,21285,9830,84226
California,Rolling Hills Estates,8188,117,569,1338,2120,1827,5971
California,Rolling Hills,816,22,182,217,130,83,634
California,Rolling Hills,1820,47,72,285,368,589,1361
California,Rio Oso,491,42,74,110,51,37,314
California,Rio Vista,7826,508,1572,2620,1076,656,6432
California,Ripley,601,181,105,24,0,0,310
California,Ripon,14801,896,2252,3719,1826,879,9572
California,Riverbank,23564,3491,4266,4471,1604,573,14405
California,Riverdale,4081,774,837,360,123,20,2114
California,Riverdale Park,1023,273,192,162,61,14,702
California,River Pines,284,16,24,85,70,11,206
California,Riverside,316335,40582,46999,59147,24749,17082,188559
California,Robbins,334,81,69,91,9,3,253
California,Robinson Mill,0,0,0,0,0,0,0
California,Rocklin,59727,1621,6526,15204,10796,4606,38753
California,Rodeo,9724,744,2040,2163,1161,502,6610
California,Rodriguez Camp,153,46,15,0,0,0,61
California,Rohnert Park,41651,3082,6115,10697,4945,1668,26507
California,Beverly Hills,34663,1283,3254,5354,7907,7621,25419
California,Auberry,2420,246,395,713,224,131,1709
California,Catheys Valley,747,68,185,200,121,91,665
California,Cazadero,243,9,59,88,23,19,198
California,Tamalpais-Homestead Valley,10542,129,386,1403,2959,2782,7659
California,Talmage,1547,280,285,160,91,166,982
California,Tahoma,943,62,95,233,187,58,635
California,Tahoe Vista,1367,98,169,293,286,91,937
California,Taft Mosswood,1117,345,169,99,43,0,656
California,Taft Heights,2859,282,378,711,37,12,1420
California,Tara Hills,4778,545,950,1259,326,177,3257
California,Taft,9130,1686,2166,1710,332,201,6095
California,Sutter Creek,2083,132,462,669,201,146,1610
California,Sutter,3195,174,567,945,235,72,1993
California,Susanville,16048,3448,3711,3574,689,249,11671
California,Sun Village,11322,2260,1696,1913,535,108,6512
California,Sunol,985,61,130,237,218,114,760
California,Sunnyvale,148178,9116,12147,20303,31488,32393,105447
California,Swall Meadows,243,0,12,69,62,40,183
California,Sunny Slopes,52,0,15,21,16,0,52
California,Tarpey Village,3460,279,851,789,240,221,2380
California,Tecopa,128,12,19,45,7,5,88
California,Rialto,102018,18809,16658,16558,4012,1626,57663
California,Thermalito,7119,1089,1446,1601,231,50,4417
California,Thermal,3106,1032,464,253,1,0,1750
California,Teviston,1623,397,137,101,0,12,647
California,Terra Bella,2526,884,152,271,54,0,1361
California,Terminous,371,80,56,120,19,21,296
California,Taylorsville,317,0,42,121,21,43,227
California,Tennant,100,24,13,25,4,5,71
California,Temple City,36079,3539,5393,7195,6662,2917,25706
California,Temescal Valley,24654,1397,4096,5753,3115,1976,16337
California,Temelec,1543,57,391,436,466,193,1543
California,Temecula,107153,5614,13495,26034,13332,6977,65452
California,Tehama,410,47,81,128,30,19,305
California,Tehachapi,13536,2409,3291,3292,636,229,9857
California,Templeton,7377,299,1253,1947,980,668,5147
California,Reliez Valley,3656,108,313,693,956,918,2988
California,Sunnyside-Tahoe City,1450,31,152,334,472,95,1084
California,Summerland,1505,31,54,433,623,162,1303
California,Cutler,4569,1316,518,317,47,0,2198
California,Cupertino,60171,1356,2370,6026,13617,17225,40594
California,Culver City,39469,2279,3351,7991,8981,6633,29235
California,Cudahy,24138,7409,2876,2084,410,192,12971
California,Crows Landing,207,49,69,29,0,0,147
California,Crowley Lake,654,33,60,152,136,36,417
California,Cutten,2999,37,523,823,630,240,2253
California,Cromberg,132,11,37,49,35,0,132
California,C-Road,99,0,9,41,24,25,99
California,Creston,22,0,0,11,11,0,22
California,Crestline,9240,405,1813,3065,755,662,6700
California,Crest,2712,138,440,838,400,149,1965
California,Cressey,315,55,56,95,25,3,234
California,Crescent Mills,219,17,48,59,0,0,124
California,Crockett,3044,124,629,914,404,290,2361
California,Sunnyside,4203,231,608,962,603,325,2729
California,Cuyama,91,26,0,19,0,0,45
California,Daly City,104930,11037,15978,23248,20515,4718,75496
California,Sultana,916,297,97,19,0,4,417
California,Suisun City,28867,2327,4332,8481,2882,612,18634
California,Sugarloaf Village,7,1,2,2,0,2,7
California,Sugarloaf Saw Mill,0,0,0,0,0,0,0
California,Sugarloaf Mountain Park,0,0,0,0,0,0,0
California,Strawberry CDP (Tuolumne County),246,2,62,102,0,0,166
California,Cypress,49008,2691,6568,10741,8869,4591,33460
California,Strawberry CDP (Marin County),5901,47,355,915,1428,1428,4173
California,Stratford,1020,275,258,96,0,0,629
California,Storrie,0,0,0,0,0,0,0
California,Stonyford,260,42,89,42,16,0,189
California,Stockton,299722,44860,44141,58372,21033,10073,178479
California,Danville,43410,604,2564,6968,11832,7136,29104
California,Dana Point,34003,1298,3206,9140,7309,5099,26052
California,Strathmore,2920,554,322,527,31,12,1446
California,Reedley,25092,5683,2884,3911,1400,664,14542
California,Redwood Valley,2372,42,297,1036,158,0,1533
California,Redwood City,81342,8625,9670,13586,13606,10465,55952
California,Pleasant Hill,34155,810,3177,7703,8503,3965,24158
California,Pleasanton,75009,2420,6190,12013,17463,12202,50288
California,Pleasure Point,5952,431,511,1371,1342,718,4373
California,Plumas Eureka,280,0,31,122,48,74,275
California,Plumas Lake,6548,441,907,1743,572,281,3944
California,Plymouth,842,51,246,204,38,18,557
California,Planada,4392,1381,405,421,149,62,2418
California,Point Arena,391,51,68,98,30,17,264
California,Pollock Pines,6797,440,1575,1893,576,357,4841
California,Pomona,151753,29280,22323,22656,11326,4506,90091
California,Ponderosa,87,0,0,87,0,0,87
California,Poplar-Cotton Center,2654,756,382,222,76,16,1452
California,Port Costa,311,48,66,113,48,0,275
California,Porterville,55218,10194,8238,8947,2335,1061,30775
California,Point Reyes Station,600,18,81,160,158,100,517
California,Port Hueneme,22058,2845,3660,4991,1654,830,13980
California,Plainview,1072,321,124,50,0,0,495
California,Placentia,52123,5298,5999,11123,7793,4175,34388
California,Auburn Lake Trails,3866,61,419,1287,518,354,2639
California,August,8369,2031,1110,1189,125,0,4455
California,Avalon,3777,540,725,582,273,221,2341
California,Avenal,14154,4671,2242,1890,227,92,9122
California,Avery,622,55,184,149,79,30,497
California,Avila Beach,1270,24,185,428,268,264,1169
California,Placerville,10471,795,2279,2638,1135,528,7375
California,Avocado Heights,15917,2862,3293,2823,1101,534,10613
California,Baker,831,144,183,49,13,10,399
California,Pioneer,1090,91,353,291,101,27,863
California,Piru,2061,407,364,345,54,52,1222
California,Pismo Beach,7890,223,935,2388,1367,1094,6007
California,Pittsburg,66947,8721,10611,15150,5936,2148,42566
California,Pixley,3584,1009,415,157,38,0,1619
California,Azusa,48033,6049,7946,7786,3620,1698,27099
California,Portola,2454,293,388,734,155,149,1719
California,Portola Valley,4515,143,315,310,1210,1616,3594
California,Posey,8,0,2,6,0,0,8
California,Rancho Murieta,5563,108,486,1593,1274,826,4287
California,Rancho Palos Verdes,42464,746,3141,7002,10505,9665,31059
California,Rancho San Diego,22062,1118,2758,5559,3841,2133,15409
California,Rancho Santa Fe,2936,73,114,355,742,752,2036
California,Rancho Santa Margarita,49026,1527,4710,9842,10361,5227,31667
California,Rancho Tehama Reserve,2156,387,364,573,35,51,1410
California,Rancho Mirage,17770,696,2878,5137,3756,3067,15534
California,Randsburg,140,0,54,86,0,0,140
California,Red Corral,1713,66,371,521,150,60,1168
California,Redcrest,50,0,25,13,12,0,50
California,Redding,91063,5753,14808,26001,9605,5028,61195
California,Redlands,70186,4340,9608,14223,9220,7705,45096
California,Redondo Beach,67695,2065,5524,13858,17431,10876,49754
California,Redway,1031,93,316,276,0,119,804
California,Red Bluff,14065,1356,3112,3550,808,399,9225
California,Rancho Cucamonga,171858,10084,22783,42650,22712,13553,111782
California,Rancho Cordova,68326,4766,11115,17221,8199,3362,44663
California,Rancho Calaveras,6023,321,1320,1995,415,168,4219
California,Poso Park,6,0,0,0,3,3,6
California,Potrero,819,211,106,55,13,29,414
California,Potter Valley,520,69,102,157,48,22,398
California,Poway,49484,2325,5613,9918,9754,5481,33091
California,Prattville,10,0,0,5,0,5,10
California,Princeton,198,58,22,51,22,11,164
California,Proberta,247,34,134,33,0,0,201
California,Prunedale,18932,2626,3405,4168,1381,850,12430
California,Quartz Hill,10619,1026,2210,2340,671,589,6836
California,Quincy,1543,162,221,483,225,109,1200
California,Rackerby,96,8,22,27,7,3,67
California,Rail Road Flat,349,21,128,108,16,40,313
California,Rainbow,1613,216,293,483,199,96,1287
California,Raisin City,234,112,5,18,6,3,144
California,Ramona,21824,2749,4196,4796,1885,715,14341
California,Crescent City,7120,1878,1736,1453,243,233,5543
California,Cayucos,2758,141,317,762,575,388,2183
California,Cowan,525,101,137,73,31,0,342
California,Covelo,1346,95,232,361,79,37,804
California,Signal Hill,11332,990,1447,2082,1660,833,7012
California,Sierraville,55,1,1,10,42,0,54
California,Sierra Village,521,40,66,221,38,82,447
California,Sierra Madre,11084,130,865,2038,3021,2294,8348
California,Sierra City,218,4,54,79,60,21,218
California,Sierra Brooks,410,0,80,126,39,36,281
California,Silverado Resort,893,0,38,194,372,199,803
California,Shoshone,25,0,15,4,0,0,19
California,Shingle Springs,4533,330,670,1406,633,330,3369
California,Sheridan,1567,235,337,399,98,23,1092
California,Shelter Cove,412,0,108,184,11,34,337
California,Shell Ridge,1039,0,59,194,222,244,719
California,Shaver Lake,742,7,127,199,139,76,548
California,Shasta Lake,10146,923,1980,3313,638,214,7068
California,Shingletown,2432,224,413,937,153,104,1831
California,Shasta,1669,97,285,467,259,183,1291
California,Silver City,0,0,0,0,0,0,0
California,Simi Valley,126103,8127,18208,31372,18337,9207,85251
California,Sonora,4827,475,856,1258,578,342,3509
California,Sonoma,10897,609,1405,2993,2328,1209,8544
California,Solvang,5456,303,742,1435,1025,687,4192
California,Soledad,25826,8409,4376,4444,649,222,18100
California,Solana Beach,13253,687,1214,1783,3595,2997,10276
California,Soda Springs,59,0,16,17,26,0,59
California,Silver Lakes,5992,296,1032,1778,621,418,4145
California,Soda Bay,1429,128,428,573,74,56,1259
California,Smith River,767,62,116,214,17,0,409
California,Smith Corner,648,189,58,44,11,13,315
California,Diablo,818,0,104,81,244,157,586
California,Sleepy Hollow,2489,68,32,398,621,678,1797
California,Sky Valley,2729,396,704,606,208,106,2020
California,Sisquoc,291,26,45,71,9,0,151
California,Snelling,104,8,23,36,2,8,77
California,Soquel,10827,452,1098,2827,1830,1052,7259
California,Cleone,648,90,153,164,58,40,505
California,Clearlake Oaks,1651,220,430,586,123,31,1390
California,Cherry Valley,6798,781,1500,1878,609,504,5272
California,Cherryland,15470,2523,3232,2676,1081,306,9818
California,Cherokee Strip,243,54,49,47,0,0,150
California,Cherokee,111,0,20,53,6,5,84
California,Charter Oak,9247,831,1416,2348,775,384,5754
California,Channel Islands Beach,3072,23,511,778,756,294,2362
California,Chester,2044,105,397,786,192,20,1500
California,Challenge-Brownsville,788,31,177,299,65,50,622
California,Cerritos,49701,2973,5238,10322,11080,6155,35768
California,Ceres,46952,8878,8252,8144,1799,591,27664
California,Centerville,404,30,71,107,0,53,261
California,Cedarville,298,26,45,117,33,12,233
California,Cedar Slope,0,0,0,0,0,0,0
California,Cedar Ridge,1250,72,227,382,150,86,917
California,Chalfant,581,23,129,204,61,14,431
California,Clearlake Riviera,2973,308,368,1072,346,48,2142
California,Chico,88455,4027,8462,19627,12347,6120,50583
California,China Lake Acres,1820,146,382,433,210,49,1220
California,Clearlake,15097,2129,3349,3849,516,345,10188
California,Clear Creek,217,25,34,82,14,4,159
California,Clayton,11497,85,1109,2622,2662,1387,7865
California,Clay,1113,88,226,287,132,95,828
California,Clarksburg,472,34,37,124,76,35,306
California,Claremont,35762,1553,2421,6037,5667,7190,22868
California,Chilcoot-Vinton,46,15,31,0,0,0,46
California,Citrus Heights,85408,5909,15941,25685,7812,3201,58548
California,Chula Vista,257296,30981,32366,54624,30585,13746,162302
California,Chualar,1229,361,196,78,23,0,658
California,Chowchilla,18384,4266,3995,4040,840,310,13451
California,Chino Hills,76796,3362,8285,16151,14783,7158,49739
California,Chino,82208,12355,13662,18145,7964,3223,55349
California,Chinese Camp,170,29,58,0,0,0,87
California,Citrus,11460,1880,2327,1901,673,228,7009
California,Soulsbyville,2071,70,273,828,177,29,1377
California,South Dos Palos,2537,528,294,463,114,0,1399
California,South El Monte,20483,6425,3278,2187,676,270,12836
California,Compton,97955,22002,14264,14828,2969,1048,55111
California,Comptche,73,0,16,57,0,0,73
California,Commerce,13017,3709,2181,1730,365,253,8238
California,Colusa,5939,975,625,1411,460,134,3605
California,Columbia,2597,174,478,805,241,96,1794
California,Colton,53566,8824,8033,8962,2299,1442,29560
California,Concord,126268,11402,20397,29467,19355,7873,88494
California,Coloma,874,51,94,472,7,128,752
California,Collierville,1697,179,496,293,70,11,1049
California,College City,188,27,56,27,35,0,145
California,Colfax,2210,91,359,758,154,60,1422
California,Coleville,368,0,26,67,170,0,263
California,Cold Springs CDP (Tuolumne County),163,0,0,96,28,0,124
California,Cold Springs CDP (El Dorado County),573,11,77,217,38,29,372
California,Colma,1571,163,244,323,266,61,1057
California,Cohasset,933,35,130,271,180,67,683
California,Concow,550,31,102,232,36,26,427
California,Copperopolis,4396,190,868,1423,440,257,3178
California,Courtland,512,91,41,237,41,22,432
California,Country Club,9997,1465,1689,2682,624,250,6710
California,Coulterville,224,0,51,53,41,0,145
California,Cottonwood,3801,532,816,945,153,91,2537
California,Coto de Caza,14554,149,932,2423,3949,2229,9682
California,Cotati,7376,499,849,1634,1183,501,4666
California,Contra Costa Centre,5940,243,447,673,1961,1448,4772
California,Costa Mesa,112377,11755,12605,23701,20348,8463,76872
California,Corralitos,2646,137,183,594,516,349,1779
California,Coronita,3079,348,685,573,235,174,2015
California,Coronado,24447,326,1950,4536,4864,4547,16223
California,Corona,159595,15334,25092,32885,18402,8884,100597
California,Corning,7586,991,1514,1092,291,119,4007
California,Corcoran,23216,7173,4325,4814,307,153,16772
California,Corte Madera,9595,184,582,1646,2543,1691,6646
California,Coffee Creek,142,11,21,34,22,20,108
California,Cobb,1016,60,135,255,189,80,719
California,Coarsegold,994,103,222,326,192,57,900
California,Spring Valley CDP (Lake County),1099,124,235,315,50,84,808
California,Spring Garden,0,0,0,0,0,0,0
California,Spreckels,761,49,33,204,131,41,458
California,Spaulding,196,19,49,74,22,9,173
California,South Whittier,59358,9356,10877,11576,4094,1494,37397
California,South Taft,1740,205,313,230,37,7,792
California,Spring Valley CDP (San Diego County),30392,2598,4563,7581,3195,1652,19589
California,South San Jose Hills,21015,5412,3491,2602,742,275,12522
California,South San Francisco,66217,7772,10594,14398,10970,3259,46993
California,South Pasadena,25999,835,2019,4670,5963,4884,18371
California,South Oroville,6124,940,1103,1083,154,27,3307
California,South Monrovia Island,6768,1542,1409,1179,308,112,4550
California,South Lake Tahoe,21437,2303,3612,5435,2382,1202,14934
California,South Gate,95350,27236,14307,11303,3396,944,57186
California,South San Gabriel,8886,1768,1714,1755,963,538,6738
California,Spring Valley Lake,7849,236,1347,2443,502,510,5038
California,Springville,763,21,170,267,146,0,604
California,Squaw Valley,2796,284,606,889,131,108,2018
California,Coalinga,16940,2983,3047,3763,809,433,11035
California,Coachella,43308,11325,6902,4079,777,122,23205
California,Clyde,751,14,140,361,95,0,610
California,Clovis,100437,6960,13080,24157,11939,6529,62665
California,Cloverdale,8735,1021,1388,2199,851,342,5801
California,Clipper Mills,94,17,17,0,0,0,34
California,Clio,47,12,0,21,0,14,47
California,Stirling City,176,8,60,0,34,8,110
California,Stinson Beach,462,0,5,110,147,149,411
California,Stevinson,290,71,89,67,0,0,227
California,Stevenson Ranch,19408,556,1509,3745,3617,2413,11840
California,Stanton,38625,7837,5336,7222,2853,1206,24454
California,Stanford,14213,66,74,145,1584,2796,4665
California,Stallion Springs,3263,78,747,1122,150,169,2266
California,Squirrel Mountain Valley,1120,54,173,324,120,88,759
California,Covina,48587,4392,7235,11597,5879,2225,31328
California,Diablo Grande,1104,91,250,284,91,60,776
California,Healdsburg,11539,1001,1435,2370,2111,1110,8027
California,Diamond Springs,12459,1167,2431,3578,1366,491,9033
California,Imperial,16215,1279,2048,4013,1279,622,9241
California,Imperial Beach,27051,3431,3686,6794,1878,979,16768
California,Independence,657,42,140,221,66,49,518
California,Indian Falls,115,0,91,10,14,0,115
California,Indianola,909,89,116,286,79,63,633
California,Indian Wells,5158,275,503,1369,1551,1203,4901
California,Indio,84094,13763,14340,15758,5480,3012,52353
California,Indio Hills,1042,232,210,145,44,30,661
California,Industry,433,22,35,102,73,4,236
California,Inglewood,111411,19641,14715,24126,8729,4282,71493
California,Interlaken,6817,1569,1125,1165,418,172,4449
California,Idyllwild-Pine Cove,2616,76,492,686,522,453,2229
California,Inverness,1089,39,192,187,257,321,996
California,Ione,7171,626,1563,1977,902,357,5425
California,Iron Horse,292,27,37,56,0,36,156
California,Irvine,238474,5771,13017,33283,58652,44332,155055
California,Irwindale,1426,234,267,290,63,2,856
California,Isla Vista,26275,474,292,474,625,859,2724
California,Isleton,806,130,195,194,37,2,558
California,Ivanhoe,3837,1129,422,271,143,0,1965
California,Jackson,4613,251,882,1388,557,178,3256
California,Jacumba,144,54,0,90,0,0,144
California,Jamestown,2867,124,730,926,197,48,2025
California,Jamul,5788,270,906,1484,847,692,4199
California,Inyokern,702,35,241,158,199,6,639
California,Janesville,1486,81,115,642,132,95,1065
California,Idlewild,15,0,5,6,0,0,11
California,Hyampom,183,31,79,63,0,0,173
California,Highland,54314,7844,7668,9859,3222,2799,31392
California,Highlands-Baywood Park,4217,115,238,738,1019,886,2996
California,Hillsborough,11253,189,430,1044,2775,3331,7769
California,Hilmar-Irwin,5313,1085,1038,1141,295,126,3685
California,Diamond Bar,56471,3124,5741,10647,13408,6832,39752
California,Hiouchi,327,25,93,55,47,8,228
California,Hollister,36529,5962,5670,6989,2378,762,21761
California,Holtville,6172,1437,700,846,335,33,3351
California,Home Garden,1816,419,250,199,54,0,922
California,Home Gardens,11420,2593,1917,1709,416,130,6765
California,Homeland,6038,1560,1194,978,124,140,3996
California,Hydesville,1272,34,178,424,158,67,861
California,Homestead Valley,3317,464,841,907,200,75,2487
California,Honcut,166,10,30,44,31,9,124
California,Hood,293,43,143,19,17,0,222
California,Hoopa,2958,281,449,747,189,76,1742
California,Hopland,819,87,105,278,73,17,560
California,Hornbrook,269,31,51,64,6,0,152
California,Hornitos,51,0,0,0,15,13,28
California,Hughson,7032,887,1038,1567,339,224,4055
California,Humboldt Hill,3812,292,746,936,272,95,2341
California,Huntington Beach,197752,10821,23545,48571,37214,21517,141668
California,Huntington Park,59003,19952,6595,5512,1557,403,34019
California,Huron,6792,2390,490,334,36,23,3273
California,Homewood Canyon,8,0,8,0,0,0,8
California,Highgrove,3784,697,581,674,212,83,2247
California,Jenner,104,8,0,57,29,10,104
California,Johnstonville,1223,20,182,449,46,39,736
California,Moskowite Corner,202,12,34,76,16,0,138
California,Morro Bay,10471,706,1514,2859,1857,1100,8036
California,Morongo Valley,3242,462,600,982,185,191,2420
California,Morgan Hill,40872,2950,4537,8777,6199,4033,26496
California,Moreno Valley,200788,28968,32105,38453,11849,5311,116686
California,Moraga,16787,163,650,1905,3869,3972,10559
California,Morada,4518,382,681,626,608,748,3045
California,Moorpark,35339,2843,3433,7986,5968,2729,22959
California,Monument Hills,1725,113,389,479,177,163,1321
California,Montgomery Creek,141,0,12,51,26,15,104
California,Monte Sereno,3508,29,151,488,915,968,2551
California,Moss Beach,3704,322,532,671,581,370,2476
California,Monte Rio,1005,35,215,352,81,107,790
California,Monterey Park,61085,9652,11084,10822,9637,4175,45370
California,Monterey,28283,1153,2808,6354,5229,4660,20204
California,Montecito,9471,154,352,1290,2432,1957,6185
California,Montebello,63530,12128,12481,10227,5750,2271,42857
California,Montclair,38025,6991,6914,6365,2540,573,23383
California,Montara,2903,84,318,493,934,400,2229
California,Montalvin Manor,3164,553,497,602,267,93,2012
California,Montague,1518,83,307,481,75,7,953
California,Monson,237,36,48,9,30,4,127
California,Monrovia,37164,2901,5111,8425,6231,3242,25910
California,Mono Vista,2334,145,515,792,268,50,1770
California,Monterey Park Tract,86,46,0,0,0,0,46
California,Johannesburg,118,0,0,91,0,0,91
California,Moss Landing,153,20,42,54,0,0,116
California,Mountain Gate,1156,112,392,301,64,9,878
California,Johnsville,43,0,0,43,0,0,43
California,Joshua Tree,7357,595,1921,1595,692,398,5201
California,Julian,1190,135,231,342,103,125,936
California,Junction City,790,68,233,198,113,24,636
California,June Lake,512,29,25,65,242,0,361
California,Jurupa Valley,98231,18767,16300,16974,4526,1782,58349
California,Keddie,58,0,5,20,10,6,41
California,Keeler,82,0,0,39,24,9,72
California,Keene,351,0,63,156,15,22,256
California,Kelly Ridge,2713,174,604,999,310,59,2146
California,Kelseyville,3783,656,569,966,222,69,2482
California,Mountain Center,78,0,23,5,0,0,28
California,Kennedy,3296,965,451,445,21,7,1889
California,Kensington,5595,37,229,439,1478,2205,4388
California,Kentfield,6813,59,194,702,1926,1946,4827
California,Kenwood,1306,91,87,279,208,192,857
California,Mount Hermon,910,0,51,254,218,124,647
California,Mount Hebron,78,15,3,6,0,26,50
California,Mountain View Acres,3578,618,664,911,100,36,2329
California,Mountain View,77973,3875,6217,9739,16402,20018,56251
California,Mountain View,2295,272,535,677,258,19,1761
California,Mountain Ranch,1378,39,356,494,170,66,1125
California,Mountain Mesa,710,78,113,211,59,16,477
California,Mountain House,12916,524,1331,2681,1857,1312,7705
California,Kennedy Meadows,21,0,0,21,0,0,21
California,Hidden Valley Lake,5986,335,1008,1764,597,413,4117
California,Hidden Meadows,3388,98,387,949,639,540,2613
California,Hidden Hills,1557,36,90,293,321,275,1015
California,Nipomo,16727,1643,2329,4150,1712,905,10739
California,Nipinnawasee,539,19,112,187,55,0,373
California,Niland,836,324,179,65,15,0,583
California,Nicolaus,213,11,38,64,23,33,169
California,Nice,2204,322,662,561,122,27,1694
California,Nicasio,93,9,27,8,11,8,63
California,Newport Beach,86911,1496,5349,16167,25019,17035,65066
California,New Pine Creek,59,16,22,6,0,0,44
California,Newman,10667,1496,2070,1964,614,88,6232
California,Newell,307,90,23,75,5,0,193
California,New Cuyama,665,92,107,93,42,11,345
California,Norco,26966,3289,5750,6552,2089,1121,18801
California,Newcastle,1416,58,289,530,195,60,1132
California,Nevada City,3101,85,363,1003,677,374,2502
California,Needles,4942,596,1144,1274,237,81,3332
California,National City,60043,10254,10095,11876,3875,889,36989
California,Napa,79113,10170,10977,16844,10057,5256,53304
California,Myrtletown,5307,303,963,1608,729,370,3973
California,Myers Flat,0,0,0,0,0,0,0
California,Muscoy,12417,3399,1503,998,219,45,6164
California,Murrieta,107507,5120,14662,26769,12309,6699,65559
California,Murphys,2091,59,358,746,300,199,1662
California,Muir Beach,275,0,22,65,90,63,240
California,Mount Shasta,3312,188,404,1146,544,300,2582
California,Newark,44207,3829,9374,8884,5975,2952,31014
California,Mount Laguna,12,0,12,0,0,0,12
California,Nord,181,13,76,82,10,0,181
California,North Auburn,14496,1225,2776,3686,1313,786,9786
California,Oakville,66,27,0,0,0,0,27
California,Oak View,4317,459,664,1103,508,284,3018
California,Oak Shores,148,0,27,47,52,22,148
California,Oak Park,15087,152,975,2667,3585,2433,9812
California,Oakley,38243,3476,6731,9539,3081,866,23693
California,Oakland,408073,56346,46986,72141,63049,49446,287968
California,Oakhurst,2632,157,468,899,252,110,1886
California,Oak Hills,9363,1370,1518,2668,559,539,6654
California,Oak Glen,776,39,112,165,102,112,530
California,Oakdale,21543,1862,3922,5490,1360,718,13352
California,Nuevo,7738,1062,1586,1145,424,146,4363
California,Norris Canyon,1093,20,61,130,217,168,596
California,Nubieber,16,4,0,5,3,4,16
California,Norwalk,106659,17723,18138,20693,7533,2757,66844
California,North Tustin,26454,504,2211,5116,6078,4832,18741
California,North Shore,3804,1313,372,209,53,86,2033
California,North San Juan,295,6,82,62,27,0,177
California,North Richmond,3988,701,634,699,183,72,2289
California,North Lakeport,2633,276,568,847,242,95,2028
California,North Highlands,46376,4637,8170,11996,2306,772,27881
California,North Gate,534,35,59,69,156,60,379
California,North Fair Oaks,14793,3214,2103,1669,1214,1157,9357
California,North El Monte,4118,314,572,1181,539,237,2843
California,North Edwards,1014,146,246,153,100,5,650
California,Novato,54133,2616,6215,12797,10549,6976,39153
California,Good Hope,8500,2136,1611,935,258,54,4994
California,Goodyears Bar,25,0,14,11,0,0,25
California,Goshen,3734,923,336,448,43,31,1781
California,Hacienda Heights,55158,5522,8460,10955,9805,4157,38899
California,Half Moon Bay,12052,1476,1207,2178,2503,1751,9115
California,Hamilton Branch,602,25,201,180,78,35,519
California,Hamilton City,1917,541,323,165,56,0,1085
California,Hanford,54790,6337,8020,12510,4332,1877,33076
California,Happy Camp,986,136,250,241,79,40,746
California,Harbison Canyon,4130,278,851,1237,311,246,2923
California,Hardwick,145,29,25,6,0,0,60
California,Hartland,0,0,0,0,0,0,0
California,Hartley,2908,193,581,881,271,162,2088
California,Hasley Canyon,1144,103,160,294,163,51,771
California,Gustine,5656,1348,980,1010,192,175,3705
California,Hat Creek,267,101,22,102,16,0,241
California,Hawthorne,86564,14197,13298,16384,7646,2673,54198
California,Hayfork,2785,218,902,583,387,130,2220
California,Hayward,152401,20244,26460,29490,18767,6859,101820
California,Heber,4370,1030,544,451,171,104,2300
California,Hemet,82118,11028,17540,19348,3956,2032,53904
California,Herald,1210,94,269,321,144,52,880
California,Hercules,24838,1148,2532,6128,5546,1765,17119
California,Herlong,1583,486,520,247,23,43,1319
California,Hermosa Beach,19747,153,1334,2982,7005,3924,15398
California,Hesperia,92309,12233,17506,18807,3310,1822,53678
California,Hickman,526,78,126,131,12,12,359
California,Hawaiian Gardens,14475,3564,2460,1754,703,174,8655
California,Guinda,749,74,58,111,35,26,304
California,Guerneville,3788,185,404,1370,697,397,3053
California,Guadalupe,7218,1707,862,1066,242,25,3902
California,Graeagle,597,40,85,228,134,57,544
California,Grand Terrace,12331,892,2157,2887,1249,1172,8357
California,Grangeville,549,55,82,131,51,19,338
California,Granite Bay,22387,360,2016,4500,4999,3288,15163
California,Granite Hills,3282,58,435,955,688,384,2520
California,Graniteville,0,0,0,0,0,0,0
California,Grass Valley,12855,1060,2151,3946,1304,940,9401
California,Graton,1643,222,158,271,296,251,1198
California,Grayson,855,195,190,181,59,0,625
California,Greeley Hill,530,112,139,142,61,21,475
California,Greenacres,5321,353,1180,1473,312,148,3466
California,Green Acres,2460,532,510,233,56,19,1350
California,Greenfield,4347,933,822,870,41,17,2683
California,Greenfield,16869,4198,1998,1738,488,69,8491
California,Greenhorn,180,12,28,94,13,22,169
California,Green Valley CDP (Los Angeles County),1012,52,279,294,136,71,832
California,Green Valley CDP (Solano County),1298,34,176,408,385,188,1191
California,Greenview,161,14,52,45,25,0,136
California,Greenville,997,141,298,325,27,5,796
California,Grenada,484,45,154,103,23,4,329
California,Gridley,6579,1220,802,1345,390,206,3963
California,Grimes,387,65,33,59,22,16,195
California,Grizzly Flats,880,42,126,282,71,73,594
California,Groveland,653,125,289,114,0,0,528
California,Grover Beach,13409,1339,2284,3697,1562,647,9529
California,Mono City,67,0,23,6,10,1,40
California,Monmouth,209,62,29,49,4,0,144
California,Mokelumne Hill,719,0,63,228,115,55,461
California,Mojave,4297,712,829,824,184,53,2602
California,Lomita,20622,1965,3884,4819,2861,1313,14842
California,Lompico,988,55,172,258,174,104,763
California,Lompoc,43428,6784,7410,9071,2243,1256,26764
California,London,2056,682,256,70,6,13,1027
California,Lone Pine,1923,300,433,408,69,27,1237
California,Long Barn,143,0,100,0,0,0,100
California,Long Beach,470237,62714,56777,95715,57227,31548,303981
California,Lookout,59,3,0,22,15,0,40
California,Loomis,6648,155,1222,1463,1047,465,4352
California,Los Alamitos,11658,637,1459,2575,1787,1258,7716
California,Los Alamos,1607,236,304,371,68,60,1039
California,Loma Rica,2584,170,466,852,346,129,1963
California,Los Altos,30075,273,884,3068,6797,10059,21081
California,Los Angeles,3900794,641622,513485,624163,553583,282529,2615382
California,Mentone,9844,692,1823,2362,845,655,6377
California,Menlo Park,33064,1741,1818,3301,6673,9180,22713
California,Menifee,83442,7788,15681,22570,6111,3278,55428
California,Mendota,11402,4396,1175,661,58,34,6324
California,Mendocino,701,48,47,122,190,167,574
California,Meiners Oaks,3595,761,503,743,405,338,2750
California,Mecca,9472,3419,979,333,73,0,4804
California,Mead Valley,19110,4862,3029,2378,483,179,10931
California,Meadow Vista,3129,141,447,843,632,319,2382
California,Meadow Valley,425,9,50,216,20,58,353
California,Los Altos Hills,8314,126,229,663,1816,3419,6253
California,Meadowbrook,3059,571,568,632,151,62,1984
California,Loma Mar,149,41,7,0,14,22,84
California,Loleta,570,61,94,203,108,19,485
California,Leona Valley,1664,141,323,554,158,94,1270
California,Lewiston,1385,108,292,512,99,46,1057
California,Lexington Hills,2581,20,185,419,699,546,1869
California,Likely,37,0,0,37,0,0,37
California,Lincoln,45038,2258,6249,12935,7080,3618,32140
California,Lincoln Village,4108,254,566,1057,571,171,2619
California,Linda,18256,2684,2617,3887,575,213,9976
California,Lindcove,494,179,87,56,11,12,345
California,Linden,1845,58,407,456,152,193,1266
California,Lindsay,12980,3399,1339,1455,307,125,6625
California,Linnell Camp,875,365,75,39,0,0,479
California,Loma Linda,23751,1627,2799,3985,4721,3656,16788
California,Litchfield,106,10,12,49,0,0,71
California,Little River,94,16,29,49,0,0,94
California,Littlerock,2228,529,347,117,136,0,1129
California,Little Valley,36,23,13,0,0,0,36
California,Live Oak,18038,1576,1872,4206,2854,1632,12140
California,Live Oak,8467,1845,1304,1473,286,180,5088
California,Livermore,85286,4947,10049,19777,14993,8414,58180
California,Livingston,13611,3790,1500,1741,613,224,7868
California,Lockeford,3410,543,568,835,235,107,2288
California,Lockwood,446,14,52,118,31,28,243
California,Lodi,63589,7798,10536,14017,4878,2570,39799
California,Lodoga,159,38,49,46,2,3,138
California,Little Grass Valley,0,0,0,0,0,0,0
California,Maywood,27739,9057,3324,2284,627,101,15393
California,Mayflower Village,5421,467,1125,891,961,375,3819
California,Mayfair,4200,941,642,737,87,81,2488
California,McGee Creek,149,46,9,53,41,0,149
California,McFarland,13028,3621,1718,938,138,93,6508
California,Macdoel,158,49,0,5,17,0,71
California,McCloud,1175,70,206,491,124,32,923
California,McClenney Tract,6,4,0,2,0,0,6
California,McClellan Park,1098,130,144,268,67,56,665
California,McArthur,283,0,60,149,23,0,232
California,Mabie,47,0,0,32,15,0,47
California,Lytle Creek,1111,81,354,320,101,26,882
California,Lynwood,71191,18972,10576,8209,1788,627,40172
California,Lucerne Valley,5425,586,1685,1684,180,201,4336
California,McKinleyville,16291,1072,2496,4234,2382,1050,11234
California,Lucerne,3162,485,621,738,91,36,1971
California,Loyola,3539,14,114,270,904,1186,2488
California,Loyalton,890,56,256,278,35,7,632
California,Lower Lake,1639,234,431,384,168,52,1269
California,Lost Hills,2126,644,223,62,0,0,929
California,Los Ranchos,1687,16,156,295,434,319,1220
California,Los Osos,15388,875,1628,4666,2822,1722,11713
California,Los Olivos,1007,34,98,238,245,124,739
California,Los Molinos,2149,465,395,504,48,84,1496
California,Los Gatos,30398,615,1754,4825,8263,6575,22032
California,Los Berros,908,103,99,252,0,93,547
California,Los Banos,36847,6966,5784,5988,1661,576,20975
California,Lucas Valley-Marinwood,6250,208,607,1100,1511,1236,4662
California,McKittrick,115,18,40,27,0,0,85
California,McSwain,4562,502,495,1108,620,285,3010
California,Madera,63053,14254,7509,9272,2293,788,34116
California,Maxwell,1033,158,159,200,54,22,593
California,Mather,4425,296,482,1055,719,316,2868
California,Matheny,1043,316,114,115,20,6,571
California,Marysville,12161,1379,1875,3180,612,366,7412
California,Martinez,37300,1820,5140,10187,6887,3240,27274
California,Martell,234,0,8,117,0,0,125
California,Markleeville,205,14,50,38,8,20,130
California,Mariposa,1580,256,286,455,84,85,1166
California,Marin City,3048,357,343,705,379,269,2053
California,Marina del Rey,9289,215,737,1930,2916,1984,7782
California,Marina,20537,2214,2894,4452,2239,1283,13082
California,Maricopa,1221,148,353,154,3,2,660
California,March ARB,1004,87,154,256,171,184,852
California,Manton,423,32,55,134,41,16,278
California,Manteca,72251,7956,14807,15908,4876,1827,45374
California,Manila,724,17,144,164,132,113,570
California,Manhattan Beach,35603,542,1599,4497,10609,7851,25098
California,Manchester,226,24,38,25,24,8,119
California,Mammoth Lakes,8104,925,963,1663,1238,444,5233
California,Malibu,12856,230,1222,2454,3176,2734,9816
California,Malaga,862,226,116,80,16,5,443
California,Magalia,11306,874,2599,3288,921,409,8091
California,Mad River,482,24,140,120,67,22,373
California,Madison,555,94,108,106,12,17,337
California,Madera Acres,9747,1331,1672,1881,688,181,5753
California,Lenwood,3844,538,562,897,67,17,2081
California,Oasis,5182,2072,261,130,11,10,2484
California,Lennox,21850,6380,3000,2288,628,159,12455
California,Lemoore,24974,2138,3402,5676,2061,639,13916
California,Kettleman City,1651,629,150,95,9,0,883
California,Keyes,6669,1158,1347,880,216,80,3681
California,King City,13389,4227,1690,828,228,112,7085
California,Kings Beach,3620,537,568,871,481,186,2643
California,Kingsburg,11681,910,1644,2460,1265,712,6991
California,Kingvale,129,0,63,53,0,13,129
California,Kirkwood,75,0,13,9,25,6,53
California,Klamath,954,117,268,267,69,18,739
California,Knightsen,1531,99,177,440,303,46,1065
California,Knights Landing,1214,253,147,206,45,17,668
California,La Cañada Flintridge,20526,329,750,2131,5379,4844,13433
California,Keswick,454,78,89,80,52,10,309
California,La Crescenta-Montrose,19940,630,2124,3818,4726,2526,13824
California,Ladera Heights,7509,156,587,1854,1514,1441,5552
California,Ladera Ranch,26714,457,1441,3849,6333,3154,15234
California,Lafayette,25082,295,1100,2969,6792,6045,17201
California,Laguna Beach,23230,459,1356,4493,6293,5681,18282
California,Laguna Hills,31017,1873,3303,6823,6641,3423,22063
California,Laguna Niguel,64825,2069,5468,14011,15063,9811,46422
California,Laguna Woods,16359,710,3604,5254,3708,3068,16344
California,Lagunitas-Forest Knolls,1485,0,124,298,466,234,1122
California,La Habra,61725,7355,10286,12718,6483,2908,39750
California,La Habra Heights,5425,184,819,1165,982,937,4087
California,La Honda,640,20,102,145,175,129,571
California,Ladera,1461,0,0,95,154,690,939
California,Lake Almanor Country Club,507,6,64,126,205,106,507
California,Kernville,1443,48,447,380,259,139,1273
California,Merced,81120,11577,10602,15528,4739,2954,45400
California,Mohawk Vista,85,0,4,53,0,0,57
California,Modesto,207482,24812,36384,46380,15990,8584,132150
California,Mi-Wuk Village,1191,91,445,356,36,23,951
California,Mission Viejo,95979,4215,10432,21825,20572,10442,67486
California,Mission Hills,3679,323,558,928,410,222,2441
California,Mission Canyon,2520,55,165,378,697,568,1863
California,Miranda,525,41,100,135,70,0,346
California,Mira Monte,6990,514,1020,2357,1022,555,5468
California,Minkler,1200,106,228,201,116,245,896
California,Mineral,199,0,33,70,38,27,168
California,Milpitas,71533,6736,8419,13234,13808,7912,50109
California,Kerman,14285,3511,1766,1980,506,142,7905
California,Millville,821,46,71,236,125,73,551
California,Millbrae,22416,1226,3085,4699,4710,2830,16550
California,Milford,192,0,59,82,27,0,168
California,Midway City,9500,1725,1341,2005,1024,177,6272
California,Midpines,826,37,56,426,89,80,688
California,Middletown,953,40,148,366,74,41,669
California,Mexican Colony,242,84,28,20,0,0,132
California,Mettler,108,49,8,7,0,0,64
California,Mesa Vista,208,12,47,47,40,18,164
California,Mesa Verde,739,215,57,121,39,0,432
California,Mesa,301,23,82,75,49,25,254
California,Meridian,500,80,107,101,29,17,334
California,Mill Valley,14243,219,542,1580,4082,3683,10106
California,Lake Almanor Peninsula,485,17,133,166,66,18,400
California,Lake Almanor West,239,0,6,117,45,67,235
California,Lake Arrowhead,11333,880,1169,3015,1487,1214,7765
California,La Porte,0,0,0,0,0,0,0
California,La Presa,36875,4385,5670,9070,2696,920,22741
California,La Puente,40496,9905,7398,5439,1768,538,25048
California,La Quinta,39301,2882,5216,9607,6383,3755,27843
California,La Riviera,11062,523,1320,3147,1928,786,7704
California,Larkfield-Wikiup,9090,544,1164,2477,1450,871,6506
California,Larkspur,12219,414,989,2164,3291,2516,9374
California,La Selva Beach,2708,37,187,851,642,446,2163
California,Las Flores CDP (Orange County),6339,119,325,1198,1353,789,3784
California,Las Flores CDP (Tehama County),191,54,31,19,0,0,104
California,Las Lomas,2952,976,372,296,47,0,1691
California,La Palma,15842,790,2188,3543,2975,1559,11055
California,Lathrop,19678,2718,3392,3808,1499,352,11769
California,La Verne,31920,1971,3669,8385,5012,3110,22147
California,La Vina,409,97,52,0,23,0,172
California,Lawndale,33231,6269,5194,6186,2478,796,20923
California,Laytonville,1274,123,418,174,156,3,874
California,Lebec,1187,112,310,124,79,11,636
California,Lee Vining,90,0,0,0,46,44,90
California,Leggett,74,0,20,13,8,0,41
California,Le Grand,1800,527,165,270,47,11,1020
California,Lemon Cove,260,10,64,86,30,9,199
California,Lemon Grove,26225,3256,5104,6378,1916,812,17466
California,Lemon Hill,13128,2921,2475,2031,433,61,7921
California,Laton,1473,360,243,130,5,53,791
California,Lancaster,159774,17953,28384,35663,9415,5120,96535
California,Lanare,304,73,45,54,0,0,172
California,Lamont,15941,4644,2062,1225,41,58,8030
California,Lake California,2979,187,659,933,238,71,2088
California,Lake City,23,0,13,3,7,0,23
California,Lake Davis,26,13,13,0,0,0,26
California,Lake Don Pedro,1054,99,352,236,82,81,850
California,Lake Elsinore,58003,7815,8403,12086,3842,1677,33823
California,Lake Forest,79928,4432,8610,17482,16294,7720,54538
California,Lakehead,673,34,114,265,78,32,523
California,Lake Hughes,395,26,200,56,41,41,364
California,Lake Isabella,2966,358,1174,797,97,18,2444
California,Lakeland Village,11995,1879,2768,2464,300,191,7602
California,Lake Los Angeles,12136,1790,2728,2278,295,129,7220
California,Lake Mathews,5511,576,1058,1305,426,325,3690
California,Lake Nacimiento,2910,101,650,915,246,176,2088
California,Lake of the Pines,3627,89,577,1242,563,301,2772
California,Lake of the Woods,753,77,139,294,68,41,619
California,Lakeport,4740,334,1061,1388,539,154,3476
California,Lake Riverside,876,32,204,307,39,14,596
California,Lake San Marcos,4798,133,522,1728,1082,514,3979
California,Lake Sherwood,1769,17,242,270,390,410,1329
California,Lakeside,21413,1165,4830,5629,1732,706,14062
California,Lakeview,2142,354,284,492,95,31,1256
California,Lake Wildwood,5375,187,477,1619,1229,621,4133
California,Lakewood,81173,6600,12294,20407,10747,4355,54403
California,La Mesa,58858,3692,7867,15295,9619,4657,41130
California,La Mirada,49182,3615,7504,11449,5819,3751,32138
California,Lemoore Station,6875,92,525,1502,495,218,2832
California,Occidental,1159,16,39,382,329,185,951
California,Flournoy,139,15,27,35,16,0,93
California,Oceanside,173050,16482,25529,42761,20330,10403,115505
California,Petaluma,59340,4431,7696,13730,10330,4990,41177
California,Pescadero,1026,248,188,124,53,28,641
California,Perris,72547,13766,10429,10510,2168,940,37813
California,Penryn,767,29,175,188,91,75,558
California,Penn Valley,1843,47,277,458,281,45,1108
California,Penngrove,2799,88,500,648,652,171,2059
California,Pearsonville,25,0,0,17,0,8,25
California,Paynes Creek,70,2,26,32,5,0,65
California,Paxton,0,0,0,0,0,0,0
California,Patton Village,575,60,170,115,23,15,383
California,Patterson Tract,1905,432,223,372,33,45,1105
California,Patterson,20967,3093,3868,3927,907,323,12118
California,Paskenta,84,13,26,25,0,0,64
California,Pasatiempo,1210,0,90,291,200,277,858
California,Pasadena,139899,12722,14009,23816,26624,24003,101174
California,Parlier,14870,4388,1689,1346,223,79,7725
California,Parkwood,2994,804,157,362,84,9,1416
California,Parkway,15369,2581,2472,2829,643,227,8752
California,Parksdale,3280,807,628,392,19,0,1846
California,Parklawn,1405,639,217,66,24,0,946
California,Paramount,55023,13150,8081,7465,1892,678,31266
California,Paradise Park,515,0,67,190,108,60,425
California,Paradise,170,1,21,56,51,12,141
California,Paradise,26289,1725,4817,8313,3290,1365,19510
California,Panorama Heights,31,11,12,3,0,2,28
California,Palo Verde,56,19,28,9,0,0,56
California,Palos Verdes Estates,13614,141,632,1684,3982,3435,9874
California,Palo Cedro,1543,25,212,551,236,41,1065
California,Palo Alto,66478,1246,2481,5732,13306,24264,47029
California,Peters,440,26,55,160,38,17,296
California,Palm Springs,46305,4723,7455,12716,7785,5052,37731
California,Phelan,13719,1780,3156,3588,437,237,9198
California,Philo,341,59,69,27,0,0,155
California,El Rancho,97,30,19,30,0,0,79
California,El Rio,7080,1660,1115,1063,251,27,4116
California,El Segundo,16929,523,1540,3934,3789,2036,11822
California,El Sobrante CDP (Contra Costa County),13388,868,2840,3392,1664,838,9602
California,El Sobrante CDP (Riverside County),15788,440,1109,3646,2244,2207,9646
California,El Verano,4008,590,342,909,860,214,2915
California,Elverta,5551,578,1430,1364,240,168,3780
California,Emerald Lake Hills,4495,49,271,790,1107,1016,3233
California,Emeryville,10830,275,628,1729,3362,2921,8915
California,Empire,4675,977,798,768,139,40,2722
California,Encinitas,61682,2500,4650,11017,15526,11085,44778
California,Escalon,7320,538,1567,1713,565,205,4588
California,Escondido,149079,24785,18390,29852,14422,6377,93826
California,Esparto,3298,380,524,705,202,163,1974
California,Etna,717,47,181,203,68,12,511
California,Pi?on Hills,6969,960,1808,1549,504,271,5092
California,Pinole,18922,1511,2800,5345,2892,1459,14007
California,Pine Valley,1754,30,282,556,237,121,1226
California,Pine Mountain Lake,2471,87,432,931,393,166,2009
California,Pine Mountain Club,1774,50,379,521,237,122,1309
California,Pine Hills,3167,248,436,931,345,200,2160
California,Pine Grove,1578,81,227,589,220,129,1246
California,Pine Flat,143,6,37,61,12,5,121
California,Pine Canyon,1866,497,172,395,113,42,1219
California,Pike,133,7,9,94,0,0,110
California,Pierpoint,25,0,0,25,0,0,25
California,Piedmont,11099,110,115,871,2688,3672,7456
California,Pico Rivera,63839,13142,12430,11099,3525,1080,41276
California,Phoenix Lake,4741,255,910,1239,749,419,3572
California,Phillipsville,71,20,31,20,0,0,71
California,El Portal,467,0,47,75,115,37,274
California,Palm Desert,50565,3395,7681,13961,8690,5076,38803
California,Palermo,5895,1171,1281,1367,243,68,4130
California,Farmersville,10704,2580,1584,1268,133,42,5607
California,Farmington,80,0,28,52,0,0,80
California,Fellows,79,2,22,26,2,0,52
California,Felton,3991,128,271,1275,715,475,2864
California,Ferndale,1354,64,289,380,220,81,1034
California,Fetters Hot Springs-Agua Caliente,5019,1123,549,686,553,287,3198
California,Fiddletown,83,13,14,37,13,6,83
California,Fieldbrook,823,33,162,230,126,93,644
California,Waterford,8649,1883,1134,1435,237,166,4855
California,Waterloo,524,12,88,141,82,62,385
California,Watsonville,52543,13103,6663,7201,2142,851,29960
California,Waukena,191,10,22,41,6,1,80
California,Wawona,323,0,29,150,9,4,192
California,Weaverville,3151,196,652,1151,297,124,2420
California,Weed,2823,188,468,624,218,84,1582
California,Weedpatch,2328,912,322,94,6,6,1340
California,Weldon,2752,437,782,745,133,112,2209
California,Weott,237,0,78,50,30,0,158
California,West Athens,8320,1394,1541,1512,530,360,5337
California,West Bishop,2873,102,453,709,528,327,2119
California,West Carson,21437,2426,3587,4430,4155,1353,15951
California,West Covina,107837,12185,17674,23116,14414,4693,72082
California,West Goshen,675,161,44,103,8,0,316
California,Westhaven-Moonstone,1031,34,130,262,204,172,802
California,West Hollywood,35332,1453,2816,7661,14498,5441,31869
California,Westlake Village,8471,120,639,1488,2171,1877,6295
California,Westley,759,209,76,30,0,0,315
California,West Menlo Park,3799,38,71,316,808,1280,2513
California,Westminster,91719,15111,15160,19468,10668,3707,64114
California,Fall River Mills,548,63,266,86,0,0,415
California,Palmdale,156672,23085,23160,29858,9010,4245,89358
California,Fallbrook,31573,4168,4805,7146,3139,1461,20719
California,Fair Oaks,31537,1319,3732,8129,6182,3767,23129
California,Pala,999,179,192,128,17,9,525
California,Pajaro Dunes,320,22,30,26,112,69,259
California,Pajaro,3230,1097,212,111,28,25,1473
California,Pacific Grove,15505,549,1873,3387,3591,2709,12109
California,Pacifica,38665,1598,4642,10063,7541,3830,27674
California,Pacheco,4282,409,1056,1159,448,155,3227
California,Oxnard,203495,41773,25888,34078,14150,5495,121384
California,Oroville East,8136,811,1733,2490,477,214,5725
California,Oroville,16060,1606,2929,4254,691,306,9786
California,Orosi,8796,2631,985,914,176,0,4706
California,Orland,7488,1037,1358,1453,328,191,4367
California,Orinda,18703,155,646,1952,5781,4694,13228
California,Orick,267,31,43,135,16,15,240
California,Orcutt,29908,1651,4685,8298,3614,2269,20517
California,Orangevale,34836,1497,6160,10036,4730,1955,24378
California,Orange Cove,9565,2871,1338,450,191,42,4892
California,Adin,173,0,25,79,22,5,131
California,Adelanto,32059,5350,4617,5454,913,143,16477
California,Acton,7058,577,1055,1819,880,548,4879
California,Acampo,787,134,85,256,17,94,586
California,Acalanes Ridge,1139,0,135,161,340,201,837
California,Eucalyptus Hills,5292,211,839,1127,645,405,3227
California,Eureka,26985,2465,4903,6451,2956,1436,18211
California,Oceano,7857,1619,1378,1583,423,218,5221
California,Fairbanks Ranch,2939,107,65,377,828,658,2035
California,Fairfax,7584,153,572,1598,1991,1494,5808
California,Fairfield,109468,9951,16713,25917,12106,4600,69287
California,Fairhaven,222,24,46,36,21,16,143
California,Fairmead,2187,481,331,321,36,60,1229
California,Fairview,10568,600,1518,2904,1725,1005,7752
California,West Modesto,6041,1560,839,734,166,60,3359
California,El Paso de Robles (Paso Robles),30863,3338,4443,8335,3036,1411,20563
California,El Monte,115711,32122,20769,14336,7168,1730,76125
California,East Orosi,572,155,70,22,0,0,247
California,East Palo Alto,29198,5744,4213,4029,1853,942,16781
California,East Pasadena,6063,446,782,1272,1144,762,4406
California,East Porterville,6395,1755,820,519,112,17,3223
California,Traver,711,261,75,54,15,0,405
California,Tres Pinos,472,29,74,147,67,19,336
California,Trinidad,219,8,14,66,57,60,205
California,Trinity Center,211,17,65,82,22,7,193
California,Trinity Village,221,9,71,73,35,12,200
California,Trona,0,0,0,0,0,0,0
California,Trowbridge,220,14,31,92,4,0,141
California,Truckee,16184,858,1824,4081,3187,1521,11471
California,Tulare,61204,9845,10230,10635,3093,1038,34841
California,Tulelake,1000,232,173,116,68,16,605
California,Tuolumne City,1763,85,480,618,171,3,1357
California,Tupman,206,44,27,29,4,4,108
California,Turlock,70596,8305,12062,13471,6700,3669,44207
California,Tustin,78787,8483,8727,13826,13057,7279,51372
California,Tuttle,0,0,0,0,0,0,0
California,Tuttletown,1068,0,159,500,109,63,831
California,Twain,31,0,0,31,0,0,31
California,Twain Harte,2297,38,521,635,359,252,1805
California,Twentynine Palms,25769,1223,3544,4650,2016,663,12096
California,Twin Lakes,5201,433,380,1674,797,774,4058
California,Ukiah,15936,1695,2797,3441,1495,835,10263
California,Union City,72690,6173,13381,13239,12466,5504,50763
California,University of California-Davis,6865,9,52,101,317,489,968
California,University of California-Merced,0,0,0,0,0,0,0
California,Upland,75542,5507,11262,18114,10109,5628,50620
California,Easton,1964,339,302,397,165,56,1259
California,Upper Lake,712,115,59,243,20,19,456
California,East Oakdale,2882,50,534,877,388,277,2126
California,East Los Angeles,125415,39677,16818,13343,3621,952,74411
California,Dillon Beach,139,0,32,44,17,23,116
California,Dinuba,23243,5207,3265,3166,719,215,12572
California,Discovery Bay,14650,358,2020,4431,2222,685,9716
California,Dixon,18908,2529,2863,3623,1536,971,11522
California,Dixon Lane-Meadow Creek,2636,268,587,680,311,152,1998
California,Dobbins,689,49,200,212,43,32,536
California,Dogtown,2337,259,528,527,268,205,1787
California,Dollar Point,1135,58,163,293,360,84,958
California,Dorrington,286,23,35,169,44,5,276
California,Dorris,930,119,196,176,56,2,549
California,Dos Palos,5068,1070,951,628,183,56,2888
California,Dos Palos Y,215,72,39,21,14,0,146
California,Douglas City,613,24,97,212,72,1,406
California,Downey,113407,17320,18100,21602,11090,4409,72521
California,Downieville,213,0,33,70,43,12,158
California,Doyle,452,31,81,271,16,0,399
California,Drytown,217,97,0,45,9,0,151
California,Duarte,21769,2682,3654,4119,2779,1796,15030
California,Dublin,52063,2905,4901,8695,12369,7310,36180
California,Ducor,661,180,82,54,12,9,337
California,Dunnigan,1183,204,398,162,60,20,844
California,Dunsmuir,1552,142,282,485,213,95,1217
California,Durham,5637,93,685,1454,928,538,3698
California,Dustin Acres,523,91,136,147,0,16,390
California,Dutch Flat,162,0,21,19,50,45,135
California,Eagleville,74,17,18,22,7,0,64
California,Earlimart,8709,2684,894,494,70,0,4142
California,East Foothills,6437,394,860,1462,1304,694,4714
California,East Hemet,19180,2219,3795,4250,941,618,11823
California,East Nicolaus,213,26,66,60,9,10,171
California,El Nido,515,142,41,67,8,0,258
California,Vacaville,94795,7357,15537,26652,9538,4595,63679
California,Vallecito,482,0,80,136,33,43,292
California,Warm Springs,3190,514,594,743,71,47,1969
California,Warner Valley,4,0,0,0,4,0,4
California,Wasco,25973,7343,4163,2943,331,245,15025
California,Washington,24,18,6,0,0,0,24
California,East Quincy,2827,159,564,1096,101,111,2031
California,East Rancho Dominguez,15615,4192,2147,2135,271,109,8854
California,East Richmond Heights,3272,121,403,910,599,463,2496
California,East San Gabriel,15980,1495,2362,2593,3667,1706,11823
California,East Shore,225,73,41,20,24,10,168
California,East Sonora,2368,213,818,657,256,171,2115
California,East Tulare Villa,954,184,158,240,6,0,588
California,Eastvale,56275,4075,6507,10728,7847,4049,33206
California,East Whittier,10440,853,1915,2964,845,364,6941
California,Edgewood,27,0,7,7,0,6,20
California,Edmundson Acres,343,70,71,23,14,0,178
California,Edna,176,0,46,56,39,0,141
California,Edwards AFB,2401,9,130,524,285,211,1159
California,El Cajon,102383,12749,18972,20913,8658,3733,65025
California,El Centro,43570,7875,5138,7914,3082,1749,25758
California,El Cerrito,24418,1143,2003,4338,5685,5380,18549
California,El Cerrito,5581,830,1184,999,346,181,3540
California,El Dorado Hills,43264,874,3533,9096,9434,5450,28387
California,Eldridge,1287,72,309,306,102,46,835
California,El Granada,5681,308,445,1126,1359,847,4085
California,Elizabeth Lake,1735,65,407,510,165,126,1273
California,Elk Creek,151,42,28,47,19,2,138
California,Elk Grove,161084,9622,19660,35983,25789,10280,101334
California,Elkhorn,1139,166,96,381,174,97,914
California,Elmira,345,32,42,91,17,0,182
California,Walnut Park,16054,5525,2248,1939,428,164,10304
California,Valinda,24026,5164,4590,3669,1482,355,15260
California,Walnut Grove,1253,100,173,355,117,50,795
California,Walnut,29970,1482,2845,5756,7844,3259,21186
California,Vallejo,118995,10298,20468,30797,15049,4963,81575
California,Valle Vista,16127,1762,3248,3961,985,721,10677
California,Valley Acres,584,39,198,155,22,0,414
California,Valley Center,10261,1227,1410,2485,1351,509,6982
California,Valley Ford,155,32,67,0,0,0,99
California,Valley Home,290,67,94,37,14,8,220
California,Valley Ranch,44,0,6,5,12,21,44
California,Valley Springs,3321,182,728,1420,214,77,2621
California,Valley Wells,0,0,0,0,0,0,0
California,Val Verde,2697,370,434,554,194,60,1612
California,Vandenberg AFB,3317,38,151,819,274,106,1388
California,Vandenberg Village,6763,267,873,2113,983,505,4741
California,Verdi,107,17,0,62,28,0,107
California,Vernon,41,9,7,11,5,1,33
California,Victor,592,160,26,23,0,0,209
California,Victorville,120703,14850,19913,26163,4473,3040,68439
California,View Park-Windsor Hills,11648,398,797,3134,2151,2441,8921
California,Villa Park,5947,136,481,1292,1266,1126,4301
California,Vina,181,28,33,63,0,33,157
California,Vincent,17006,3005,3416,3123,1003,229,10776
California,Vine Hill,4144,696,881,716,293,113,2699
California,Vineyard,26452,1966,3138,6354,3507,1419,16384
California,Visalia,127842,13460,18646,27908,11816,6016,77846
California,Vista,97564,14589,15608,20855,8465,3699,63216
California,Vista Santa Rosa,3173,762,382,434,117,57,1752
California,Volcano,20,0,0,20,0,0,20
California,Volta,172,21,37,65,0,0,123
California,Walker,832,128,119,358,27,42,674
California,Wallace,877,71,151,320,114,43,699
California,Walnut Creek,66799,1382,5389,12620,18773,13277,51441
California,Westmont,32566,5779,5629,6217,1090,288,19003
California,Exeter,10481,1382,1669,2286,672,216,6225
California,Fortuna,11904,1052,2540,3121,826,368,7907
California,Woodcrest,16049,1430,2996,4027,1506,833,10792
California,Woodbridge,3705,358,589,762,620,362,2691
California,Woodacre,1623,57,60,349,488,380,1334
California,Wofford Heights,1684,179,451,697,139,105,1571
California,Winton,11669,2839,1504,1184,272,92,5891
California,Winters,6927,1031,988,1570,678,477,4744
California,Winterhaven,171,79,25,12,9,0,125
California,Winter Gardens,20703,1422,4512,5495,1627,959,14015
California,Windsor,27205,2387,3875,6464,3763,1602,18091
California,Winchester,2824,492,635,503,176,55,1861
California,Wilton,5030,221,792,1608,719,332,3672
California,Wilsonia,0,0,0,0,0,0,0
California,Willows,6111,836,938,1149,513,347,3783
California,Willow Creek,1553,55,219,595,252,22,1143
California,Willowbrook,20685,5487,2846,2042,390,85,10850
California,Williams,5159,1443,708,794,205,58,3208
California,Wilkerson,557,13,122,135,112,17,399
California,Wildomar,34220,3415,5939,8692,2529,912,21487
California,Whittier,86688,9358,13300,19768,8272,5280,55978
California,Whitley Gardens,280,19,32,137,0,16,204
California,Whitewater,611,68,127,146,10,20,371
California,Whitehawk,44,10,0,16,9,9,44
California,Wheatland,3543,362,667,955,199,120,2303
California,Westwood,1595,50,238,530,138,71,1027
California,West Whittier-Los Nietos,27114,5153,5716,4888,1667,608,18032
California,Westside,279,94,13,39,5,0,151
California,West Sacramento,50747,5519,7846,10615,5198,2778,31956
California,West Rancho Dominguez,22605,4061,4184,4119,1216,402,13982
California,West Puente Valley,24077,5683,5084,3472,1019,362,15620
California,Woodlake,7525,1858,819,1084,187,60,4008
California,Woodland,56997,7462,9005,11105,5548,3295,36415
California,Woodlands,632,0,57,149,199,194,599
California,Woodside,5479,110,312,583,1408,1538,3951
California,Fountain Valley,56696,3971,6681,13811,11017,5125,40605
California,Foster City,32377,960,2283,4951,8204,7343,23741
California,Fort Washington,734,0,45,88,115,107,355
California,Fort Jones,978,60,139,251,78,24,552
California,Fort Irwin,9238,30,593,1856,896,419,3794
California,Fort Dick,918,14,158,96,180,97,545
California,Fort Bragg,7261,698,1330,1737,670,280,4715
California,Fort Bidwell,204,47,43,31,14,7,142
California,Forestville,3367,156,609,1061,675,299,2800
California,Forest Ranch,831,51,98,362,62,195,768
California,Forest Meadows,1568,109,197,516,339,68,1229
California,Foresthill,1124,144,260,343,86,15,848
California,Ford City,4085,811,684,793,92,37,2417
California,Forbestown,344,34,176,18,0,0,228
California,West Point,628,54,185,213,42,20,514
California,Foothill Farms,33090,3005,6395,8146,2223,814,20583
California,Folsom,74156,3880,8093,14747,15069,9415,51204
California,Floriston,40,0,0,35,0,5,40
California,Florin,50899,9143,9203,9951,2832,818,31947
California,Florence-Graham,63177,20130,8021,4705,1209,317,34382
California,Fish Camp,51,0,42,9,0,0,51
California,Firebaugh,8084,2444,1019,567,145,12,4187
California,Fillmore,15296,3129,1770,2942,569,330,8740
California,Fields Landing,229,28,47,21,100,0,196
California,Yorba Linda,67033,2049,5577,14692,14753,8806,45877
California,Yolo,577,52,141,112,31,0,336
California,Yettem,300,119,30,0,0,0,149
California,Yankee Hill,270,43,32,108,46,10,239
California,Wrightwood,4442,85,567,1136,507,540,2835
California,Woodville,1798,724,166,73,27,4,994
California,Fontana,203677,32274,31279,35326,13532,4874,117285
California,West Park,717,194,146,157,29,3,529
California,Willits,4853,531,988,1415,295,152,3381
California,Friant,244,56,78,61,27,22,244
California,Galt,24607,2467,4506,5214,1781,603,14571
California,Furnace Creek,187,34,90,44,9,5,182
California,Fulton,638,131,182,97,40,31,481
California,Fullerton,138976,12068,16702,26378,21875,12873,89896
California,Fuller Acres,970,303,145,46,16,10,520
California,Fruitridge Pocket,5725,1467,924,773,200,27,3391
California,Onyx,604,44,134,242,48,27,495
California,Ontario,168218,29970,27458,30521,10653,3480,102082
California,Olivehurst,14293,2567,2239,3113,340,180,8439
California,Old Station,109,0,8,69,7,0,84
California,Old Fig Garden,5493,421,665,1348,770,694,3898
California,Olancha,152,20,29,97,2,0,148
California,Ojai,7587,489,777,1634,1341,1105,5346
California,Garberville,988,120,207,316,52,8,703
California,Oildale,33842,3982,7420,7707,1732,599,21440
California,Fruitdale,980,92,173,252,106,82,705
California,Westmorland,1750,454,202,282,81,11,1030
California,Fresno,510451,74340,69019,96032,40894,18957,299242
California,French Valley,27752,1551,3599,7122,2951,1414,16637
California,French Gulch,494,29,176,133,20,29,387
California,French Camp,4057,1016,839,475,81,58,2469
California,Fremont,225221,11987,29113,32750,43771,38447,156068
California,Freeport,51,7,16,4,0,10,37
California,Freedom,3027,739,394,522,155,32,1842
California,Frazier Park,2654,151,667,546,210,83,1657
California,Franklin CDP (Sacramento County),97,17,27,34,0,0,78
California,Franklin CDP (Merced County),7511,1896,779,1407,213,44,4339
California,Fowler,6006,1096,895,1083,352,100,3526
California,Ocotillo,252,21,33,62,21,14,151
California,Gardena,59931,7585,11278,13188,7361,2312,41724
California,Orange,139761,14422,17556,28049,20372,10752,91151
California,Garden Farms,265,15,55,50,67,21,208
California,Zayante,881,22,82,315,132,63,614
California,Yucca Valley,21258,2148,4453,6382,1067,729,14779
California,Yucaipa,52739,4705,9129,14004,4212,2464,34514
California,Yuba City,66038,9017,10252,15108,5000,2245,41622
California,Garden Acres,11278,3220,1895,1230,154,64,6563
California,Yountville,2985,250,554,673,806,378,2661
California,Yosemite Valley,1067,82,220,408,145,42,897
California,Yosemite Lakes,4990,232,707,1662,584,453,3638
California,Gonzales,8378,2052,1066,1058,245,26,4447
California,Goleta,30541,2135,3666,5916,4597,3972,20286
California,Gold River,7639,209,485,1411,2144,1614,5863
California,Gold Mountain,21,0,0,10,0,11,21
California,Golden Hills,8313,443,1290,2311,785,425,5254
California,Yreka,7635,791,1240,2167,579,304,5081
California,Glen Ellen,593,28,57,242,65,160,552
California,Garden Grove,174721,30264,28476,34629,16453,5280,115102
California,Garey,170,117,10,15,2,0,144
California,Gasquet,596,0,110,244,24,35,413
California,Gazelle,56,20,17,13,0,2,52
California,Georgetown,2473,213,348,940,82,161,1744
California,Garnet,6844,1114,1783,654,402,173,4126
California,Gerber,1129,312,201,216,47,0,776
California,Geyserville,1088,220,169,230,113,37,769
California,Gilroy,51649,7265,6058,10315,5360,2546,31544
California,Glendale,196984,22735,27721,39789,36221,18853,145319
California,Glendora,51137,3405,6526,13405,6998,4236,34570
Colorado,Montrose,18970,1567,3626,4619,2289,1423,13524
Colorado,Milliken,5975,643,1045,1374,473,237,3772
Colorado,Minturn,1050,124,144,188,285,59,800
Colorado,Moffat,131,3,36,39,20,15,113
Colorado,Monte Vista,4366,637,1010,868,253,146,2914
Colorado,Castle Pines Village,4504,66,169,605,1207,805,2852
Colorado,Montezuma,57,0,0,21,12,10,43
Colorado,Midland,163,0,32,69,0,34,135
Colorado,Monument,6252,173,296,1264,1054,819,3606
Colorado,Mount Crested Butte,859,12,59,66,414,123,674
Colorado,Morrison,394,31,122,90,80,44,367
Colorado,Mountain Meadows,192,0,25,40,47,65,177
Colorado,Mountain View,607,82,97,160,80,42,461
Colorado,Mountain Village,1405,21,146,232,382,162,943
Colorado,Mulford,169,15,11,21,30,52,129
Colorado,Nederland,1531,26,138,358,287,217,1026
Colorado,Naturita,461,43,150,112,35,5,345
Colorado,Merino,245,12,59,46,11,4,132
Colorado,Morgan Heights,386,0,39,141,79,19,278
Colorado,Meridian,3107,71,153,929,794,488,2435
Colorado,Aguilar,660,140,127,159,24,14,464
Colorado,Mead,3967,184,593,793,496,552,2618
Colorado,Aetna Estates,1165,161,251,226,44,39,721
Colorado,Acres Green,2921,38,343,722,620,239,1962
Colorado,New Castle,4569,292,557,894,505,446,2694
Colorado,Carbondale,6516,920,755,985,1318,685,4663
Colorado,Louviers,152,17,42,62,11,6,138
Colorado,Cascade-Chipita Park,1561,20,329,422,238,160,1169
Colorado,Castle Pines,10399,93,473,1359,3017,1752,6694
Colorado,Loveland,71755,2929,11866,18122,11568,5398,49883
Colorado,Meeker,2770,226,593,671,193,98,1781
Colorado,Lynn,6,0,0,0,3,0,3
Colorado,McCoy,27,0,0,20,0,0,20
Colorado,Manassa,1060,74,212,242,59,33,620
Colorado,Mancos,1727,118,285,462,189,119,1173
Colorado,Manitou Springs,5211,178,789,1364,1071,670,4072
Colorado,Manzanola,445,90,115,68,17,17,307
Colorado,Marble,150,7,26,33,28,26,120
Colorado,Maybell,56,0,27,23,0,0,50
Colorado,Maysville,95,0,0,60,18,17,95
Colorado,Lyons,2056,33,220,379,425,345,1402
Colorado,Niwot,4497,15,137,597,1322,958,3029
Colorado,Estes Park,6103,119,1064,1563,1397,851,4994
Colorado,Norrie,0,0,0,0,0,0,0
Colorado,Brush,5488,602,1099,1059,301,252,3313
Colorado,Broomfield,60699,1773,6010,11893,13421,7783,40880
Colorado,Brookside,247,11,56,57,18,11,153
Colorado,Brighton,35582,3865,6721,7126,3182,1192,22086
Colorado,Brick Center,34,0,0,34,0,0,34
Colorado,Breckenridge,4682,33,427,1081,1190,629,3360
Colorado,Branson,41,1,5,14,8,6,34
Colorado,Brandon,18,8,3,7,0,0,18
Colorado,Bow Mar,1045,3,41,100,296,246,686
Colorado,Boulder,103919,2186,4322,9677,20027,22170,58382
Colorado,Boone,346,35,87,75,15,5,217
Colorado,Bonanza Mountain Estates,96,14,25,0,13,44,96
Colorado,Bonanza,8,0,0,0,8,0,8
Colorado,Blue Sky,0,0,0,0,0,0,0
Colorado,Blue River,784,0,70,202,264,49,585
Colorado,Blende,727,87,204,169,39,22,521
Colorado,Blanca,478,112,105,65,31,12,325
Colorado,Black Hawk,155,5,77,51,8,5,146
Colorado,Black Forest,12918,185,1287,2962,2632,2103,9169
Colorado,Buena Vista,2705,66,423,723,332,237,1781
Colorado,Burlington,3931,543,1198,892,222,112,2967
Colorado,Byers,1357,100,470,316,132,39,1057
Colorado,Calhan,832,35,209,183,59,31,517
Colorado,Peyton,307,0,47,34,80,0,161
Colorado,Perry Park,1727,14,193,405,507,281,1400
Colorado,Peoria,178,20,5,64,21,14,124
Colorado,Penrose,3211,215,759,940,302,167,2383
Colorado,Peetz,242,9,73,72,9,1,164
Colorado,Parshall,57,13,0,44,0,0,57
Colorado,Parker,47342,587,4042,8899,10784,4514,28826
Colorado,Paragon Estates,848,0,82,110,250,213,655
Colorado,Parachute,1095,130,250,195,55,10,640
Colorado,Beulah Valley,768,44,83,183,124,83,517
Colorado,Paonia,1255,60,331,325,151,82,949
Colorado,Palmer Lake,2529,20,500,549,436,230,1735
Colorado,Palisade,2654,206,440,786,278,161,1871
Colorado,Pagosa Springs,1729,208,368,336,227,105,1244
Colorado,Padroni,143,32,32,23,4,0,91
Colorado,Ovid,311,37,98,57,30,3,225
Colorado,Ouray,853,25,145,183,201,98,652
Colorado,Capulin,115,18,44,16,4,0,82
Colorado,Ca?on City,16408,1316,3765,4234,1215,846,11376
Colorado,Campo,41,5,10,19,7,0,41
Colorado,Paoli,63,37,10,13,1,0,61
Colorado,No Name,146,0,0,66,72,8,146
Colorado,Bethune,297,39,57,50,11,5,162
Colorado,Berkley,11599,2160,1946,1898,995,278,7277
Colorado,Alamosa East,1576,136,247,356,100,67,906
Colorado,Alamosa,9592,834,1338,1569,717,697,5155
Colorado,Akron,1903,169,575,482,115,58,1399
Colorado,Air Force Academy,5864,20,149,551,138,99,957
Colorado,Otis,438,25,79,105,40,7,256
Colorado,Ordway,1393,117,249,314,61,56,797
Colorado,Orchard Mesa,6385,374,1584,1469,746,226,4399
Colorado,Orchard City,3047,182,871,826,232,107,2218
Colorado,Orchard,113,22,29,33,17,0,101
Colorado,Ophir,226,0,9,42,76,18,145
Colorado,Olney Springs,507,37,75,67,23,5,207
Colorado,Olathe,1999,472,441,211,40,49,1213
Colorado,Oak Creek,836,52,191,160,126,72,601
Colorado,Nunn,524,37,137,123,39,4,340
Colorado,Nucla,525,58,156,109,25,27,375
Colorado,Norwood,595,63,112,126,93,36,430
Colorado,North Washington,272,92,86,77,3,0,258
Colorado,North La Junta,449,25,105,150,7,8,295
Colorado,Northglenn,37754,3331,7842,9127,3247,1355,24902
Colorado,Allenspark,673,0,78,127,151,160,516
Colorado,Alma,302,3,62,68,67,12,212
Colorado,Alpine,146,0,8,74,16,33,131
Colorado,Altona,550,0,10,31,175,145,361
Colorado,Bennett,1915,79,551,447,183,45,1305
Colorado,Bayfield,2478,131,418,496,345,148,1538
Colorado,Battlement Mesa,4689,480,822,1142,405,224,3073
Colorado,Basalt,3791,196,295,646,1332,451,2920
Colorado,Bark Ranch,222,0,0,103,0,60,163
Colorado,Avondale,803,81,250,228,22,28,609
Colorado,Avon,6414,384,1119,782,1599,367,4251
Colorado,Aurora,345867,29724,55050,74313,42585,19046,220718
Colorado,Castle Rock,52143,1256,4972,10801,10986,4799,32814
Colorado,Berthoud,5497,115,896,1705,832,325,3873
Colorado,Ault,1750,146,340,412,97,52,1047
Colorado,Aspen Park,748,21,57,206,158,61,503
Colorado,Aspen,6740,180,482,1280,2409,1126,5477
Colorado,Arvada,111658,4529,18889,25624,19277,10237,78556
Colorado,Arriba,188,12,55,44,14,5,130
Colorado,Aristocrat Ranchettes,1275,243,292,240,60,21,856
Colorado,Arboles,246,15,68,74,32,8,197
Colorado,Applewood,7623,186,1167,1503,1819,1109,5784
Colorado,Antonito,757,57,244,143,70,11,525
Colorado,Amherst,56,0,20,20,7,9,56
Colorado,Atwood,228,5,74,64,12,0,155
Colorado,Cathedral,17,0,4,10,0,0,14
Colorado,La Junta,7018,693,1296,1945,402,278,4614
Colorado,Cattle Creek,731,53,179,22,0,0,254
Colorado,East Pleasant View,425,43,80,85,81,14,303
Colorado,Eaton,4662,236,666,1162,441,251,2756
Colorado,Eckley,342,30,77,100,10,1,218
Colorado,Edgewater,5237,639,912,1356,636,265,3808
Colorado,Edwards,9792,855,1230,1371,1872,1053,6381
Colorado,Elbert,187,12,41,52,11,3,119
Colorado,Eldora,119,0,0,48,16,28,92
Colorado,Eldorado Springs,782,0,22,40,295,226,583
Colorado,Elizabeth,1236,62,297,290,102,62,813
Colorado,Eagle,6553,302,756,1046,1715,469,4288
Colorado,El Jebel,3526,359,589,624,519,164,2255
Colorado,El Moro,325,0,69,88,42,31,230
Colorado,Empire,312,15,81,85,29,14,224
Colorado,Englewood,31877,2775,5778,6989,5161,2529,23232
Colorado,Haswell,74,9,21,20,3,6,59
Colorado,Hasty,96,5,26,16,3,17,67
Colorado,Hartman,62,7,19,16,0,1,43
Colorado,Gypsum,6685,988,1112,1256,938,402,4696
Colorado,Gunnison,5955,269,602,792,748,356,2767
Colorado,Gunbarrel,9184,36,556,1474,2845,2105,7016
Colorado,Ellicott,703,77,134,165,35,19,430
Colorado,Eads,612,30,185,123,24,34,396
Colorado,Durango,17486,464,1669,3194,3726,2148,11201
Colorado,Downieville-Lawson-Dumont,474,37,144,140,42,0,363
Colorado,Crested Butte,1445,18,88,253,534,186,1079
Colorado,Crestone,107,2,7,51,11,14,85
Colorado,Cripple Creek,1341,175,296,248,109,21,849
Colorado,Crisman,351,0,0,44,96,86,226
Colorado,Crook,143,19,39,42,8,4,112
Colorado,Crowley,284,29,37,81,37,1,185
Colorado,Dacono,4461,521,1112,986,380,60,3059
Colorado,Dakota Ridge,33580,821,4485,7864,6488,3093,22751
Colorado,De Beque,369,51,104,63,20,10,248
Colorado,Deer Trail,573,14,181,143,42,7,387
Colorado,Del Norte,1984,255,478,313,125,43,1214
Colorado,Delta,8779,879,1890,2096,794,474,6133
Colorado,Denver,649654,63240,80415,107032,124473,80249,455409
Colorado,Derby,8565,1972,1554,1022,194,11,4753
Colorado,Dillon,865,11,81,198,308,96,694
Colorado,Dinosaur,313,44,77,52,30,0,203
Colorado,Divide,124,0,0,25,49,0,74
Colorado,Dolores,1048,68,148,206,178,89,689
Colorado,Dotsero,863,194,89,74,2,0,359
Colorado,Dove Creek,707,58,178,134,69,12,451
Colorado,Dove Valley,5600,197,475,1126,1127,278,3203
Colorado,Guffey,81,0,0,22,19,40,81
Colorado,Crawford,287,20,95,70,14,1,200
Colorado,Grover,83,5,7,31,12,4,59
Colorado,Green Mountain Falls,671,8,77,216,80,102,483
Colorado,Fraser,1102,77,199,242,279,58,855
Colorado,Franktown,203,0,13,11,84,39,147
Colorado,Foxfield,683,10,72,160,142,100,484
Colorado,Fowler,1144,92,265,345,84,20,806
Colorado,Fountain,27062,722,4178,7760,2363,1039,16062
Colorado,Fort Morgan,11377,1804,2202,1943,478,450,6877
Colorado,Fort Lupton,7669,1137,1599,1316,347,170,4569
Colorado,Fort Garland,470,67,59,119,18,10,273
Colorado,Fort Collins,153292,3521,12717,25877,28574,17968,88657
Colorado,Frederick,10186,285,1437,2413,1893,549,6577
Colorado,Fort Carson,14742,138,1291,2759,531,295,5014
Colorado,Florissant,77,14,13,41,0,0,68
Colorado,Florence,3884,247,743,1135,275,103,2503
Colorado,Fleming,608,9,143,201,33,7,393
Colorado,Flagler,596,26,169,108,28,13,344
Colorado,Firestone,11255,232,1461,2974,1755,716,7138
Colorado,Federal Heights,12037,1986,2543,2011,626,159,7325
Colorado,Fairplay,817,41,106,182,106,34,469
Colorado,Fairmount,8222,303,1343,1407,1548,1127,5728
Colorado,Evergreen,8688,202,729,1408,2341,1828,6508
Colorado,Floyd Hill,1153,0,116,249,377,216,958
Colorado,Frisco,2855,52,445,611,555,678,2341
Colorado,Fruita,12750,815,1828,3540,1341,887,8411
Colorado,Fruitvale,7458,654,1681,2152,822,228,5537
Colorado,Greeley,97074,9263,14406,18392,9258,5022,56341
Colorado,Grand View Estates,689,3,111,86,112,107,419
Colorado,Grand Lake,329,10,96,81,55,45,287
Colorado,Grand Junction,59945,3332,9963,13048,7934,3870,38147
Colorado,Granby,1864,95,535,443,147,117,1337
Colorado,Granada,507,137,58,87,25,10,317
Colorado,Gold Hill,189,0,76,51,26,20,173
Colorado,Goldfield,41,0,9,18,0,0,27
Colorado,Golden,19780,723,1872,2743,3394,3125,11857
Colorado,Glenwood Springs,9756,974,1512,1884,1402,828,6600
Colorado,Gleneagle,6470,108,384,1209,1374,1371,4446
Colorado,Glendale,112,0,0,0,65,15,80
Colorado,Glendale,4744,340,491,1040,1022,400,3293
Colorado,Gilcrest,917,133,194,160,61,2,550
Colorado,Gerrard,122,9,60,32,6,15,122
Colorado,Georgetown,1031,28,171,284,167,132,782
Colorado,Genoa,85,15,15,27,3,3,63
Colorado,Genesee,3703,25,125,539,1010,1135,2834
Colorado,Garfield,8,0,0,8,0,0,8
Colorado,Garden City,277,57,72,60,10,0,199
Colorado,Fulford,0,0,0,0,0,0,0
Colorado,Greenwood Village,14920,235,741,1743,4397,3496,10612
Colorado,Catherine,288,25,22,58,34,38,177
Colorado,Craig,8983,539,2361,1980,629,276,5785
Colorado,Cortez,8571,720,1564,2036,750,660,5730
Colorado,Larkspur,248,24,58,90,13,11,196
Colorado,Laporte,2497,189,438,748,368,211,1954
Colorado,Lamar,7744,868,1474,1944,404,173,4863
Colorado,Lakewood,147836,8798,24327,32983,24661,13345,104114
Colorado,Lake City,354,11,56,102,102,24,295
Colorado,La Junta Gardens,25,0,23,0,1,1,25
Colorado,Erie,19948,429,1204,3682,4802,2889,13006
Colorado,La Jara,713,87,125,138,75,45,470
Colorado,La Salle,2571,288,632,524,90,72,1606
Colorado,Laird,30,6,0,24,0,0,30
Colorado,Kremmling,2090,184,449,375,210,36,1254
Colorado,Kittredge,1324,14,187,273,280,146,900
Colorado,Kit Carson,263,4,45,67,32,6,154
Colorado,Kirk,102,27,30,18,17,0,92
Colorado,Kiowa,859,47,214,210,94,28,593
Colorado,Kim,61,6,19,7,13,2,47
Colorado,Keystone,1067,148,359,266,132,88,993
Colorado,Kersey,1585,244,357,282,99,33,1015
Colorado,Ken Caryl,33021,753,4449,8091,6368,3232,22893
Colorado,Lafayette,26430,920,2877,4361,6025,3944,18127
Colorado,Las Animas,1813,267,462,459,91,48,1327
Colorado,La Veta,729,35,150,185,145,79,594
Colorado,Lazy Acres,977,0,39,208,190,322,759
Colorado,Cedaredge,2272,150,650,414,249,113,1576
Colorado,Centennial,106604,1742,10691,21309,25324,14895,73961
Colorado,Center,2105,728,210,192,70,35,1235
Colorado,Central City,771,42,149,303,62,63,619
Colorado,Chacra,544,7,47,98,54,82,288
Colorado,Cheraw,175,9,54,60,15,2,140
Colorado,Cherry Creek,12087,296,605,1752,2871,2504,8028
Colorado,Louisville,19548,249,1255,2560,4954,4710,13728
Colorado,Longmont,89814,7428,12031,17171,13713,8342,58685
Colorado,Lone Tree,12462,178,780,1668,3686,2128,8440
Colorado,Loma,1254,140,238,360,121,53,912
Colorado,Log Lane Village,1003,188,214,198,28,8,636
Colorado,Loghill Village,452,5,45,137,131,93,411
Colorado,Lochbuie,5222,818,904,908,306,0,2936
Colorado,Littleton,44553,1570,5676,10104,9432,5068,31850
Colorado,Lincoln Park,3222,305,888,901,256,110,2460
Colorado,Limon,1425,78,318,299,190,50,935
Colorado,Leyner,30,0,0,30,0,0,30
Colorado,Lewis,391,31,66,101,0,24,222
Colorado,Leadville North,1815,106,409,380,158,155,1208
Colorado,Leadville,2595,61,471,580,624,155,1891
Colorado,Keenesburg,1319,98,279,402,88,28,895
Colorado,Cotopaxi,7,0,0,7,0,0,7
Colorado,Julesburg,1218,58,309,329,102,54,852
Colorado,Johnson Village,224,0,65,85,0,0,150
Colorado,Hayden,1819,102,467,446,162,58,1235
Colorado,Haxtun,1005,60,184,252,98,49,643
Colorado,Cherry Hills Village,6329,25,300,598,1475,1718,4116
Colorado,Cimarron Hills,16746,740,2786,4651,1655,416,10248
Colorado,City of Creede,189,11,53,55,38,21,178
Colorado,Clifton,20079,2323,4671,4338,1342,290,12964
Colorado,Coal Creek,1894,13,257,447,669,292,1678
Colorado,Coal Creek,335,54,93,80,24,2,253
Colorado,Coaldale,364,0,77,132,35,0,244
Colorado,Heeney,251,43,79,96,19,14,251
Colorado,Cokedale,140,0,26,43,22,1,92
Colorado,Colona,0,0,0,0,0,0,0
Colorado,Colorado City,2249,0,329,828,282,139,1578
Colorado,Colorado Springs,442040,19546,58893,100707,64685,41352,285183
Colorado,Columbine,24709,604,3510,5752,5165,2671,17702
Colorado,Columbine Valley,1164,18,62,191,360,243,874
Colorado,Comanche Creek,375,0,113,128,9,15,265
Colorado,Commerce City,50346,5899,8910,8851,3994,2055,29709
Colorado,Conejos,76,5,17,22,12,0,56
Colorado,Copper Mountain,268,0,42,80,20,24,166
Colorado,Collbran,646,29,88,109,59,17,302
Colorado,Hidden Lake,0,0,0,0,0,0,0
Colorado,Highlands Ranch,104432,1048,7438,16609,27034,13939,66068
Colorado,Hillrose,280,28,67,64,11,12,182
Colorado,Joes,45,2,10,11,6,5,34
Colorado,Jansen,131,5,117,0,9,0,131
Colorado,Jamestown,256,5,20,53,74,41,193
Colorado,Jackson Lake,178,50,54,31,6,0,141
Colorado,Inverness,1109,0,26,125,612,243,1006
Colorado,Indian Hills,1380,26,188,297,220,194,925
Colorado,Iliff,212,5,53,70,13,0,141
Colorado,Ignacio,887,74,229,206,82,19,610
Colorado,Idledale,282,23,43,102,16,7,191
Colorado,Idalia,45,0,11,14,2,0,27
Colorado,Idaho Springs,1996,87,471,497,230,98,1383
Colorado,Hugo,670,94,186,123,33,14,450
Colorado,Hudson,2138,345,663,416,87,45,1556
Colorado,Howard,794,32,190,203,162,112,699
Colorado,Hot Sulphur Springs,772,34,210,172,107,11,534
Colorado,Hotchkiss,932,40,286,182,54,62,624
Colorado,Hooper,55,5,18,20,3,9,55
Colorado,Holyoke,2185,227,460,545,166,72,1470
Colorado,Holly Hills,2560,50,125,361,749,635,1920
Colorado,Holly,882,147,125,210,53,29,564
Colorado,Hoehne,128,15,44,15,13,0,87
Colorado,Johnstown,12818,442,2304,3272,1720,671,8409
Colorado,Cheyenne Wells,909,92,202,211,107,26,638
Colorado,Evans,20308,2715,3283,3876,1136,422,11432
Colorado,Williamsburg,680,37,189,155,29,29,439
Colorado,Seven Hills,83,0,0,16,0,67,83
Colorado,Windsor,20455,423,2761,4584,3473,2307,13548
Colorado,Winter Park,578,0,96,68,157,93,414
Colorado,Wolcott,0,0,0,0,0,0,0
Colorado,Woodland Park,7155,120,853,2064,996,863,4896
Colorado,Woodmoor,8427,21,528,1578,1995,1487,5609
Colorado,Woody Creek,276,0,8,92,45,54,199
Colorado,Wray,2714,208,514,595,227,57,1601
Colorado,Yampa,417,13,97,85,56,26,277
Colorado,Yuma,3601,380,746,876,434,326,2762
Colorado,Wiley,350,23,92,65,33,7,220
Colorado,Stonegate,9264,124,741,1357,2679,795,5696
Colorado,Steamboat Springs,12148,286,1544,2232,3289,1412,8763
Colorado,Starkville,31,7,10,7,5,0,29
Colorado,Springfield,1392,131,320,328,138,57,974
Colorado,South Fork,589,20,128,148,59,78,433
Colorado,Southern Ute,156,3,53,48,0,8,112
Colorado,Snyder,145,0,47,61,0,0,108
Colorado,Snowmass Village,2865,0,236,461,1179,320,2196
Colorado,Smeltertown,174,14,36,43,10,11,114
Colorado,Simla,555,61,132,123,67,23,406
Colorado,Silverton,552,36,144,131,99,24,434
Colorado,Sterling,14046,1439,2935,3256,723,501,8854
Colorado,Silverthorne,4117,316,491,830,849,424,2910
Colorado,Wiggins,1054,127,181,289,36,29,662
Colorado,West Pleasant View,3830,216,769,1074,404,352,2815
Colorado,Two Buttes,63,5,13,19,10,0,47
Colorado,Upper Bear Creek,1143,28,59,280,239,266,872
Colorado,Vail,5321,36,418,1201,1873,634,4162
Colorado,Valdez,18,3,6,2,0,3,14
Colorado,Valmont,104,0,12,43,16,10,81
Colorado,Vernon,10,0,4,6,0,0,10
Colorado,Victor,374,24,109,94,61,27,315
Colorado,Vilas,214,17,17,61,14,0,109
Colorado,Vineland,166,19,42,40,0,15,116
Colorado,Vona,45,9,13,11,3,1,37
Colorado,Wheat Ridge,30863,2551,5987,7084,4626,2566,22814
Colorado,Walden,535,79,148,124,30,18,399
Colorado,Walsh,618,75,139,167,38,18,437
Colorado,Ward,115,2,9,59,14,5,89
Colorado,Watkins,492,24,119,135,70,38,386
Colorado,Welby,16408,2106,3654,3025,646,292,9723
Colorado,Weldona,104,6,28,44,7,3,88
Colorado,Wellington,6934,135,781,2017,956,474,4363
Colorado,Westcliffe,440,25,92,127,24,42,310
Colorado,Westcreek,117,0,21,35,22,22,100
Colorado,Westminster,110598,6828,17017,24677,17583,9402,75507
Colorado,Weston,51,9,5,32,0,0,46
Colorado,Walsenburg,2930,434,554,836,210,166,2200
Colorado,Silver Plume,239,4,59,65,31,41,200
Colorado,Silver Cliff,789,65,164,176,56,28,489
Colorado,Silt,2976,254,658,611,208,44,1775
Colorado,Rock Creek Park,20,0,0,10,0,0,10
Colorado,Rockvale,475,41,112,96,26,32,307
Colorado,Rocky Ford,3877,501,761,988,288,89,2627
Colorado,Rollinsville,15,0,0,0,0,15,15
Colorado,Romeo,337,78,60,33,14,7,192
Colorado,Roxborough Park,9859,134,967,1826,2009,1533,6469
Colorado,Rye,209,9,57,40,31,10,147
Colorado,Saddle Ridge,64,0,5,26,25,0,56
Colorado,Saguache,536,97,106,156,70,8,437
Colorado,St. Ann Highlands,350,0,32,72,112,65,281
Colorado,Rifle,9451,890,2047,1725,747,271,5680
Colorado,St. Mary's,291,0,91,72,0,14,177
Colorado,Salt Creek,662,120,178,129,15,5,447
Colorado,San Acacio,14,0,6,5,3,0,14
Colorado,Sanford,918,64,181,260,91,8,604
Colorado,San Luis,642,165,81,89,30,38,403
Colorado,Sawpit,30,0,1,12,6,5,24
Colorado,Security-Widefield,34836,1631,5939,10201,2660,1403,21834
Colorado,Sedalia,131,0,13,65,7,13,98
Colorado,Sedgwick,155,19,52,40,13,1,125
Colorado,Segundo,153,18,33,39,0,5,95
Colorado,Seibert,182,15,70,35,10,2,132
Colorado,Salida,5373,394,927,1461,961,471,4214
Colorado,Ridgway,898,12,150,165,251,116,694
Colorado,Rico,199,5,22,57,41,12,137
Colorado,Redvale,171,6,71,28,5,17,127
Colorado,Sherrelwood,19209,3831,4065,3087,824,342,12149
Colorado,Sheridan Lake,85,9,3,14,7,0,33
Colorado,Sheridan,5912,680,1244,1162,407,220,3713
Colorado,Shaw Heights,4760,720,1067,983,416,90,3276
Colorado,Phippsburg,139,0,53,47,20,12,132
Colorado,Piedra,61,0,16,10,19,9,54
Colorado,Pierce,946,131,292,171,63,50,707
Colorado,Pine Brook Hill,1263,0,73,162,287,340,862
Colorado,Pitkin,104,5,28,11,24,8,76
Colorado,Platteville,2574,295,558,589,164,20,1626
Colorado,Poncha Springs,1172,100,235,257,164,66,822
Colorado,Ponderosa Park,3211,78,539,980,636,148,2381
Colorado,Portland,168,0,57,32,24,38,151
Colorado,Pritchett,130,6,64,35,2,0,107
Colorado,Pueblo,108073,10558,21416,26035,8848,5185,72042
Colorado,Pueblo West,30440,1073,5247,8361,3335,1931,19947
Colorado,Ramah,72,5,22,24,6,2,59
Colorado,Rangely,2322,120,537,507,179,106,1449
Colorado,Raymer (New Raymer),88,12,16,14,11,5,58
Colorado,Red Cliff,279,17,80,64,46,5,212
Colorado,Red Feather Lakes,181,0,54,63,29,5,151
Colorado,Redlands,10086,572,1717,2543,1824,826,7482
Colorado,Redstone,26,0,0,15,11,0,26
Colorado,Twin Lakes CDP (Lake County),140,0,53,19,36,11,119
Colorado,Twin Lakes CDP (Adams County),6698,1557,1482,1088,337,131,4595
Colorado,Severance,3448,96,489,775,660,262,2282
Colorado,Trail Side,82,0,15,17,0,0,32
Colorado,Stonewall Gap,41,0,0,6,19,16,41
Colorado,Strasburg,3027,129,627,627,341,87,1811
Colorado,Stratmoor,6035,478,1121,1888,292,119,3898
Colorado,Stratton,627,54,142,149,39,18,402
Colorado,Sugar City,434,48,88,77,35,4,252
Colorado,Sugarloaf,305,0,13,38,155,68,274
Colorado,Sunshine,151,0,30,19,18,67,134
Colorado,Superior,12815,158,420,1191,3165,3099,8033
Colorado,Swink,659,12,82,174,59,36,363
Colorado,Trinidad,8470,925,1443,2459,608,375,5810
Colorado,Tall Timber,217,0,13,39,76,51,179
Colorado,Telluride,2019,62,330,223,741,262,1618
Colorado,The Pinery,11384,75,1171,2318,2637,1284,7485
Colorado,Thornton,127688,9882,21701,26290,14829,6549,79251
Colorado,Timnath,1204,11,144,206,282,109,752
Colorado,Todd Creek,3879,140,484,1102,759,371,2856
Colorado,Towaoc,787,104,196,115,18,12,445
Colorado,Towner,43,4,5,6,2,4,21
Colorado,Tabernash,355,0,0,0,168,71,239
Connecticut,South Woodstock,1155,35,357,201,158,96,847
Connecticut,Southwood Acres,7731,414,2284,1605,877,392,5572
Connecticut,South Windham,1458,131,449,370,109,38,1097
Connecticut,Southport,1667,45,125,195,553,374,1292
Connecticut,South Coventry,1117,56,261,302,122,173,914
Connecticut,Somers,1927,40,381,586,178,134,1319
Connecticut,Sharon,666,67,143,175,97,38,520
Connecticut,Sherwood Manor,5457,270,1378,1116,745,416,3925
Connecticut,Shelton,40783,1974,8372,7550,6931,4687,29514
Connecticut,Stafford Springs,5061,597,915,1102,287,269,3170
Connecticut,Saybrook Manor,1103,60,163,288,160,196,867
Connecticut,Salmon Brook,2676,76,473,543,598,319,2009
Connecticut,Rockville,7459,639,1990,1488,440,346,4903
Connecticut,Simsbury Center,5926,159,456,970,1388,1096,4069
Connecticut,Stamford,126592,9704,18454,18427,23242,18154,87981
Connecticut,Tariffville,1272,30,193,270,198,207,898
Connecticut,Storrs,15914,63,408,314,197,488,1470
Connecticut,Bridgeport,147340,22812,30268,24355,9834,6141,93410
Connecticut,Bristol,60554,4870,15257,12268,7331,3433,43159
Connecticut,Broad Brook,4504,86,1246,827,502,409,3070
Connecticut,Waterbury,109551,14704,25716,19305,6671,4015,70411
Connecticut,Wallingford Center,17710,1059,4422,3186,2604,1418,12689
Connecticut,Trumbull,36571,1408,4990,5579,6961,5669,24607
Connecticut,Stonington borough,971,28,93,196,243,234,794
Connecticut,Torrington,35493,3567,9634,7708,3566,1985,26460
Connecticut,Thompsonville,8878,789,2371,1655,754,448,6017
Connecticut,Thomaston,1909,197,640,349,182,70,1438
Connecticut,Terryville,5180,493,1250,1069,514,231,3557
Connecticut,Terramuggus,862,20,139,137,218,173,687
Connecticut,Suffield Depot,1468,26,216,202,306,218,968
Connecticut,Stratford,52316,3478,12786,10201,7518,4550,38533
Connecticut,Riverside,8592,163,520,1074,1790,1845,5392
Connecticut,Ridgefield,7725,98,442,608,2174,1779,5101
Connecticut,Orange,13946,410,1879,1708,2801,3022,9820
Connecticut,Putnam,7147,451,1538,1929,501,244,4663
Connecticut,Noank,2133,50,215,376,458,427,1526
Connecticut,Niantic,3005,92,610,631,563,473,2369
Connecticut,Glastonbury Center,7409,372,967,952,1360,1534,5185
Connecticut,Glenville,2478,111,413,330,627,449,1930
Connecticut,Greenwich,13499,579,2042,1340,2905,2822,9688
Connecticut,Groton,9305,387,2227,1832,832,915,6193
Connecticut,Norfolk,591,51,93,102,88,104,438
Connecticut,Groton Long Point borough,510,5,37,86,139,186,453
Connecticut,Hartford,124795,21622,22588,17778,6639,4893,73520
Connecticut,Lakeville,858,18,46,251,150,179,644
Connecticut,Lake Pocotopaug,3313,142,732,491,514,532,2411
Connecticut,Kensington,8824,457,2034,1847,1598,539,6475
Connecticut,Jewett City borough,3472,440,866,575,131,61,2073
Connecticut,Higganum,1683,72,235,215,298,394,1214
Connecticut,Guilford Center,2476,57,277,536,608,515,1993
Connecticut,North Granby,1781,18,227,207,474,246,1172
Connecticut,North Grosvenor Dale,1707,206,359,367,70,102,1104
Connecticut,North Haven,23937,837,5355,4346,3852,3178,17568
Connecticut,Portland,5619,314,1436,1014,842,484,4090
Connecticut,Poquonock Bridge,1828,102,554,293,144,39,1132
Connecticut,Plantsville,1672,70,516,307,336,183,1412
Connecticut,Plainfield Village,2244,223,827,573,66,25,1714
Connecticut,Pemberwick,3935,112,763,421,1156,435,2887
Connecticut,Pawcatuck,5242,366,1267,776,774,462,3645
Connecticut,Oxoboxo River,3081,223,938,705,230,168,2264
Connecticut,Branford Center,6015,295,1497,1231,741,828,4592
Connecticut,Old Saybrook Center,2139,51,289,340,559,324,1563
Connecticut,Old Mystic,3625,153,642,721,675,561,2752
Connecticut,Old Greenwich,6764,52,200,476,1505,1857,4090
Connecticut,Georgetown,1845,22,177,425,397,289,1310
Connecticut,Norwich,40254,4022,10482,8126,3023,1736,27389
Connecticut,Norwalk,87701,7254,15552,14477,15583,10308,63174
Connecticut,Northwest Harwinton,3167,229,659,619,467,281,2255
Connecticut,Quinebaug,1102,114,312,219,78,124,847
Connecticut,Blue Hills,2872,368,823,609,198,57,2055
Connecticut,Westbrook Center,2125,226,566,392,245,258,1687
Connecticut,Bethel,9731,499,1881,1738,1421,1253,6792
Connecticut,Deep River Center,2417,109,454,459,326,297,1645
Connecticut,Darien,21392,197,1057,1287,5711,4492,12744
Connecticut,Danielson borough,4026,555,825,703,468,141,2692
Connecticut,Litchfield borough,1474,42,242,324,257,238,1103
Connecticut,Long Hill,4269,234,1141,880,588,449,3292
Connecticut,Madison Center,2421,74,295,360,605,444,1778
Connecticut,Derby,12796,1368,3050,2283,1516,906,9123
Connecticut,Manchester,30883,1685,6264,7080,3774,2050,20853
Connecticut,Mashantucket,167,8,21,47,13,5,94
Connecticut,Meriden,60439,5975,16572,12838,5439,3142,43966
Connecticut,Middletown,47218,2565,8822,8844,6119,5303,31653
Connecticut,Milford city (balance),51643,2264,11251,9882,8500,6426,38323
Connecticut,Moodus,1212,0,282,416,151,47,896
Connecticut,Moosup,3192,361,737,878,226,91,2293
Connecticut,Mansfield Center,1127,26,112,178,136,218,670
Connecticut,Mystic,3981,141,508,656,1063,986,3354
Connecticut,Durham,2932,90,497,445,548,460,2040
Connecticut,East Hampton,2643,187,449,586,310,328,1860
Connecticut,Woodmont borough,1563,38,280,245,370,302,1235
Connecticut,Woodbury Center,1438,34,262,205,306,375,1182
Connecticut,Winsted,7753,830,1981,1833,633,281,5558
Connecticut,Windsor Locks,12564,865,3309,2965,1426,743,9308
Connecticut,Wilton Center,712,7,57,109,209,130,512
Connecticut,Falls Village,403,26,101,82,91,52,352
Connecticut,East Brooklyn,1672,163,469,405,72,75,1184
Connecticut,Fenwick borough,81,5,11,31,17,15,79
Connecticut,Willimantic,17411,2315,3047,2372,748,750,9232
Connecticut,Wethersfield,26510,1815,4717,4710,4637,3525,19404
Connecticut,West Simsbury,2466,77,188,296,692,559,1812
Connecticut,Essex Village,2196,76,158,471,710,395,1810
Connecticut,East Haven,29104,2440,8831,5457,2682,1850,21260
Connecticut,East Hartford,51137,5664,11951,10925,4377,2456,35373
Connecticut,Gales Ferry,824,7,192,178,129,99,605
Connecticut,Bethlehem Village,1850,88,374,387,261,236,1346
Connecticut,Naugatuck borough,31722,2790,7031,6491,3339,2437,22088
Connecticut,New Hartford Center,1557,88,415,402,127,133,1165
Connecticut,Canaan,1098,68,317,255,86,33,759
Connecticut,Byram,4836,319,889,678,790,582,3258
Connecticut,Brooklyn,908,198,212,272,84,104,870
Connecticut,Heritage Village,3934,140,1064,1098,684,704,3690
Connecticut,Westport,27343,202,1908,2111,6778,7035,18034
Connecticut,West Haven,55189,4845,12623,10230,4994,3293,35985
Connecticut,Cannondale,117,0,0,30,39,19,88
Connecticut,West Hartford,63288,2621,6696,8023,12238,14838,44416
Connecticut,Wauregan,1428,161,365,201,70,0,797
Connecticut,Watertown,2996,74,424,771,590,347,2206
Connecticut,Waterford,2948,262,752,713,372,166,2265
Connecticut,Ansonia,19035,1608,5922,3225,1194,906,12855
Connecticut,Baltic,1026,87,367,218,53,31,756
Connecticut,Bantam borough,842,84,236,223,96,34,673
Connecticut,Weatogue,3020,10,253,440,760,616,2079
Connecticut,New Britain,72988,8973,17621,11383,5334,3454,46765
Connecticut,Canton Valley,1659,76,489,247,179,270,1261
Connecticut,Chester Center,1847,57,297,411,308,296,1369
Connecticut,New Haven,130612,13801,23640,15807,12527,15337,81112
Connecticut,Newington,30638,1865,5738,6078,5339,3518,22538
Connecticut,New London,27423,2806,5261,4377,2123,1499,16066
Connecticut,New Milford,6915,717,1444,1406,781,356,4704
Connecticut,New Preston,915,14,130,228,167,168,707
Connecticut,Newtown borough,2009,59,162,290,445,382,1338
Connecticut,Cheshire Village,5730,141,712,848,1200,1239,4140
Connecticut,Danbury,83476,10022,17330,12692,9804,7547,57395
Connecticut,Coventry Lake,3393,176,946,655,357,243,2377
Connecticut,Cos Cob,6433,184,556,626,1361,1575,4302
Connecticut,Conning Towers Nautilus Park,9814,99,1274,1662,920,429,4384
Connecticut,Collinsville,3518,120,529,709,605,661,2624
Connecticut,Colchester,4309,159,1097,905,653,283,3097
Connecticut,Clinton,3498,149,969,652,513,364,2647
Connecticut,Crystal Lake,2220,68,495,400,322,160,1445
Connecticut,Oakville,9246,695,2411,1883,715,730,6434
Connecticut,Hazardville,4868,208,1307,1050,418,353,3336
Delaware,Wilmington Manor,7912,850,1844,1877,565,233,5369
Delaware,Viola,164,9,51,30,20,6,116
Delaware,Townsend,2617,150,412,288,290,218,1358
Delaware,South Bethany,423,4,82,93,111,107,397
Delaware,Smyrna,10904,709,2452,2372,1046,448,7027
Delaware,Slaughter Beach,211,7,37,66,40,43,193
Delaware,Selbyville,2675,488,482,516,156,70,1712
Delaware,Seaford,7290,959,1799,1138,348,321,4565
Delaware,St. Georges,1141,55,315,174,136,48,728
Delaware,Rodney Village,1586,150,381,400,153,111,1195
Delaware,Riverview,2863,107,558,685,405,206,1961
Delaware,Felton,1658,105,339,278,150,95,967
Delaware,Fenwick Island,396,12,73,79,107,109,380
Delaware,Frankford,988,117,283,101,55,22,578
Delaware,Lewes,2887,216,646,515,523,622,2522
Delaware,Little Creek,190,27,43,27,3,0,100
Delaware,Long Neck,2359,189,748,717,163,134,1951
Delaware,Magnolia,192,8,49,50,13,4,124
Delaware,Middletown,19744,793,3259,3624,2410,1731,11817
Delaware,Milford,9993,964,2108,2221,1005,467,6765
Delaware,Millsboro,4050,522,1099,736,234,176,2767
Delaware,Millville,1510,65,244,271,228,103,911
Delaware,Milton,2717,225,627,508,323,350,2033
Delaware,Newark,32740,691,2532,3593,4479,4086,15381
Delaware,Wilmington,71549,8148,16693,10808,7418,5386,48453
Delaware,New Castle,5371,453,1394,1153,635,422,4057
Delaware,Farmington,91,15,35,9,2,0,61
Delaware,Woodside East,2027,165,508,349,130,52,1204
Delaware,Dover Base Housing,3417,52,133,1022,263,135,1605
Delaware,Dover,37144,2739,6147,6503,3523,2718,21630
Delaware,Dewey Beach,250,19,22,54,82,50,227
Delaware,Delmar,1784,201,442,382,114,55,1194
Delaware,Delaware City,1933,174,552,402,152,27,1307
Delaware,Dagsboro,980,41,237,208,103,51,640
Delaware,Clayton,3034,253,743,455,297,119,1867
Delaware,Claymont,9060,748,2120,1688,962,506,6024
Delaware,Cheswold,1219,151,299,259,89,36,834
Delaware,Camden,3501,201,622,856,472,304,2455
Delaware,Brookside,13743,998,3573,2810,1476,819,9676
Delaware,Bridgeville,2364,270,515,499,251,187,1722
Delaware,Bowers,320,23,67,66,23,41,220
Delaware,Blades,1303,175,353,192,76,29,825
Delaware,Bethel,171,3,58,42,27,14,144
Delaware,Bethany Beach,908,33,138,208,244,204,827
Delaware,Bellefonte,1318,48,339,236,231,131,985
Delaware,Bear,19886,1761,3957,3814,2264,1096,12892
Delaware,Ardentown,297,4,47,53,94,38,236
Delaware,Ardencroft,262,9,50,59,48,41,207
Delaware,Arden,538,18,80,105,96,118,417
Delaware,Elsmere,6154,900,1637,848,415,227,4027
Delaware,Wyoming,1673,125,224,426,189,88,1052
Delaware,Woodside,150,10,50,41,4,4,109
Delaware,Edgemoor,6257,118,1221,1417,988,356,4100
Delaware,Newport,1165,205,249,245,56,37,792
Delaware,Georgetown,6775,1541,1404,721,361,244,4271
Delaware,North Star,7596,101,695,890,1966,1827,5479
Delaware,Ocean View,1880,50,627,366,406,227,1676
Delaware,Odessa,598,32,147,122,108,47,456
Delaware,Pike Creek,8463,125,697,1535,1789,1913,6059
Delaware,Pike Creek Valley,10672,284,1600,2370,2051,1618,7923
Delaware,Rehoboth Beach,1098,12,176,151,360,347,1046
Delaware,Rising Sun-Lebanon,3970,293,725,822,525,202,2567
Delaware,Frederica,1053,118,213,183,98,27,639
Delaware,Leipsic,118,15,30,23,6,3,77
Delaware,Laurel,3916,447,773,584,118,94,2016
Delaware,Ellendale,363,30,111,64,11,3,219
Delaware,Kent Acres,2283,217,543,389,188,109,1446
Delaware,Houston,390,27,133,70,35,11,276
Delaware,Glasgow,14640,453,2861,3290,2107,1097,9808
Delaware,Greenville,2378,55,241,305,556,701,1858
Delaware,Greenwood,1289,171,381,173,66,19,810
Delaware,Harrington,3665,247,688,848,154,65,2002
Delaware,Hartly,54,7,6,9,7,5,34
Delaware,Henlopen Acres,157,0,10,30,61,33,134
Delaware,Highland Acres,3966,179,762,842,554,431,2768
Delaware,Kenton,299,47,68,49,0,1,165
Delaware,Hockessin,13230,484,1194,1663,3230,2691,9262
Florida,Palm Bay,105212,8947,24951,25539,8806,4137,72380
Florida,Palm Beach,8418,168,862,2087,2741,1819,7677
Florida,Palm Beach Gardens,50977,2061,7733,11847,11216,7857,40714
Florida,Palmetto Bay,24443,787,2262,4224,4679,3920,15872
Florida,Palm City,23413,926,3333,5573,4844,3084,17760
Florida,Palm Coast,79297,5105,20129,20027,8428,4031,57720
Florida,Palmetto,12973,1538,3654,2110,1331,532,9165
Florida,Palmetto Estates,16175,1625,3872,3079,1530,553,10659
Florida,Palm Beach Shores,1077,36,197,296,258,180,967
Florida,Palatka,10414,1462,2417,1814,701,193,6587
Florida,Page Park,549,13,91,119,80,0,303
Florida,Pahokee,6003,1479,1044,869,249,107,3748
Florida,Olga,2104,168,801,501,109,57,1636
Florida,Olympia Heights,14645,2065,3542,2595,2008,1078,11288
Florida,Ona,94,12,34,0,0,0,46
Florida,Opa-locka,16139,3002,3477,2439,792,77,9787
Florida,Orange City,11023,1051,3019,2969,1012,410,8461
Florida,Orange Park,8545,464,1640,2788,902,493,6287
Florida,Orangetree,5248,454,634,788,761,529,3166
Florida,Paisley,1159,278,200,302,26,0,806
Florida,Orchid,374,2,22,50,159,128,361
Florida,Orlando,256738,18225,42799,52633,39341,19796,172794
Florida,Orlovista,5978,724,1532,1170,295,80,3801
Florida,Ormond Beach,39938,1860,8527,10846,5434,3789,30456
Florida,Osprey,6664,207,1557,1423,1303,1162,5652
Florida,Otter Creek,134,27,60,19,0,0,106
Florida,Oviedo,36617,1113,4282,7800,6427,3293,22915
Florida,Pace,21997,1138,4058,4961,2721,1264,14142
Florida,Oriole Beach,1608,21,209,436,224,178,1068
Florida,Ormond-by-the-Sea,7678,536,2173,2080,985,817,6591
Florida,Dania Beach,30878,3152,7365,6193,3215,2008,21933
Florida,Palm Harbor,59769,2102,12116,16399,10278,5336,46231
Florida,Jasmine Estates,19604,2424,5162,4996,960,413,13955
Florida,Jasper,4243,953,1099,519,154,83,2808
Florida,Jay,420,45,120,81,14,25,285
Florida,Jennings,668,200,101,93,3,6,403
Florida,Jensen Beach,12266,785,2912,3389,1611,1062,9759
Florida,June Park,3981,290,1109,916,569,138,3022
Florida,Juno Beach,3325,105,610,670,1110,589,3084
Florida,Juno Ridge,566,50,122,176,77,10,435
Florida,Wabasso Beach,1549,29,107,302,653,364,1455
Florida,Wabasso,575,31,144,153,31,68,427
Florida,Jan Phyl Village,4690,487,1391,720,368,101,3067
Florida,Virginia Gardens,2957,311,739,520,310,144,2024
Florida,Villas,10349,922,2174,2899,1462,945,8402
Florida,Villano Beach,3051,180,465,704,421,280,2050
Florida,Viera West,8365,114,1123,1680,1340,1810,6067
Florida,Viera East,11264,516,1842,3008,1970,1200,8536
Florida,Verona Walk,2645,256,729,667,436,234,2322
Florida,Vero Beach South,23973,2226,5311,6146,2860,1502,18045
Florida,Vero Beach,15788,1350,3413,3680,2542,1542,12527
Florida,Vernon,1144,162,229,126,84,5,606
Florida,Venice Gardens,7659,320,2150,2048,1208,472,6198
Florida,Venice,21402,884,5506,5591,4195,3248,19424
Florida,Vineyards,3983,102,514,876,1177,642,3311
Florida,Oldsmar,13860,597,3210,3204,1686,764,9461
Florida,Jacob City,383,61,145,62,25,1,294
Florida,Jacksonville,846951,66330,164307,185319,102775,45741,564472
Florida,Okeechobee,5566,1118,1167,1068,228,171,3752
Florida,Okahumpka,48,22,12,14,0,0,48
Florida,Highland City,10120,549,2112,2450,1493,540,7144
Florida,Gulf Gate Estates,10358,614,2728,2978,1325,768,8413
Florida,Gulfport,12167,1051,2850,2830,2076,1028,9835
Florida,Gulf Stream,677,12,47,99,234,159,551
Florida,Gun Club Estates,1174,163,258,228,52,0,701
Florida,Haines City,21624,3536,4905,3246,1467,551,13705
Florida,Hallandale Beach,38725,4280,8126,8550,5804,3302,30062
Florida,Hampton,412,118,133,60,10,3,324
Florida,Jacksonville Beach,22149,639,3355,5658,4386,2886,16924
Florida,Harbor Bluffs,2786,46,483,596,688,376,2189
Florida,Harlem,2347,376,803,232,98,35,1544
Florida,Harlem Heights,1423,287,183,462,46,9,987
Florida,Inverness,7184,1025,1847,1599,500,479,5450
Florida,Inverness Highlands North,2944,166,850,659,104,104,1883
Florida,Inverness Highlands South,6375,683,2063,1444,422,215,4827
Florida,Inwood,6739,1246,1595,845,200,25,3911
Florida,Iona,13830,796,3466,3243,2783,2067,12355
Florida,Island Walk,3041,58,788,731,519,620,2716
Florida,Istachatta,215,91,13,47,0,0,151
Florida,Ives Estates,20510,1711,3728,5016,2470,1298,14223
Florida,Harbour Heights,3400,217,1003,905,437,133,2695
Florida,Palmona Park,1245,187,334,193,42,39,795
Florida,Perry,7058,756,1788,1343,290,222,4399
Florida,Palm Shores,1123,36,155,384,131,59,765
Florida,Hillsboro Beach,1568,32,316,285,546,289,1468
Florida,Hill 'n Dale,1906,252,306,334,98,21,1011
Florida,Hilliard,3121,382,778,632,152,61,2005
Florida,Hillcrest Heights,280,11,62,57,30,33,193
Florida,High Springs,5591,225,1044,1485,519,389,3662
Florida,High Point,3409,501,1365,851,210,89,3016
Florida,Highland Park,309,0,40,74,65,32,211
Florida,Fountainebleau,55596,7934,11989,9685,8710,2886,41204
Florida,Four Corners,32727,2879,6167,7796,4302,1459,22603
Florida,Franklin Park,958,77,176,243,0,0,496
Florida,Freeport,2346,229,366,564,256,85,1500
Florida,Frostproof,3062,379,1073,441,111,107,2111
Florida,Fruit Cove,31146,824,3250,6357,6717,3150,20298
Florida,Fruitland Park,4330,383,1052,844,116,150,2545
Florida,Fruitville,13725,601,2923,3291,2185,1189,10189
Florida,Fuller Heights,9777,958,2413,1596,1406,448,6821
Florida,Fussels Corner,5064,971,1690,1131,321,73,4186
Florida,Gainesville,127559,5104,13250,18679,14036,13866,64935
Florida,Garcon Point,468,0,28,78,96,131,333
Florida,Garden Grove,462,49,147,169,42,16,423
Florida,Gardner,277,24,111,105,8,16,264
Florida,Gateway,8208,160,1193,1685,1684,1184,5906
Florida,Geneva,2459,90,657,595,359,210,1911
Florida,Gibsonton,18070,2213,3191,3451,1188,450,10493
Florida,Gifford,8750,1066,1608,1810,814,790,6088
Florida,Hillsboro Pines,401,0,76,99,46,21,242
Florida,Hobe Sound,13545,1180,3071,3504,2127,868,10750
Florida,Holden Heights,4065,323,940,1115,575,231,3184
Florida,Holiday,20636,2518,6386,4668,1349,527,15448
Florida,Indiantown,6065,1604,1036,600,267,131,3638
Florida,Indian Shores,1469,22,341,423,379,205,1370
Florida,Indian Rocks Beach,4172,187,720,987,1044,561,3499
Florida,Indian River Shores,4026,102,303,832,1348,1325,3910
Florida,Indian River Estates,6439,619,2033,1621,583,242,5098
Florida,Indian Harbour Beach,8315,402,1408,2103,1443,873,6229
Florida,Indian Creek,60,2,15,5,13,9,44
Florida,Indialantic,2764,56,416,610,536,449,2067
Florida,Immokalee,24879,7693,3052,1842,342,181,13110
Florida,Hypoluxo,2668,128,434,670,472,505,2209
Florida,Hutchinson Island South,5026,242,1715,1270,945,755,4927
Florida,Hunters Creek,22327,693,3056,4475,4162,2745,15131
Florida,Gladeview,12525,1971,2931,1555,369,158,6984
Florida,Hudson,12033,1447,3626,3079,1103,585,9840
Florida,Hosford,740,108,198,169,46,8,529
Florida,Horseshoe Beach,123,22,36,38,14,6,116
Florida,Horizon West,19706,317,1845,3004,5568,1630,12364
Florida,Homosassa Springs,13012,1965,3916,3195,824,128,10028
Florida,Homosassa,1673,179,585,400,258,141,1563
Florida,Homestead Base,1141,144,208,129,13,0,494
Florida,Homestead,64676,12185,10003,10748,4590,1845,39371
Florida,Homeland,212,17,36,17,4,9,83
Florida,Holmes Beach,4045,51,793,1112,934,791,3681
Florida,Hollywood,146791,13759,32728,30708,17709,10525,105429
Florida,Holly Hill,11726,1722,3593,2594,656,296,8861
Florida,Holley,1531,128,346,403,115,88,1080
Florida,Howey-in-the-Hills,1234,54,274,393,131,109,961
Florida,Palm River-Clair Mel,23017,3571,5504,3752,1627,700,15154
Florida,Glencoe,2843,106,952,526,195,177,1956
Florida,Glen St. Mary,567,53,127,87,9,19,295
Florida,Pine Hills,66906,9738,14186,11267,3570,1496,40257
Florida,Pinecrest,19174,605,1172,2519,3526,4352,12174
Florida,Pine Castle,10796,1709,2839,1628,594,289,7059
Florida,Pine Air,2450,402,734,331,81,47,1595
Florida,Pierson,1466,356,289,233,43,21,942
Florida,Vamo,4768,521,1049,867,971,583,3991
Florida,Pensacola,52752,3040,8818,12568,7676,4456,36558
Florida,Penney Farms,618,40,177,80,97,205,599
Florida,Pembroke Pines,162243,9929,27982,36946,23582,14102,112541
Florida,Pembroke Park,6244,993,1271,896,489,291,3940
Florida,Pelican Bay,5230,49,637,1044,1721,1710,5161
Florida,Pebble Creek,8111,202,731,1704,1839,890,5366
Florida,Pea Ridge,4036,234,928,1085,306,113,2666
Florida,Paxton,577,77,142,136,26,16,397
Florida,Patrick AFB,1371,36,84,285,193,65,663
Florida,Pasadena Hills,8292,587,2056,2107,913,379,6042
Florida,Parkland,27114,530,2249,4057,6182,3927,16945
Florida,Parker,4462,643,866,1267,372,179,3327
Florida,Paradise Heights,823,263,201,46,0,14,524
Florida,Panama City Beach,12092,640,2274,3583,1653,810,8960
Florida,Panama City,36917,3259,7732,8629,3715,2107,25442
Florida,Panacea,937,86,397,160,87,0,730
Florida,Palm Valley,21630,410,2279,4234,5166,3604,15693
Florida,Palm Springs North,5648,504,1263,1354,450,248,3819
Florida,Palm Springs,21832,3555,4451,4214,1260,553,14033
Florida,Pine Island,0,0,0,0,0,0,0
Florida,Pine Island Center,1877,171,634,419,227,117,1568
Florida,Pine Lakes,626,128,157,113,23,19,440
Florida,Pineland,293,12,75,93,77,5,262
Florida,Glenvar Heights,17881,1074,2168,3452,3438,2932,13064
Florida,Golden Beach,709,36,33,83,132,166,450
Florida,Golden Gate,29258,5786,6233,3343,1745,623,17730
Florida,Golden Glades,33806,5736,7039,5976,2030,1253,22034
Florida,Goldenrod,12603,732,2242,2983,1323,714,7994
Florida,Golf,170,0,8,30,62,68,168
Florida,Gonzalez,14187,765,2373,3723,2063,782,9706
Florida,Goodland,330,0,80,71,89,0,240
Florida,Gotha,1810,43,117,283,477,217,1137
Florida,Goulding,4274,883,1360,589,71,15,2918
Florida,Goulds,10909,1595,2744,1302,697,179,6517
Florida,Graceville,2321,436,416,425,59,85,1421
Florida,Glen Ridge,204,13,58,47,16,3,137
Florida,Grand Ridge,825,84,218,207,28,21,558
Florida,Greenacres,38840,5018,7649,7833,3859,1414,25773
Florida,Greenbriar,2385,128,453,636,412,134,1763
Florida,Green Cove Springs,7054,809,1476,1556,686,349,4876
Florida,Greensboro,664,144,150,112,63,16,485
Florida,Greenville,1080,121,257,183,69,26,656
Florida,Greenwood,882,59,230,129,64,71,553
Florida,Grenelefe,1800,53,429,422,187,171,1262
Florida,Gretna,1271,211,347,214,74,40,886
Florida,Grove City,1982,91,808,585,139,123,1746
Florida,Groveland,9931,826,2703,1664,1088,251,6532
Florida,Gulf Breeze,6092,120,827,1083,1175,944,4149
Florida,Pine Level,168,14,75,8,42,0,139
Florida,Grant-Valkaria,3938,151,903,1345,419,317,3135
Florida,Valrico,36975,2020,6679,8358,5344,2732,25133
Florida,Hernando,9699,711,3381,2160,524,223,6999
Florida,Upper Grand Lagoon,14216,453,2622,3696,1962,1076,9809
Florida,Marco Island,17148,1009,2797,4270,4052,2733,14861
Florida,Marathon,8563,662,2009,1979,959,386,5995
Florida,Mangonia Park,1929,258,473,263,51,24,1069
Florida,Mango,12267,1516,2746,2034,629,349,7274
Florida,Manatee Road,2790,419,868,538,156,30,2011
Florida,Manasota Key,1131,85,381,275,185,183,1109
Florida,Manalapan,265,5,22,41,86,75,229
Florida,Stuart,16037,1010,3366,4625,1925,1092,12018
Florida,Madeira Beach,4320,248,877,1126,1022,459,3732
Florida,Sumatra,197,19,56,27,36,0,138
Florida,Sun City Center,20554,1164,5573,6584,3421,2983,19725
Florida,Suncoast Estates,4570,617,1859,637,127,0,3240
Florida,Sunny Isles Beach,21837,1241,3342,5601,4183,3644,18011
Florida,Margate,55678,5677,14425,12394,6048,2280,40824
Florida,Sunrise,89942,7481,19092,20441,10713,5075,62802
Florida,Surfside,5987,193,486,1036,1507,965,4187
Florida,Sweetwater,20739,5284,4529,2014,2013,620,14460
Florida,Taft,1852,338,622,242,151,38,1391
Florida,Tallahassee,187024,7368,16243,28093,25359,21395,98458
Florida,Tamarac,63227,4877,15729,14628,9484,3924,48642
Florida,Tamiami,57195,8211,13238,9706,7557,3140,41852
Florida,Tampa,355603,31520,61446,60801,49689,32360,235816
Florida,Tangelo Park,2346,250,522,620,136,29,1557
Florida,Tangerine,2538,425,487,448,354,183,1897
Florida,Chattahoochee,3229,801,790,592,193,93,2469
Florida,Cheval,10833,226,1573,2199,2151,1011,7160
Florida,Chiefland,2234,388,666,318,77,35,1484
Florida,Chipley,3564,489,941,570,185,62,2247
Florida,Sunset,16069,1451,2452,3258,2888,1803,11852
Florida,Chokoloskee,418,0,93,73,11,51,228
Florida,Marianna,8860,1149,2294,1408,471,450,5772
Florida,Mary Esther,4109,276,961,1133,583,294,3247
Florida,Munson,257,10,56,160,8,0,234
Florida,Mulberry,3900,562,1281,727,190,68,2828
Florida,Mulat,466,0,96,41,72,43,252
Florida,Mount Plymouth,5305,418,1441,998,326,287,3470
Florida,Mount Dora,12929,1252,2409,3262,1944,1171,10038
Florida,Mount Carmel,219,0,52,65,19,12,148
Florida,Morriston,70,0,55,15,0,0,70
Florida,Moore Haven,2818,576,877,339,53,43,1888
Florida,Moon Lake,4774,751,1083,996,299,68,3197
Florida,Montverde,1594,61,294,316,248,105,1024
Florida,Montura,3087,901,660,390,40,10,2001
Florida,Monticello,2006,283,415,410,196,179,1483
Florida,Molino,1256,164,154,284,185,35,822
Florida,Marineland,13,0,0,0,0,0,0
Florida,Miramar Beach,7120,265,694,1980,2011,948,5898
Florida,Minneola,10086,597,1725,2548,1060,353,6283
Florida,Mims,6334,600,1782,1495,574,238,4689
Florida,Milton,9276,586,1785,2436,1255,292,6354
Florida,Midway CDP (Seminole County),1485,209,344,302,92,30,977
Florida,Midway CDP (Santa Rosa County),17434,520,2992,4600,2786,1261,12159
Florida,Midway,3234,187,614,668,315,178,1962
Florida,Meadow Woods,28943,2910,5322,6827,3199,947,19205
Florida,Meadow Oaks,2343,135,801,577,176,115,1804
Florida,Mayo,1145,243,283,209,37,0,772
Florida,Matlacha Isles-Matlacha Shores,354,18,178,18,61,32,307
Florida,Matlacha,851,9,345,273,133,91,851
Florida,Mascotte,5267,1007,1162,991,112,56,3328
Florida,Masaryktown,888,242,225,201,8,10,686
Florida,Miramar,131384,8178,19656,29829,16694,10245,84602
Florida,Myrtle Grove,16134,1052,3250,4245,1319,398,10264
Florida,Christmas,2211,317,609,577,183,95,1781
Florida,Chumuckla,767,121,234,123,78,6,562
Florida,Cross City,2198,356,598,337,72,36,1399
Florida,Crystal Lake,6452,802,1540,1120,241,130,3833
Florida,Crystal River,3060,348,807,603,455,107,2320
Florida,Crystal Springs,968,238,246,164,29,24,701
Florida,Cudjoe Key,1833,111,393,432,334,365,1635
Florida,Cutler Bay,43474,3410,7140,8962,5463,3415,28390
Florida,Cypress Gardens,8955,527,1926,2255,1268,719,6695
Florida,Cypress Lake,11964,872,3369,3404,1699,1077,10421
Florida,Cypress Quarters,1281,151,318,176,98,80,823
Florida,Dade City,6655,1008,1761,1270,510,209,4758
Florida,Malone,1926,592,483,343,84,26,1528
Florida,Malabar,2822,129,672,750,353,237,2141
Florida,Maitland,16630,302,1650,3216,4321,2574,12063
Florida,Crooked Lake Park,1564,120,331,299,94,150,994
Florida,Madison,2940,362,723,454,164,167,1870
Florida,Deltona,86418,6844,22313,19849,6393,2516,57915
Florida,Delray Beach,63939,7153,11438,13652,10460,6607,49310
Florida,De Leon Springs,2418,628,414,301,237,147,1727
Florida,DeLand Southwest,826,142,214,139,34,0,529
Florida,DeLand,28524,2308,5725,6042,2570,1743,18388
Florida,DeFuniak Springs,5543,649,1214,1071,508,226,3668
Florida,Deerfield Beach,78227,8290,19890,15778,9594,4096,57648
Florida,DeBary,19547,1392,4980,4697,2607,1129,14805
Florida,Daytona Beach Shores,4294,186,922,1285,1061,468,3922
Florida,Daytona Beach,62726,5962,14434,14672,5793,2777,43638
Florida,Day,168,35,33,38,0,6,112
Florida,Davie,97372,6162,17294,19047,15038,7900,65441
Florida,Davenport,3137,235,897,654,213,74,2073
Florida,Desoto Lakes,3692,108,746,913,374,395,2536
Florida,Chuluota,2481,74,561,541,282,76,1534
Florida,Crestview,22524,1012,3863,5748,2297,808,13728
Florida,Crescent Beach,859,5,221,240,154,142,762
Florida,Cinco Bayou,348,24,24,73,84,52,257
Florida,Citrus Hills,8039,701,2184,2042,1312,1125,7364
Florida,Citrus Park,25570,1386,4521,5667,3860,2062,17496
Florida,Citrus Springs,8695,735,2114,2563,690,282,6384
Florida,Clarcona,2785,237,973,498,133,247,2088
Florida,Clearwater,110381,8587,22610,26937,14718,7462,80314
Florida,Clermont,30319,1545,4846,7609,4147,1980,20127
Florida,Cleveland,2881,324,928,812,131,31,2226
Florida,Clewiston,7240,1480,878,970,621,198,4147
Florida,Cloud Lake,114,17,17,24,18,2,78
Florida,Cobbtown,53,0,15,11,16,0,42
Florida,Cocoa,17339,1931,3498,3971,1193,823,11416
Florida,Cocoa Beach,11355,360,2134,3150,2455,1680,9779
Florida,Crescent City,1814,362,315,394,109,69,1249
Florida,Cocoa West,4910,927,1149,1003,223,29,3331
Florida,Coleman,575,114,281,74,5,0,474
Florida,Combee Settlement,5921,1151,1583,785,172,38,3729
Florida,Connerton,3573,697,929,659,242,82,2609
Florida,Conway,15187,674,2591,3931,2348,1089,10633
Florida,Cooper City,33382,1126,4415,6933,5190,4227,21891
Florida,Coral Gables,50059,1556,4243,7762,10019,10638,34218
Florida,Coral Springs,126673,6300,18398,27726,19953,8949,81326
Florida,Coral Terrace,23994,3955,5370,4379,2864,1513,18081
Florida,Cortez,4043,216,872,1069,603,660,3420
Florida,Cottondale,947,141,147,169,25,23,505
Florida,Country Club,48622,4716,9681,9679,5281,2562,31919
Florida,Country Walk,16485,677,2628,3952,2422,991,10670
Florida,Crawfordville,3998,197,1017,1114,352,89,2769
Florida,Coconut Creek,56816,2658,12306,11756,8853,4242,39815
Florida,Valparaiso,5069,170,627,1177,514,461,2949
Florida,Naples,20603,1080,2728,4769,5259,4399,18235
Florida,Naples Park,6691,580,1864,1199,963,416,5022
Florida,The Crossings,23938,1113,3512,5733,4008,2037,16403
Florida,The Acreage,37853,3507,8856,8570,3042,1549,25524
Florida,Tequesta,5819,140,1070,1137,1271,725,4343
Florida,Temple Terrace,25354,1090,3204,5162,4427,2707,16590
Florida,Taylor Creek,3600,772,1086,713,158,104,2833
Florida,Tavernier,2435,183,650,590,240,160,1823
Florida,Tavares,14608,1319,4421,3410,1536,647,11333
Florida,Tarpon Springs,24003,2126,6045,5835,3262,1748,19016
Florida,Middleburg,13062,1526,3804,2955,559,385,9229
Florida,Micco,8293,1251,2919,2393,618,250,7431
Florida,Micanopy,668,62,142,169,75,51,499
Florida,Miami Springs,14397,1596,3042,2979,2008,925,10550
Florida,Miami Shores,10784,410,1144,1882,1854,1487,6777
Florida,The Hammocks,55713,3938,9176,12897,8194,3516,37721
Florida,Miami Lakes,30728,1987,4715,6993,4737,2756,21188
Florida,Miami Beach,91564,9104,14243,16078,17163,14280,70868
Florida,Miami,424632,83429,92924,59374,46891,29040,311658
Florida,Mexico Beach,1355,89,260,386,217,220,1172
Florida,Merritt Island,35900,1935,7036,9366,5440,2932,26709
Florida,Memphis,8152,1053,1928,1757,517,232,5487
Florida,Melbourne Village,769,43,95,198,149,135,620
Florida,Melbourne Beach,3146,73,487,734,756,468,2518
Florida,Melbourne,78012,6148,17668,19184,8347,5724,57071
Florida,Medulla,8334,366,2135,1671,963,355,5490
Florida,Lealman,20783,3409,5958,3880,1443,482,15172
Florida,Lecanto,5415,792,1527,1113,309,278,4019
Florida,Lee,561,33,165,86,39,7,330
Florida,Leesburg,21209,2268,4994,4486,1329,865,13942
Florida,Miami Gardens,112021,14358,27193,21124,6526,3667,72868
Florida,Lehigh Acres,110244,15167,24389,19322,6246,2644,67768
Florida,The Meadows,4022,89,723,985,968,769,3534
Florida,Thonotosassa,13292,1480,3479,2491,1050,542,9042
Florida,University Park,25870,3191,6109,3519,3408,1633,17860
Florida,Hernando Beach,2376,166,563,695,307,155,1886
Florida,Dade City North,2467,439,462,438,111,32,1482
Florida,Heritage Pines,1987,94,641,560,415,267,1977
Florida,Heathrow,5962,224,486,1566,1094,1215,4585
Florida,Hawthorne,1670,158,438,270,103,58,1027
Florida,Haverhill,1979,183,374,446,194,83,1280
Florida,Havana,1895,250,453,441,209,95,1448
Florida,Hastings,682,105,209,144,74,45,577
Florida,Harold,908,33,215,344,46,8,646
Florida,University CDP (Orange County),32937,1005,2580,2726,2559,1297,10167
Florida,University CDP (Hillsborough County),41858,5469,6449,6282,3062,2067,23329
Florida,Union Park,10498,1002,1676,2358,1052,410,6498
Florida,The Villages,66083,3001,17298,20686,14190,10700,65875
Florida,Umatilla,3586,398,893,745,197,231,2464
Florida,Trinity,10459,237,1790,2805,1714,927,7473
Florida,Trilby,333,56,86,34,26,8,210
Florida,Trenton,2199,292,476,439,117,47,1371
Florida,Treasure Island,6783,252,1387,1670,1297,1155,5761
Florida,Town 'n' Country,82219,7690,18733,16868,10075,4498,57864
Florida,Titusville,44363,3158,10139,11765,4981,2265,32308
Florida,Timber Pines,5305,227,1798,1678,923,584,5210
Florida,Tildenville,1921,0,716,53,177,0,946
Florida,Tiger Point,2978,50,428,872,626,265,2241
Florida,Tierra Verde,3359,78,456,727,834,740,2835
Florida,Tice,4293,1414,782,545,56,79,2876
Florida,Three Oaks,3188,89,515,746,514,271,2135
Florida,Three Lakes,16749,875,2387,3320,2695,1499,10776
Florida,Tyndall AFB,3128,16,172,510,368,159,1225
Florida,Naples Manor,5566,1682,936,292,45,81,3036
Florida,Leisure City,25952,6017,4936,3484,1178,279,15894
Florida,Lely Resort,5088,543,981,1212,803,624,4163
Florida,North Sarasota,7587,1019,1760,1525,628,254,5186
Florida,North River Shores,4068,123,606,939,529,481,2678
Florida,North Redington Beach,1484,70,302,333,405,211,1321
Florida,North Port,59555,3963,15382,14833,5322,2223,41723
Florida,North Palm Beach,12425,545,2101,2877,2752,1625,9900
Florida,North Miami Beach,43489,5915,8521,9503,3671,2170,29780
Florida,North Miami,62042,10338,10998,10964,5518,2603,40421
Florida,North Lauderdale,42853,5376,10442,6745,2376,1329,26268
Florida,North Key Largo,1024,23,220,241,235,170,889
Florida,North Fort Myers,40560,4310,13929,10194,3895,2688,35016
Florida,North DeLand,1511,91,456,286,170,41,1044
Florida,Northdale,22725,801,3948,5227,3978,1689,15643
Florida,North Brooksville,3695,374,1020,861,252,182,2689
Florida,North Weeki Wachee,8436,712,2209,1854,925,802,6502
Florida,North Bay Village,7689,488,1290,1632,1478,895,5783
Florida,Nokomis,3152,276,1159,721,278,149,2583
Florida,Nocatee,7306,63,582,1074,1680,1099,4498
Florida,Nobleton,335,90,24,39,0,24,177
Florida,Niceville,13929,520,2415,3417,1704,1287,9343
Florida,New Smyrna Beach,23356,1735,5390,6081,3399,2567,19172
Florida,New Port Richey East,8686,696,2594,2518,606,238,6652
Florida,New Port Richey,15260,1840,4584,3421,1104,497,11446
Florida,Newberry,5307,108,988,1220,739,366,3421
Florida,Neptune Beach,6683,89,904,1530,1527,930,4980
Florida,Medley,998,226,253,141,50,37,707
Florida,Navarre,32949,1316,4724,8795,4467,1889,21191
Florida,Nassau Village-Ratliff,5228,401,1613,1188,220,161,3583
Florida,Naranja,9392,1567,1798,1407,510,152,5434
Florida,Noma,258,43,54,41,6,0,144
Florida,Lely,3589,168,968,1028,500,470,3134
Florida,Oak Hill,1517,147,490,438,96,50,1221
Florida,Oakland Park,43347,5356,8796,10259,4692,2123,31226
Florida,Lemon Grove,678,60,182,110,48,2,402
Florida,Lighthouse Point,10842,311,1906,2215,2757,1470,8659
Florida,Limestone,269,23,131,16,0,0,170
Florida,Limestone Creek,1022,94,182,203,171,16,666
Florida,Lisbon,44,16,28,0,0,0,44
Florida,Live Oak,6920,1466,1723,951,387,91,4618
Florida,Lloyd,378,31,69,58,45,13,216
Florida,Lochmoor Waterway Estates,4561,329,1083,1297,585,235,3529
Florida,Lockhart,14312,915,2888,3456,1504,652,9415
Florida,Longboat Key,7072,258,795,1527,2267,1955,6802
Florida,Longwood,13848,970,3148,3555,1700,925,10298
Florida,Loughman,2877,371,392,732,306,58,1859
Florida,Lower Grand Lagoon,3722,194,721,1105,616,266,2902
Florida,Oakland,2721,127,575,555,326,199,1782
Florida,Loxahatchee Groves,3306,382,788,859,300,156,2485
Florida,Lynn Haven,19355,1179,3336,4623,2448,1543,13129
Florida,Macclenny,6414,518,1498,1379,327,202,3924
Florida,McGregor,7652,288,1226,1615,1689,950,5768
Florida,McIntosh,357,9,101,101,64,35,310
Florida,Ojus,19030,967,2975,4310,3340,1867,13459
Florida,Odessa,7404,435,1344,1281,984,560,4604
Florida,Ocoee,39884,3483,6403,8352,4684,2723,25645
Florida,Ocean Ridge,1590,11,183,396,514,271,1375
Florida,Ocean City,6120,577,1100,1641,615,343,4276
Florida,Ocean Breeze Park,241,38,49,103,31,20,241
Florida,Ocala,57209,5220,11482,12750,5324,2888,37664
Florida,Oak Ridge,23108,3830,5159,3989,1380,240,14598
Florida,Oakleaf Plantation,23087,1176,2960,4823,3471,1245,13675
Florida,Lutz,20398,775,3374,4679,3263,2161,14252
Florida,Navarre Beach,1079,0,50,206,470,200,926
Florida,Sugarmill Woods,9129,771,2667,2772,1434,450,8094
Florida,Dickerson City,73,0,0,60,13,0,73
Florida,South Pasadena,5009,315,1389,1458,959,579,4700
Florida,South Palm Beach,1350,35,223,385,358,273,1274
Florida,South Miami Heights,38255,6602,8903,6169,3150,834,25658
Florida,South Miami,12156,710,1545,2192,2207,1568,8222
Florida,South Highpoint,4624,808,1035,863,164,146,3016
Florida,South Gate Ridge,5902,419,1613,1426,752,350,4560
Florida,South Patrick Shores,6529,290,1108,1666,1083,701,4848
Florida,Southgate,7329,339,1808,1589,1270,670,5676
Florida,South Daytona,12343,1083,3303,3037,958,337,8718
Florida,Southchase,14987,1382,2032,3727,2198,598,9937
Florida,South Brooksville,3701,511,1036,886,336,217,2986
Florida,South Bradenton,23822,3140,6794,4918,1385,1017,17254
Florida,South Beach,3320,56,307,617,1169,812,2961
Florida,South Bay,4976,1449,1500,659,149,70,3827
Florida,Southeast Arcadia,8129,2313,1779,539,155,24,4810
Florida,South Sarasota,4973,181,920,1120,1029,672,3922
Florida,South Venice,14652,1256,4170,3715,1839,578,11558
Florida,Southwest Ranches,7676,514,1169,1571,1279,791,5324
Florida,Destin,13055,353,2178,3332,2683,1196,9742
Florida,White City,3407,290,782,930,348,368,2718
Florida,White Springs,961,104,209,179,55,24,571
Florida,Whitfield CDP (Manatee County),3173,113,530,880,510,459,2492
Florida,Whitfield CDP (Santa Rosa County),110,23,48,39,0,0,110
Florida,Wildwood,6052,494,1463,1677,714,410,4758
Florida,Stock Island,3901,458,993,723,319,252,2745
Florida,Steinhatchee,962,182,196,434,0,14,826
Florida,Starke,5401,806,1420,937,394,209,3766
Florida,Stacey Street,516,149,0,69,20,0,238
Florida,Spring Ridge,319,18,103,92,46,4,263
Florida,Spring Lake,454,28,119,140,133,5,425
Florida,Springhill,114,6,19,41,20,0,86
Florida,Spring Hill,101709,9139,27482,25906,7227,3080,72834
Florida,Springfield,9186,1331,2416,1674,514,188,6123
Florida,South Apopka,5372,839,1422,673,189,117,3240
Florida,Wewahitchka,1979,348,463,485,106,27,1429
Florida,Sorrento,514,266,68,0,32,0,366
Florida,Solana,289,33,138,63,30,8,272
Florida,Sarasota Springs,15547,1061,4283,3500,1822,844,11510
Florida,Sarasota,53583,4712,11513,10708,7942,5391,40266
Florida,Sanibel,6899,109,824,1339,2156,1777,6205
Florida,Sanford,56170,3975,11168,13282,5375,2233,36033
Florida,San Castle,4358,895,952,553,221,53,2674
Florida,San Carlos Park,18443,1960,4026,3644,1616,849,12095
Florida,Satellite Beach,10351,354,1349,2511,1761,1312,7287
Florida,San Antonio,1107,46,185,306,145,99,781
Florida,Samoset,4695,1462,884,880,65,30,3321
Florida,St. Petersburg,250713,19122,49815,56824,36098,20267,182126
Florida,St. Pete Beach,9466,297,1361,2729,1995,1770,8152
Florida,St. Marks,255,23,78,51,49,3,204
Florida,St. Lucie Village,613,19,107,167,103,41,437
Florida,St. Leo,1343,12,36,83,57,50,238
Florida,Samsula-Spruce Creek,6314,432,876,1648,1032,550,4538
Florida,Sawgrass,5321,16,291,1434,1493,1040,4274
Florida,Schall Circle,1253,244,245,131,54,3,677
Florida,Sea Ranch Lakes,701,4,58,85,198,142,487
Florida,Sneads,1849,264,550,319,65,62,1260
Florida,Sky Lake,6260,910,1929,1015,261,159,4274
Florida,Silver Springs Shores,7809,715,1898,1506,243,322,4684
Florida,Silver Lake,1555,77,341,300,273,193,1184
Florida,Siesta Key,6058,96,950,1321,1540,1315,5222
Florida,Sharpes,2885,388,785,605,272,266,2316
Florida,Shalimar,676,5,87,151,120,107,470
Florida,Shady Hills,10817,1225,3392,2503,549,294,7963
Florida,Sewall's Point,2057,45,173,376,558,413,1565
Florida,Seville,568,104,203,43,21,0,371
Florida,Seminole Manor,2866,592,424,545,129,33,1723
Florida,Seminole,17637,1018,4493,4232,2745,1409,13897
Florida,Seffner,7907,541,1471,2230,807,294,5343
Florida,Sebring,10371,1775,2627,2142,695,480,7719
Florida,Sebastian,22920,2242,6109,5950,2117,1189,17607
Florida,Sopchoppy,389,20,96,78,36,31,261
Florida,Westwood Lakes,12449,1910,3143,2418,1459,522,9452
Florida,Westville,362,50,90,63,11,2,216
Florida,Westview,10624,1626,2896,2022,709,173,7426
Florida,Asbury Lake,8078,477,1841,1746,874,368,5306
Florida,Astatula,1541,202,441,308,79,3,1033
Florida,Astor,1742,331,374,326,102,36,1169
Florida,Atlantic Beach,12961,507,2036,2612,2814,1927,9896
Florida,Atlantis,2175,69,334,471,522,344,1740
Florida,Auburndale,14281,1747,3705,2453,679,673,9257
Florida,Aripeka,105,7,57,5,19,5,93
Florida,Aucilla,112,28,62,8,0,0,98
Florida,Aventura,37357,1868,4956,7562,8564,7051,30001
Florida,Avon Park,9974,1811,2361,1670,413,218,6473
Florida,Azalea Park,13287,1954,3275,2614,804,232,8879
Florida,Babson Park,1337,71,290,251,37,32,681
Florida,Bagdad,3951,393,796,810,460,94,2553
Florida,Baldwin,1929,296,521,275,80,40,1212
Florida,Avalon,571,53,86,278,51,14,482
Florida,Archer,1180,67,276,275,62,33,713
Florida,Arcadia,7704,1193,2102,1080,201,151,4727
Florida,Apopka,45801,4087,8212,9955,5227,2911,30392
Florida,Welaka,642,89,188,117,27,24,445
Florida,Acacia Villas,375,30,88,46,0,0,164
Florida,Alachua,9435,435,1327,2335,1619,845,6561
Florida,Alafaya,85167,3195,10257,17500,14553,7091,52596
Florida,Alford,538,101,137,104,29,0,371
Florida,Allentown,946,35,229,353,80,25,722
Florida,Altamonte Springs,42218,2122,7763,11053,7474,2991,31403
Florida,Altha,670,27,188,191,21,19,446
Florida,Altoona,123,19,32,11,0,0,62
Florida,Alturas,3756,521,1282,508,225,48,2584
Florida,Alva,2088,311,689,539,151,94,1784
Florida,Andrews,1191,226,326,272,16,0,840
Florida,Anna Maria,1219,8,333,293,239,190,1063
Florida,Apalachicola,2077,233,469,406,201,123,1432
Florida,Apollo Beach,16336,655,2624,4341,2574,1525,11719
Florida,Bal Harbour,2677,70,241,699,708,357,2075
Florida,Balm,1880,263,217,487,89,84,1140
Florida,Bardmoor,9448,703,2299,2260,1229,792,7283
Florida,Bartow,18094,1902,4181,3257,1636,453,11429
Florida,Westchase,23222,407,2156,4059,5468,3679,15769
Florida,Westchester,30585,4575,7261,4984,3728,1917,22465
Florida,West DeLand,3997,267,886,925,360,98,2536
Florida,Westgate,8310,2009,1636,950,280,56,4931
Florida,West Lealman,15838,1956,5000,3754,1226,692,12628
Florida,West Little River,30749,5727,8154,5160,1524,828,21393
Florida,West Melbourne,19667,841,3826,4571,2919,1569,13726
Florida,West Miami,6400,960,1394,1549,654,317,4874
Florida,Weston,68423,1173,5268,11008,14735,10434,42618
Florida,West Palm Beach,103588,11509,18062,19926,15531,8812,73840
Florida,West Park,14779,2153,3551,2631,982,342,9659
Florida,West Pensacola,20538,2203,5159,4835,1142,417,13756
Florida,West Perrine,10399,1310,2235,1634,998,334,6511
Florida,West Samoset,7010,1575,1283,728,82,103,3771
Florida,West Vero Corridor,6945,528,2280,2079,771,432,6090
Florida,West Bradenton,4492,303,1133,962,451,468,3317
Florida,St. James City,3900,370,902,1360,633,316,3581
Florida,Wesley Chapel,49735,2011,6806,10924,7574,4391,31706
Florida,Belleair Bluffs,2236,97,414,586,533,200,1830
Florida,Bascom,94,8,26,18,4,4,60
Florida,Bay Harbor Islands,5921,285,705,998,1392,802,4182
Florida,Bay Hill,5133,168,477,1025,1356,697,3723
Florida,Bay Lake,31,2,4,11,1,0,18
Florida,Bayonet Point,25453,2763,8020,6012,1654,676,19125
Florida,Bay Pines,3240,153,979,983,413,163,2691
Florida,Bayport,452,0,180,119,20,14,333
Florida,Bayshore Gardens,19446,2594,5702,3487,1141,824,13748
Florida,Beacon Square,6564,630,2050,1395,539,163,4777
Florida,Bear Creek,1840,112,400,418,344,168,1442
Florida,Bee Ridge,9836,469,2119,2057,1616,1402,7663
Florida,Bell,505,62,126,87,26,11,312
Florida,Bellair-Meadowbrook Terrace,13987,810,2944,3852,1081,294,8981
Florida,Belleair,3941,116,349,867,934,640,2906
Florida,Belleair Beach,1685,82,254,333,472,271,1412
Florida,Wellington,60155,2106,7787,12395,10797,6448,39533
Florida,Pinellas Park,50433,5148,14359,11761,4146,2522,37936
Florida,Pine Manor,4451,949,876,327,95,10,2257
Florida,Pine Ridge CDP (Citrus County),10402,796,2818,3000,1348,587,8549
Florida,Lake Harbor,0,0,0,0,0,0,0
Florida,Lake Hamilton,1080,96,467,140,46,18,767
Florida,Lake Clarke Shores,3483,116,724,828,846,329,2843
Florida,Lake City,12082,1016,3054,2868,867,580,8385
Florida,Lake Butler,2224,182,615,292,77,65,1231
Florida,Lake Butler,16871,491,1053,2285,4543,2199,10571
Florida,Lake Hart,280,0,0,61,72,84,217
Florida,Lake Buena Vista,7,0,4,1,0,2,7
Florida,Lake Alfred,5213,219,1199,1232,394,246,3290
Florida,Laguna Beach,3665,415,1003,955,634,236,3243
Florida,Lady Lake,14312,1296,4250,3598,1518,1071,11733
Florida,La Crosse,261,24,71,84,16,4,199
Florida,Lacoochee,1630,369,368,187,8,33,965
Florida,LaBelle,4648,997,838,822,202,138,2997
Florida,Lake Belvedere Estates,3475,383,670,505,429,276,2263
Florida,Lake Helen,2643,304,725,705,261,83,2078
Florida,Lake Kathryn,920,173,390,76,0,0,639
Florida,Lakeland,101302,8647,23315,19547,11037,6000,68546
Florida,Lakewood Park,11511,932,3590,3514,699,476,9211
Florida,Lake Wales,14929,2088,3129,2292,1271,641,9421
Florida,Lakeside,31223,1646,7293,7539,3412,1268,21158
Florida,Lake Sarasota,4759,231,912,1486,466,156,3251
Florida,Lake Placid,2541,736,452,225,136,113,1662
Florida,Lake Park,8376,1057,1717,1901,872,519,6066
Florida,Lake Panasoffkee,3311,504,947,882,172,38,2543
Florida,Lake Mystic,381,7,121,34,28,18,208
Florida,Lake Mary Jane,1430,24,246,359,280,75,984
Florida,Lake Mary,15038,751,1954,3613,3308,1608,11234
Florida,Lake Magdalene,28560,1984,5276,6006,4915,2764,20945
Florida,Lake Mack-Forest Hills,568,121,208,151,0,0,480
Florida,Lake Lorraine,7152,299,1214,1551,1167,702,4933
Florida,Lake Lindsey,39,0,21,0,0,8,29
Florida,Lakeland Highlands,11728,469,1967,2380,2204,1295,8315
Florida,Kissimmee,65422,7485,13996,14618,4539,1789,42427
Florida,Key West,25366,1880,5006,6013,3913,2396,19208
Florida,Key Vista,1559,31,387,470,227,48,1163
Florida,Keystone Heights,1652,68,220,445,171,95,999
Florida,Wilton Manors,12133,849,2651,3122,2674,1393,10689
Florida,Wimauma,6405,1808,901,582,158,78,3527
Florida,Windermere,3106,9,195,499,662,702,2067
Florida,Windsor,157,0,0,80,44,13,137
Florida,Winter Beach,2594,196,377,508,285,318,1684
Florida,Winter Garden,37955,2566,5686,7286,5471,3167,24176
Florida,Winter Haven,35835,3854,8783,8317,2972,1329,25255
Florida,Winter Park,29182,1047,2962,4670,6065,5309,20053
Florida,Winter Springs,33973,1269,6312,7728,5730,3213,24252
Florida,Wiscon,414,112,120,86,22,8,348
Florida,Woodlawn Beach,2026,61,533,576,225,205,1600
Florida,Woodville,2695,234,781,422,173,114,1724
Florida,World Golf Village,13323,192,1817,2477,2807,1303,8596
Florida,Worthington Springs,616,84,141,75,2,5,307
Florida,Wright,24862,2202,4798,5735,2295,1245,16275
Florida,Willow Oak,4948,575,1200,949,278,50,3052
Florida,Lake Worth,36403,7387,6535,6085,3626,1451,25084
Florida,Williston Highlands,2142,172,811,494,103,82,1662
Florida,Williamsburg,8148,600,1633,2264,1378,497,6372
Florida,Keystone,23271,479,2868,4623,5057,2746,15773
Florida,Key Largo,10496,1092,2127,2517,1599,1112,8447
Florida,Key Colony Beach,739,34,193,208,181,123,739
Florida,Key Biscayne,12888,175,673,1568,3385,2841,8642
Florida,Kenwood Estates,1451,387,359,207,26,10,989
Florida,Kensington Park,4185,435,1004,852,341,168,2800
Florida,Kenneth City,5013,500,1531,876,356,321,3584
Florida,Kendall West,39347,5452,7060,7360,5382,1817,27071
Florida,Kendall,76267,5462,10447,14389,14927,10415,55640
Florida,Kendale Lakes,59354,6837,13466,12427,7409,3183,43322
Florida,Kathleen,5895,750,1721,1119,223,51,3864
Florida,Jupiter Island,656,8,86,121,223,129,567
Florida,Jupiter Inlet Colony,390,10,42,63,97,78,290
Florida,Jupiter Farms,11514,463,2199,2954,1724,898,8238
Florida,Jupiter,59054,3488,9844,12561,12306,7018,45217
Florida,Williston,2730,327,612,595,134,96,1764
Florida,Wekiwa Springs,23500,670,2380,5399,5254,2805,16508
Florida,Lamont,191,0,0,107,0,10,117
Florida,Lantana,10910,1365,2324,2095,998,490,7272
Florida,Port Richey,2699,294,780,672,303,144,2193
Florida,Port St. Joe,3413,187,934,922,281,84,2408
Florida,Port St. John,11335,461,2589,3354,1050,606,8060
Florida,Port St. Lucie,172054,15081,39384,39570,15995,7766,117796
Florida,Port Salerno,9999,798,2588,2628,1036,547,7597
Florida,Pretty Bayou,3432,260,711,856,409,240,2476
Florida,Port Orange,57858,4466,13522,14141,7179,3589,42897
Florida,Princeton,26992,3493,4672,4612,1912,961,15650
Florida,Punta Gorda,17288,629,3919,5176,3298,2303,15325
Florida,Punta Rassa,1767,31,262,416,466,502,1677
Florida,Quail Ridge,1263,81,167,324,227,97,896
Florida,Quincy,7947,1314,1906,1282,580,316,5398
Florida,Raiford,121,11,49,26,1,0,87
Florida,Raleigh,165,39,67,35,16,0,157
Florida,Progress Village,7366,715,910,1732,1036,374,4767
Florida,Port LaBelle,4385,894,829,623,150,137,2633
Florida,Port Charlotte,56434,5615,15503,14452,4807,3073,43450
Florida,Ponce Inlet,3086,46,708,826,559,548,2687
Florida,Pine Ridge CDP (Collier County),1994,92,372,288,398,375,1525
Florida,Pinewood,16992,2953,4118,2645,646,317,10679
Florida,Pioneer,728,40,164,261,108,62,635
Florida,Pittman,279,0,125,48,19,19,211
Florida,Plantation,89904,4311,13414,20359,15715,10476,64275
Florida,Plantation,4933,175,1278,1239,1211,816,4719
Florida,Plantation Island,452,30,53,97,19,0,199
Florida,Plantation Mobile Home Park,1123,365,119,102,69,10,665
Florida,Plant City,36382,4448,8269,6397,2790,1556,23460
Florida,Poinciana,59927,5646,12965,11507,5282,2070,37470
Florida,Point Baker,3440,292,632,736,210,126,1996
Florida,Polk City,2413,371,571,392,139,44,1517
Florida,Pomona Park,732,104,180,140,35,12,471
Florida,Pompano Beach,104741,13101,25311,20475,11592,5883,76362
Florida,Ponce de Leon,496,72,122,128,32,2,356
Florida,Reddick,559,123,72,96,19,21,331
Florida,Redington Beach,1565,70,282,416,407,167,1342
Florida,Redington Shores,2046,78,419,541,521,265,1824
Florida,Richmond Heights,9985,913,2775,2124,789,369,6970
Florida,St. Augustine,13676,1046,1748,3216,2167,1221,9398
Florida,St. Augustine Beach,6564,17,775,1384,1924,1166,5266
Florida,St. Augustine Shores,8024,280,1663,2533,1040,619,6135
Florida,St. Augustine South,5349,427,844,1437,996,261,3965
Florida,St. Cloud,41502,3586,9982,9649,3452,1580,28249
Florida,St. George Island,587,19,45,184,209,92,549
Florida,Lazy Lake,33,2,8,10,7,6,33
Florida,Layton,122,0,24,46,28,12,110
Florida,Lawtey,1051,157,259,164,56,5,641
Florida,Laurel Hill,609,74,128,159,33,14,408
Florida,Laurel,9390,463,2384,2474,1207,1010,7538
Florida,Lauderhill,69979,7655,15897,13386,5869,2904,45711
Florida,Lauderdale Lakes,34103,5447,8169,5813,1607,1175,22211
Florida,Lauderdale-by-the-Sea,6313,326,1396,1483,1699,876,5780
Florida,Largo,79737,7337,21769,19585,8711,3508,60910
Florida,Safety Harbor,17142,927,3343,3982,3087,1909,13248
Florida,Land O' Lakes,33812,1826,5333,8512,5348,2722,23741
Florida,Ruskin,20643,2674,3980,4021,1476,689,12840
Florida,Royal Palm Beach,36175,2121,6840,7794,4668,2051,23474
Florida,Richmond West,35693,3284,7227,7167,4656,1565,23899
Florida,Ridgecrest,3237,333,783,690,168,26,2000
Florida,Ridge Manor,4593,422,1459,1209,310,118,3518
Florida,Ridge Wood Heights,4760,200,1164,1170,676,227,3437
Florida,Rio,1022,30,274,178,132,142,756
Florida,Rio Pinar,5490,179,796,1183,1018,685,3861
Florida,River Park,5622,979,1242,1594,408,161,4384
Florida,River Ridge,4601,379,1147,1358,530,187,3601
Florida,Riverview,79886,4141,13708,18922,9943,4671,51385
Florida,Riviera Beach,33445,3906,7034,6450,3096,1740,22226
Florida,Rockledge,25798,1587,4186,7288,3416,2223,18700
Florida,Roeville,513,28,173,147,13,0,361
Florida,Roosevelt Gardens,2760,478,543,556,117,47,1741
Florida,Roseland,1669,121,609,397,217,130,1474
Florida,Rotonda,8337,418,3118,2335,1232,384,7487
Florida,Royal Palm Estates,3014,510,885,355,193,5,1948
Florida,Weeki Wachee Gardens,1527,123,498,573,184,21,1399
Florida,Whiskey Creek,4973,162,697,1225,1107,746,3937
Florida,Wedgefield,7800,234,1737,1839,778,611,5199
Florida,Cape Coral,165843,11409,43634,38393,16620,8838,118894
Florida,Cape Canaveral,10031,576,2372,3278,1372,1083,8681
Florida,Canal Point,376,58,169,57,13,0,297
Florida,Campbellton,169,34,46,47,11,2,140
Florida,Campbell,2561,261,771,825,245,150,2252
Florida,Callaway,14760,1011,3499,3995,858,521,9884
Florida,Captiva,163,12,52,58,6,10,138
Florida,Callahan,1291,152,323,217,67,48,807
Florida,Butler Beach,5629,234,1110,1406,928,999,4677
Florida,Bushnell,2973,447,771,661,168,85,2132
Florida,Burnt Store Marina,1903,56,303,483,606,425,1873
Florida,Bunnell,2762,285,869,467,202,72,1895
Florida,Buenaventura Lakes,31348,4265,7256,6249,1744,622,20136
Florida,Buckingham,4316,290,1219,759,571,182,3021
Florida,Cabana Colony,2266,97,565,667,246,91,1666
Florida,Buckhead Ridge,1595,306,592,335,101,46,1380
Florida,Carrabelle,2770,640,902,414,162,37,2155
Florida,Caryville,300,76,56,27,10,0,169
Florida,Fort Pierce North,7058,1212,1657,1230,344,202,4645
Florida,Fort Pierce South,4646,920,1526,675,288,66,3475
Florida,Fort Walton Beach,20767,1555,4104,5258,1957,1463,14337
Florida,Fort White,728,52,155,159,23,28,417
Florida,Weeki Wachee,1,0,0,1,0,0,1
Florida,Charlotte Park,2475,219,832,865,210,113,2239
Florida,Carrollwood,35027,1517,4943,8148,6538,3739,24885
Florida,Charlotte Harbor,4001,348,845,1180,549,213,3135
Florida,Century,1529,279,530,323,24,37,1193
Florida,Center Hill,1150,277,235,148,29,24,713
Florida,Celebration,7816,18,802,1123,1843,1429,5215
Florida,Cedar Key,667,30,163,172,133,81,579
Florida,Cedar Grove,3313,432,985,503,149,104,2173
Florida,Casselberry,26663,1589,5437,7488,3564,1398,19476
Florida,Charleston Park,146,41,9,61,0,0,111
Florida,Brownsville,16410,3025,4214,2059,824,178,10300
Florida,Brownsdale,518,44,185,108,65,18,420
Florida,Brooksville,7752,962,2015,1540,520,367,5404
Florida,Blountstown,2625,390,731,554,177,37,1889
Florida,Bloomingdale,22882,600,3781,5099,4091,2181,15752
Florida,Black Hammock,963,31,243,187,212,108,781
Florida,Black Diamond,1114,26,163,260,333,82,864
Florida,Bithlo,8559,850,1602,1530,921,577,5480
Florida,Biscayne Park,3193,274,411,695,555,288,2223
Florida,Boca Raton,89793,2614,11518,16901,20145,13921,65099
Florida,Big Pine Key,4716,236,1230,1289,794,337,3886
Florida,Beverly Hills,8593,929,2770,2261,449,104,6513
Florida,Beverly Beach,342,30,137,68,56,42,333
Florida,Berrydale,406,52,119,45,27,29,272
Florida,Bellview,22341,1433,4685,6334,2459,859,15770
Florida,Belleview,4612,758,1254,513,489,145,3159
Florida,Belle Isle,6403,206,1455,1409,1389,501,4960
Florida,Big Coppitt Key,2567,52,629,762,224,325,1992
Florida,Bokeelia,1339,71,460,324,219,125,1199
Florida,Bonifay,2756,370,686,460,143,156,1815
Florida,Bonita Springs,47915,5992,9461,10504,7286,4507,37750
Florida,Brookridge,4429,424,1582,1497,260,128,3891
Florida,Brooker,394,51,149,72,7,10,289
Florida,Bronson,955,100,280,216,76,17,689
Florida,Broadview Park,7593,1639,1586,1183,441,101,4950
Florida,Bristol,1107,220,285,143,56,49,753
Florida,Briny Breezes,812,52,186,203,177,164,782
Florida,Brent,21957,1907,4407,4368,1022,616,12320
Florida,Branford,867,153,241,185,22,15,616
Florida,Brandon,108287,6152,20129,25853,14935,6704,73773
Florida,Bradley Junction,480,125,205,54,0,0,384
Florida,Bradenton Beach,946,66,234,272,171,117,860
Florida,Bradenton,51811,5520,12251,11122,4732,2922,36547
Florida,Boynton Beach,71530,6978,14580,16725,10085,4331,52699
Florida,Bowling Green,2916,658,786,164,67,39,1714
Florida,Boulevard Gardens,1870,535,524,302,165,0,1526
Florida,Fort Pierce,43267,6575,9186,7868,2436,1448,27513
Florida,Fort Myers Shores,5541,974,1417,1210,503,204,4308
Florida,Fort Myers Beach,6668,390,1624,1822,1358,1023,6217
Florida,Fort Myers,68472,9478,13841,12860,7411,4556,48146
Florida,Dundee,3908,495,1000,770,142,112,2519
Florida,Dunedin,35712,2559,8175,9134,5664,2786,28318
Florida,Dunnellon,1783,161,563,473,186,55,1438
Florida,Eagle Lake,2486,265,567,556,95,65,1548
Florida,East Bronson,2355,460,711,426,53,18,1668
Florida,East Lake,32054,1011,5153,6863,6975,3869,23871
Florida,Duck Key,665,37,91,265,139,45,577
Florida,East Lake-Orient Park,25373,2828,5312,4810,1959,1239,16148
Florida,East Palatka,1852,212,562,411,140,64,1389
Florida,Eastpoint,2165,363,484,472,35,65,1419
Florida,East Williston,731,139,270,155,0,15,579
Florida,Eatonville,2299,367,587,451,67,10,1482
Florida,Ebro,259,25,96,41,18,0,180
Florida,Edgewater,21050,1596,6130,6010,1504,864,16104
Florida,East Milton,12490,2524,2991,2787,526,297,9125
Florida,Dover,3817,1225,675,227,81,43,2251
Florida,Doral,51382,1563,6152,6946,11256,6131,32048
Florida,Zolfo Springs,2003,470,375,95,20,9,969
Florida,Dixonville,182,22,97,54,0,9,182
Florida,Doctor Phillips,11501,500,1412,2273,2356,1834,8375
Florida,Highland Beach,3654,115,473,791,1226,707,3312
Florida,Hialeah Gardens,23092,3933,5957,3600,1971,837,16298
Florida,Hialeah,234714,50027,63413,34554,17196,5682,170872
Florida,Inglis,1370,176,502,305,112,36,1131
Florida,Yalaha,1117,52,183,451,177,146,1009
Florida,Yankeetown,514,45,153,118,78,40,434
Florida,Yeehaw Junction,213,40,129,30,0,0,199
Florida,Yulee,11672,1012,3432,2760,730,249,8183
Florida,Zellwood,3302,438,1009,888,358,45,2738
Florida,Zephyrhills,14275,1869,4480,3483,1111,427,11370
Florida,Zephyrhills North,2310,179,991,531,151,53,1905
Florida,Zephyrhills South,5359,705,2104,1361,213,49,4432
Florida,Zephyrhills West,5207,838,2075,1277,314,256,4760
Florida,Edgewood,2690,99,405,653,497,334,1988
Florida,Belle Glade,17950,3942,3373,2286,707,517,10825
Florida,Eglin AFB,2384,37,293,706,185,77,1298
Florida,Elfers,13982,1481,4396,3295,491,390,10053
Florida,Five Points,812,219,150,179,98,8,654
Florida,Flagler Beach,4682,171,1203,1153,869,475,3871
Florida,Flagler Estates,3051,482,841,576,115,45,2059
Florida,Fleming Island,30350,447,3736,6528,5998,2719,19428
Florida,Floral City,4919,626,1634,1227,315,86,3888
Florida,Florida City,12024,2876,2007,1151,224,74,6332
Florida,Fish Hawk,16297,252,1294,2517,3326,2095,9484
Florida,Florida Ridge,19701,1611,4831,4770,1543,912,13667
Florida,Forest City,14924,854,3070,3360,1900,981,10165
Florida,Fort Denaud,1639,301,623,270,54,62,1310
Florida,Fort Green,161,3,55,37,27,0,122
Florida,Fort Green Springs,325,9,104,55,0,16,184
Florida,Fort Lauderdale,173570,18390,32288,34367,27971,17089,130105
Florida,Fort Meade,5824,779,1673,890,312,156,3810
Florida,Floridatown,326,9,75,59,47,14,204
Florida,Fisher Island,232,42,41,0,0,0,83
Florida,Fidelis,37,6,15,9,0,0,30
Florida,Ferry Pass,32077,1325,4935,6977,3979,2045,19261
Florida,Ellenton,3009,161,908,788,457,191,2505
Florida,El Portal,2492,225,525,617,333,232,1932
Florida,Englewood,14515,1106,4790,3833,1899,1233,12861
Florida,Ensley,21981,1649,4857,5810,1954,610,14880
Florida,Estero,29588,1149,5653,6696,6483,4546,24527
Florida,Esto,375,51,100,82,10,3,246
Florida,Eustis,19198,1813,5394,3658,1516,828,13209
Florida,Everglades,268,7,66,39,71,14,197
Florida,Fairview Shores,10586,1146,1891,2289,1500,522,7348
Florida,Fanning Springs,1046,174,295,204,55,30,758
Florida,Feather Sound,3370,109,237,634,1177,596,2753
Florida,Fellsmere,5390,1511,795,468,129,36,2939
Florida,Fernandina Beach,11990,641,2461,2809,2419,1254,9584
Florida,Ferndale,469,112,52,187,22,10,383
Florida,Fern Park,8161,501,1744,2215,1203,555,6218
Florida,Egypt Lake-Leto,37408,5013,8996,7204,2832,1339,25384
Florida,Belleair Shore,62,1,4,17,21,14,57
Florida,Interlachen,1430,192,414,282,58,25,971
Florida,Wacissa,229,72,47,48,9,0,176
Florida,Wahneta,5372,1440,1181,209,91,16,2937
Florida,Waldo,1004,132,315,187,42,13,689
Florida,Wallace,1502,61,263,312,271,202,1109
Florida,Warrington,13053,1158,2809,3648,957,697,9269
Florida,Washington Park,1310,203,393,179,77,6,858
Florida,Watergate,3245,379,649,811,199,73,2111
Florida,Warm Mineral Springs,4935,371,2002,1433,439,369,4614
Florida,Wauchula,4909,800,1447,746,316,120,3429
Florida,Waukeenah,148,10,40,46,0,0,96
Florida,Wausau,486,44,152,100,6,3,305
Florida,Waverly,828,165,196,168,0,0,529
Florida,Webster,813,193,179,141,31,14,558
Florida,Watertown,3318,333,1002,675,142,104,2256
Georgia,Tifton,16656,2201,3149,2661,943,754,9708
Georgia,The Rock,192,6,44,65,9,16,140
Georgia,Thomaston,9032,1654,1895,1502,451,409,5911
Georgia,Thomasville,18612,2170,3881,3505,1452,1349,12357
Georgia,Thomson,6697,1169,1525,767,257,153,3871
Georgia,Thunderbolt,2594,207,578,611,364,208,1968
Georgia,Tiger,412,47,90,84,38,6,265
Georgia,Metter,4145,921,902,555,220,127,2725
Georgia,Toccoa,8302,848,1746,1377,662,392,5025
Georgia,Toomsboro,345,89,123,51,8,4,275
Georgia,Trenton,2123,290,543,469,102,41,1445
Georgia,Trion,2210,431,422,306,132,49,1340
Georgia,Tucker,27761,1465,3981,4862,5474,3891,19673
Georgia,Tennille,1499,196,377,211,81,52,917
Georgia,Tignall,523,89,162,128,16,4,399
Georgia,Temple,4248,747,1179,538,208,86,2758
Georgia,Talbotton,1147,224,409,136,12,25,806
Georgia,Tate City,0,0,0,0,0,0,0
Georgia,Sunset Village,803,140,152,126,74,52,544
Georgia,Surrency,184,44,64,21,8,4,141
Georgia,Suwanee,17291,712,2021,2671,3814,1868,11086
Georgia,Swainsboro,7456,1067,1621,1185,183,179,4235
Georgia,Sycamore,788,172,176,108,28,6,490
Georgia,Sylvania,2550,329,631,469,142,67,1638
Georgia,Taylorsville,222,14,91,39,30,9,183
Georgia,Sylvester,6146,976,1476,903,163,243,3761
Georgia,Riceboro,665,104,207,85,51,42,489
Georgia,Talking Rock,89,14,25,13,7,1,60
Georgia,Tallapoosa,3138,442,653,651,119,129,1994
Georgia,Tallulah Falls,90,7,22,28,4,2,63
Georgia,Talmo,214,24,59,25,25,7,140
Georgia,Tarrytown,64,6,27,6,5,7,51
Georgia,Talahi Island,1237,70,201,518,177,88,1054
Georgia,Richland,1692,455,502,195,86,45,1283
Georgia,Roberta,843,151,173,146,31,34,535
Georgia,Riddleville,58,16,12,8,5,0,41
Georgia,Union City,20459,1726,4066,3783,1864,782,12221
Georgia,Unadilla,3699,997,1114,508,86,53,2758
Georgia,Ty Ty,985,134,220,157,39,8,558
Georgia,Tyrone,7081,402,890,1436,1280,755,4763
Georgia,Tybee Island,3058,164,393,920,529,467,2473
Georgia,Twin City,2161,423,588,269,34,21,1335
Georgia,Turin,412,19,55,64,94,28,260
Georgia,Tunnel Hill,1096,133,225,210,87,67,722
Georgia,Sandy Springs,100691,4185,9641,14792,26416,16039,71073
Georgia,Sandersville,5831,681,1537,810,506,212,3746
Georgia,Salem,293,57,88,92,5,4,246
Georgia,Sale City,459,44,119,90,17,3,273
Georgia,St. Simons,13287,542,1236,3078,3512,2257,10625
Georgia,St. Marys,17675,574,3211,4081,1371,1160,10397
Georgia,Rutledge,937,150,259,153,78,39,679
Georgia,Russell,1374,278,347,105,57,14,801
Georgia,Royston,2478,488,553,492,79,105,1717
Georgia,Rincon,9487,560,1614,1873,1003,270,5320
Georgia,Ringgold,3668,461,495,1013,195,118,2282
Georgia,Riverdale,15650,1402,3319,3279,1152,603,9755
Georgia,Riverside,22,6,8,3,0,1,18
Georgia,Lovejoy,6450,547,980,1605,544,232,3908
Georgia,Robins AFB,1405,18,99,173,112,114,516
Georgia,Richmond Hill,10872,393,1609,2011,1532,817,6362
Georgia,Rochelle,1076,207,397,120,54,10,788
Georgia,Rockmart,4197,679,1123,717,265,139,2923
Georgia,Rocky Ford,221,21,75,32,14,9,151
Georgia,Rome,36278,5958,6114,6340,2806,2075,23293
Georgia,Roopville,363,30,95,69,22,18,234
Georgia,Rossville,4035,919,893,791,222,53,2878
Georgia,Roswell,93471,4434,9883,14080,23345,12207,63949
Georgia,Rockingham,411,39,84,15,0,15,153
Georgia,Louisville,2581,448,699,369,128,49,1693
Georgia,Cadwell,611,97,191,111,11,7,417
Georgia,Lone Oak,62,14,19,12,3,5,53
Georgia,Mountain City,886,153,210,171,71,11,616
Georgia,Mountain Park,591,9,71,103,163,82,428
Georgia,Chattanooga Valley,3625,532,731,764,323,104,2454
Georgia,Chauncey,345,48,122,22,19,9,220
Georgia,Cherry Log,159,0,56,73,15,0,144
Georgia,Chester,2037,483,854,216,21,21,1595
Georgia,Chickamauga,3115,246,753,609,237,99,1944
Georgia,Clarkesville,1937,152,374,384,191,190,1291
Georgia,Clarkston,11990,2087,1933,1645,972,346,6983
Georgia,Claxton,2163,296,470,323,164,51,1304
Georgia,Clayton,2068,290,517,330,137,112,1386
Georgia,Clermont,1060,114,182,272,98,40,706
Georgia,Cleveland,3689,190,690,770,342,152,2144
Georgia,Climax,165,36,50,37,9,8,140
Georgia,Cobbtown,339,48,103,58,20,6,235
Georgia,Cochran,4765,635,1057,380,234,249,2555
Georgia,Cohutta,666,59,171,161,56,19,466
Georgia,Newnan,35224,2692,6388,6214,4239,1996,21529
Georgia,Newington,284,27,85,42,27,13,194
Georgia,Newborn,641,116,146,129,14,20,425
Georgia,Nelson,1407,170,275,279,72,48,844
Georgia,Nashville,4914,741,1274,966,175,180,3336
Georgia,Nahunta,1095,182,291,181,49,35,738
Georgia,Moultrie,14474,2565,3536,2047,680,443,9271
Georgia,Mount Zion,1850,252,508,305,96,41,1202
Georgia,Mount Airy,1233,238,218,278,84,46,864
Georgia,Mountain Park,12702,812,1823,2561,2010,1575,8781
Georgia,Collins,484,116,112,59,3,22,312
Georgia,College Park,14026,1818,2584,2379,1026,698,8505
Georgia,Coleman,35,14,0,21,0,0,35
Georgia,Colbert,663,69,176,107,40,55,447
Georgia,Mount Vernon,2003,225,566,355,105,75,1326
Georgia,Lookout Mountain,1664,4,79,153,585,323,1144
Georgia,Morven,518,115,104,87,33,7,346
Georgia,Morganton,375,35,117,90,21,10,273
Georgia,Loganville,10855,911,1908,2874,1002,507,7202
Georgia,Locust Grove,5666,645,973,989,587,87,3281
Georgia,Byromville,446,101,142,49,41,3,336
Georgia,Byron,4818,179,1032,1395,514,224,3344
Georgia,Union Point,1485,281,419,231,33,30,994
Georgia,Cairo,9759,1850,2039,1374,473,394,6130
Georgia,Calhoun,15948,3129,2807,2373,991,732,10032
Georgia,Calvary,97,0,18,47,6,7,78
Georgia,Camak,187,16,53,30,5,13,117
Georgia,Camilla,5083,947,984,842,491,175,3439
Georgia,Candler-McAfee,22835,3209,5587,4644,1833,930,16203
Georgia,Canon,790,279,164,101,4,4,552
Georgia,Canoochee,93,5,55,12,0,0,72
Georgia,Canton,24305,3517,3261,4610,2813,1151,15352
Georgia,Carl,224,19,73,59,12,10,173
Georgia,Carlton,355,69,116,49,32,12,278
Georgia,Carnesville,664,74,133,128,60,13,408
Georgia,Morgan,2679,693,858,330,62,1,1944
Georgia,Moreland,379,25,106,75,32,18,256
Georgia,Moody AFB,637,0,29,115,33,7,184
Georgia,Chattahoochee Hills,2575,137,597,714,327,178,1953
Georgia,Chatsworth,4297,702,1174,726,405,164,3171
Georgia,Chamblee,27654,5085,3549,3029,4773,2436,18872
Georgia,Morrow,6982,1148,1432,1235,388,174,4377
Georgia,Centralhatchee,418,45,112,59,21,9,246
Georgia,Cedartown,9781,2128,2019,954,357,220,5678
Georgia,Cedar Springs,22,0,10,12,0,0,22
Georgia,Cecil,391,86,74,68,16,0,244
Georgia,Cave Spring,1355,159,217,310,97,70,853
Georgia,Cartersville,19964,2509,4075,3952,1780,1036,13352
Georgia,Carrollton,25515,2866,3489,3116,2001,1710,13182
Georgia,Centerville,7519,701,1358,1758,798,535,5150
Georgia,Unionville,1574,320,446,158,8,23,955
Georgia,Uvalda,565,65,156,85,30,31,367
Georgia,Valdosta,56504,5308,8068,9382,4515,3180,30453
Georgia,Sparks,2373,457,479,286,65,39,1326
Georgia,Sparta,1515,251,422,269,87,43,1072
Georgia,Springfield,2826,358,679,515,145,92,1789
Georgia,Stapleton,471,104,103,55,32,7,301
Georgia,Statenville,1142,229,200,188,48,15,680
Georgia,Statesboro,30059,1632,2526,3737,1791,1718,11404
Georgia,Statham,2564,481,647,337,153,31,1649
Georgia,Stillmore,603,102,156,121,21,3,403
Georgia,Stockbridge,27328,2096,3924,5395,3609,1950,16974
Georgia,Stone Mountain,5991,551,985,1137,903,551,4127
Georgia,Sugar Hill,20323,933,2547,4268,2871,1642,12261
Georgia,Summertown,213,34,49,31,7,0,121
Georgia,Summerville,4422,1057,1113,605,196,54,3025
Georgia,Sumner,402,73,127,53,13,12,278
Georgia,Buchanan,1260,251,346,165,34,12,808
Georgia,Soperton,3073,539,971,321,269,41,2141
Georgia,Brunswick,15794,2169,3578,3230,765,472,10214
Georgia,Social Circle,4304,575,1029,900,173,141,2818
Georgia,Smyrna,53829,3620,5700,8946,11868,7868,38002
Georgia,Matthews,250,88,53,0,0,0,141
Georgia,Buford,13244,2222,2657,1932,1180,483,8474
Georgia,Buena Vista,2231,405,657,368,39,86,1555
Georgia,Buckhead,227,22,63,47,6,7,145
Georgia,Seville,155,35,12,34,16,0,97
Georgia,Shady Dale,321,41,72,47,14,9,183
Georgia,Shannon,1829,131,411,386,98,75,1101
Georgia,Sharon,110,50,42,10,4,1,107
Georgia,Sharpsburg,538,64,107,74,64,52,361
Georgia,Shellman,1071,176,223,223,27,14,663
Georgia,Shiloh,558,75,140,112,38,14,379
Georgia,Siloam,393,59,135,28,7,9,238
Georgia,Skidaway Island,8042,64,593,1431,2380,2245,6713
Georgia,Sky Valley,325,8,57,96,86,57,304
Georgia,Smithville,584,58,184,88,48,2,380
Georgia,Snellville,19199,745,3389,4765,2890,1266,13055
Georgia,Broxton,1101,198,311,113,39,20,681
Georgia,Brooks,637,12,171,139,65,42,429
Georgia,Brooklet,1540,71,314,309,165,178,1037
Georgia,Molena,496,51,107,110,20,12,300
Georgia,Mitchell,194,20,68,31,5,2,126
Georgia,Mineral Bluff,96,0,31,32,9,0,72
Georgia,Milton,35799,540,2257,5102,9980,5033,22912
Georgia,Milner,1140,196,181,186,65,42,670
Georgia,Millen,3003,509,760,356,184,41,1850
Georgia,Milledgeville,18971,1977,4329,1942,912,866,10026
Georgia,Milan,705,166,204,67,49,18,504
Georgia,Midway,2040,113,360,543,154,77,1247
Georgia,Maxeys,301,32,20,87,15,22,176
Georgia,Maysville,2215,282,624,415,51,27,1399
Georgia,Meansville,157,12,40,43,11,16,122
Georgia,Meigs,918,210,244,105,5,21,585
Georgia,Mendes,45,0,18,9,8,0,35
Georgia,Menlo,496,60,145,90,22,26,343
Georgia,Monroe,13476,1878,3525,1955,868,235,8461
Georgia,Montezuma,3284,567,798,638,101,22,2126
Georgia,Montgomery,4544,682,864,915,648,231,3340
Georgia,Monticello,2607,265,587,376,181,98,1507
Georgia,Brookhaven,50812,4408,4686,5107,12364,9305,35870
Georgia,Bronwood,191,63,35,24,2,9,133
Georgia,Brinson,344,81,113,54,22,12,282
Georgia,Bremen,6224,569,1094,919,638,542,3762
Georgia,Braswell,364,32,79,58,14,15,198
Georgia,Braselton,8074,476,991,1464,1601,752,5284
Georgia,Boykin,108,14,44,49,0,1,108
Georgia,Martinez,36895,1765,6310,8097,4865,3609,24646
Georgia,Bowman,842,196,229,122,57,18,622
Georgia,Bowdon,2252,482,507,345,92,51,1477
Georgia,Bostwick,528,40,109,50,89,23,311
Georgia,Boston,1461,242,350,245,71,22,930
Georgia,Bonanza,3873,442,576,713,541,178,2450
Georgia,Bogart,1117,120,277,216,96,58,767
Georgia,Blythe,728,55,233,142,59,26,515
Georgia,Montrose,246,14,49,62,6,1,132
Georgia,Bowersville,414,29,130,82,18,10,269
Georgia,Martin,458,37,143,66,47,22,315
Georgia,Marshallville,1359,192,411,287,74,57,1021
Georgia,Marietta,58906,5244,7595,11284,9826,4258,38207
Georgia,Waynesboro,5801,819,1308,818,183,150,3278
Georgia,Webster County unified governm,2720,452,860,404,80,61,1857
Georgia,West Point,3410,497,860,658,290,150,2455
Georgia,Whigham,738,142,181,178,24,8,533
Georgia,White,762,98,250,86,23,0,457
Georgia,Sunnyside,1413,23,284,293,188,47,835
Georgia,Sunny Side,94,2,22,17,16,8,65
Georgia,Ludowici,2343,283,569,477,138,130,1597
Georgia,Lula,2793,283,651,481,131,78,1624
Georgia,Lumber City,1327,201,611,115,51,31,1009
Georgia,Lumpkin,1311,217,357,160,119,21,874
Georgia,Luthersville,1214,208,213,245,39,18,723
Georgia,Lyerly,534,77,161,99,13,10,360
Georgia,Lyons,4362,548,1275,687,98,51,2659
Georgia,Mableton,39589,4007,6212,6105,5728,3092,25144
Georgia,Waycross,14258,1794,3359,2824,707,586,9270
Georgia,Waverly Hall,891,127,367,139,21,56,710
Georgia,Watkinsville,2871,161,473,561,374,305,1874
Georgia,Washington,4001,524,1381,514,297,276,2992
Georgia,Varnell,1835,184,366,393,153,81,1177
Georgia,Vernonburg,126,1,16,20,33,28,98
Georgia,Vidalia,10627,1360,2354,1615,871,536,6736
Georgia,Vidette,127,18,47,19,6,3,93
Georgia,Vienna,3846,574,1209,551,210,67,2611
Georgia,Villa Rica,14435,1103,2477,2821,1505,687,8593
Georgia,Vinings,11224,353,862,1704,3203,2209,8331
Georgia,McCaysville,1176,187,252,237,91,11,778
Georgia,Waco,474,101,143,78,5,12,339
Georgia,Waleska,642,35,58,40,18,10,161
Georgia,Walnut Grove,1213,121,315,250,59,47,792
Georgia,Walthourville,4136,320,805,890,188,153,2356
Georgia,Warm Springs,518,99,113,100,31,12,355
Georgia,Warner Robins,72520,4883,13595,16614,6058,3317,44467
Georgia,Warrenton,2136,507,504,169,91,76,1347
Georgia,Warwick,418,93,102,54,9,1,259
Georgia,Wadley,1992,436,640,209,63,37,1385
Georgia,Midville,296,68,56,64,12,2,202
Georgia,McDonough,22830,1653,3990,5773,2087,993,14496
Georgia,Sardis,953,164,227,126,41,17,575
Georgia,Winterville,1084,48,171,191,201,155,766
Georgia,Winder,14928,2069,3257,2642,937,481,9386
Georgia,Wilmington Island,14781,338,2080,3619,3035,1713,10785
Georgia,Williamson,347,52,44,111,19,1,227
Georgia,Willacoochee,1547,356,325,251,9,19,960
Georgia,Whitesburg,581,136,163,96,36,3,434
Georgia,White Plains,205,7,93,33,25,11,169
Georgia,Whitemarsh Island,7202,140,976,1334,1512,973,4935
Georgia,McIntyre,718,151,308,83,15,3,560
Georgia,Macon-Bibb,154608,16654,32407,26619,14392,9259,99331
Georgia,McRae-Helena,8720,2238,2996,814,352,289,6689
Georgia,Madison,3991,651,586,653,468,372,2730
Georgia,Butler,1647,358,477,230,64,40,1169
Georgia,Manchester,4141,549,1111,642,93,104,2499
Georgia,Mansfield,351,63,114,56,8,5,246
Georgia,Woodbine,1552,184,289,368,64,32,937
Georgia,Woodbury,803,153,234,120,29,9,545
Georgia,Woodland,326,93,109,39,8,8,257
Georgia,Woodstock,26793,752,3505,5508,4874,2147,16786
Georgia,Sasser,356,67,60,66,10,10,213
Georgia,Satilla,419,74,150,67,0,0,291
Georgia,Sautee-Nacoochee,315,23,14,121,67,22,247
Georgia,Savannah,142919,12460,24839,26732,15388,9307,88726
Georgia,Scotland,371,30,172,24,2,6,234
Georgia,Scottdale,10672,1383,1299,1588,1394,1283,6947
Georgia,Screven,893,110,274,144,29,7,564
Georgia,Santa Claus,270,31,70,53,5,11,170
Georgia,Senoia,3773,238,640,920,388,300,2486
Georgia,Young Harris,1004,19,52,63,42,19,195
Georgia,Yonah,391,68,35,33,114,0,250
Georgia,Yatesville,420,62,133,106,14,11,326
Georgia,Wrightsville,3689,811,858,630,106,94,2499
Georgia,Wrens,2532,371,585,422,134,38,1550
Georgia,Woolsey,188,9,38,31,22,32,132
Georgia,Woodville,366,71,154,29,10,12,276
Georgia,Zebulon,1380,164,309,261,83,47,864
Georgia,Manassas,133,5,26,43,15,0,89
Georgia,Druid Hills,13928,132,320,658,2587,3336,7033
Georgia,Franklin Springs,924,33,90,137,54,64,378
Georgia,Alma,3513,506,890,497,205,113,2211
Georgia,Allentown,233,27,86,18,14,18,163
Georgia,Allenhurst,577,44,164,102,42,13,365
Georgia,Aldora,89,20,27,21,1,0,69
Georgia,Albany,76466,9306,13580,15262,4857,3320,46325
Georgia,Alapaha,735,67,142,193,9,13,424
Georgia,Alamo,4240,1007,1767,488,65,55,3382
Georgia,Ailey,671,12,106,90,63,36,307
Georgia,Adrian,578,90,158,96,4,2,350
Georgia,Adel,5281,856,1295,753,435,220,3559
Georgia,Adairsville,4712,526,890,1045,224,71,2756
Georgia,Alpharetta,62054,1318,4105,9288,15836,9523,40070
Georgia,Acworth,21512,1310,3597,4698,2893,1562,14060
Georgia,Rhine,508,111,139,83,12,18,363
Georgia,Reynolds,1257,163,324,263,71,82,903
Georgia,Rest Haven,94,32,29,10,0,0,71
Georgia,Resaca,915,166,196,137,65,3,567
Georgia,Rentz,352,27,123,63,16,13,242
Georgia,Remerton,1393,12,70,148,76,23,329
Georgia,Reidsville,2623,343,669,523,143,90,1768
Georgia,Register,105,19,14,21,22,7,83
Georgia,Reed Creek,2967,317,727,706,389,196,2335
Georgia,Redan,32614,1672,6050,8096,3722,1742,21282
Georgia,Rebecca,300,71,82,22,1,13,189
Georgia,Abbeville,2860,718,1161,364,88,17,2348
Georgia,Rayle,215,61,52,18,1,15,147
Georgia,Alston,152,18,46,33,3,11,111
Georgia,Ambrose,410,83,139,35,6,6,269
Georgia,Greensboro,3405,705,796,332,98,136,2067
Georgia,Greenville,925,140,251,184,31,9,615
Georgia,Gresham Park,7607,887,1797,1441,604,386,5115
Georgia,Griffin,23312,3376,4992,3505,1677,1031,14581
Georgia,Grovetown,12521,1070,1559,2643,1557,524,7353
Georgia,Gumbranch,194,16,75,39,2,1,133
Georgia,Gumlog,2463,353,595,428,131,57,1564
Georgia,Guyton,1963,175,515,309,149,48,1196
Georgia,Hagan,968,152,191,147,86,63,639
Georgia,Hahira,2843,196,495,662,227,66,1646
Georgia,Hamilton,1013,75,327,200,48,45,695
Georgia,Alto,1165,290,197,113,18,14,632
Georgia,Hampton,7188,711,1259,1196,263,295,3724
Georgia,Hapeville,6649,891,1280,1549,597,295,4612
Georgia,Haralson,126,20,40,22,2,15,99
Georgia,Hardwick,3539,731,947,468,75,50,2271
Georgia,Harlem,2872,264,707,570,248,113,1902
Georgia,Harrison,525,132,183,43,7,0,365
Georgia,Hartwell,4504,605,1027,784,192,206,2814
Georgia,Aragon,977,215,204,164,32,8,623
Georgia,Arabi,552,103,180,81,21,8,393
Georgia,Appling,656,78,171,88,91,46,474
Georgia,Andersonville,295,71,66,70,8,2,217
Georgia,Americus,16345,2082,2783,2454,806,1104,9229
Georgia,Hannahs Mill,3949,571,1032,623,90,70,2386
Georgia,Grayson,2778,88,506,573,365,354,1886
Georgia,Ray City,1236,115,267,289,66,57,794
Georgia,Ranger,169,36,54,12,0,3,105
Georgia,Parrott,173,29,58,34,18,1,140
Georgia,Panthersville,9367,726,2284,2250,687,209,6156
Georgia,Palmetto,4928,621,1124,842,235,92,2914
Georgia,Oxford,2265,223,391,346,132,92,1184
Georgia,Orchard Hill,222,80,45,21,4,1,151
Georgia,Omega,1299,268,396,112,7,10,793
Georgia,Oliver,221,53,81,30,2,3,169
Georgia,Oglethorpe,1307,387,184,238,119,60,988
Georgia,Offerman,433,109,143,54,1,1,308
Georgia,Odum,586,107,138,79,25,18,367
Georgia,Oconee,413,58,182,53,19,3,315
Georgia,Patterson,720,51,211,75,86,32,455
Georgia,Ocilla,3445,425,1026,621,138,107,2317
Georgia,Oakwood,4123,464,836,1076,230,80,2686
Georgia,Oak Park,843,194,160,123,8,5,490
Georgia,Nunez,80,19,14,19,2,4,58
Georgia,Norwood,272,110,43,37,11,5,206
Georgia,North High Shoals,767,69,115,150,107,61,502
Georgia,North Druid Hills,18385,444,1720,2451,4736,4548,13899
Georgia,North Decatur,17040,893,1083,2595,4337,3931,12839
Georgia,Norristown,82,16,21,0,14,0,51
Georgia,Norman Park,1220,157,327,195,37,38,754
Georgia,Norcross,16103,3006,2386,1887,1512,739,9530
Georgia,Nicholson,1587,341,347,249,49,45,1031
Georgia,Ochlocknee,665,169,106,147,11,12,445
Georgia,Raoul,2982,757,773,760,99,80,2469
Georgia,Pavo,580,154,150,141,12,6,463
Georgia,Peachtree City,34868,1018,3391,6000,8389,3985,22783
Georgia,Quitman,3804,738,909,580,140,87,2454
Georgia,Putney,2519,366,723,571,156,114,1930
Georgia,Pulaski,310,32,103,40,19,17,211
Georgia,Powder Springs,14462,1073,2063,3091,1921,876,9024
Georgia,Poulan,1031,205,261,148,58,7,679
Georgia,Port Wentworth,6619,365,1597,1229,1102,336,4629
Georgia,Porterdale,1890,325,473,256,117,55,1226
Georgia,Portal,639,116,152,120,31,20,439
Georgia,Crooked Creek,927,54,294,272,36,57,713
Georgia,Plainville,335,78,58,66,12,0,214
Georgia,Plains,733,172,164,144,43,34,557
Georgia,Payne,208,33,41,24,6,7,111
Georgia,Pitts,463,67,80,64,0,26,237
Georgia,Pine Mountain,1419,101,324,352,146,107,1030
Georgia,Pine Lake,648,37,89,147,159,100,532
Georgia,Pinehurst,405,68,125,82,30,4,309
Georgia,Phillipsburg,459,37,135,50,11,15,248
Georgia,Perry,14991,1167,3263,2755,1133,808,9126
Georgia,Perkins,243,0,26,52,0,0,78
Georgia,Pendergrass,464,71,116,78,24,13,302
Georgia,Pembroke,3036,237,604,526,180,59,1606
Georgia,Pelham,3828,720,887,525,103,28,2263
Georgia,Pearson,1935,487,371,145,133,26,1162
Georgia,Peachtree Corners,39910,1734,3928,6567,9153,5080,26462
Georgia,Pineview,485,68,127,87,18,5,305
Georgia,Gray,3287,212,726,686,309,245,2178
Georgia,Grantville,3124,276,799,604,168,40,1887
Georgia,Graham,284,52,83,33,2,3,173
Georgia,Dawson,4388,915,816,613,106,74,2524
Georgia,Dawsonville,2416,212,410,605,158,143,1528
Georgia,Dearing,552,78,104,121,15,7,325
Georgia,Decatur,20605,603,1155,1806,4545,4970,13079
Georgia,Deenwood,1845,108,499,387,119,100,1213
Georgia,Deepstep,156,11,31,48,33,8,131
Georgia,Demorest,1842,109,290,311,116,140,966
Georgia,Denton,241,36,78,36,2,2,154
Georgia,De Soto,309,48,48,50,10,0,156
Georgia,Dewy Rose,230,70,23,0,0,0,93
Georgia,Dexter,571,64,198,81,20,20,383
Georgia,Davisboro,1776,410,676,307,67,23,1483
Georgia,Dillard,401,54,86,55,69,34,298
Georgia,Doerun,790,105,166,120,34,33,458
Georgia,Donalsonville,2716,301,669,548,233,51,1802
Georgia,Dooling,322,64,71,18,8,6,167
Georgia,Doraville,10650,2572,1665,1231,848,493,6809
Georgia,Douglas,11750,1537,2573,1688,657,521,6976
Georgia,Ball Ground,1869,143,453,474,187,72,1329
Georgia,Baldwin,3467,643,616,394,212,106,1971
Georgia,Bainbridge,12576,1630,2833,2086,970,758,8277
Georgia,Baconton,794,115,148,135,26,0,424
Georgia,Avondale Estates,3066,24,202,356,726,990,2298
Georgia,Avera,282,22,79,67,6,4,178
Georgia,Dock Junction,7272,965,1934,1408,391,368,5066
Georgia,Avalon,266,53,70,49,16,10,198
Georgia,Dasher,881,78,187,189,68,36,558
Georgia,Danville,201,41,64,17,10,3,135
Georgia,Crawfordville,626,182,163,80,27,13,465
Georgia,Crawford,948,286,225,140,27,34,712
Georgia,Covington,13507,2032,3046,2574,913,590,9155
Georgia,Country Club Estates,8568,950,1790,1987,559,254,5540
Georgia,Cornelia,4199,703,839,467,153,179,2341
Georgia,Cordele,11140,1607,2163,1953,446,269,6438
Georgia,Coolidge,598,104,115,160,8,3,390
Georgia,Conyers,15577,1623,3333,2601,1040,600,9197
Georgia,Conley,5125,895,1034,910,192,87,3118
Georgia,Concord,372,20,71,72,19,24,206
Georgia,Commerce,6575,1015,1547,1157,336,188,4243
Georgia,Darien,2844,288,627,801,122,65,1903
Georgia,Comer,1280,181,298,160,118,106,863
Georgia,Colquitt,2268,309,548,386,73,20,1336
Georgia,Cumming,5588,740,1431,951,527,258,3907
Georgia,Cusseta-Chattahoochee County unified governm,11914,427,1406,2033,1003,336,5205
Georgia,Cuthbert,3697,768,982,405,86,120,2361
Georgia,Dacula,4831,813,839,556,520,101,2829
Georgia,Dahlonega,6052,416,490,956,887,411,3160
Georgia,Daisy,146,17,40,18,4,21,100
Georgia,Dallas,12363,997,2623,2525,882,535,7562
Georgia,Dalton,33496,7712,4295,4564,2243,1430,20244
Georgia,Damascus,332,42,86,42,14,17,201
Georgia,Danielsville,912,120,213,135,47,33,548
Georgia,Columbus,200285,17392,35308,44071,19158,11628,127557
Georgia,Austell,6994,719,1630,1352,464,382,4547
Georgia,Douglasville,31917,2289,5315,6460,3837,2356,20257
Georgia,Augusta-Richmond County consolidated government (balance),196635,21208,39006,39773,16071,9782,125840
Georgia,Flowery Branch,6216,255,930,1247,1097,503,4032
Georgia,Folkston,5313,1391,1532,687,251,113,3974
Georgia,Forest Park,18953,4078,4046,2683,816,213,11836
Georgia,Forsyth,3993,768,927,647,181,179,2702
Georgia,Fort Gaines,1087,164,218,169,11,58,620
Georgia,Fort Oglethorpe,9547,1037,2312,2313,591,339,6592
Georgia,Fort Stewart,4977,39,348,840,329,80,1636
Georgia,Fort Valley,9192,1056,1094,1192,446,292,4080
Georgia,Franklin,890,240,239,147,36,15,677
Georgia,Funston,790,125,180,68,25,16,414
Georgia,Gainesville,37115,6246,5662,4886,2783,2104,21681
Georgia,Flovilla,500,111,114,102,9,5,341
Georgia,Garden City,8966,1184,2463,1653,571,188,6059
Georgia,Gay,100,18,16,14,11,5,64
Georgia,Geneva,106,15,35,39,7,0,96
Georgia,Georgetown,12600,971,2007,2990,1623,717,8308
Georgia,Georgetown-Quitman County unified governm,2326,459,693,438,108,6,1704
Georgia,Gibson,695,132,195,112,29,41,509
Georgia,Gillsville,287,28,62,37,36,12,175
Georgia,Girard,154,50,34,13,3,1,101
Georgia,Glennville,5150,885,1071,1018,370,191,3535
Georgia,Glenwood,683,73,233,55,36,27,424
Georgia,Good Hope,236,39,76,54,12,8,189
Georgia,Gordon,2328,304,750,338,46,55,1493
Georgia,Garfield,191,41,40,42,8,1,132
Georgia,Flemington,877,20,137,291,38,51,537
Georgia,Fitzgerald,9032,1105,2413,1418,519,246,5701
Georgia,Fayetteville,16500,861,2677,3118,3100,1255,11011
Georgia,Auburn,7409,830,1926,1430,571,204,4961
Georgia,Attapulgus,585,136,127,65,24,15,367
Georgia,Atlanta,448901,33019,57670,65849,82175,61954,300667
Georgia,Athens-Clarke County unified government (balance),119684,8830,13914,15524,12857,12811,63936
Georgia,Ashburn,3875,887,994,573,152,29,2635
Georgia,Arnoldsville,451,42,115,102,27,37,323
Georgia,Arlington,1242,229,326,188,20,32,795
Georgia,Argyle,143,34,27,28,10,2,101
Georgia,Arcade,1471,298,482,201,55,12,1048
Georgia,Ellenton,108,58,20,12,0,8,98
Georgia,Ellijay,1952,374,424,288,116,82,1284
Georgia,Emerson,1461,231,352,220,180,62,1045
Georgia,Empire,421,71,166,76,0,0,313
Georgia,Enigma,903,148,228,157,15,0,548
Georgia,Ephesus,423,62,100,77,23,10,272
Georgia,Epworth,340,63,125,91,0,17,296
Georgia,Eton,1122,161,201,185,53,32,632
Georgia,Euharlee,4182,456,1002,688,309,169,2624
Georgia,Evans,33730,992,3845,6870,5470,4415,21592
Georgia,Experiment,2557,677,493,360,85,94,1709
Georgia,Fairburn,13697,1803,1975,2768,1386,763,8695
Georgia,Fairmount,841,158,286,82,28,8,562
Georgia,Fair Oaks,9109,2149,1424,1243,496,151,5463
Georgia,Fairview,8026,955,2418,1387,377,137,5274
Georgia,Fargo,339,68,86,46,7,1,208
Georgia,Nicholls,4067,968,1602,588,92,0,3250
Georgia,Newton,699,129,182,136,34,2,483
Georgia,Pooler,21400,815,3389,4523,3614,2112,14453
Georgia,Irwinton,703,129,214,79,26,32,480
Georgia,Jenkinsburg,342,37,79,42,16,9,183
Georgia,Jersey,126,24,38,23,9,5,99
Georgia,Jesup,10163,1146,3044,1966,625,395,7176
Georgia,Johns Creek,82203,2406,5450,10660,20805,13446,52767
Georgia,Jonesboro,4669,732,1122,653,292,114,2913
Georgia,Junction City,152,18,50,22,0,5,95
Georgia,Kennesaw,32186,1569,4801,6994,5887,2304,21555
Georgia,Keysville,245,43,109,14,3,6,175
Georgia,Kings Bay Base,1701,57,157,265,51,11,541
Georgia,Jeffersonville,1111,313,315,194,21,12,855
Georgia,Kingsland,16239,776,3316,4009,1421,598,10120
Georgia,Kite,289,72,82,39,2,4,199
Georgia,Knoxville,60,16,22,18,0,0,56
Georgia,LaFayette,7107,1043,1770,1463,451,191,4918
Georgia,LaGrange,30356,3621,5996,5067,2315,1506,18505
Georgia,Lake City,2650,463,586,454,112,72,1687
Georgia,Lakeland,3378,628,759,589,173,90,2239
Georgia,Lake Park,1070,112,166,222,66,37,603
Georgia,Lakeview,5878,1000,1542,1010,246,272,4070
Georgia,Lakeview Estates,2789,804,399,62,9,0,1274
Georgia,Kingston,766,109,234,115,11,7,476
Georgia,Lavonia,1842,257,503,358,187,30,1335
Georgia,Jefferson,9771,766,1918,2115,1137,449,6385
Georgia,Jakin,205,32,34,40,11,0,117
Georgia,Hinesville,34287,1795,5946,7923,2650,1194,19508
Georgia,Hiram,3681,278,914,1036,375,205,2808
Georgia,Hoboken,657,95,182,86,35,27,425
Georgia,Hogansville,3078,453,742,523,98,110,1926
Georgia,Holly Springs,9979,255,1264,1798,2002,743,6062
Georgia,Homeland,1028,101,206,171,61,18,557
Georgia,Homer,1343,115,341,246,72,61,835
Georgia,Homerville,2494,472,687,334,71,43,1607
Georgia,Hoschton,1781,180,306,295,167,95,1043
Georgia,Jasper,3715,381,693,896,280,203,2453
Georgia,Howard,0,0,0,0,0,0,0
Georgia,Ideal,468,109,127,117,13,10,376
Georgia,Ila,428,86,85,52,25,7,255
Georgia,Indian Springs,2739,136,505,806,158,74,1679
Georgia,Iron City,228,21,78,43,15,12,169
Georgia,Irondale,8488,520,1678,1281,664,355,4498
Georgia,Isle of Hope,2581,95,232,555,668,424,1974
Georgia,Ivey,930,87,308,198,23,11,627
Georgia,Jackson,4949,880,1263,740,211,139,3233
Georgia,Jacksonville,96,16,39,27,7,0,89
Georgia,Hull,239,52,62,38,14,8,174
Georgia,Lawrenceville,29738,3441,5144,5844,2673,1280,18382
Georgia,Leary,519,79,147,102,36,12,376
Georgia,Leesburg,2965,266,498,674,179,74,1691
Georgia,Blue Ridge,1492,329,428,255,99,45,1156
Georgia,Bluffton,73,25,13,12,5,6,61
Georgia,Ellaville,2022,350,456,332,102,36,1276
Georgia,Elberton,4474,758,1219,702,199,86,2964
Georgia,Edison,1054,178,257,198,40,25,698
Georgia,Edge Hill,23,0,4,14,5,0,23
Georgia,Eatonton,6486,1085,2050,974,271,191,4571
Georgia,East Point,35357,3532,6504,7318,3967,1825,23146
Georgia,East Newnan,1495,447,472,207,17,0,1143
Georgia,Bloomingdale,2746,247,798,532,233,120,1930
Georgia,Eastman,5375,532,1072,1115,415,140,3274
Georgia,East Ellijay,993,170,153,124,19,22,488
Georgia,East Dublin,2470,320,866,307,48,13,1554
Georgia,Eagle Grove,0,0,0,0,0,0,0
Georgia,Dutch Island,923,15,56,123,236,194,624
Georgia,Du Pont,177,45,72,5,7,4,133
Georgia,Dunwoody,47727,2161,3375,5855,12668,9295,33354
Georgia,Duluth,28294,1665,4776,4759,5504,2798,19502
Georgia,Dudley,773,77,202,172,56,36,543
Georgia,Dublin,16181,1713,4381,2607,758,1072,10531
Georgia,East Griffin,1416,313,368,200,17,16,914
Georgia,Blakely,4854,657,1177,762,221,194,3011
Georgia,Blairsville,731,152,185,105,10,24,476
Georgia,Blackshear,3522,494,811,622,135,215,2277
Georgia,Lenox,832,136,240,143,16,13,548
Georgia,Leslie,365,53,56,72,13,12,206
Georgia,Lexington,266,16,64,41,38,23,182
Georgia,Lilburn,12372,1836,1993,2014,1391,823,8057
Georgia,Lilly,228,40,68,22,8,0,138
Georgia,Lincoln Park,500,217,134,123,0,9,483
Georgia,Lincolnton,1518,175,388,345,69,68,1045
Georgia,Lindale,4041,524,1196,725,130,101,2676
Georgia,Lithia Springs,17246,1806,3976,2990,1211,741,10724
Georgia,Lithonia,1961,196,455,417,106,42,1216
Georgia,Barnesville,6609,559,1133,1194,399,213,3498
Georgia,Bartow,310,66,80,63,21,4,234
Georgia,Barwick,443,58,105,50,19,13,245
Georgia,Baxley,4428,688,1392,478,398,161,3117
Georgia,Bellville,123,2,48,23,18,13,104
Georgia,Belvedere Park,16214,2149,3273,2874,1747,990,11033
Georgia,Berkeley Lake,1796,56,175,290,527,312,1360
Georgia,Berlin,554,95,142,87,24,11,359
Georgia,Bethlehem,700,99,160,134,34,26,453
Georgia,Between,331,13,71,64,47,14,209
Georgia,Bishop,296,10,30,48,33,22,143
Georgia,Hiltonia,469,115,111,65,3,4,298
Georgia,Hilltop,293,56,123,9,6,0,194
Georgia,Culloden,254,68,51,36,8,13,176
Georgia,Hazlehurst,4217,602,1116,855,86,104,2763
Georgia,Henderson,1886,6,189,700,291,122,1308
Georgia,Hephzibah,3950,316,865,976,194,164,2515
Georgia,Heron Bay,3539,26,700,835,567,195,2323
Georgia,Hiawassee,982,99,194,261,155,72,781
Georgia,Higgston,429,87,95,54,18,15,269
Georgia,Hawkinsville,5546,679,1993,956,237,360,4225
Georgia,Helen,296,11,58,116,53,19,257
Hawaii,Holualoa,8390,464,1418,2181,1491,520,6074
Hawaii,Kaanapali,1202,24,172,385,251,139,971
Hawaii,Kaaawa,1139,56,205,262,174,80,777
Hawaii,Iroquois Point,3935,89,614,1078,333,189,2303
Hawaii,Honomu,364,17,83,97,62,27,286
Hawaii,Hauula,3755,175,770,515,392,336,2188
Hawaii,Honokaa,2359,241,558,566,149,127,1641
Hawaii,Honalo,2571,209,646,508,229,165,1757
Hawaii,Hawaiian Acres,2516,213,544,776,243,59,1835
Hawaii,Hawaiian Ocean View,4276,274,1326,916,293,69,2878
Hawaii,Hawaiian Paradise Park,11684,735,2939,2307,1661,818,8460
Hawaii,Honaunau-Napoopoo,2813,202,802,592,305,214,2115
Hawaii,Heeia,4481,207,679,986,1034,726,3632
Hawaii,Hickam Housing,9243,1,490,2009,1209,698,4407
Hawaii,Hilo,45380,2314,9633,9647,6098,3145,30837
Hawaii,Hawaiian Beaches,4453,132,905,1337,317,253,2944
Hawaii,Hawi,1345,97,393,290,104,29,913
Hawaii,Waimalu,13333,632,2692,3615,2298,836,10073
Hawaii,Hanapepe,2630,55,543,736,460,98,1892
Hawaii,Ainaloa,3596,323,706,904,176,115,2224
Hawaii,Anahola,1951,145,671,354,132,42,1344
Hawaii,Captain Cook,4594,172,1164,921,466,394,3117
Hawaii,Discovery Harbour,1107,29,300,338,123,38,828
Hawaii,East Honolulu,48092,1184,5901,9271,11093,8522,35971
Hawaii,Eden Roc,687,98,189,121,23,24,455
Hawaii,Eleele,2604,257,560,554,318,84,1773
Hawaii,Ewa Beach,14287,1847,3866,2688,974,193,9568
Hawaii,Ewa Gentry,22676,1034,3879,5220,3390,1110,14633
Hawaii,Ewa Villages,7356,816,1346,1847,335,136,4480
Hawaii,Fern Acres,1426,115,378,393,118,50,1054
Hawaii,Fern Forest,669,46,170,238,42,29,525
Hawaii,Haena,280,4,52,72,39,49,216
Hawaii,Wailuku,16064,1015,3458,4149,1823,1092,11537
Hawaii,Halaula,530,45,168,66,61,33,373
Hawaii,Halawa,14812,743,3319,3400,2292,692,10446
Hawaii,Haleiwa,3576,329,684,936,335,65,2349
Hawaii,Haliimaile,1190,163,312,232,83,33,823
Hawaii,Hana,1258,39,393,143,89,62,726
Hawaii,Hanalei,210,17,32,66,29,15,159
Hawaii,Hanamaulu,4946,566,1322,983,275,60,3206
Hawaii,Kahaluu,4565,229,905,964,457,244,2799
Hawaii,Kahaluu-Keauhou,3783,267,455,720,666,525,2633
Hawaii,Kahuku,2513,192,528,437,283,30,1470
Hawaii,Kahului,28476,2822,7583,5627,2330,1079,19441
Hawaii,Naalehu,847,116,283,99,52,10,560
Hawaii,Nanakuli,12405,730,3627,2125,436,135,7053
Hawaii,Nanawale Estates,1714,193,471,309,62,61,1096
Hawaii,Napili-Honokowai,6723,453,1501,1728,1162,163,5007
Hawaii,Ocean Pointe,11336,324,1179,3173,1609,958,7243
Hawaii,Olinda,1161,28,195,311,230,147,911
Hawaii,Olowalu,92,4,17,28,20,11,80
Hawaii,Omao,1270,88,289,398,181,72,1028
Hawaii,Orchidlands Estates,3305,254,776,705,315,158,2208
Hawaii,Paauilo,633,91,219,108,39,13,470
Hawaii,Mountain View,3088,48,551,801,284,325,2009
Hawaii,Pahala,1405,145,432,251,107,10,945
Hawaii,Paia,2561,126,594,507,419,210,1856
Hawaii,Punaluu,1064,54,238,251,158,70,771
Hawaii,Pukalani,8072,317,1511,2362,782,756,5728
Hawaii,Puhi,3435,178,972,685,254,156,2245
Hawaii,Puako,741,12,95,212,203,105,627
Hawaii,Princeville,2400,51,396,452,465,268,1632
Hawaii,Poipu,1042,24,116,263,287,162,852
Hawaii,Pepeekeo,1681,129,394,389,254,37,1203
Hawaii,Pearl City,47021,2471,9411,11518,6419,2885,32704
Hawaii,Paukaa,520,25,101,152,93,61,432
Hawaii,Pahoa,826,41,213,197,85,65,601
Hawaii,Aiea,9262,406,1713,2143,1413,871,6546
Hawaii,Mokuleia,1653,26,232,397,348,219,1222
Hawaii,Mililani Mauka,21055,427,2072,4755,4506,1820,13580
Hawaii,Kailua CDP (Hawaii County),12652,1127,3386,2492,1427,689,9121
Hawaii,Kailua CDP (Honolulu County),38722,1240,5554,8338,7587,5553,28272
Hawaii,Kalaeloa,9,1,0,0,2,3,6
Hawaii,Lahaina,12118,863,2744,2625,1464,416,8112
Hawaii,Laie,5644,96,447,898,800,406,2647
Hawaii,Lanai City,3519,328,862,716,376,182,2464
Hawaii,Launiupoko,505,2,45,132,133,60,372
Hawaii,Laupahoehoe,533,15,108,162,60,23,368
Hawaii,Lawai,2253,61,424,656,400,191,1732
Hawaii,Leilani Estates,1557,135,210,467,261,165,1238
Hawaii,Mililani Town,28021,748,4808,6945,4580,1874,18955
Hawaii,Lihue,7360,407,1524,1295,735,643,4604
Hawaii,Mahinahina,1016,62,80,321,258,62,783
Hawaii,Maili,8910,611,2011,1786,433,192,5033
Hawaii,Makaha,8813,829,2332,1274,476,284,5195
Hawaii,Makaha Valley,1284,43,274,300,135,64,816
Hawaii,Makakilo,20631,673,3265,4917,2901,1247,13003
Hawaii,Makawao,6523,226,1361,2001,669,197,4454
Hawaii,Makena,132,2,21,15,43,11,92
Hawaii,Manele,20,0,0,9,11,0,20
Hawaii,Maunaloa,431,25,83,79,15,5,207
Hawaii,Maunawili,2149,15,232,384,494,480,1605
Hawaii,Maalaea,298,4,41,104,62,73,284
Hawaii,Ahuimanu,8354,222,1292,1802,1640,840,5796
Hawaii,Haiku-Pauwela,7846,340,1239,1826,1367,767,5539
Hawaii,Kula,7478,112,1466,1752,1436,889,5655
Hawaii,Volcano,2430,216,411,507,392,349,1875
Hawaii,Wahiawa,17484,1282,4365,4035,1448,715,11845
Hawaii,Waialua,3690,453,704,817,456,207,2637
Hawaii,Waianae,13632,1276,3542,2499,525,190,8032
Hawaii,Waihee-Waiehu,9159,707,2227,1765,793,433,5925
Hawaii,Waikane,771,54,258,173,63,29,577
Hawaii,Waikapu,3561,130,816,852,454,85,2337
Hawaii,Waikele,7786,204,747,2084,1712,689,5436
Hawaii,Waikoloa Village,6350,178,806,1949,738,592,4263
Hawaii,Wailea,5656,195,889,1659,1167,742,4652
Hawaii,Wailua,2584,156,555,643,321,213,1888
Hawaii,Wailua Homesteads,5645,284,1034,1575,1116,428,4437
Hawaii,Urban Honolulu,347973,29862,62504,71630,57337,31771,253104
Hawaii,Kurtistown,1070,78,281,346,149,23,877
Hawaii,Wheeler AFB,2712,23,145,580,192,85,1025
Hawaii,West Loch Estate,5364,245,902,1529,861,235,3772
Hawaii,Waipio Acres,4961,228,891,1218,663,227,3227
Hawaii,Waipio,11261,482,2181,2988,1858,525,8034
Hawaii,Waipahu,41165,4416,9769,8533,3789,685,27192
Hawaii,Waiohinu,112,9,29,26,10,0,74
Hawaii,Wainiha,168,2,23,33,44,19,121
Hawaii,Wainaku,1388,145,280,388,184,96,1093
Hawaii,Waimea CDP (Kauai County),1690,115,424,463,284,84,1370
Hawaii,Waimea CDP (Hawaii County),10817,459,2169,2157,1080,729,6594
Hawaii,Waimanalo Beach,4255,275,1282,838,302,188,2885
Hawaii,Waimanalo,6164,278,1535,1202,363,107,3485
Hawaii,Whitmore Village,4919,499,1091,876,556,68,3090
Hawaii,Ualapue,372,9,107,89,29,40,274
Hawaii,Papaikou,1234,102,359,249,144,48,902
Hawaii,Royal Kunia,14198,819,2691,3617,1699,532,9358
Hawaii,Schofield Barracks,20858,212,1655,4488,1094,397,7846
Hawaii,Kaumakani,940,136,249,151,45,0,581
Hawaii,Kaunakakai,3544,122,883,925,353,122,2405
Hawaii,Kawela Bay,248,2,39,73,51,39,204
Hawaii,Keaau,2415,252,590,507,227,113,1689
Hawaii,Kealakekua,1894,136,402,479,220,110,1347
Hawaii,Kekaha,2915,281,634,851,230,143,2139
Hawaii,Keokea,1951,79,373,470,197,86,1205
Hawaii,Kihei,22401,1080,4503,5795,2966,1090,15434
Hawaii,Kilauea,3208,190,547,796,491,233,2257
Hawaii,Ko Olina,1872,28,121,536,442,239,1366
Hawaii,Kualapuu,1998,132,469,399,101,109,1210
Hawaii,Koloa,2623,233,581,511,199,78,1602
Hawaii,Kapalua,322,9,48,110,69,47,283
Hawaii,Pupukea,5705,140,799,1326,989,565,3819
Hawaii,Pakala Village,317,51,115,59,7,13,245
Hawaii,Kukuihaele,436,15,111,65,36,19,246
Hawaii,Kalaheo,4358,150,813,940,657,486,3046
Hawaii,Kapolei,18737,768,3151,4306,2446,939,11610
Hawaii,Kalihiwai,271,5,40,63,73,30,211
Hawaii,Kalaoa,12214,553,2618,3123,1767,787,8848
Hawaii,Kaneohe,33654,1332,7529,7381,5831,2679,24752
Hawaii,Kaneohe Station,11285,5,698,2098,817,285,3903
Hawaii,Kapaa,10794,470,2364,2938,1220,694,7686
Hawaii,Kapaau,1851,109,687,352,145,22,1315
Idaho,Groveland,834,54,126,168,98,22,468
Idaho,Greenleaf,1000,133,145,223,67,30,598
Idaho,Grand View,469,73,140,105,9,1,328
Idaho,Grangeville,3160,296,862,851,309,129,2447
Idaho,Hagerman,1186,121,209,227,86,51,694
Idaho,Kimberly,3444,212,670,923,206,103,2114
Idaho,Island Park,184,7,51,64,17,18,157
Idaho,Kendrick,456,61,125,91,32,17,326
Idaho,Kellogg,2192,181,502,558,177,50,1468
Idaho,Kamiah,1329,141,340,358,65,32,936
Idaho,Juliaetta,635,67,134,176,48,36,461
Idaho,Jerome,11100,2105,1758,1658,565,132,6218
Idaho,Hailey,8002,875,1038,1672,1255,507,5347
Idaho,Ketchum,2706,0,298,578,1196,244,2316
Idaho,Hamer,71,5,12,16,1,0,34
Idaho,Hope,54,0,10,13,4,12,39
Idaho,Harrison,168,15,55,51,25,3,149
Idaho,Elk River,119,18,34,30,13,3,98
Idaho,Idaho Falls,58374,3551,9869,13216,6396,3094,36126
Idaho,Idaho City,485,26,114,100,48,12,300
Idaho,Huetter,78,16,21,20,1,0,58
Idaho,Horseshoe Bend,775,72,252,201,43,9,577
Idaho,Irwin,235,13,86,67,17,5,188
Idaho,Hansen,1448,213,275,338,32,16,874
Idaho,Homedale,2590,507,621,328,48,14,1518
Idaho,Hidden Springs,2336,31,77,337,603,297,1345
Idaho,Heyburn,3163,521,514,476,88,75,1674
Idaho,Hazelton,742,142,114,160,21,4,441
Idaho,Hayden Lake,680,2,90,192,154,80,518
Idaho,Hayden,13749,783,2761,3848,1407,847,9646
Idaho,Hauser,694,51,191,191,53,22,508
Idaho,Hollister,168,31,50,47,3,1,132
Idaho,Iona,1980,103,293,473,240,37,1146
Idaho,Lapwai,1286,89,193,328,98,39,747
Idaho,Lincoln,2986,130,464,491,326,82,1493
Idaho,East Hope,170,7,29,68,29,13,146
Idaho,Eden,398,35,108,98,17,7,265
Idaho,Elk City,174,63,27,7,18,11,126
Idaho,Gooding,3498,606,723,672,145,129,2275
Idaho,Glenns Ferry,1137,127,252,294,53,18,744
Idaho,Georgetown,440,32,146,93,14,2,287
Idaho,Genesee,910,14,164,237,107,74,596
Idaho,Garden Valley,211,2,39,58,13,26,138
Idaho,Garden City,11313,838,2005,2387,1863,1256,8349
Idaho,Fruitland,4842,296,985,1155,326,132,2894
Idaho,Franklin,654,70,137,108,35,14,364
Idaho,Fort Hall,3336,408,803,666,142,62,2081
Idaho,Firth,462,57,107,92,44,9,309
Idaho,Filer,2625,297,468,679,146,51,1641
Idaho,Fernan Lake Village,143,0,13,48,25,28,114
Idaho,Ferdinand,154,5,49,47,8,2,111
Idaho,Fairfield,536,50,122,95,34,28,329
Idaho,Emmett,6548,824,1534,1219,486,217,4280
Idaho,Inkom,894,13,185,259,80,20,557
Idaho,Eagle,21863,586,2259,5104,4701,2214,14864
Idaho,Dubois,615,125,106,95,31,18,375
Idaho,Drummond,1,0,1,0,0,0,1
Idaho,Driggs,1936,174,285,356,270,74,1159
Idaho,Lewisville,488,39,117,95,54,11,316
Idaho,Lewiston,32284,1911,6957,8127,3764,1431,22190
Idaho,Leadore,131,12,40,19,11,1,83
Idaho,Lava Hot Springs,333,41,108,54,60,4,267
Idaho,Kuna,16557,685,2160,4481,2032,329,9687
Idaho,Kootenai,913,39,252,221,18,5,535
Idaho,Kooskia,602,97,204,110,32,17,460
Idaho,Cottonwood,1019,58,238,162,143,25,626
Idaho,Council,962,108,240,198,48,29,623
Idaho,Grace,855,63,224,204,68,21,580
Idaho,Craigmont,472,27,151,152,29,13,372
Idaho,Culdesac,330,42,107,96,7,1,253
Idaho,Dalton Gardens,2331,121,400,682,387,134,1724
Idaho,Dayton,526,10,75,107,49,26,267
Idaho,Deary,462,10,172,70,60,2,314
Idaho,Declo,563,122,37,90,17,16,282
Idaho,De Smet,174,17,26,53,0,0,96
Idaho,Dietrich,323,25,53,85,7,6,176
Idaho,Dover,798,29,106,215,103,99,552
Idaho,Downey,640,47,161,142,56,10,416
Idaho,Crouch,119,20,33,30,9,1,93
Idaho,Donnelly,77,4,10,8,0,1,23
Idaho,Worley,267,22,34,107,16,9,188
Idaho,Lowman,23,0,5,0,10,8,23
Idaho,Bliss,346,58,95,46,20,0,219
Idaho,Blanchard,160,0,48,71,16,25,160
Idaho,Blackfoot,11843,982,2134,2475,1080,359,7030
Idaho,Bennington,286,0,22,76,63,0,161
Idaho,Bellevue,2514,216,470,456,275,68,1485
Idaho,Basalt,344,36,84,72,19,4,215
Idaho,Banks,9,9,0,0,0,0,9
Idaho,Bancroft,308,17,74,93,18,7,209
Idaho,Bloomington,188,4,54,46,14,5,123
Idaho,Atomic City,21,3,5,6,0,0,14
Idaho,Ashton,968,113,224,170,101,19,627
Idaho,Arimo,344,15,59,85,38,8,205
Idaho,Arco,955,49,270,222,51,42,634
Idaho,Arbon Valley,715,102,110,126,95,0,433
Idaho,Ammon,14469,438,1632,3196,2139,661,8066
Idaho,American Falls,4380,675,1168,623,168,81,2715
Idaho,Albion,254,10,44,51,16,11,132
Idaho,Acequia,140,40,27,16,1,5,89
Idaho,Athol,798,69,241,195,30,16,551
Idaho,Boise City,214196,8166,28578,49143,36578,20279,142744
Idaho,Bonners Ferry,2496,233,636,637,153,110,1769
Idaho,Bovill,243,43,53,53,13,0,162
Idaho,Rigby,4011,217,735,637,509,75,2173
Idaho,Riggins,267,21,75,70,52,6,224
Idaho,Ririe,790,86,151,166,24,2,429
Idaho,Yellow Pine,82,53,0,29,0,0,82
Idaho,Conkling Park,60,8,22,12,7,6,55
Idaho,Coeur d'Alene,46796,2731,8087,12516,5324,2215,30873
Idaho,Clifton,374,17,52,72,31,14,186
Idaho,Clayton,0,0,0,0,0,0,0
Idaho,Clark Fork,423,63,118,127,20,4,332
Idaho,Chubbuck,14224,658,2183,3977,1428,515,8761
Idaho,Challis,883,96,267,227,75,3,668
Idaho,Castleford,147,31,20,36,6,1,94
Idaho,Cascade,1056,74,404,224,56,29,787
Idaho,Carey,539,14,104,154,53,29,354
Idaho,Cambridge,251,43,79,70,21,6,219
Idaho,Caldwell,49149,5898,8916,9335,2856,1179,28184
Idaho,Butte City,81,24,17,21,4,2,68
Idaho,Burley,10245,1263,1553,2175,521,252,5764
Idaho,Buhl,4205,739,1012,726,152,69,2698
Idaho,Aberdeen,2046,480,315,233,61,43,1132
Idaho,Riverside,1037,69,197,206,42,7,521
Idaho,Roberts,578,111,102,74,20,2,309
Idaho,Robie Creek,1487,16,222,493,302,153,1186
Idaho,Sweetwater,200,32,35,61,0,2,130
Idaho,Tensed,136,20,38,37,2,0,97
Idaho,Teton,1046,132,261,184,37,17,631
Idaho,Tetonia,347,52,78,53,22,0,205
Idaho,Troy,884,14,185,212,94,57,562
Idaho,Twin Falls,45984,3875,8033,11133,3714,1612,28367
Idaho,Tyhee,1165,71,174,312,116,72,745
Idaho,Ucon,1397,46,386,275,98,24,829
Idaho,Victor,2244,214,326,415,323,106,1384
Idaho,Wallace,781,80,200,190,66,26,562
Idaho,Wardner,196,9,45,54,11,4,123
Idaho,Warm River,0,0,0,0,0,0,0
Idaho,Weippe,540,65,157,132,28,10,392
Idaho,Weiser,5362,795,1386,1010,222,115,3528
Idaho,Wendell,2734,413,570,359,173,50,1565
Idaho,Weston,528,14,101,104,42,11,272
Idaho,White Bird,64,1,40,15,0,0,56
Idaho,Wilder,1452,324,308,93,15,13,753
Idaho,Winchester,304,30,89,92,21,2,234
Idaho,Swan Valley,126,0,39,39,16,6,100
Idaho,Richfield,429,72,101,97,5,4,279
Idaho,Sun Valley,1408,27,105,295,404,351,1182
Idaho,Stites,228,30,75,58,9,1,173
Idaho,Rockford,414,50,13,119,42,17,241
Idaho,Rockford Bay,213,13,26,99,39,18,195
Idaho,Rockland,358,26,54,54,37,0,171
Idaho,Rupert,5601,912,934,995,212,108,3161
Idaho,St. Anthony,3476,284,825,755,271,97,2232
Idaho,St. Charles,110,0,37,18,6,4,65
Idaho,St. Maries,2208,189,670,483,121,67,1530
Idaho,Salmon,3052,230,755,718,270,120,2093
Idaho,Sandpoint,7571,614,1685,1863,736,368,5266
Idaho,Shelley,4404,390,660,879,236,66,2231
Idaho,Shoshone,1542,201,403,269,47,36,956
Idaho,Smelterville,679,56,178,176,24,10,444
Idaho,Smiths Ferry,162,0,136,26,0,0,162
Idaho,Soda Springs,2974,146,705,604,349,60,1864
Idaho,Spencer,20,2,6,6,5,0,19
Idaho,Lost River,9,0,0,5,0,4,9
Idaho,Stanley,161,0,24,31,44,31,130
Idaho,Star,6768,191,874,2068,811,289,4233
Idaho,State Line,20,0,5,5,0,0,10
Idaho,Sugar City,1301,101,115,158,141,97,612
Idaho,Rexburg,26723,212,1163,4692,2558,1040,9665
Idaho,Spirit Lake,2193,140,605,571,101,13,1430
Idaho,Rathdrum,7174,374,1467,1833,520,238,4432
Idaho,Marsing,1397,264,271,185,35,11,766
Idaho,Nampa,86203,8032,15490,17468,6543,2449,49982
Idaho,Newdale,341,17,54,103,40,3,217
Idaho,New Meadows,522,31,183,72,31,0,317
Idaho,New Plymouth,1952,240,526,439,118,21,1344
Idaho,Nezperce,487,12,118,131,59,22,342
Idaho,Notus,532,70,141,108,11,3,333
Idaho,Oakley,779,68,132,179,74,10,463
Idaho,Oldtown,235,49,67,44,0,3,163
Idaho,Onaway,190,22,40,61,6,12,141
Idaho,Orofino,3088,315,812,876,216,82,2301
Idaho,Osburn,1429,136,398,372,115,36,1057
Idaho,Oxford,54,0,10,8,5,0,23
Idaho,Paris,462,17,135,121,42,8,323
Idaho,Parker,340,25,72,71,13,4,185
Idaho,Parkline,69,9,26,14,7,0,56
Idaho,Parma,2266,417,513,299,110,57,1396
Idaho,Murphy,95,3,41,20,15,0,79
Idaho,Paul,1299,275,303,183,77,37,875
Idaho,Mullan,717,85,181,151,56,4,477
Idaho,Moyie Springs,730,69,212,201,47,2,531
Idaho,Melba,501,28,104,110,36,14,292
Idaho,Menan,808,85,129,183,52,22,471
Idaho,Meridian,84018,2794,12955,19382,12306,5268,52705
Idaho,Middleton,6145,313,1464,1469,327,208,3781
Idaho,Midvale,161,8,81,24,12,7,132
Idaho,Minidoka,66,27,0,4,0,0,31
Idaho,Montpelier,2545,157,680,534,158,57,1586
Idaho,Moore,150,10,33,49,3,4,99
Idaho,Moreland,1295,128,133,190,81,26,558
Idaho,Moscow,24688,322,1426,3404,3996,2893,12041
Idaho,Mountain Home,13804,953,2534,3724,742,434,8387
Idaho,Mountain Home AFB,3190,43,217,649,206,75,1190
Idaho,Malad City,2017,85,495,599,116,47,1342
Idaho,Mackay,434,10,121,108,49,47,335
Idaho,McCammon,630,39,179,110,67,24,419
Idaho,McCall,2955,51,188,836,552,284,1911
Idaho,Reubens,68,1,22,13,6,4,46
Idaho,Mud Lake,421,48,50,38,13,13,162
Idaho,Payette,7428,877,1485,1848,341,179,4730
Idaho,Murtaugh,92,21,8,22,6,2,59
Idaho,Malta,237,21,65,44,25,6,161
Idaho,Peck,163,11,50,37,24,4,126
Idaho,Pierce,681,80,186,151,70,24,511
Idaho,Pinehurst,1686,225,410,371,126,61,1193
Idaho,Plummer,1145,113,229,223,48,42,655
Idaho,Pocatello,54549,2584,8735,12022,6070,3574,32985
Idaho,Placerville,28,0,3,10,7,4,24
Idaho,Post Falls,29320,1401,5964,8289,2458,1236,19348
Idaho,Potlatch,792,39,173,196,42,39,489
Idaho,Preston,5190,361,1293,1019,393,113,3179
Idaho,Priest River,1659,122,465,355,90,19,1051
Idaho,Princeton,76,14,15,9,0,0,38
Idaho,Ponderay,947,56,197,271,76,5,605
Illinois,Iroquois,160,9,54,47,13,5,128
Illinois,Ingalls Park,3047,257,1050,523,117,94,2041
Illinois,Inverness,7431,121,746,1271,1686,1693,5517
Illinois,Iola,107,8,37,14,0,0,59
Illinois,Ipava,560,30,153,126,58,7,374
Illinois,Irving,445,53,135,46,10,10,254
Illinois,Jacksonville,19241,1468,5145,3298,1637,986,12534
Illinois,Irwin,82,2,21,22,5,2,52
Illinois,Island Lake,8041,433,1535,2179,1068,316,5531
Illinois,Itasca,8574,519,1488,1883,1432,787,6109
Illinois,Iuka,472,50,148,110,15,5,328
Illinois,Ivesdale,281,17,74,70,34,6,201
Illinois,Industry,396,17,104,90,49,19,279
Illinois,Irvington,848,44,244,238,36,30,592
Illinois,Indianola,368,23,155,41,16,4,239
Illinois,Hutsonville,567,61,117,138,43,28,387
Illinois,Indian Creek,569,5,32,35,182,113,367
Illinois,Ina,2342,667,557,452,62,23,1761
Illinois,Illiopolis,943,60,257,200,54,34,605
Illinois,Sailor Springs,90,23,24,17,0,0,64
Illinois,Jeffersonville,497,51,112,128,21,3,315
Illinois,Hurst,780,117,221,216,43,11,608
Illinois,Huntley,25412,827,4441,6704,4629,1777,18378
Illinois,Hume,366,42,107,104,14,1,268
Illinois,Humboldt,448,53,164,101,18,7,343
Illinois,Hull,499,22,173,102,14,9,320
Illinois,Sadorus,394,22,126,94,21,17,280
Illinois,Rutland,256,28,126,60,6,0,220
Illinois,Russellville,61,6,28,5,5,0,44
Illinois,Rushville,3159,299,847,704,165,134,2149
Illinois,Indian Head Park,3827,207,424,734,1123,562,3050
Illinois,Saybrook,785,46,218,186,37,21,508
Illinois,Scales Mound,518,26,135,93,37,7,298
Illinois,Jerseyville,8583,562,2258,2173,623,356,5972
Illinois,St. Joseph,4302,47,617,969,486,357,2476
Illinois,St. Libory,625,24,182,221,21,18,466
Illinois,St. Peter,303,15,109,86,23,0,233
Illinois,Salem,7054,627,1662,1688,418,276,4671
Illinois,Sammons Point,379,33,94,90,16,14,247
Illinois,Sandoval,1196,176,217,245,67,3,708
Illinois,Sandwich,7540,565,1989,1772,433,250,5009
Illinois,San Jose,601,38,147,135,33,21,374
Illinois,Sauget,219,26,84,66,5,4,185
Illinois,Sauk Village,10540,982,2228,2344,551,147,6252
Illinois,Saunemin,348,22,113,79,15,1,230
Illinois,Savanna,2980,363,945,448,192,122,2070
Illinois,Savoy,8066,113,762,1118,1713,1395,5101
Illinois,Sawyerville,264,22,83,48,16,11,180
Illinois,Scott AFB,2982,3,165,639,187,278,1272
Illinois,Sciota,86,0,35,14,7,0,56
Illinois,Schram City,473,43,178,84,18,6,329
Illinois,Schiller Park,11834,1461,2528,2629,1141,562,8321
Illinois,Schaumburg,74559,3236,10946,15458,15847,8876,54363
Illinois,St. Johns,224,16,65,58,9,3,151
Illinois,Jerome,1579,56,311,391,332,116,1206
Illinois,St. Jacob,1226,42,187,275,212,87,803
Illinois,Ste. Marie,275,14,78,78,27,2,199
Illinois,Jewett,276,52,76,46,4,3,181
Illinois,Johnsburg,6321,205,1550,1287,761,436,4239
Illinois,Shelbyville,4964,277,1536,1238,336,174,3561
Illinois,Sheffield,760,80,222,162,65,25,554
Illinois,Shawneetown,1330,101,336,421,37,15,910
Illinois,Shannon,625,53,188,151,38,24,454
Illinois,Shabbona,936,71,276,279,37,32,695
Illinois,Seymour,373,13,45,69,31,0,158
Illinois,Sesser,1959,107,518,412,184,30,1251
Illinois,Seneca,2521,116,654,544,182,71,1567
Illinois,Secor,355,30,138,62,15,8,253
Illinois,Seatonville,311,34,63,86,15,5,203
Illinois,Seaton,236,19,90,53,15,7,184
Illinois,Scottville,68,5,25,8,5,11,54
Illinois,St. Anne,1422,162,329,322,51,31,895
Illinois,St. Augustine,120,23,41,32,4,0,100
Illinois,St. Charles,33685,1493,4452,6219,7335,4045,23544
Illinois,St. David,609,47,169,188,44,5,453
Illinois,St. Elmo,1340,144,373,303,43,40,903
Illinois,St. Francisville,440,38,150,106,20,10,324
Illinois,Jeisyville,111,25,46,8,1,0,80
Illinois,Bowen,458,35,145,95,30,10,315
Illinois,Brimfield,901,41,173,195,101,31,541
Illinois,Hillview,182,13,78,11,8,0,110
Illinois,Hillside,8190,1273,1524,1594,849,343,5583
Illinois,Hillsdale,547,47,163,132,25,16,383
Illinois,Hillsboro,8545,1381,2216,2339,395,218,6549
Illinois,Hillcrest,1167,98,263,196,101,31,689
Illinois,Highwood,5391,599,1102,585,736,524,3546
Illinois,Highland Park,29789,669,1966,3280,6980,7607,20502
Illinois,Highland,9848,561,2110,2329,1297,492,6789
Illinois,Hidalgo,108,15,27,29,3,0,74
Illinois,Ruma,293,9,75,73,11,0,168
Illinois,Hickory Hills,13933,1185,3244,3038,1576,791,9834
Illinois,Heyworth,2937,139,660,536,469,150,1954
Illinois,Hettick,176,13,75,38,7,0,133
Illinois,Herscher,1548,58,340,372,137,95,1002
Illinois,Belleville,42898,2156,8415,11815,4545,2345,29276
Illinois,Bellevue,1566,121,536,319,89,72,1137
Illinois,Bellflower,330,15,101,83,25,6,230
Illinois,Hinckley,2035,88,414,524,241,95,1362
Illinois,Bellmont,204,35,71,53,5,2,166
Illinois,Hindsboro,330,22,84,118,9,8,241
Illinois,Hodgkins,2097,549,472,278,78,34,1411
Illinois,Huey,199,16,65,44,19,4,148
Illinois,Hudson,1931,18,347,376,356,147,1244
Illinois,Hoyleton,661,40,98,164,60,13,375
Illinois,Hopkins Park,409,94,101,75,23,2,295
Illinois,Hopewell,451,19,83,122,76,31,331
Illinois,Hopedale,1013,82,248,277,70,28,705
Illinois,Hooppole,337,16,83,77,13,2,191
Illinois,Hoopeston,5420,704,1955,945,308,114,4026
Illinois,Homewood,19375,609,2231,4187,3680,2621,13328
Illinois,Hometown,4356,345,1188,1201,337,161,3232
Illinois,Homer Glen,24358,1019,4585,5239,3890,2120,16853
Illinois,Homer,1246,44,365,317,88,28,842
Illinois,Hollowayville,68,1,34,13,3,0,51
Illinois,Holiday Shores,2913,96,487,762,475,233,2053
Illinois,Holiday Hills,658,50,218,143,40,19,470
Illinois,Hoffman Estates,52271,2943,6567,9667,10496,6220,35893
Illinois,Hoffman,474,27,102,130,32,5,296
Illinois,Hinsdale,17308,194,710,1248,3924,4435,10511
Illinois,Broadlands,380,6,119,84,31,18,258
Illinois,Bellwood,19190,2163,4485,3916,1204,721,12489
Illinois,Bement,1744,79,551,420,124,53,1227
Illinois,Bluford,617,74,171,149,37,9,440
Illinois,Bolingbrook,74371,5216,10863,13626,10965,5346,46016
Illinois,Bondville,476,24,126,132,38,6,326
Illinois,Bone Gap,201,12,63,53,5,5,138
Illinois,Bonfield,319,12,86,88,24,10,220
Illinois,Bonnie,403,37,132,90,22,9,290
Illinois,Boody,232,25,64,71,7,0,167
Illinois,Boulder Hill,8584,588,1882,1897,755,371,5493
Illinois,Bourbonnais,18656,782,2963,3974,1761,1263,10743
Illinois,Braceville,757,64,234,143,32,5,478
Illinois,Bradford,707,38,191,177,41,20,467
Illinois,Bradley,15763,810,3400,3986,1426,719,10341
Illinois,Braidwood,6049,383,1983,1593,311,72,4342
Illinois,Breese,4539,260,927,1310,443,190,3130
Illinois,Bridgeport,1196,111,278,323,42,30,784
Illinois,Bridgeview,16359,2358,4093,2788,1165,460,10864
Illinois,Brighton,2109,118,501,590,102,47,1358
Illinois,Bluffs,795,33,252,186,29,10,510
Illinois,Belvidere,25741,2940,5850,4995,1476,635,15896
Illinois,Blue Mound,1055,109,285,238,54,27,713
Illinois,Bloomington,78206,2520,12254,12142,15676,7913,50505
Illinois,Benld,1657,112,385,439,105,55,1096
Illinois,Bensenville,18485,2513,4208,3414,1586,525,12246
Illinois,Benson,427,15,147,85,34,8,289
Illinois,Bentley,37,14,2,12,5,1,34
Illinois,Benton,7319,779,1327,1737,765,306,4914
Illinois,Berkeley,5217,464,1008,1116,673,246,3507
Illinois,Berlin,144,21,78,16,9,2,126
Illinois,Berwyn,56706,7894,10234,10449,5280,2184,36041
Illinois,Bethalto,9406,623,2269,2293,851,398,6434
Illinois,Bethany,1308,69,347,317,82,35,850
Illinois,Biggsville,298,21,103,75,23,11,233
Illinois,Big Rock,1128,38,276,294,143,44,795
Illinois,Bingham,45,9,11,4,3,4,31
Illinois,Bishop Hill,136,2,48,32,18,10,110
Illinois,Bismarck,598,15,174,136,51,22,398
Illinois,Blandinsville,693,34,237,201,72,11,555
Illinois,Bloomingdale,22261,1497,4174,5140,4034,2065,16910
Illinois,Blue Island,23096,2999,4872,4578,1433,816,14698
Illinois,Royalton,1177,123,320,301,68,21,833
Illinois,Princeville,2024,107,410,537,170,102,1326
Illinois,Royal,231,6,70,55,20,12,163
Illinois,Mitchell,1161,85,385,261,38,19,788
Illinois,Minooka,11505,468,1931,2535,1140,690,6764
Illinois,Minonk,2087,84,596,506,144,67,1397
Illinois,Minier,1346,101,305,302,140,45,893
Illinois,Mineral,248,22,71,53,15,0,161
Illinois,Milton,287,46,98,28,7,2,181
Illinois,Pittsburg,559,75,192,150,24,6,447
Illinois,Pittsfield,4611,375,1324,816,599,128,3242
Illinois,Plainfield,40855,1116,4146,6970,7787,4264,24283
Illinois,Plainville,417,28,90,95,4,11,228
Illinois,Plano,11920,1322,1836,2716,889,456,7219
Illinois,Plattville,274,9,42,82,15,17,165
Illinois,Pleasant Hill,1110,117,330,199,27,30,703
Illinois,Pleasant Plains,904,22,170,219,113,47,571
Illinois,Plymouth,429,72,154,82,34,4,346
Illinois,Pocahontas,631,97,209,128,33,6,473
Illinois,Polo,2172,194,591,501,169,77,1532
Illinois,Metropolis,6417,1048,1413,1563,456,121,4601
Illinois,Mettawa,430,6,43,70,130,79,328
Illinois,Middletown,280,36,88,70,8,7,209
Illinois,Midlothian,14906,1023,3639,3544,1333,442,9981
Illinois,Milan,5137,342,1719,1418,362,153,3994
Illinois,Milford,1289,193,389,223,54,49,908
Illinois,Modesto,174,17,52,40,7,3,119
Illinois,Millbrook,342,10,85,111,52,12,270
Illinois,Milledgeville,1061,49,376,227,76,45,773
Illinois,Millington,643,37,187,142,57,11,434
Illinois,Mill Shoals,204,18,54,52,12,2,138
Illinois,Millstadt,3930,232,638,1082,519,283,2754
Illinois,Pontoon Beach,5840,522,1471,1463,420,115,3991
Illinois,Pontiac,12085,1358,3353,2592,813,424,8540
Illinois,Mill Creek,36,3,9,14,5,0,31
Illinois,Metcalf,204,33,70,40,1,0,144
Illinois,Mokena,19369,521,3306,3934,3287,1808,12856
Illinois,Momence,2845,323,764,715,84,133,2019
Illinois,Muncie,193,16,39,48,19,2,124
Illinois,Mulkeytown,151,16,19,44,10,39,128
Illinois,Mulberry Grove,662,52,211,137,20,25,445
Illinois,Muddy,39,4,6,20,4,0,34
Illinois,Moweaqua,1776,121,485,346,159,76,1187
Illinois,Mount Zion,6118,172,989,1152,944,587,3844
Illinois,Mount Vernon,15136,1417,3247,3795,1124,756,10339
Illinois,Mount Sterling,2080,167,539,453,192,92,1443
Illinois,Mount Pulaski,1336,62,418,276,155,32,943
Illinois,Mount Prospect,54710,3959,8759,10439,9831,5423,38411
Illinois,Mount Olive,2090,146,621,483,134,44,1428
Illinois,Mount Morris,2997,317,617,627,274,124,1959
Illinois,Mount Erie,87,9,21,32,1,0,63
Illinois,Mount Clare,206,25,93,40,14,4,176
Illinois,Mount Carroll,1685,91,482,368,180,96,1217
Illinois,Mount Carmel,7098,466,1585,1948,607,255,4861
Illinois,Mount Auburn,535,33,157,123,15,11,339
Illinois,Monee,5114,95,1233,1247,652,245,3472
Illinois,Monmouth,9302,984,1971,1579,723,367,5624
Illinois,Monroe Center,477,25,131,108,42,24,330
Illinois,Montgomery,19196,968,3445,3808,2525,966,11712
Illinois,Monticello,5493,158,1243,1012,879,647,3939
Illinois,Montrose,280,35,88,37,16,2,178
Illinois,Moline,43062,3595,8334,10122,4914,2672,29637
Illinois,Morris,14402,968,3672,3006,1370,838,9854
Illinois,Morrisonville,903,46,272,181,54,11,564
Illinois,Morton,16534,556,2248,3600,3360,1582,11346
Illinois,Morton Grove,23472,1622,3920,4493,5071,2472,17578
Illinois,Mound City,634,109,123,96,18,8,354
Illinois,Mounds,1131,146,263,210,34,30,683
Illinois,Mound Station,165,6,59,27,2,10,104
Illinois,Morrison,4225,336,1009,975,412,110,2842
Illinois,Mundelein,31624,2404,4641,5313,5593,3474,21425
Illinois,Metamora,3454,188,669,640,514,163,2174
Illinois,Meredosia,1043,102,345,230,31,6,714
Illinois,Mansfield,896,64,285,219,61,19,648
Illinois,Manlius,423,39,110,100,17,2,268
Illinois,Manito,1689,86,509,379,123,57,1154
Illinois,Manhattan,7161,170,1309,1569,894,589,4531
Illinois,Manchester,327,11,116,80,28,0,235
Illinois,Malta,1118,71,210,282,108,28,699
Illinois,Malden,375,28,89,76,18,10,221
Illinois,Makanda,588,7,72,134,102,124,439
Illinois,Mahomet,7762,169,885,1347,1444,1021,4866
Illinois,Magnolia,386,33,123,55,14,4,229
Illinois,Maeystown,123,5,9,42,18,7,81
Illinois,Madison,4063,603,1167,699,55,46,2570
Illinois,Macon,1229,54,343,291,100,33,821
Illinois,Macomb,18944,651,1992,2279,2071,1981,8974
Illinois,McNabb,360,14,87,86,36,11,234
Illinois,Abingdon,3105,287,1021,655,112,47,2122
Illinois,Adair,150,7,88,8,10,6,119
Illinois,Alma,371,33,87,93,15,12,240
Illinois,Allerton,231,13,97,60,12,3,185
Illinois,Allenville,170,42,58,25,5,6,136
Illinois,Allendale,717,46,151,188,28,9,422
Illinois,Alhambra,633,40,224,139,57,15,475
Illinois,Algonquin,30278,774,3633,6540,5671,3049,19667
Illinois,Manteno,9251,256,2260,1868,1340,521,6245
Illinois,Alexis,967,57,241,286,68,24,676
Illinois,Albion,2154,186,468,604,153,39,1450
Illinois,Albers,1134,62,165,255,154,77,713
Illinois,Albany,1039,80,340,222,89,24,755
Illinois,Adeline,83,11,33,21,4,1,70
Illinois,Addison,37270,5170,7318,6500,3570,1362,23920
Illinois,Addieville,311,32,70,81,17,6,206
Illinois,Aledo,3590,165,981,909,323,138,2516
Illinois,Merrionette Park,1812,144,481,451,192,77,1345
Illinois,Maple Park,1316,58,266,357,130,37,848
Illinois,Maquon,340,17,96,99,18,9,239
Illinois,Menominee,264,26,57,53,22,10,168
Illinois,Mendota,7321,775,1999,1394,459,205,4832
Illinois,Mendon,912,42,274,203,78,32,629
Illinois,Melvin,509,31,163,96,16,15,321
Illinois,Melrose Park,25491,5075,4995,3678,1186,535,15469
Illinois,Medora,408,26,120,91,19,16,272
Illinois,Media,148,10,81,28,4,2,125
Illinois,Mechanicsburg,560,39,139,149,37,19,383
Illinois,Mazon,1024,41,261,229,83,26,640
Illinois,Maywood,24138,3112,5164,4816,1366,845,15303
Illinois,Maunie,122,28,42,22,0,0,92
Illinois,Mattoon,17646,1363,4824,4402,1257,612,12458
Illinois,Matteson,19159,714,2854,4644,2604,1778,12594
Illinois,Matherville,960,25,290,216,25,29,585
Illinois,Mason City,2305,196,733,495,95,70,1589
Illinois,Mason,463,73,143,56,6,3,281
Illinois,Mascoutah,7801,363,1213,1819,963,391,4749
Illinois,Marengo,7714,571,1801,1840,634,312,5158
Illinois,Marietta,218,9,113,19,1,26,168
Illinois,Marine,1107,67,251,326,124,67,835
Illinois,Marion,17588,1226,3473,5026,1546,1349,12620
Illinois,Marissa,2011,121,645,486,127,39,1418
Illinois,Mark,599,47,148,176,32,13,416
Illinois,Mapleton,329,15,80,85,26,4,210
Illinois,Markham,12685,1357,2809,2749,752,349,8016
Illinois,Marquette Heights,2851,129,791,727,155,56,1858
Illinois,Marseilles,4757,467,1280,1138,189,46,3120
Illinois,Marshall,3895,300,954,930,311,113,2608
Illinois,Martinsville,1219,96,283,271,86,28,764
Illinois,Martinton,304,10,79,97,9,4,199
Illinois,Maryville,7791,210,1494,1466,1406,919,5495
Illinois,Maroa,1724,172,412,414,182,32,1212
Illinois,Murphysboro,8055,787,1933,1589,785,431,5525
Illinois,Murrayville,472,34,194,98,21,6,353
Illinois,Naperville,145058,3111,10589,18643,33675,27709,93727
Illinois,Oak Brook,7977,206,910,1115,1752,2298,6281
Illinois,Norwood,491,37,187,101,19,9,353
Illinois,North Utica,1401,83,355,444,121,42,1045
Illinois,North Riverside,6991,331,1542,1704,704,420,4701
Illinois,North Pekin,1480,152,385,335,61,27,960
Illinois,Northlake,12353,2178,2611,1992,762,141,7684
Illinois,North Henderson,184,8,58,34,14,2,116
Illinois,Northfield,5305,65,252,569,1540,1356,3782
Illinois,North City,834,63,173,216,78,13,543
Illinois,North Chicago,29925,3014,3410,4366,1875,722,13387
Illinois,Northbrook,33572,723,2415,4306,9078,7589,24111
Illinois,North Barrington,3032,15,197,469,789,699,2169
Illinois,North Aurora,17154,921,3081,3496,2747,1341,11586
Illinois,Norris City,1358,119,277,334,57,35,822
Illinois,Norris,172,17,40,45,13,6,121
Illinois,Norridge,14856,1360,4106,3074,1749,866,11155
Illinois,Normal,54488,1089,5645,6056,8716,4304,25810
Illinois,Oreana,885,38,267,195,81,38,619
Illinois,New Holland,179,3,50,57,20,7,137
Illinois,New Lenox,25024,590,4188,5002,3995,2149,15924
Illinois,Newman,916,68,285,219,53,20,645
Illinois,New Milford,791,80,202,192,51,18,543
Illinois,New Minden,233,21,68,65,14,1,169
Illinois,Oakbrook Terrace,2252,118,238,566,523,360,1805
Illinois,New Salem,129,11,21,27,2,0,61
Illinois,Niantic,628,44,194,91,62,36,427
Illinois,Niles,29955,3583,7256,5858,4551,2091,23339
Illinois,Nilwood,223,34,79,46,17,5,181
Illinois,Noble,574,51,107,180,25,18,381
Illinois,Nokomis,2294,163,674,472,131,99,1539
Illinois,Nora,113,12,60,17,2,0,91
Illinois,Newton,2818,317,822,592,264,59,2054
Illinois,Oregon,3715,268,1023,1026,295,142,2754
Illinois,Oakdale,189,17,37,45,15,10,124
Illinois,Oak Forest,28134,1614,6059,6337,3635,1542,19187
Illinois,Orangeville,929,60,230,214,65,22,591
Illinois,Oquawka,1367,199,497,152,68,38,954
Illinois,Opdyke,339,52,56,86,21,3,218
Illinois,Oneida,776,9,196,166,72,36,479
Illinois,Onarga,1381,299,268,229,54,17,867
Illinois,Omaha,308,39,97,63,15,12,226
Illinois,Olympia Fields,4916,171,522,1244,1174,915,4026
Illinois,Olney,9085,807,1964,2072,1004,391,6238
Illinois,Olmsted,422,52,89,94,30,2,267
Illinois,Olivet,319,45,86,92,11,34,268
Illinois,Olive Branch,698,141,166,175,31,0,513
Illinois,Old Shawneetown,174,40,36,38,2,0,116
Illinois,Old Ripley,100,26,37,22,0,1,86
Illinois,Old Mill Creek,152,2,22,35,37,22,118
Illinois,Okawville,1460,63,217,407,208,102,997
Illinois,Ohlman,110,6,44,16,5,3,74
Illinois,Ohio,424,52,132,60,29,10,283
Illinois,Oak Grove,762,133,184,129,18,8,472
Illinois,Oakland,910,101,286,189,71,41,688
Illinois,Oak Lawn,56980,4049,12657,12962,6658,3786,40112
Illinois,Oak Park,52080,1282,3400,7000,11116,13517,36315
Illinois,Oak Run,499,17,83,200,89,45,434
Illinois,Oakwood,1650,82,470,406,128,25,1111
Illinois,Oakford,335,15,113,95,5,6,234
Illinois,Oakwood Hills,2152,77,340,610,348,143,1518
Illinois,Oconee,199,6,62,29,12,3,112
Illinois,Odell,1000,70,268,222,41,52,653
Illinois,Odin,1052,99,244,387,38,9,777
Illinois,O'Fallon,29144,692,3151,6136,4858,3973,18810
Illinois,Ogden,740,37,155,216,56,34,498
Illinois,Oglesby,3880,275,911,1109,212,167,2674
Illinois,Oblong,1472,87,447,333,93,56,1016
Illinois,Orient,358,56,75,119,9,4,263
Illinois,Orion,2011,116,468,456,261,52,1353
Illinois,Orland Hills,7259,364,1415,1420,865,436,4500
Illinois,Peru,10019,531,2497,2572,1012,574,7186
Illinois,Pesotum,520,20,167,91,56,23,357
Illinois,Petersburg,2357,200,537,533,155,83,1508
Illinois,Phillipstown,30,9,11,4,1,0,25
Illinois,Philo,1737,27,309,406,202,100,1044
Illinois,Phoenix,2088,259,504,526,84,47,1420
Illinois,Pierron,460,31,150,95,22,21,319
Illinois,Pinckneyville,5450,941,1239,994,325,205,3704
Illinois,Pingree Grove,5460,183,831,1085,683,233,3015
Illinois,Piper City,825,76,270,184,31,12,573
Illinois,Pistakee Highlands,3212,105,861,846,297,110,2219
Illinois,New Haven,373,58,108,103,4,2,275
Illinois,New Grand Chain,173,17,48,41,11,7,124
Illinois,New Douglas,355,18,112,85,21,12,248
Illinois,New Canton,364,36,126,79,15,1,257
Illinois,New Burnside,205,21,71,57,12,0,161
Illinois,New Boston,698,84,243,164,14,9,514
Illinois,Naplate,438,36,141,111,24,3,315
Illinois,Naples,48,9,19,13,0,0,41
Illinois,Nashville,3265,176,776,700,415,277,2344
Illinois,Nason,241,50,80,69,2,0,201
Illinois,Nauvoo,1362,63,240,301,263,114,981
Illinois,Nebo,310,53,111,41,1,0,206
Illinois,Perry,329,18,135,90,10,16,269
Illinois,Nelson,153,17,36,25,11,1,90
Illinois,Neponset,603,34,146,142,28,34,384
Illinois,Newark,1131,41,250,277,85,48,701
Illinois,New Athens,2072,146,424,545,207,53,1375
Illinois,New Baden,3432,116,684,979,547,160,2486
Illinois,New Bedford,67,10,33,15,2,0,60
Illinois,New Berlin,1501,67,280,347,175,86,955
Illinois,Neoga,1602,192,393,394,121,37,1137
Illinois,Percy,854,169,312,139,5,3,628
Illinois,Peotone,3990,144,872,870,438,206,2530
Illinois,Peoria Heights,6046,306,1282,1797,785,277,4447
Illinois,Panama,262,19,79,64,5,0,167
Illinois,Pana,5684,556,2033,1112,217,131,4049
Illinois,Palos Park,4944,157,774,1284,945,649,3809
Illinois,Palos Hills,17596,1058,4527,3990,1739,1235,12549
Illinois,Palos Heights,12566,714,1911,2546,2469,1752,9392
Illinois,Palmyra,584,63,182,131,29,3,408
Illinois,Panola,53,2,7,17,8,4,38
Illinois,Palmer,135,15,65,22,8,0,110
Illinois,Palatine,69188,4314,8859,11454,14227,8622,47476
Illinois,Paderborn,36,0,11,11,0,0,22
Illinois,Owaneco,183,18,57,41,17,2,135
Illinois,Ottawa,18565,1493,4628,4136,1458,839,12554
Illinois,Oswego,32468,796,4254,6802,5315,3297,20464
Illinois,Orland Park,58273,2567,10291,12091,10371,6843,42163
Illinois,Palestine,1375,91,379,390,69,38,967
Illinois,Alorton,1867,210,436,349,46,34,1075
Illinois,Papineau,306,20,98,44,0,5,167
Illinois,Park City,7432,1262,1562,945,268,89,4126
Illinois,Peoria,115847,8404,18741,21930,14563,9638,73276
Illinois,Penfield,159,8,74,43,2,0,127
Illinois,Pekin,33905,2274,9102,8153,2882,1301,23712
Illinois,Pecatonica,2234,103,552,517,169,108,1449
Illinois,Pearl City,884,52,202,189,92,18,553
Illinois,Pearl,250,34,69,28,7,0,138
Illinois,Paris,8517,913,2368,1546,789,275,5891
Illinois,Payson,1261,114,373,277,53,32,849
Illinois,Paw Paw,797,60,215,250,50,18,593
Illinois,Pawnee,2730,77,659,626,316,114,1792
Illinois,Patoka,529,52,136,151,12,11,362
Illinois,Park Ridge,37608,1115,4279,6251,8197,6095,25937
Illinois,Park Forest,21928,1136,3347,5912,2255,1523,14173
Illinois,Parkersburg,147,19,40,28,0,2,89
Illinois,Paxton,4252,352,1107,1158,333,84,3034
Illinois,Alpha,558,25,184,157,54,18,438
Illinois,Alsey,233,21,95,27,9,0,152
Illinois,Alsip,19396,2008,4075,4346,1555,584,12568
Illinois,Kempton,150,4,43,43,15,7,112
Illinois,Kell,196,15,51,64,5,0,135
Illinois,Keithsburg,609,113,224,101,12,8,458
Illinois,Keensburg,138,14,40,35,1,0,90
Illinois,Keenes,71,7,25,20,0,0,52
Illinois,Kaskaskia,20,7,7,2,0,0,16
Illinois,Karnak,605,91,162,132,12,5,402
Illinois,Kappa,313,25,52,42,42,16,177
Illinois,Kansas,655,71,204,145,35,16,471
Illinois,Kankakee,26821,3973,5568,5258,1252,804,16855
Illinois,Kangley,337,24,77,73,16,9,199
Illinois,Kaneville,432,23,80,107,54,20,284
Illinois,Kane,383,30,117,87,11,4,249
Illinois,Kampsville,304,18,100,68,19,2,207
Illinois,Justice,13015,1429,2888,2511,783,360,7971
Illinois,Junction City,513,98,133,101,8,2,342
Illinois,Junction,113,8,34,30,2,0,74
Illinois,Annapolis,40,0,4,12,10,0,26
Illinois,Anna,4360,736,914,935,280,269,3134
Illinois,Andover,554,32,192,140,39,14,417
Illinois,Andalusia,1384,78,321,368,107,39,913
Illinois,Anchor,145,15,47,30,1,2,95
Illinois,Amboy,2535,266,776,552,112,78,1784
Illinois,Kenilworth,2653,17,28,90,655,810,1600
Illinois,Alvan,286,28,81,66,14,0,189
Illinois,Johnsonville,57,3,20,11,3,4,41
Illinois,Johnston City,3531,314,908,937,107,48,2314
Illinois,Joliet,147918,14956,27411,27116,14269,6378,90130
Illinois,Jonesboro,2059,229,470,520,161,64,1444
Illinois,Joppa,342,43,84,60,18,2,207
Illinois,Joy,378,28,115,99,22,9,273
Illinois,Alto Pass,402,49,69,89,23,9,239
Illinois,Annawan,900,37,234,211,71,51,604
Illinois,Kenney,330,18,126,66,22,6,238
Illinois,Keyesport,542,83,145,107,10,3,348
Illinois,Lake Villa,8878,226,1097,1587,1749,778,5437
Illinois,Lake Summerset,1999,26,509,510,364,123,1532
Illinois,Lake Petersburg,628,17,163,113,192,89,574
Illinois,Lake of the Woods,2941,132,455,912,295,107,1901
Illinois,Lakemoor,6535,334,1097,1545,757,411,4144
Illinois,Lake Ka-Ho,232,30,92,48,6,3,179
Illinois,Lake in the Hills,28968,1105,4978,6260,4282,1690,18315
Illinois,Lake Holiday,4852,111,1138,1238,633,241,3361
Illinois,Lake Forest,18951,251,926,1852,4768,4777,12574
Illinois,Lake Catherine,1712,59,450,409,215,90,1223
Illinois,Lake Camelot,1986,31,396,429,249,225,1330
Illinois,Lake Bluff,5813,25,253,611,1554,1383,3826
Illinois,Lake Barrington,4934,53,604,919,1254,1162,3992
Illinois,La Harpe,1414,62,415,306,146,47,976
Illinois,La Grange Park,13649,486,1533,2748,2630,1937,9334
Illinois,La Grange,15709,447,1631,1941,3208,2828,10055
Illinois,La Fayette,252,19,100,42,6,0,167
Illinois,Kilbourne,284,41,95,58,13,0,207
Illinois,Kildeer,3938,35,231,641,1026,723,2656
Illinois,Kincaid,1653,189,482,244,57,29,1001
Illinois,Kinderhook,269,10,82,55,11,7,165
Illinois,Kingston,1066,71,269,234,77,15,666
Illinois,Kingston Mines,288,19,98,79,2,3,201
Illinois,Kewanee,12736,1609,2874,2663,767,433,8346
Illinois,Kinmundy,1015,104,222,258,33,12,629
Illinois,Kirkland,1655,100,372,374,104,42,992
Illinois,Kirkwood,773,42,204,142,57,4,449
Illinois,Knollwood,1613,104,205,393,352,128,1182
Illinois,Knoxville,2827,164,849,756,188,102,2059
Illinois,Lacon,1996,90,666,463,122,71,1412
Illinois,Ladd,1212,70,276,356,110,87,899
Illinois,Kinsman,118,7,36,36,1,0,80
Illinois,Antioch,14386,450,2855,2909,1999,1000,9213
Illinois,Apple Canyon Lake,304,25,78,53,39,75,270
Illinois,Apple River,456,29,137,94,22,8,290
Illinois,Basco,78,4,23,25,7,0,59
Illinois,Batavia,26105,845,2679,5107,5525,3401,17557
Illinois,Batchtown,189,11,59,59,21,6,156
Illinois,Bath,267,27,90,61,12,0,190
Illinois,Baylis,195,60,53,30,8,2,153
Illinois,Bay View Gardens,336,34,101,74,22,5,236
Illinois,Beach Park,13833,1008,3169,3111,1502,661,9451
Illinois,Beardstown,6217,843,1710,771,312,163,3799
Illinois,Beason,70,12,28,6,4,0,50
Illinois,Beaverville,285,28,79,64,10,5,186
Illinois,Beckemeyer,948,78,342,256,22,30,728
Illinois,Bedford Park,646,54,106,166,74,30,430
Illinois,Beecher,4532,220,1309,1196,329,124,3178
Illinois,Beecher City,454,48,124,105,7,9,293
Illinois,Belgium,325,34,104,79,22,0,239
Illinois,Belknap,54,10,12,11,0,0,33
Illinois,Belle Prairie City,60,5,10,24,9,0,48
Illinois,Roxana,1653,83,487,407,104,41,1122
Illinois,Round Lake Park,7957,1258,2014,1353,431,112,5168
Illinois,Round Lake Heights,2908,252,584,389,236,115,1576
Illinois,Round Lake Beach,27966,4108,5631,4465,1718,804,16726
Illinois,Round Lake,18446,1505,2169,3315,2880,930,10799
Illinois,Rossville,1675,138,377,357,130,35,1037
Illinois,Bartonville,6438,510,2077,1544,351,128,4610
Illinois,Rosiclare,950,105,223,251,40,16,635
Illinois,Roseville,1135,93,312,241,107,75,828
Illinois,Rosemont,4305,515,927,882,218,178,2720
Illinois,Roselle,22979,902,3478,5215,3864,1916,15375
Illinois,Rose Hill,50,1,34,5,4,0,44
Illinois,Roscoe,10536,397,1974,2281,1319,737,6708
Illinois,Belle Rive,301,18,76,84,23,18,219
Illinois,Rosewood Heights,4051,197,1408,1178,212,69,3064
Illinois,Bartlett,41552,1882,5586,8179,8372,3944,27963
Illinois,Bartelso,608,31,160,117,32,39,379
Illinois,Barry,1300,107,380,320,96,21,924
Illinois,Ashton,958,48,304,233,68,25,678
Illinois,Ashmore,828,69,196,197,65,32,559
Illinois,Ashley,563,71,150,128,19,7,375
Illinois,Ashland,1318,70,425,310,86,37,928
Illinois,Ashkum,795,32,211,230,59,18,550
Illinois,Arthur,2563,308,603,488,210,107,1716
Illinois,Assumption,1315,97,449,202,77,20,845
Illinois,Arrowsmith,316,4,59,83,26,10,182
Illinois,Armington,360,18,89,90,17,2,216
Illinois,Arlington Heights,75802,2195,9770,12936,18607,11319,54827
Illinois,Arlington,166,13,56,40,7,10,126
Illinois,Argenta,958,28,248,235,82,28,621
Illinois,Arenzville,364,12,106,68,50,7,243
Illinois,Arcola,2961,344,673,616,274,67,1974
Illinois,Aroma Park,659,50,201,121,40,21,433
Illinois,Lakewood,4258,40,330,517,1153,704,2744
Illinois,Astoria,1198,98,307,241,70,8,724
Illinois,Atkinson,1006,74,306,221,101,22,724
Illinois,Barrington Hills,3370,41,384,555,767,817,2564
Illinois,Barrington,10576,302,797,1505,2531,1911,7046
Illinois,Bardolph,268,21,69,69,20,5,184
Illinois,Bannockburn,1390,7,38,69,248,224,586
Illinois,Banner,207,25,56,46,18,4,149
Illinois,Baldwin,409,17,153,66,18,4,258
Illinois,Athens,1776,61,497,355,170,102,1185
Illinois,Avon,686,64,165,193,38,14,474
Illinois,Ava,661,58,134,170,54,17,433
Illinois,Aurora,200614,28669,24769,29436,24199,13151,120224
Illinois,Augusta,573,16,163,164,28,22,393
Illinois,Auburn,4870,177,1307,937,560,167,3148
Illinois,Atwood,1115,93,411,281,66,26,877
Illinois,Atlanta,1321,73,378,243,166,28,888
Illinois,Aviston,2228,82,431,531,354,105,1503
Illinois,Royal Lakes,155,38,32,38,7,3,118
Illinois,Lakewood Shores,1385,127,407,326,59,35,954
Illinois,La Moille,793,52,241,175,42,20,530
Illinois,Richton Park,13744,527,2103,3398,1902,1006,8936
Illinois,Richview,203,16,58,51,4,2,131
Illinois,Ridge Farm,838,48,294,204,37,17,600
Illinois,Ridgway,804,78,259,219,27,18,601
Illinois,Ridott,155,18,37,41,8,0,104
Illinois,Ringwood,791,8,182,181,88,52,511
Illinois,Rio,204,17,73,40,12,2,144
Illinois,Ripley,94,10,29,10,0,0,49
Illinois,Riverdale,13106,1032,2941,3139,778,325,8215
Illinois,River Forest,11233,235,484,1179,2427,2673,6998
Illinois,River Grove,10260,776,2713,2415,831,455,7190
Illinois,Riverside,8859,216,902,1103,1895,1929,6045
Illinois,Riverton,3478,245,845,759,278,76,2203
Illinois,Riverwoods,3811,62,151,505,1004,879,2601
Illinois,Roanoke,2189,60,554,569,300,71,1554
Illinois,Robbins,5157,568,1177,1270,237,117,3369
Illinois,Roberts,311,38,94,51,15,12,210
Illinois,Rome,1831,124,660,414,75,61,1334
Illinois,Rolling Meadows,23401,2282,3683,5122,3419,1968,16474
Illinois,Rockwood,63,12,7,13,0,0,32
Illinois,Rockton,7567,310,1745,1519,1074,491,5139
Illinois,Rock Island Arsenal,131,0,17,4,28,26,75
Illinois,Rock Island,38946,3272,7805,8400,3857,1722,25056
Illinois,Richmond,1989,78,536,438,223,63,1338
Illinois,Rockford,150283,16475,30251,30232,12310,8036,97304
Illinois,Rockdale,2061,236,536,495,123,49,1439
Illinois,Rock City,288,15,83,61,18,12,189
Illinois,Rockbridge,180,24,82,32,6,0,144
Illinois,Rochester,3883,112,447,598,786,594,2537
Illinois,Rochelle,9440,1144,1901,2051,637,403,6136
Illinois,Robinson,7506,808,1558,1919,605,439,5329
Illinois,Rock Falls,9178,1126,2200,2205,434,235,6200
Illinois,Romeoville,39774,3128,6389,7898,4545,1575,23535
Illinois,Reynolds,451,15,128,120,31,8,302
Illinois,Redmon,124,10,36,45,14,0,105
Illinois,Altamont,2399,308,547,547,167,50,1619
Illinois,Alton,27335,1814,6041,7560,2237,1087,18739
Illinois,Altona,494,35,114,102,31,10,292
Illinois,Pontoosuc,94,6,33,29,10,0,78
Illinois,Poplar Grove,5258,244,1566,906,442,289,3447
Illinois,Port Barrington,1451,47,181,266,316,150,960
Illinois,Port Byron,1708,47,368,469,181,151,1216
Illinois,Posen,6319,1016,1365,950,277,85,3693
Illinois,Potomac,700,35,254,108,26,11,434
Illinois,Prairie City,508,53,137,111,14,7,322
Illinois,Prairie du Rocher,694,48,231,168,22,5,474
Illinois,Prairie Grove,1685,21,235,283,322,251,1112
Illinois,Prestbury,1580,37,332,283,419,192,1263
Illinois,Preston Heights,2907,445,715,518,118,66,1862
Illinois,Princeton,7719,376,2159,1865,642,580,5622
Illinois,Broadview,7957,633,1980,2048,924,336,5921
Illinois,Prophetstown,2150,184,559,460,190,62,1455
Illinois,Reddick,353,12,70,81,22,1,186
Illinois,Red Bud,3623,221,1041,859,210,123,2454
Illinois,Raymond,781,61,252,181,37,41,572
Illinois,Raritan,93,2,36,26,7,3,74
Illinois,Rapids City,1047,64,187,301,122,97,771
Illinois,Rantoul,13256,1074,3039,2692,868,377,8050
Illinois,Rentchler,0,0,0,0,0,0,0
Illinois,Ransom,354,14,115,105,11,3,248
Illinois,Ramsey,1274,145,309,290,36,3,783
Illinois,Raleigh,306,19,80,119,12,3,233
Illinois,Radom,163,12,69,38,8,6,133
Illinois,Quincy,40763,2513,9962,9157,4187,2157,27976
Illinois,Pulaski,182,37,60,34,4,1,136
Illinois,Prospect Heights,16370,1571,3056,2806,2601,1538,11572
Illinois,Rankin,393,56,115,85,23,5,284
Illinois,Roodhouse,1788,241,543,298,90,19,1191
Illinois,McLeansboro,2894,319,706,901,114,73,2113
Illinois,McLean,821,63,247,193,63,21,587
Illinois,Lindenhurst,14414,334,1759,2710,2916,1515,9234
Illinois,Lincolnwood,12666,780,1517,1771,3025,2033,9126
Illinois,Lincolnshire,7271,183,537,997,1922,1784,5423
Illinois,Lincoln,14285,1040,3361,2855,1217,537,9010
Illinois,Limestone,1435,76,411,358,142,58,1045
Illinois,Lima,175,9,55,47,6,2,119
Illinois,Lily Lake,1113,19,140,258,196,95,708
Illinois,Libertyville,20395,440,1463,2563,5285,4094,13845
Illinois,Liberty,512,53,109,140,22,24,348
Illinois,Lexington,2153,73,524,508,294,107,1506
Illinois,Lewistown,2395,195,795,585,165,51,1791
Illinois,Le Roy,3584,130,810,688,588,156,2372
Illinois,Lerna,324,9,110,64,14,2,199
Illinois,Leonore,75,11,25,17,9,0,62
Illinois,Lenzburg,509,60,127,132,18,5,342
Illinois,Lena,2935,232,732,788,264,109,2125
Illinois,Lemont,16513,703,2664,3325,3010,1473,11175
Illinois,Lanark,1625,101,407,405,134,44,1091
Illinois,Langleyville,348,29,93,134,0,9,265
Illinois,Lansing,28445,2013,6035,7216,2725,1250,19239
Illinois,LaPlace,157,24,62,31,0,0,117
Illinois,La Prairie,84,14,20,19,0,3,56
Illinois,La Rose,113,1,57,18,0,5,81
Illinois,Lisbon,368,6,95,70,29,8,208
Illinois,LaSalle,9510,936,2342,2387,770,309,6744
Illinois,Lawrenceville,4486,469,1156,1124,297,55,3101
Illinois,Leaf River,585,65,160,125,32,5,387
Illinois,Lebanon,4259,200,646,983,776,507,3112
Illinois,Lee,352,13,81,84,24,12,214
Illinois,Leland,978,76,241,261,81,25,684
Illinois,Leland Grove,1617,39,115,250,426,446,1276
Illinois,Latham,277,17,77,72,19,8,193
Illinois,Lisle,22747,703,2103,4107,5248,3553,15714
Illinois,Litchfield,7004,687,1717,1383,420,207,4414
Illinois,Littleton,175,11,67,26,8,4,116
Illinois,Loves Park,24494,1618,5572,5690,2402,1350,16632
Illinois,Lovington,1042,77,402,190,30,23,722
Illinois,Ludlow,393,25,94,98,16,4,237
Illinois,Lyndon,682,68,209,155,40,6,478
Illinois,Lynnville,62,7,17,15,7,0,46
Illinois,Lynwood,9297,351,990,2384,1250,689,5664
Illinois,Louisville,1038,91,288,231,83,21,714
Illinois,Lyons,10668,1206,2697,2052,842,347,7144
Illinois,McCook,208,11,56,49,11,30,157
Illinois,McCullom Lake,913,77,259,211,34,0,581
Illinois,Macedonia,59,11,21,17,2,0,51
Illinois,McHenry,26739,1544,5830,6209,2885,1386,17854
Illinois,Machesney Park,23037,1738,6023,5513,1641,602,15517
Illinois,Mackinaw,2357,78,508,583,273,48,1490
Illinois,McClure,376,63,105,60,11,2,241
Illinois,Lake Zurich,19923,727,2033,3091,4569,2627,13047
Illinois,Lost Nation,650,0,150,207,135,21,513
Illinois,Loraine,301,28,103,62,15,2,210
Illinois,Little York,288,31,74,78,12,2,197
Illinois,Liverpool,144,27,44,14,2,0,87
Illinois,Livingston,809,50,272,212,49,15,598
Illinois,Loami,932,50,215,204,55,14,538
Illinois,Lockport,25088,876,4225,5598,3505,1809,16013
Illinois,Loda,323,60,83,96,6,12,257
Illinois,Lostant,396,22,102,99,31,16,270
Illinois,Lomax,358,60,126,87,13,1,287
Illinois,London Mills,375,30,103,74,21,18,246
Illinois,Long Creek,1528,84,427,300,203,64,1078
Illinois,Long Grove,8086,104,477,902,1842,1900,5225
Illinois,Long Lake,3715,381,846,818,331,95,2471
Illinois,Long Point,204,12,57,61,14,10,154
Illinois,Longview,146,9,45,21,11,11,97
Illinois,Lombard,43957,1745,6270,9620,8453,4912,31000
Illinois,Broadwell,117,10,25,29,11,1,76
Illinois,Otterville,99,9,37,31,2,0,79
Illinois,Winfield,9492,275,1106,2050,2015,1446,6892
Illinois,Smithboro,169,9,74,29,9,0,121
Illinois,Smithfield,187,20,49,43,5,7,124
Illinois,Smithton,3827,138,724,914,498,252,2526
Illinois,Somonauk,2128,100,499,529,198,61,1387
Illinois,Sorento,527,57,163,98,11,3,332
Illinois,South Barrington,4835,42,218,527,1399,1249,3435
Illinois,South Beloit,8131,537,1891,1778,740,239,5185
Illinois,South Chicago Heights,4152,533,1210,934,95,93,2865
Illinois,South Elgin,22227,1063,3879,4272,3397,1372,13983
Illinois,Southern View,2010,119,483,597,154,65,1418
Illinois,South Holland,22124,1100,3774,5697,2617,1648,14836
Illinois,South Jacksonville,3299,161,982,697,385,291,2516
Illinois,Darmstadt,0,0,0,0,0,0,0
Illinois,South Pekin,1175,100,357,238,12,6,713
Illinois,South Roxana,2362,226,623,531,79,14,1473
Illinois,South Wilmington,770,43,219,179,59,19,519
Illinois,Sparland,395,45,144,106,3,3,301
Illinois,Sleepy Hollow,3337,102,468,650,647,389,2256
Illinois,Skokie,65061,4943,8920,11661,12743,8908,47175
Illinois,Sims,313,44,85,48,9,0,186
Illinois,Simpson,103,10,17,13,4,1,45
Illinois,Bryant,200,23,52,65,3,12,155
Illinois,Buckingham,304,24,71,73,7,10,185
Illinois,Buckley,578,40,212,138,33,9,432
Illinois,Buckner,428,41,124,116,22,8,311
Illinois,Buda,644,48,263,75,18,18,422
Illinois,Sheldon,1222,128,380,208,21,16,753
Illinois,Sheridan,2320,650,501,506,33,13,1703
Illinois,Sherman,4565,192,579,1012,919,482,3184
Illinois,Sparta,4371,266,1568,895,297,175,3201
Illinois,Sherrard,759,18,222,195,53,18,506
Illinois,Shipman,679,27,159,172,49,27,434
Illinois,Shorewood,16354,700,2716,2933,2838,1418,10605
Illinois,Shumway,188,23,48,48,8,7,134
Illinois,Sibley,355,22,124,66,18,1,231
Illinois,Sidell,598,45,234,110,19,7,415
Illinois,Sidney,1300,63,283,352,130,39,867
Illinois,Sigel,394,22,87,106,27,7,249
Illinois,Silvis,7522,536,1518,2137,423,415,5029
Illinois,Shiloh,12902,325,1782,2716,2286,1530,8639
Illinois,Brussels,132,9,38,44,6,3,100
Illinois,Spaulding,773,16,171,208,102,20,517
Illinois,Spring Bay,502,30,147,125,21,8,331
Illinois,Streamwood,40865,3928,7743,7581,6095,2340,27687
Illinois,Streator,12990,1344,3762,2477,899,279,8761
Illinois,Stronghurst,811,45,255,215,55,25,595
Illinois,Sublette,413,9,156,106,33,7,311
Illinois,Sugar Grove,9195,225,1518,2291,1504,709,6247
Illinois,Davis,790,48,192,159,54,26,479
Illinois,Davis Junction,2532,159,405,583,221,65,1433
Illinois,Dawson,545,24,180,123,68,13,408
Illinois,Dayton,491,44,124,122,32,43,365
Illinois,Decatur,74654,6445,17297,15936,6891,3682,50251
Illinois,Deer Creek,731,32,131,185,87,21,456
Illinois,Deerfield,18588,194,911,1768,4628,4710,12211
Illinois,Deer Grove,38,4,15,8,0,1,28
Illinois,Deer Park,3323,89,150,447,816,680,2182
Illinois,DeKalb,43483,1475,4815,6836,4640,3056,20822
Illinois,De Land,430,42,137,106,7,5,297
Illinois,Delavan,1625,67,444,395,129,39,1074
Illinois,Strawn,109,8,40,22,4,1,75
Illinois,Strasburg,550,14,147,165,54,21,401
Illinois,Stoy,164,7,32,38,6,36,119
Illinois,Stonington,957,49,275,180,63,26,593
Illinois,Springerton,120,14,35,20,11,0,80
Illinois,Springfield,117061,7294,20834,23339,16964,11179,79610
Illinois,Spring Grove,5510,117,1038,1335,784,221,3495
Illinois,Spring Valley,5405,348,1509,1308,425,237,3827
Illinois,Standard,235,20,45,72,2,5,144
Illinois,Standard City,214,23,44,52,6,4,129
Illinois,Stanford,688,49,189,150,42,6,436
Illinois,Staunton,4965,341,1416,1356,420,174,3707
Illinois,Spillertown,250,29,42,70,21,9,171
Illinois,Steeleville,2171,124,571,531,202,37,1465
Illinois,Sterling,15170,1409,3249,3883,948,510,9999
Illinois,Steward,338,37,67,73,21,10,208
Illinois,Stewardson,757,21,214,183,68,32,518
Illinois,Stickney,6804,929,1604,1672,460,129,4794
Illinois,Stillman Valley,1048,42,234,250,94,56,676
Illinois,Stockton,1931,73,610,362,138,58,1241
Illinois,Stonefort,404,52,103,72,9,0,236
Illinois,Stone Park,4947,1417,795,559,169,25,2965
Illinois,Steger,9563,1021,2466,2095,579,351,6512
Illinois,De Pue,1852,400,353,201,86,23,1063
Illinois,Brownstown,777,80,240,150,28,7,505
Illinois,Browning,103,15,32,26,5,0,78
Illinois,Campbell Hill,304,22,99,68,22,6,217
Illinois,Camden,114,7,50,6,8,4,75
Illinois,Timberlane,937,27,139,220,137,90,613
Illinois,Time,21,6,13,2,0,0,21
Illinois,Tinley Park,57176,2492,10834,12498,9328,4439,39591
Illinois,Tiskilwa,898,47,269,232,36,4,588
Illinois,Toledo,1309,89,357,319,69,17,851
Illinois,Tolono,3066,73,578,687,352,251,1941
Illinois,Toluca,1332,130,390,311,104,18,953
Illinois,Tonica,771,43,185,222,67,17,534
Illinois,Topeka,82,7,27,10,3,0,47
Illinois,Toulon,1336,113,310,319,122,57,921
Illinois,Tovey,483,74,182,65,16,7,344
Illinois,Towanda,561,45,218,95,48,23,429
Illinois,Tower Hill,508,56,168,83,24,9,340
Illinois,Tower Lakes,1158,3,78,160,304,221,766
Illinois,Tremont,2170,59,476,590,275,96,1496
Illinois,Camp Point,1150,135,338,231,67,39,810
Illinois,Campton Hills,11012,136,1276,1664,2536,1587,7199
Illinois,Campus,158,1,47,44,8,1,101
Illinois,Candlewick Lake,4486,181,1210,888,359,102,2740
Illinois,Thornton,2615,177,913,639,163,39,1931
Illinois,Tilden,687,118,193,158,16,13,498
Illinois,Tilton,2669,166,1143,542,102,16,1969
Illinois,Carterville,5691,261,770,1176,696,646,3549
Illinois,Carrollton,2478,167,636,702,218,100,1823
Illinois,Carrier Mills,2081,300,473,546,83,25,1427
Illinois,Carpentersville,38264,6208,5374,5584,3174,1512,21852
Illinois,Carol Stream,40253,2615,5847,8568,7159,2955,27144
Illinois,Trenton,2698,161,648,575,368,119,1871
Illinois,Carmi,5107,483,1302,1464,306,199,3754
Illinois,Carlock,613,30,130,131,81,13,385
Illinois,Carlinville,5452,479,938,1207,467,345,3436
Illinois,Carbon Hill,328,22,95,64,8,6,195
Illinois,Carbondale,26192,799,1752,3416,2788,2782,11537
Illinois,Carbon Cliff,2076,168,504,395,106,93,1266
Illinois,Capron,1846,285,395,282,63,12,1037
Illinois,Cantrall,233,2,32,29,40,31,134
Illinois,Canton,14539,1612,3120,3959,1177,520,10388
Illinois,Carlyle,3299,225,790,731,463,103,2312
Illinois,Browns,127,36,39,26,0,0,101
Illinois,Trout Valley,557,13,35,84,166,84,382
Illinois,Troy Grove,240,16,74,65,9,1,165
Illinois,Dalton City,434,17,157,79,32,19,304
Illinois,Dalzell,725,33,178,238,53,27,529
Illinois,Damiansville,522,48,85,160,49,13,355
Illinois,Dana,126,21,40,14,1,0,76
Illinois,Danforth,577,54,157,130,34,40,415
Illinois,Danvers,1204,28,201,271,189,80,769
Illinois,Danville,32337,3233,7807,6528,1896,1101,20565
Illinois,Darien,22263,731,3220,4796,4370,3184,16301
Illinois,Goodfield,884,8,144,149,154,68,523
Illinois,Golf,474,23,12,33,119,115,302
Illinois,Golden Gate,66,19,15,10,0,4,48
Illinois,Golden,681,38,189,184,26,20,457
Illinois,Brocton,357,24,127,63,17,6,237
Illinois,Brookfield,18964,767,3143,4746,2844,1780,13280
Illinois,Brooklyn,836,69,162,147,46,1,425
Illinois,Brookport,883,111,218,290,41,6,666
Illinois,Broughton,218,46,42,14,10,1,113
Illinois,Dallas City,1254,87,394,267,86,44,878
Illinois,Dakota,511,38,139,117,25,4,323
Illinois,Dahlgren,375,29,92,145,35,22,323
Illinois,Cypress,247,28,63,78,5,3,177
Illinois,Tuscola,4405,286,1170,891,560,134,3041
Illinois,Twin Grove,1789,40,245,365,452,172,1274
Illinois,Ullin,406,88,83,86,42,22,321
Illinois,Union,535,13,143,109,38,29,332
Illinois,Union Hill,85,0,11,25,2,3,41
Illinois,University Park,6963,313,906,1936,581,355,4091
Illinois,Urbana,41988,1208,3418,4341,4793,5970,19730
Illinois,Ursa,639,18,173,182,66,19,458
Illinois,Troy,9939,304,1959,2595,1156,587,6601
Illinois,Valier,599,23,169,196,40,25,453
Illinois,Valmeyer,1434,40,301,313,176,37,867
Illinois,Crossville,691,72,147,166,37,20,442
Illinois,Crystal Lake,40635,2010,5314,8329,7575,3684,26912
Illinois,Crystal Lawns,2122,133,554,603,115,69,1474
Illinois,Cuba,1561,189,292,347,125,17,970
Illinois,Cullom,607,46,150,126,35,13,370
Illinois,Curran,190,17,66,50,5,1,139
Illinois,Cutler,389,52,138,82,12,6,290
Illinois,Valley City,3,0,1,0,2,0,3
Illinois,Carthage,2580,187,620,587,346,162,1902
Illinois,De Soto,1567,165,270,355,146,123,1059
Illinois,Varna,420,21,138,107,24,9,299
Illinois,Winnetka,12407,71,333,511,2900,3716,7531
Illinois,Winslow,245,8,82,73,8,2,173
Illinois,Winthrop Harbor,6849,469,1245,1772,723,404,4613
Illinois,Witt,774,73,252,144,43,9,521
Illinois,Wonder Lake,3966,93,670,1032,418,426,2639
Illinois,Wood Dale,13923,1160,3427,3063,1457,710,9817
Illinois,Woodhull,945,34,288,226,89,21,658
Illinois,Woodland,328,40,82,88,0,0,210
Illinois,Woodlawn,676,43,155,147,58,27,430
Illinois,Woodridge,33321,949,4304,6825,6803,4403,23284
Illinois,Wood River,10417,726,2623,2922,904,216,7391
Illinois,Woodson,417,21,154,66,39,20,300
Illinois,Woodstock,25247,2026,4290,5363,2918,1514,16111
Illinois,Worden,1250,88,332,307,84,36,847
Illinois,Worth,10829,1012,2723,2313,960,263,7271
Illinois,Wyanet,1122,66,298,258,28,10,660
Illinois,Wyoming,1599,182,449,354,91,35,1111
Illinois,Winnebago,3027,80,700,750,339,149,2018
Illinois,Forest View,703,58,223,140,63,15,499
Illinois,Windsor,1445,55,326,402,72,20,875
Illinois,Windsor,988,63,307,207,29,50,656
Illinois,East Cape Girardeau,619,61,184,150,15,8,418
Illinois,East Carondelet,587,53,168,137,7,5,370
Illinois,East Dubuque,1812,116,538,349,163,55,1221
Illinois,White Hall,2569,304,778,562,121,38,1803
Illinois,White Heath,234,17,57,80,0,0,154
Illinois,Williamsfield,540,50,146,116,34,29,375
Illinois,Williamson,212,16,85,44,6,0,151
Illinois,Williamsville,1526,21,213,435,210,92,971
Illinois,Xenia,493,34,114,154,14,3,319
Illinois,Willisville,448,59,152,96,12,0,319
Illinois,Willowbrook,2044,128,290,578,452,162,1610
Illinois,Willow Hill,233,30,86,40,4,0,160
Illinois,Willow Springs,5676,182,1078,1177,915,829,4181
Illinois,Wilmette,27420,283,941,2143,6171,8327,17865
Illinois,Wilmington,128,19,29,30,3,0,81
Illinois,Wilmington,5776,318,1856,1043,462,170,3849
Illinois,Wilsonville,563,73,159,138,19,2,391
Illinois,Winchester,1569,96,498,314,106,60,1074
Illinois,Willowbrook,8629,237,1311,1939,1687,1422,6596
Illinois,East Brooklyn,142,2,80,25,10,4,121
Illinois,Yale,80,4,27,17,4,0,52
Illinois,Yorkville,18222,513,2224,4070,2277,1733,10817
Illinois,Burnham,4224,349,951,1063,250,122,2735
Illinois,Burnt Prairie,66,7,9,29,0,1,46
Illinois,Burr Ridge,10753,414,878,1653,2545,2590,8080
Illinois,Bush,265,52,68,74,7,6,207
Illinois,Bushnell,3022,281,795,711,167,168,2122
Illinois,Butler,130,2,44,28,5,2,81
Illinois,Byron,3672,313,740,822,393,187,2455
Illinois,Cabery,326,31,99,78,8,8,224
Illinois,Cahokia,14740,1624,3734,3024,569,115,9066
Illinois,Cairo,2758,364,494,740,156,31,1785
Illinois,Caledonia,219,23,61,47,16,9,156
Illinois,Calhoun,204,36,42,88,5,1,172
Illinois,Calumet City,37184,3498,6657,10048,2731,1167,24101
Illinois,Calumet Park,8367,658,1833,2321,493,285,5590
Illinois,Camargo,550,25,127,164,36,10,362
Illinois,Cambria,1380,170,306,372,60,33,941
Illinois,Cambridge,2126,132,498,549,193,66,1438
Illinois,Burlington,659,18,164,149,54,37,422
Illinois,Bureau Junction,242,29,110,30,1,0,170
Illinois,Burbank,29157,4028,7665,4996,1615,536,18840
Illinois,Bunker Hill,1719,126,489,463,129,59,1266
Illinois,Zeigler,1804,195,436,371,117,12,1131
Illinois,Zion,24251,2681,5062,4417,1647,531,14338
Illinois,Forest Park,14194,822,2214,2865,2877,2191,10969
Illinois,Forest Lake,1719,102,214,252,487,180,1235
Illinois,Forest City,222,29,71,35,5,1,141
Illinois,Ford Heights,2780,459,830,282,142,23,1736
Illinois,Foosland,115,10,31,27,0,0,68
Illinois,Flossmoor,9492,152,746,1534,2000,2159,6591
Illinois,Yates City,813,46,234,175,62,5,522
Illinois,Florence,40,7,18,11,0,0,36
Illinois,Flora,5027,376,1177,1142,326,206,3227
Illinois,Flat Rock,347,15,94,97,24,11,241
Illinois,Flanagan,1138,73,349,271,96,32,821
Illinois,Fithian,504,39,147,129,22,9,346
Illinois,Buffalo Grove,41591,746,3451,6402,10931,8171,29701
Illinois,Bull Valley,1085,23,123,178,302,186,812
Illinois,Bulpitt,262,15,77,46,8,6,152
Illinois,Buncombe,203,26,47,37,15,4,129
Illinois,Floraville,0,0,0,0,0,0,0
Illinois,Vandalia,6550,979,1768,1361,404,234,4746
Illinois,East Alton,6215,695,1692,1661,347,197,4592
Illinois,Eagarville,169,14,47,41,10,2,114
Illinois,Gifford,861,27,260,190,83,39,599
Illinois,Gibson City,3542,273,925,723,371,109,2401
Illinois,German Valley,440,14,131,128,36,15,324
Illinois,Germantown Hills,3480,40,342,783,717,337,2219
Illinois,Germantown,1112,89,260,274,107,38,768
Illinois,Georgetown,3413,305,1067,790,170,65,2397
Illinois,Georgetown,477,2,132,73,61,94,362
Illinois,Genoa,5233,356,1291,1350,153,128,3278
Illinois,Geneva,21704,335,2612,3782,4734,3268,14731
Illinois,Geneseo,6523,223,1424,1531,877,432,4487
Illinois,Gays,288,14,104,75,18,2,213
Illinois,Garrett,108,16,50,24,2,0,92
Illinois,Gardner,1211,70,297,306,106,23,802
Illinois,Garden Prairie,198,15,122,20,2,4,163
Illinois,Galva,2543,175,665,621,262,105,1828
Illinois,Galesburg,31696,3400,7870,6870,2100,1579,21819
Illinois,Galena,3345,322,923,827,375,208,2655
Illinois,Gilberts,7338,180,908,1598,1235,713,4634
Illinois,Gillespie,3310,185,935,806,251,144,2321
Illinois,Gilman,1680,252,438,302,82,68,1142
Illinois,Gilson,132,30,47,25,12,0,114
Illinois,Venedy,125,11,45,29,1,1,87
Illinois,Venetian Village,2709,126,719,706,154,153,1858
Illinois,Venice,1963,211,592,343,72,20,1238
Illinois,Vergennes,269,26,72,61,13,0,172
Illinois,Vermilion,235,39,79,31,10,0,159
Illinois,Golconda,770,130,213,147,32,7,529
Illinois,Godley,752,54,152,177,36,3,422
Illinois,Godfrey,17868,594,3454,5345,2073,1377,12843
Illinois,Galatia,941,85,267,286,37,4,679
Illinois,Glenwood,8923,564,1591,2196,1210,518,6079
Illinois,Glen Ellyn,27890,886,2226,4126,6642,4873,18753
Illinois,Glendale Heights,34497,4314,5288,6458,4559,1673,22292
Illinois,Glencoe,8881,76,175,521,2140,2810,5722
Illinois,Glen Carbon,12882,409,1444,2463,2725,1593,8634
Illinois,Glasgow,126,21,60,23,0,2,106
Illinois,Glasford,1201,55,368,249,74,17,763
Illinois,Gladstone,221,17,77,47,15,0,156
Illinois,Girard,1805,124,609,357,92,36,1218
Illinois,Glenview,45969,1312,4715,6223,11230,8957,32437
Illinois,Earlville,1847,180,573,380,88,96,1317
Illinois,Gages Lake,10025,397,1504,2295,1596,974,6766
Illinois,Fulton,3467,306,797,897,319,283,2602
Illinois,Dixon,15196,1747,3447,3687,1238,576,10695
Illinois,Dolton,23283,1986,4243,6140,1862,792,15023
Illinois,Dongola,913,74,186,219,54,0,533
Illinois,Donnellson,140,30,61,19,4,6,120
Illinois,Donovan,281,16,85,56,13,3,173
Illinois,Dorchester,157,12,57,37,9,3,118
Illinois,Dover,146,5,40,35,10,1,91
Illinois,Dowell,328,51,98,84,9,3,245
Illinois,Downers Grove,49504,1258,5935,9185,10345,7787,34510
Illinois,Downs,972,26,234,144,159,61,624
Illinois,Du Bois,150,8,57,40,5,0,110
Illinois,Dunfermline,273,27,61,53,19,12,172
Illinois,Dunlap,1478,22,174,218,278,174,866
Illinois,Dupo,4006,215,985,1147,197,127,2671
Illinois,Du Quoin,6002,575,1657,1541,344,174,4291
Illinois,Durand,1201,66,366,271,132,24,859
Illinois,Dwight,4192,271,1095,1002,236,299,2903
Illinois,Dixmoor,3626,510,768,510,138,41,1967
Illinois,Dix,464,37,97,151,37,10,332
Illinois,Divernon,1292,55,386,315,102,29,887
Illinois,Dieterich,679,53,164,140,59,27,443
Illinois,Freeport,24973,1880,5992,6413,1723,1218,17226
Illinois,Freeman Spur,200,32,52,62,3,0,149
Illinois,Freeburg,4226,246,691,1119,635,417,3108
Illinois,Franklin Park,18410,2376,4567,3630,1760,453,12786
Illinois,Franklin Grove,1185,70,320,270,75,46,781
Illinois,Franklin,505,21,117,117,59,30,344
Illinois,Frankfort Square,9258,325,1594,2336,1128,505,5888
Illinois,Frankfort,18295,352,2131,2822,3903,2687,11895
Illinois,Fults,18,1,8,2,5,0,16
Illinois,Fox River Grove,4739,162,561,963,917,391,2994
Illinois,Fox Lake,10539,790,2542,2581,1327,451,7691
Illinois,Forsyth,3493,60,562,533,783,498,2436
Illinois,Forreston,1707,59,541,392,97,30,1119
Illinois,Forrest,1193,80,348,217,61,23,729
Illinois,Des Plaines,58930,5198,10651,11728,10439,4852,42868
Illinois,Detroit,110,5,36,17,0,0,58
Illinois,De Witt,224,11,85,42,11,1,150
Illinois,Diamond,2612,126,575,579,146,78,1504
Illinois,Fox Lake Hills,2190,83,609,707,158,77,1634
Illinois,Cary,18038,711,2150,3778,3459,1783,11881
Illinois,Buffalo,537,26,192,99,48,15,380
Illinois,Caseyville,4103,466,1175,892,223,51,2807
Illinois,Ferris,143,3,51,29,13,0,96
Illinois,Fidelity,133,25,42,13,2,0,82
Illinois,Fieldon,198,10,81,58,5,4,158
Illinois,Fillmore,262,19,112,53,6,4,194
Illinois,Findlay,718,41,232,193,46,4,516
Illinois,Fisher,1860,52,469,484,147,63,1215
Illinois,Fayetteville,408,64,118,90,18,4,294
Illinois,Casey,2546,229,700,602,193,114,1838
Illinois,Waggoner,166,21,47,24,4,0,96
Illinois,Walnut,1554,100,417,255,142,78,992
Illinois,Walnut Hill,91,12,12,25,16,0,65
Illinois,Walshville,41,10,19,1,0,0,30
Illinois,Waltonville,434,44,86,119,17,11,277
Illinois,Wamac,1351,191,384,264,27,17,883
Illinois,Wadsworth,3700,116,754,817,618,362,2667
Illinois,Farmington,2455,131,542,629,269,54,1625
Illinois,Farmersville,569,17,198,135,29,17,396
Illinois,Farmer City,1947,116,433,571,199,89,1408
Illinois,Villa Grove,2166,81,639,542,224,66,1552
Illinois,Villa Park,21800,1317,3469,4624,3346,1679,14435
Illinois,Viola,897,56,321,245,56,17,695
Illinois,Virden,3539,367,822,830,251,97,2367
Illinois,Virgil,339,11,69,90,40,13,223
Illinois,Virginia,1322,81,510,294,71,34,990
Illinois,Volo,3757,123,635,824,611,357,2550
Illinois,Fairbury,3722,243,1246,743,169,183,2584
Illinois,Fairfield,4882,508,1107,1411,292,158,3476
Illinois,Fairmont,2322,224,583,520,168,59,1554
Illinois,Fairmont City,2498,680,468,241,37,7,1433
Illinois,Fairmount,671,58,242,155,17,12,484
Illinois,Fairview,515,40,119,127,46,18,350
Illinois,Fairview Heights,17014,1017,3059,4442,2196,1784,12498
Illinois,Farina,576,62,199,116,12,20,409
Illinois,Wapella,565,24,222,115,55,8,424
Illinois,Warren,1510,135,465,334,104,65,1103
Illinois,Warrensburg,1217,62,251,293,130,41,777
Illinois,Warrenville,13373,752,1764,2563,2492,1301,8872
Illinois,Wenona,1165,121,278,250,96,45,790
Illinois,Wenonah,45,4,24,1,2,0,31
Illinois,West Brooklyn,124,14,38,26,7,0,85
Illinois,Westchester,16783,935,3126,3771,2880,1732,12444
Illinois,West Chicago,27461,4361,4228,3666,2495,1423,16173
Illinois,West City,709,110,147,219,11,14,501
Illinois,West Dundee,7391,221,999,1490,1742,735,5187
Illinois,Western Springs,13125,89,610,1141,3378,3079,8297
Illinois,Westervelt,107,0,25,41,0,0,66
Illinois,Westfield,742,51,241,164,36,10,502
Illinois,West Frankfort,7720,884,1872,2111,423,203,5493
Illinois,Westmont,25389,1221,4293,5295,4407,3212,18428
Illinois,West Peoria,4445,291,983,1392,589,277,3532
Illinois,West Point,224,13,51,44,16,4,128
Illinois,West Salem,923,85,252,230,55,19,641
Illinois,Wellington,268,21,80,67,11,7,186
Illinois,Vienna,1450,160,404,321,69,43,997
Illinois,Weldon,461,28,121,101,36,15,301
Illinois,Wayne City,1138,146,241,231,89,27,734
Illinois,Warsaw,1538,112,407,427,127,59,1132
Illinois,Washburn,1028,95,264,183,52,23,617
Illinois,Washington,15824,481,2473,3552,2860,1079,10445
Illinois,Washington Park,4072,754,896,851,98,66,2665
Illinois,Chapin,479,35,172,87,24,18,336
Illinois,Ewing,265,29,65,76,10,2,182
Illinois,Wataga,725,43,192,199,70,6,510
Illinois,Waterloo,10151,398,2276,2717,1135,604,7130
Illinois,Waterman,1539,34,311,407,125,54,931
Illinois,Watseka,5426,456,1590,1285,478,101,3910
Illinois,Watson,714,59,196,180,38,10,483
Illinois,Wauconda,13140,929,2154,2435,1948,1286,8752
Illinois,Waukegan,88570,15357,15525,12432,6312,3069,52695
Illinois,Waverly,1201,68,376,227,83,61,815
Illinois,Wayne,2318,44,276,483,519,398,1720
Illinois,Waynesville,544,31,218,104,65,7,425
Illinois,West Union,354,19,97,114,16,8,254
Illinois,Victoria,311,33,90,58,25,0,206
Illinois,Verona,240,20,51,55,7,1,134
Illinois,Cicero,84361,17830,16384,9370,2868,485,46937
Illinois,Cisco,251,9,61,64,30,7,171
Illinois,Cisne,646,75,138,205,38,14,470
Illinois,Cissna Park,834,59,259,227,71,31,647
Illinois,Claremont,244,25,55,71,18,4,173
Illinois,Clarendon Hills,8609,113,378,778,2153,1934,5356
Illinois,Christopher,2876,235,699,815,156,67,1972
Illinois,Clay City,898,110,312,124,48,5,599
Illinois,Clear Lake,240,42,102,39,7,1,191
Illinois,Cleveland,175,13,41,49,6,5,114
Illinois,Clifton,1581,54,397,325,109,55,940
Illinois,Clinton,6987,536,1729,1739,493,254,4751
Illinois,Coal City,5724,185,1582,1297,404,278,3746
Illinois,Coalton,283,26,108,51,24,2,211
Illinois,Clayton,613,100,206,135,12,6,459
Illinois,Chrisman,1346,95,376,386,80,48,985
Illinois,Chillicothe,6092,458,1342,1776,524,241,4341
Illinois,Chicago Ridge,14407,1011,3188,3421,1071,423,9114
Illinois,Evergreen Park,19934,945,3815,3853,2761,1851,13225
Illinois,Evansville,671,60,237,143,19,15,474
Illinois,Evanston,75603,2891,5580,7760,13971,18040,48242
Illinois,Chatham,12341,164,1631,2575,2396,1216,7982
Illinois,Chatsworth,1012,117,310,166,17,22,632
Illinois,Chebanse,1129,45,294,301,52,39,731
Illinois,Chemung,294,96,57,17,0,0,170
Illinois,Chenoa,1763,75,586,356,155,89,1261
Illinois,Cherry,446,36,149,89,34,13,321
Illinois,Cherry Valley,2913,130,730,761,501,150,2272
Illinois,Chester,8592,1946,2486,1665,370,114,6581
Illinois,Chesterfield,238,14,85,51,3,2,155
Illinois,Chestnut,169,0,27,38,14,16,95
Illinois,Chicago,2717534,322272,422626,430156,387078,261129,1823261
Illinois,Chicago Heights,30428,3892,6053,6387,1801,967,19100
Illinois,Coal Valley,3784,174,738,932,528,286,2658
Illinois,Coatsburg,164,16,58,38,1,6,119
Illinois,Cobden,1425,167,235,237,146,82,867
Illinois,Coffeen,405,43,123,103,11,2,282
Illinois,Countryside,5984,323,1394,1282,849,386,4234
Illinois,Cowden,547,74,208,87,17,2,388
Illinois,Coyne Center,953,139,323,200,57,25,744
Illinois,Crab Orchard,293,21,58,108,13,12,212
Illinois,Crainville,1287,60,252,310,215,85,922
Illinois,Creal Springs,446,67,181,102,10,2,362
Illinois,Crescent City,728,29,190,161,65,16,461
Illinois,Crest Hill,20479,2185,4789,4970,1846,679,14469
Illinois,Creston,740,74,171,155,41,36,477
Illinois,Crestwood,11027,745,2719,2888,1379,601,8332
Illinois,Crete,8246,216,1479,1913,1179,868,5655
Illinois,Creve Coeur,5652,435,2027,1182,182,92,3918
Illinois,Vermont,674,74,166,147,48,13,448
Illinois,Vernon,104,15,20,34,2,0,71
Illinois,Vernon Hills,25768,663,2338,3623,6407,4284,17315
Illinois,Country Club Hills,16806,920,2696,4432,1824,1304,11176
Illinois,Versailles,489,36,149,140,16,25,366
Illinois,Coulterville,969,60,318,226,34,8,646
Illinois,Cornland,50,7,29,7,0,7,50
Illinois,Colchester,1539,85,486,324,95,53,1043
Illinois,Coleta,212,25,33,38,2,19,117
Illinois,Colfax,1101,46,307,263,92,14,722
Illinois,Collinsville,25025,1339,5049,5836,3007,1633,16864
Illinois,Colona,4918,585,1144,1107,352,34,3222
Illinois,Colp,253,22,58,56,6,0,142
Illinois,Columbia,10029,464,2002,1968,1883,747,7064
Illinois,Columbus,80,17,23,12,0,1,53
Illinois,Como,405,25,111,122,43,9,310
Illinois,Compton,266,19,74,76,7,11,187
Illinois,Concord,186,12,44,48,22,1,127
Illinois,Congerville,483,20,117,104,36,5,282
Illinois,Cooksville,194,9,66,43,17,4,139
Illinois,Cordova,624,26,146,244,64,26,506
Illinois,Cornell,353,12,126,66,16,5,225
Illinois,Cortland,4323,170,486,960,500,248,2364
Illinois,Westville,3355,249,829,784,185,89,2136
Illinois,Exeter,105,11,38,20,2,4,75
Illinois,Wheaton,53585,1321,4199,7807,12550,8996,34873
Illinois,Edinburg,1097,89,355,246,70,23,783
Illinois,Edgewood,507,57,162,63,29,13,324
Illinois,Eddyville,63,14,12,17,0,0,43
Illinois,East St. Louis,26689,3101,5678,6226,824,604,16433
Illinois,East Peoria,23137,1318,5385,6263,2577,1194,16737
Illinois,Easton,347,37,104,77,15,9,242
Illinois,Edwardsville,24896,472,2437,3549,4461,3033,13952
Illinois,East Moline,21422,2486,4934,4341,1941,789,14491
Illinois,Harvey,25773,3632,7247,4259,1198,259,16595
Illinois,Harwood Heights,8649,1060,2016,1885,1059,502,6522
Illinois,Havana,3395,332,896,857,188,148,2421
Illinois,Hawthorn Woods,7634,209,849,764,1993,1427,5242
Illinois,Hazel Crest,14195,827,2819,3526,1396,851,9419
Illinois,Hebron,1237,115,308,276,64,14,777
Illinois,Harvel,182,11,58,40,5,5,119
Illinois,Effingham,12513,796,2741,2938,1414,562,8451
Illinois,Elburn,5785,70,1067,1154,1014,373,3678
Illinois,El Dara,123,1,9,95,6,2,113
Illinois,Hanna City,1361,64,364,408,126,22,984
Illinois,Hanover,711,75,241,172,58,10,556
Illinois,Hanover Park,38373,5565,6516,6182,4156,1479,23898
Illinois,Hardin,944,108,293,194,49,28,672
Illinois,Harmon,122,11,58,20,3,2,94
Illinois,Harrisburg,9247,953,2204,2255,583,337,6332
Illinois,Harrison,957,89,177,235,111,26,638
Illinois,Harristown,1330,83,461,279,110,23,956
Illinois,Hartford,1654,156,557,444,50,3,1210
Illinois,Hartsburg,243,11,71,59,19,7,167
Illinois,Harvard,9802,1413,1966,1466,303,160,5308
Illinois,Elizabeth,744,37,219,155,78,39,528
Illinois,Elgin,112105,15442,17660,19689,11684,5244,69719
Illinois,Eldred,207,18,67,78,0,4,167
Illinois,Eldorado,4103,425,890,977,266,61,2619
Illinois,Hecker,467,30,118,124,21,7,300
Illinois,Henderson,237,29,79,64,13,5,190
Illinois,Hennepin,905,52,281,262,39,28,662
Illinois,Henning,354,18,120,92,0,0,230
Illinois,Tamms,827,199,228,148,17,10,602
Illinois,Tamaroa,494,78,127,100,8,0,313
Illinois,Tallula,445,40,114,116,18,8,296
Illinois,Table Grove,365,15,93,94,27,13,242
Illinois,Symerton,107,6,25,26,5,0,62
Illinois,Sycamore,17572,562,2648,4109,2769,1540,11628
Illinois,Swansea,13869,471,2298,3388,2106,1387,9650
Illinois,Sun River Terrace,450,45,94,142,19,10,310
Illinois,Sumner,5988,1947,1297,1414,95,24,4777
Illinois,Summit,11447,2131,2501,1567,594,203,6996
Illinois,Summerfield,581,51,161,118,27,6,363
Illinois,Sullivan,4600,379,1230,1053,291,215,3168
Illinois,Charleston,21552,1099,2410,3051,1660,1804,10024
Illinois,East Dundee,3074,163,874,758,392,194,2381
Illinois,East Galesburg,801,53,217,174,70,48,562
Illinois,Tampico,684,43,222,160,18,11,454
Illinois,Hanaford,297,18,123,100,13,3,257
Illinois,Taylor Springs,556,62,214,130,24,4,434
Illinois,Tennessee,131,10,52,29,4,11,106
Illinois,Henry,2343,156,687,559,182,64,1648
Illinois,Heritage Lake,1354,0,109,288,327,103,827
Illinois,East Hazel Crest,1611,134,438,393,99,30,1094
Illinois,Herrick,440,37,172,49,8,4,270
Illinois,Herrin,12797,885,2425,3418,1324,569,8621
Illinois,Thomson,736,57,218,157,37,14,483
Illinois,Thompsonville,735,58,162,184,38,6,448
Illinois,Thomasboro,1230,61,431,332,64,40,928
Illinois,Third Lake,1246,10,113,195,260,276,854
Illinois,The Galena Territory,996,39,85,263,252,308,947
Illinois,Thebes,372,44,97,37,13,7,198
Illinois,Thayer,726,31,203,215,45,13,507
Illinois,Thawville,192,20,67,33,4,3,127
Illinois,West York,152,13,54,43,0,0,110
Illinois,Teutopolis,1793,49,375,383,261,81,1149
Illinois,Taylorville,11068,996,3359,2251,795,367,7768
Illinois,East Gillespie,256,15,92,63,18,5,193
Illinois,Hampton,1942,101,451,510,179,130,1371
Illinois,Elizabethtown,256,30,57,75,13,3,178
Illinois,El Paso,2694,118,773,523,292,71,1777
Illinois,Elmwood Park,24971,2549,5749,4990,2918,1708,17914
Illinois,Elmwood,2253,86,408,533,303,158,1488
Illinois,Elmhurst,45469,1306,4244,6856,10027,7048,29481
Illinois,Ellsworth,259,4,76,62,23,2,167
Illinois,Ellisville,106,9,32,21,4,0,66
Illinois,Elsah,739,3,33,19,58,32,145
Illinois,Ellis Grove,439,54,117,115,16,1,303
Illinois,Elkville,1047,67,239,256,35,15,612
Illinois,Elkhart,346,24,71,79,40,26,240
Illinois,Catlin,1981,61,365,501,281,69,1277
Illinois,Cave-In-Rock,365,70,78,87,12,3,250
Illinois,Cedar Point,322,16,100,80,15,4,215
Illinois,Cedarville,633,24,156,173,98,29,480
Illinois,Elliott,239,25,68,65,11,3,172
Illinois,Elvaston,119,16,27,36,1,2,82
Illinois,Elwood,2130,71,619,520,159,107,1476
Illinois,Emden,348,21,122,65,31,9,248
Illinois,Wheeler,118,21,30,33,3,0,87
Illinois,Wheeling,37982,3886,6571,6946,6140,3170,26713
Illinois,Whiteash,341,40,85,82,23,8,238
Illinois,White City,189,15,76,41,23,0,155
Illinois,Channel Lake,1505,133,447,348,166,51,1145
Illinois,Channahon,12845,358,2532,3212,1212,654,7968
Illinois,Chandlerville,621,33,209,122,46,3,413
Illinois,Champaign,84008,2274,7947,11897,11746,11664,45528
Illinois,Eureka,5704,219,1210,1090,830,467,3816
Illinois,Essex,858,51,220,166,51,27,515
Illinois,Erie,1507,36,361,394,123,98,1012
Illinois,Equality,551,41,139,148,32,20,380
Illinois,Enfield,628,55,191,107,24,19,396
Illinois,Energy,1215,80,294,409,97,28,908
Illinois,Emington,87,5,22,27,2,0,56
Illinois,Central City,1047,116,227,292,37,7,679
Illinois,Hampshire,5851,478,969,1189,463,601,3700
Illinois,Centralia,12798,1076,2929,3368,921,482,8776
Illinois,Cerro Gordo,1348,59,330,342,88,45,864
Illinois,Green Oaks,3850,103,328,427,814,786,2458
Illinois,Greenup,1769,237,436,381,110,40,1204
Illinois,Green Valley,733,29,187,206,70,9,501
Illinois,Greenview,860,38,297,177,37,20,569
Illinois,Greenville,6842,706,1386,1172,580,423,4267
Illinois,Greenwood,400,33,78,99,36,24,270
Illinois,Gridley,1356,55,360,309,163,47,934
Illinois,Griggsville,1161,83,331,232,72,18,736
Illinois,Gulf Port,19,4,7,5,0,0,16
Illinois,Gurnee,31136,1148,3869,5570,6329,3500,20416
Illinois,Hainesville,3690,182,345,600,666,489,2282
Illinois,Hamburg,77,2,32,18,4,0,56
Illinois,Hamel,886,2,163,205,159,64,593
Illinois,Hamilton,2918,174,905,708,255,61,2103
Illinois,Hammond,446,30,173,105,7,5,320
Illinois,Greenfield,1412,133,420,245,63,25,886
Illinois,Centreville,5142,579,1263,987,217,130,3176
Illinois,Grayville,1630,153,454,501,63,23,1194
Illinois,Granville,1380,120,402,282,83,34,921
Illinois,Chadwick,481,33,149,127,49,11,369
Illinois,Good Hope,387,10,123,103,42,23,301
Illinois,Goofy Ridge,167,31,77,23,0,0,131
Illinois,Goreville,1206,82,189,322,85,49,727
Illinois,Gorham,173,25,78,13,6,4,126
Illinois,Grafton,616,60,144,129,77,73,483
Illinois,Grayslake,21117,988,2021,3520,4093,2684,13306
Illinois,Grand Detour,548,0,118,186,112,21,437
Illinois,Grand Tower,451,76,143,122,20,2,363
Illinois,Grandview,1406,135,396,324,72,13,940
Illinois,Grandwood Park,5757,166,739,912,1127,569,3513
Illinois,Granite City,29421,2393,8599,6497,2039,956,20484
Illinois,Grantfork,337,8,79,87,41,17,232
Illinois,Elk Grove Village,33333,1371,5796,8191,6194,2576,24128
Illinois,Grant Park,1270,62,364,323,87,49,885
Illinois,Grand Ridge,538,18,131,133,49,17,348
Indiana,Westphalia,79,8,38,0,25,0,71
Indiana,Austin,4235,772,1157,679,153,23,2784
Indiana,Leo-Cedarville,3785,108,563,849,538,134,2192
Indiana,Avoca,710,0,112,162,88,22,384
Indiana,Wynnedale,162,3,11,31,38,57,140
Indiana,Yeoman,137,13,31,25,12,6,87
Indiana,Yorktown,11268,357,2397,2301,1543,878,7476
Indiana,Zanesville,639,47,193,100,49,14,403
Indiana,Zionsville,25072,325,1895,2795,5681,5302,15998
Indiana,Marion,29075,3371,7452,4895,1646,1025,18389
Indiana,Marengo,852,145,258,128,14,6,551
Indiana,Manilla,240,29,105,58,3,27,222
Indiana,Madison,12054,1143,2990,2752,1096,762,8743
Indiana,Macy,269,26,66,36,5,9,142
Indiana,Worthington,1214,174,392,252,38,35,891
Indiana,Mackey,92,10,29,14,7,1,61
Indiana,Lyons,784,132,256,151,25,15,579
Indiana,Lynnville,936,46,248,165,53,70,582
Indiana,Lynn,1113,103,367,244,36,33,783
Indiana,Crawfordsville,15982,1690,4489,2536,888,484,10087
Indiana,Cromwell,478,79,141,62,16,3,301
Indiana,Crothersville,1574,141,594,324,28,24,1111
Indiana,Crown Point,28444,1525,6846,5528,4998,1761,20658
Indiana,Crows Nest,113,0,1,8,40,26,75
Indiana,Culver,1444,64,315,304,147,172,1002
Indiana,Cumberland,5316,474,1248,1185,453,323,3683
Indiana,McCordsville,5224,27,535,1167,1182,510,3421
Indiana,Cynthiana,561,68,162,122,47,8,407
Indiana,Woodlawn Heights,63,0,6,17,20,12,55
Indiana,Wolcottville,1009,161,273,158,28,3,623
Indiana,West Point,566,0,135,121,14,86,356
Indiana,Westport,1403,139,419,284,40,23,905
Indiana,West Terre Haute,2505,362,598,448,61,37,1506
Indiana,Westville,7065,1416,1979,1721,244,84,5444
Indiana,Wheatfield,990,39,276,198,43,29,585
Indiana,Wheatland,455,34,120,104,27,5,290
Indiana,Wheeler,347,38,139,70,22,0,269
Indiana,Whiteland,4732,173,959,886,767,182,2967
Indiana,Whitestown,4864,133,482,849,1077,475,3016
Indiana,Whitewater,80,7,26,17,2,0,52
Indiana,Woodburn,1549,102,376,350,102,54,984
Indiana,Whiting,4905,408,1496,948,363,136,3351
Indiana,Williams,322,15,125,45,45,30,260
Indiana,Williams Creek,396,2,5,27,117,103,254
Indiana,Williamsport,1842,246,537,391,120,63,1357
Indiana,Winamac,2623,261,771,496,217,92,1837
Indiana,Winchester,4822,607,1393,975,162,131,3268
Indiana,Windfall City,856,117,228,125,51,7,528
Indiana,Winfield,5054,203,966,1183,672,265,3289
Indiana,Wingate,257,19,102,29,18,2,170
Indiana,Winona Lake,4935,245,558,767,731,543,2844
Indiana,Wolcott,1055,58,315,199,68,20,660
Indiana,Wilkinson,474,30,130,111,15,13,299
Indiana,Avilla,2193,146,646,476,135,68,1471
Indiana,Dale,1789,329,493,325,114,15,1276
Indiana,Dana,546,61,186,148,15,6,416
Indiana,Leesburg,589,38,151,152,59,9,409
Indiana,Lebanon,15762,1420,3973,3032,1817,383,10625
Indiana,Leavenworth,283,49,88,49,23,20,229
Indiana,Lawrenceburg,4996,678,1550,945,193,103,3469
Indiana,Dublin,752,89,285,128,60,14,576
Indiana,Dubois,409,50,125,74,21,0,270
Indiana,Dugger,799,53,305,149,41,17,565
Indiana,Dune Acres,188,4,12,27,44,76,163
Indiana,Dunkirk,2446,385,672,371,78,44,1550
Indiana,Dunlap,6220,577,1610,1115,448,424,4174
Indiana,Lewisville,382,36,105,97,16,11,265
Indiana,Dunreith,208,12,62,28,2,5,109
Indiana,Dyer,16257,830,3781,3696,2296,1142,11745
Indiana,Earl Park,407,27,166,62,16,5,276
Indiana,East Chicago,29178,5134,5970,4523,904,447,16978
Indiana,Bedford,13371,1350,3753,3183,700,392,9378
Indiana,Battle Ground,1085,36,177,207,192,133,745
Indiana,Batesville,6398,257,1310,1322,1097,400,4386
Indiana,Bass Lake,1330,114,354,350,81,52,951
Indiana,Bargersville,6492,356,1486,1060,857,363,4122
Indiana,Bainbridge,841,93,241,161,18,9,522
Indiana,Avon,15145,517,1821,3157,2308,1101,8904
Indiana,Dupont,276,17,89,63,4,6,179
Indiana,Daleville,1588,103,361,421,152,36,1073
Indiana,Liberty,2074,198,549,441,115,63,1366
Indiana,Linden,783,79,221,155,28,12,495
Indiana,Danville,9379,460,1737,2168,1187,467,6019
Indiana,Darlington,750,59,231,128,57,21,496
Indiana,Darmstadt,1471,15,344,363,243,173,1138
Indiana,Dayton,1500,85,307,314,163,57,926
Indiana,Decatur,9084,658,3128,1665,587,223,6261
Indiana,Decker,257,41,92,49,3,0,185
Indiana,Delphi,2874,416,746,564,108,127,1961
Indiana,De Motte,3944,297,1180,861,140,91,2569
Indiana,Denver,506,35,176,81,53,12,357
Indiana,Deputy,17,0,17,0,0,0,17
Indiana,Ligonier,4361,1181,787,512,65,19,2564
Indiana,Dillsboro,1634,165,485,295,51,37,1033
Indiana,Dresser,24,0,0,18,0,0,18
Indiana,Lowell,9400,555,2035,2210,696,438,5934
Indiana,Losantville,223,55,70,41,4,2,172
Indiana,Loogootee,2701,319,787,571,109,129,1915
Indiana,Long Beach,1127,17,122,237,303,278,957
Indiana,Logansport,17716,3172,4275,2572,998,413,11430
Indiana,Lizton,519,32,127,81,65,5,310
Indiana,Livonia,132,12,43,21,6,2,84
Indiana,Little York,159,22,48,28,1,0,99
Indiana,Linton,5340,701,1443,1207,266,143,3760
Indiana,Dover Hill,141,24,50,17,0,0,91
Indiana,Winslow,1087,117,303,181,19,16,636
Indiana,Norway,492,64,200,87,0,10,361
Indiana,Reynolds,562,52,190,85,54,16,397
Indiana,Laconia,77,9,9,47,0,0,65
Indiana,La Crosse,582,35,192,132,11,18,388
Indiana,Ladoga,1057,56,259,228,76,22,641
Indiana,Lafayette,70661,6507,13439,14353,7205,3812,45316
Indiana,La Fontaine,727,87,279,131,35,17,549
Indiana,Lagrange,2723,380,1001,426,75,38,1920
Indiana,Lagro,548,67,167,74,10,7,325
Indiana,Lake Dalecarlia,1373,13,414,424,48,30,929
Indiana,Lake Holiday,879,16,279,262,52,62,671
Indiana,Lake Santee,858,40,238,196,98,47,619
Indiana,Lakes of the Four Seasons,6692,246,1336,1779,1116,294,4771
Indiana,Lake Station,12268,1721,3684,1982,444,173,8004
Indiana,Laketon,444,65,155,43,24,8,295
Indiana,Lake Village,667,62,350,142,0,32,586
Indiana,Lakeville,831,75,226,203,43,16,563
Indiana,Landess,299,8,15,163,14,19,219
Indiana,Lanesville,604,9,177,141,82,21,430
Indiana,La Paz,639,77,165,116,25,0,383
Indiana,Lapel,1833,59,653,347,227,110,1396
Indiana,La Porte,22242,2306,6315,4203,1370,604,14798
Indiana,Larwill,333,27,88,60,10,2,187
Indiana,Laurel,547,130,102,61,7,1,301
Indiana,Lawrence,47120,4168,7158,8953,6688,3067,30034
Indiana,Chrisney,446,38,86,138,30,11,303
Indiana,Chesterton,14124,652,3016,2580,1619,1275,9142
Indiana,Chesterfield,2590,187,763,598,113,81,1742
Indiana,Newtown,294,14,108,48,15,5,190
Indiana,Kouts,1899,108,513,405,182,56,1264
Indiana,Koontz Lake,1431,198,365,317,142,34,1056
Indiana,Kokomo,58054,5453,14983,13136,4084,2195,39851
Indiana,Churubusco,1953,114,468,465,140,45,1232
Indiana,West Lebanon,818,73,301,130,42,17,563
Indiana,Covington,2553,122,722,638,214,100,1796
Indiana,Country Squire Lakes,3155,680,1041,311,80,19,2131
Indiana,Country Club Heights,114,2,11,18,22,26,79
Indiana,Corydon,3121,343,935,595,233,173,2279
Indiana,Corunna,245,20,89,29,10,1,149
Indiana,Cordry Sweetwater Lakes,1024,106,278,265,111,139,899
Indiana,Converse,1455,145,384,237,77,63,906
Indiana,Connersville,13241,1989,4131,2454,510,214,9298
Indiana,Columbus,45868,2526,8883,8076,6711,4683,30879
Indiana,Columbia City,9070,981,2185,1810,679,479,6134
Indiana,Collegeville,614,0,7,20,0,0,27
Indiana,Colfax,820,87,213,202,34,15,551
Indiana,New Trenton,354,45,93,14,73,17,242
Indiana,Colburn,349,0,66,121,0,0,187
Indiana,Coalmont,336,10,151,17,8,0,186
Indiana,Cloverdale,1794,200,528,341,84,60,1213
Indiana,Clinton,4812,536,1346,918,391,125,3316
Indiana,Clifford,218,28,78,33,9,0,148
Indiana,Clermont,1352,58,380,298,205,81,1022
Indiana,Clear Lake,500,7,85,115,132,89,428
Indiana,Clayton,957,54,296,208,68,21,647
Indiana,Claypool,361,57,112,54,7,1,231
Indiana,Clay City,789,56,221,176,68,18,539
Indiana,Clarksville,21627,2335,5245,4472,2264,646,14962
Indiana,Clarks Hill,583,52,192,130,14,2,390
Indiana,Clarksburg,323,46,125,30,0,0,201
Indiana,Cicero,4894,235,1129,940,614,291,3209
Indiana,Coatesville,618,80,184,88,47,4,403
Indiana,New Washington,538,0,133,143,75,19,370
Indiana,New Whiteland,5725,192,1534,1320,551,97,3694
Indiana,Noblesville,58013,2048,7566,11004,11182,4958,36758
Indiana,Parkers Settlement,799,50,187,256,88,18,599
Indiana,Patoka,1061,83,285,209,79,25,681
Indiana,Patriot,339,49,102,35,5,0,191
Indiana,Pendleton,4224,238,1043,1030,551,298,3160
Indiana,Pennville,769,88,237,152,18,5,500
Indiana,Perrysville,502,23,179,123,21,11,357
Indiana,Peru,11197,1305,3009,2357,548,198,7417
Indiana,Petersburg,2592,314,725,481,111,84,1715
Indiana,Pierceton,1074,107,293,158,60,32,650
Indiana,Pine Village,193,15,75,39,15,2,146
Indiana,Pittsboro,3116,145,569,635,457,132,1938
Indiana,Plainfield,29710,1738,6622,6252,3927,1775,20314
Indiana,Plainville,637,85,164,133,10,18,410
Indiana,Parker City,1411,145,450,221,92,61,969
Indiana,Plymouth,10031,1272,2510,1315,653,343,6093
Indiana,Poneto,138,11,56,32,6,1,106
Indiana,Portage,37197,2963,10318,8079,2562,1165,25087
Indiana,Porter,4887,300,1099,816,507,461,3183
Indiana,Portland,6201,748,1910,1100,202,110,4070
Indiana,Poseyville,1311,98,265,267,126,58,814
Indiana,Pottawattamie Park,266,10,27,56,51,48,192
Indiana,Princes Lakes,1433,98,427,339,127,77,1068
Indiana,Princeton,8618,749,2224,2100,389,193,5655
Indiana,Raglesville,53,53,0,0,0,0,53
Indiana,Ragsdale,157,10,75,15,11,8,119
Indiana,Redkey,1456,76,440,268,36,16,836
Indiana,Remington,1165,140,321,257,83,39,840
Indiana,Rensselaer,5495,653,1456,1148,356,276,3889
Indiana,Point Isabel,136,0,89,18,6,0,113
Indiana,Richland,453,26,117,119,13,9,284
Indiana,Paragon,791,115,249,157,8,2,531
Indiana,Palmyra,1290,63,409,321,36,30,859
Indiana,North Crows Nest,54,1,0,3,18,11,33
Indiana,North Judson,1867,174,449,439,90,38,1190
Indiana,North Liberty,1883,128,416,348,156,37,1085
Indiana,North Manchester,6303,368,1436,748,603,537,3692
Indiana,North Salem,528,58,195,81,18,12,364
Indiana,North Terre Haute,4505,336,1178,947,331,91,2883
Indiana,North Vernon,6895,808,2407,968,195,265,4643
Indiana,North Webster,1196,125,337,274,80,48,864
Indiana,Notre Dame,6446,8,53,29,200,256,546
Indiana,Oakland City,2601,387,722,491,120,112,1832
Indiana,Oaktown,708,52,253,129,33,6,473
Indiana,Odon,1477,123,490,299,60,32,1004
Indiana,Ogden Dunes,1203,7,141,228,311,320,1007
Indiana,Paoli,3852,470,1264,561,100,85,2480
Indiana,Oldenburg,670,34,172,89,111,70,476
Indiana,Oolitic,1091,141,390,261,19,8,819
Indiana,Orestes,436,47,133,92,30,9,311
Indiana,Orland,391,38,139,83,17,6,283
Indiana,Orleans,2212,351,738,333,76,18,1516
Indiana,Osceola,2711,262,693,580,249,80,1864
Indiana,Osgood,1806,260,552,255,70,14,1151
Indiana,Ossian,3658,183,897,857,343,59,2339
Indiana,Otterbein,1404,125,332,296,82,26,861
Indiana,Otwell,428,97,175,46,0,6,324
Indiana,Owensburg,797,60,257,147,42,20,526
Indiana,Owensville,1233,92,416,262,40,43,853
Indiana,Oxford,1171,127,325,211,115,21,799
Indiana,Painted Hills,849,16,279,151,140,21,607
Indiana,Onward,133,7,50,32,5,0,94
Indiana,West Lafayette,43999,864,1396,1939,3978,5893,14070
Indiana,Jamestown,1038,68,321,230,116,53,788
Indiana,Westfield,33744,727,2971,5250,8531,3278,20757
Indiana,Center Point,229,28,32,74,13,5,152
Indiana,Cedar Lake,11757,889,3088,2337,881,235,7430
Indiana,Cedar Grove,246,22,64,72,27,0,185
Indiana,Cayuga,1000,100,402,150,54,14,720
Indiana,Carthage,794,82,253,143,23,22,523
Indiana,Merrillville,35322,2082,7914,8635,3539,1555,23725
Indiana,Metamora,84,47,29,8,0,0,84
Indiana,Mexico,790,78,306,235,22,7,648
Indiana,Michiana Shores,277,13,37,59,77,55,241
Indiana,Michigan City,31412,3371,8288,6251,2253,1284,21447
Indiana,Michigantown,434,28,133,79,21,18,279
Indiana,Middlebury,3494,310,580,775,382,189,2236
Indiana,Middletown,2272,187,674,479,132,34,1506
Indiana,Mier,136,0,9,68,0,29,106
Indiana,Milan,2088,261,670,430,71,39,1471
Indiana,Milford,1683,225,559,196,77,20,1077
Indiana,Millersburg,1016,151,288,159,28,8,634
Indiana,Millhousen,155,4,41,50,11,1,107
Indiana,Milltown,912,136,312,130,36,18,632
Indiana,Milroy,709,180,229,52,13,0,474
Indiana,Milton,492,58,141,98,23,4,324
Indiana,Mishawaka,48121,4338,9950,9485,4776,2706,31255
Indiana,Mitchell,4291,624,1625,644,207,106,3206
Indiana,Centerville,2609,153,684,538,174,119,1668
Indiana,Chalmers,450,16,131,108,28,6,289
Indiana,Chandler,3355,270,931,709,101,91,2102
Indiana,Charlestown,7906,821,1922,1589,477,232,5041
Indiana,Ferdinand,2092,222,619,383,217,122,1563
Indiana,Farmland,1392,80,464,264,91,35,934
Indiana,Farmersburg,1257,58,340,331,55,33,817
Indiana,Fairview Park,1191,82,361,320,81,43,887
Indiana,Fairmount,3002,259,823,518,169,116,1885
Indiana,Fairland,663,60,219,134,31,21,465
Indiana,Evansville,120212,10200,30043,25257,10567,5223,81290
Indiana,Etna Green,751,100,214,150,51,12,527
Indiana,English,860,163,203,110,14,6,496
Indiana,Emison,157,17,47,27,12,11,114
Indiana,Elwood,8484,1046,2565,1553,540,143,5847
Indiana,Modoc,206,27,73,29,4,0,133
Indiana,Elnora,585,74,153,146,14,17,404
Indiana,Elkhart,52354,7236,12406,8355,2959,1345,32301
Indiana,Elizabethtown,487,74,136,39,6,5,260
Indiana,Elizabeth,214,12,78,35,16,7,148
Indiana,Elberfeld,699,48,167,202,54,16,487
Indiana,Edwardsport,338,52,109,53,13,2,229
Indiana,Edinburgh,4346,551,1758,616,98,56,3079
Indiana,Edgewood,1872,66,325,482,366,130,1369
Indiana,Economy,163,25,51,32,4,8,120
Indiana,Eaton,1671,124,465,396,94,68,1147
Indiana,East Germantown,262,36,85,72,9,13,215
Indiana,East Enterprise,413,13,170,29,0,0,212
Indiana,Ellettsville,6434,580,1382,1225,728,398,4313
Indiana,Monon,1910,282,490,295,32,9,1108
Indiana,Monroe,646,40,164,128,45,38,415
Indiana,Monroe City,598,21,150,164,25,12,372
Indiana,Newberry,161,19,63,32,5,1,120
Indiana,Newburgh,3306,120,622,837,498,263,2340
Indiana,New Carlisle,2028,109,416,447,248,84,1304
Indiana,New Castle,17755,2154,5060,3588,1184,533,12519
Indiana,New Chicago,2081,303,522,420,83,8,1336
Indiana,New Goshen,476,21,153,124,50,0,348
Indiana,New Harmony,715,86,224,134,73,81,598
Indiana,New Haven,15832,1274,3821,3549,1215,608,10467
Indiana,New Market,546,24,180,96,27,11,338
Indiana,New Middletown,27,2,8,5,3,1,19
Indiana,Southport,2288,161,542,427,240,82,1452
Indiana,New Amsterdam,15,1,5,5,1,0,12
Indiana,South Haven,5145,461,1407,1269,272,101,3510
Indiana,Somerville,213,18,57,32,22,2,131
Indiana,Somerset,502,4,235,33,75,24,371
Indiana,Smithville-Sanders,3440,164,664,780,567,381,2556
Indiana,Sims,180,0,83,38,0,9,130
Indiana,Simonton Lake,4446,396,1192,997,456,219,3260
Indiana,Silver Lake,1002,100,298,219,19,10,646
Indiana,Sidney,81,21,20,16,0,0,57
Indiana,West Harrison,417,70,112,73,8,0,263
Indiana,Shoals,789,139,304,86,28,35,592
Indiana,Shirley,874,92,255,164,39,9,559
Indiana,Shipshewana,688,120,117,96,67,33,433
Indiana,South Bend,100590,10484,19837,18237,8959,6172,63689
Indiana,Fillmore,659,81,163,147,19,13,423
Indiana,New Albany,36582,3842,8839,7935,2916,1446,24978
Indiana,Nappanee,6650,729,1646,1114,393,217,4099
Indiana,Monroeville,1188,94,392,262,46,38,832
Indiana,Monrovia,1725,106,387,333,84,36,946
Indiana,Monterey,310,22,87,68,14,0,191
Indiana,Montezuma,1021,124,265,210,11,12,622
Indiana,Montgomery,335,38,109,62,25,3,237
Indiana,Monticello,5332,522,1393,1230,358,207,3710
Indiana,Montmorenci,184,30,51,44,22,19,166
Indiana,Montpelier,1704,208,614,236,76,18,1152
Indiana,Mooreland,294,24,86,71,7,6,194
Indiana,Moores Hill,696,101,185,111,14,0,411
Indiana,Mooresville,9508,671,2836,2430,667,185,6789
Indiana,Nashville,1255,136,234,284,104,199,957
Indiana,Morgantown,889,86,259,189,14,12,560
Indiana,Morristown,1264,142,512,208,53,12,927
Indiana,Mount Auburn,120,8,31,34,5,2,80
Indiana,Mount Ayr,116,27,54,8,4,0,93
Indiana,Mount Carmel,58,13,16,4,1,0,34
Indiana,Mount Etna,97,7,34,17,17,2,77
Indiana,Mount Summit,537,50,146,111,45,18,370
Indiana,Mount Vernon,6610,452,1988,1292,484,194,4410
Indiana,Mulberry,1362,170,361,231,138,37,937
Indiana,Muncie,70173,5180,13169,11134,4616,3991,38090
Indiana,Munster,23250,1027,4221,4220,4150,2639,16257
Indiana,Napoleon,189,24,62,42,6,5,139
Indiana,Morocco,1111,150,300,243,56,40,789
Indiana,Fishers,83177,1350,5500,12654,21286,11019,51809
Indiana,Fish Lake,915,121,288,149,71,45,674
Indiana,Flora,2148,187,658,414,157,50,1466
Indiana,Union City,3486,495,723,726,90,76,2110
Indiana,Ulen,125,0,11,21,36,37,105
Indiana,Troy,287,36,135,50,5,10,236
Indiana,Tri-Lakes,1241,28,471,249,162,71,981
Indiana,Trail Creek,2006,74,423,584,172,93,1346
Indiana,Trafalgar,1161,56,328,249,77,17,727
Indiana,Town of Pines,734,77,227,164,30,35,533
Indiana,Topeka,1060,206,188,103,46,3,546
Indiana,Toad Hop,52,0,52,0,0,0,52
Indiana,Tipton,5252,540,1315,1064,396,125,3440
Indiana,Thorntown,1648,156,490,352,72,19,1089
Indiana,Uniondale,303,40,72,54,6,7,179
Indiana,Terre Haute,61061,5846,12377,11686,4455,3221,37585
Indiana,Tell City,7234,593,2327,1242,325,371,4858
Indiana,Tecumseh,734,6,183,181,62,23,455
Indiana,Taylorsville,1080,44,265,218,53,0,580
Indiana,Syracuse,2864,356,690,534,167,72,1819
Indiana,Switz City,288,30,89,59,7,8,193
Indiana,Sweetser,1242,44,433,170,140,61,848
Indiana,Swayzee,1025,48,321,219,69,34,691
Indiana,Sunman,919,100,292,146,46,32,616
Indiana,Summitville,1026,97,365,201,49,8,720
Indiana,Sulphur Springs,390,11,144,79,19,5,258
Indiana,Sullivan,4184,423,1241,943,295,81,2983
Indiana,Tennyson,335,59,79,59,11,3,211
Indiana,Straughn,253,21,85,30,7,7,150
Indiana,Universal,295,38,95,46,10,4,193
Indiana,Utica,711,54,146,168,47,53,468
Indiana,Waynetown,1237,99,300,237,76,11,723
Indiana,Waveland,351,40,115,48,27,7,237
Indiana,Waterloo,2210,171,492,370,106,37,1176
Indiana,Washington,11874,1410,3086,1790,659,516,7461
Indiana,Warsaw,14385,1342,3139,2618,1408,666,9173
Indiana,Warren Park,1697,283,388,324,78,141,1214
Indiana,Warren,1511,88,492,278,68,34,960
Indiana,Wanatah,1158,69,353,228,88,13,751
Indiana,Walton,1102,122,329,218,55,43,767
Indiana,Wallace,122,12,26,23,11,0,72
Indiana,Walkerton,1874,184,543,411,120,52,1310
Indiana,Upland,3883,71,455,312,318,384,1540
Indiana,Waldron,603,87,169,141,34,5,436
Indiana,Wabash,10469,1004,3021,2396,542,328,7291
Indiana,Vincennes,18135,1601,3860,3901,987,612,10961
Indiana,Vevay,1471,198,488,270,59,43,1058
Indiana,Versailles,2126,161,680,413,158,81,1493
Indiana,Vernon,382,24,60,106,29,7,226
Indiana,Vera Cruz,116,10,33,16,13,0,72
Indiana,Veedersburg,2237,233,742,366,85,45,1471
Indiana,Van Buren,867,74,327,186,27,23,637
Indiana,Van Bibber Lake,276,30,154,72,0,0,256
Indiana,Valparaiso,32123,1332,5325,6206,4989,2674,20526
Indiana,Vallonia,274,94,110,7,0,16,227
Indiana,Wakarusa,2024,175,544,306,237,73,1335
Indiana,Sheridan,2841,228,733,613,186,74,1834
Indiana,Stockwell,594,9,202,79,73,27,390
Indiana,Stilesville,206,17,73,50,8,11,159
Indiana,Gas City,6046,665,1974,1149,230,79,4097
Indiana,Gary,78483,8143,17972,17734,4126,2449,50424
Indiana,Garrett,6552,639,1803,1354,293,140,4229
Indiana,Galveston,1068,43,320,240,69,48,720
Indiana,Galena,1803,104,294,342,218,97,1055
Indiana,Fulton,516,19,148,55,6,42,270
Indiana,French Lick,1989,355,566,322,45,21,1309
Indiana,Fremont,2255,175,669,450,133,27,1454
Indiana,Freetown,265,26,170,23,0,0,219
Indiana,Freelandville,617,33,167,171,0,71,442
Indiana,Fredericksburg,110,32,8,15,0,4,59
Indiana,Gaston,945,62,280,184,66,28,620
Indiana,Frankton,1878,104,672,253,121,62,1212
Indiana,Frankfort,16467,1918,4675,2360,844,362,10159
Indiana,Francisco,703,41,241,115,16,0,413
Indiana,Francesville,867,93,295,183,55,15,641
Indiana,Fowlerton,276,16,90,33,14,3,156
Indiana,Fowler,2269,142,831,351,120,115,1559
Indiana,Fountain City,732,67,172,193,33,19,484
Indiana,Fort Wayne,257059,19159,47432,54293,28196,14589,163669
Indiana,Fortville,4095,228,1227,685,443,243,2826
Indiana,Fort Branch,2971,123,788,739,257,138,2045
Indiana,Fontanet,334,6,99,89,28,12,234
Indiana,Florence,78,50,28,0,0,0,78
Indiana,Franklin,24090,1766,5534,4807,2480,1339,15926
Indiana,Stinesville,183,42,51,32,18,7,150
Indiana,Geneva,1407,186,503,255,84,17,1045
Indiana,Georgetown,3084,122,584,619,422,169,1916
Indiana,Staunton,562,39,176,107,17,9,348
Indiana,State Line City,165,17,43,38,9,0,107
Indiana,Star City,194,0,71,35,17,0,123
Indiana,Spurgeon,171,12,85,39,6,2,144
Indiana,Springport,173,11,48,53,2,9,123
Indiana,Spring Lake,304,7,110,69,27,16,229
Indiana,Spring Hill,87,3,5,17,20,40,85
Indiana,Spring Grove,384,60,105,71,31,36,303
Indiana,Spiceland,917,32,326,149,39,32,578
Indiana,Spencer,2374,295,634,485,104,45,1563
Indiana,Speedway,12100,1068,2224,2714,1337,798,8141
Indiana,Gentryville,344,38,109,55,26,0,228
Indiana,South Whitley,1903,113,634,427,72,28,1274
Indiana,Greensboro,139,9,43,26,5,2,85
Indiana,Greenfield,21179,1332,5286,4637,1827,1126,14208
Indiana,Greendale,4554,135,1102,994,597,279,3107
Indiana,Greencastle,10314,671,2006,1478,613,453,5221
Indiana,Granger,30690,687,4140,5073,6256,4450,20606
Indiana,Grandview,700,65,231,106,17,11,430
Indiana,Grabill,1454,48,354,353,130,30,915
Indiana,Gosport,740,113,195,151,35,39,533
Indiana,Goshen,32946,4990,6735,4659,2700,1692,20776
Indiana,Goodland,1003,101,359,161,95,12,728
Indiana,Glenwood,309,27,112,58,1,0,198
Indiana,Greensburg,12054,1017,3155,2401,943,519,8035
Indiana,Shepardsville,380,20,104,51,35,6,216
Indiana,Shorewood Forest,2494,57,365,404,547,383,1756
Indiana,Shelby,612,68,206,48,12,14,348
Indiana,Andrews,1090,134,351,229,15,24,753
Indiana,Angola,8615,674,1720,1486,532,417,4829
Indiana,Arcadia,1248,99,390,220,84,29,822
Indiana,Argos,1944,235,543,340,80,20,1218
Indiana,Arlington,518,72,146,71,51,0,340
Indiana,Ashley,1080,112,313,217,38,4,684
Indiana,Atlanta,702,55,227,151,19,4,456
Indiana,Attica,3352,407,1033,596,154,104,2294
Indiana,Auburn,12979,982,2912,3057,1317,712,8980
Indiana,Aurora,3744,343,1034,888,179,91,2535
Indiana,New Palestine,2169,63,538,394,302,122,1419
Indiana,New Paris,1160,72,293,286,89,10,750
Indiana,New Pekin,1497,255,334,268,33,37,927
Indiana,New Point,315,36,112,68,4,1,221
Indiana,Newport,500,48,175,116,21,24,384
Indiana,New Richmond,351,27,83,67,22,11,210
Indiana,New Ross,342,34,73,66,12,12,197
Indiana,New Salisbury,495,0,145,134,41,30,350
Indiana,Carlisle,594,39,156,122,36,25,378
Indiana,Carbon,463,47,163,27,10,3,250
Indiana,Cannelton,1520,178,436,260,64,19,957
Indiana,Cannelburg,193,30,59,23,7,2,121
Indiana,Canaan,52,0,28,17,7,0,52
Indiana,Campbellsburg,609,53,193,80,1,15,342
Indiana,Camden,684,43,233,108,25,17,426
Indiana,Anderson,55630,5814,14268,11461,3514,1711,36768
Indiana,Cambridge City,1773,225,506,350,88,50,1219
Indiana,Amo,508,44,130,110,36,3,323
Indiana,Amboy,323,38,105,69,12,9,233
Indiana,Rolling Prairie,712,0,125,112,97,62,396
Indiana,Rocky Ripple,693,26,70,170,157,78,501
Indiana,Rockville,2577,195,822,554,150,110,1831
Indiana,Rockport,2467,313,743,450,97,34,1637
Indiana,Rochester,6123,637,2000,1283,403,238,4561
Indiana,Roanoke,1784,41,345,424,260,99,1169
Indiana,Roann,492,52,112,103,14,21,302
Indiana,Roachdale,949,105,286,196,38,14,639
Indiana,River Forest,24,0,2,9,4,7,22
Indiana,Rising Sun,2456,271,953,385,137,49,1795
Indiana,Riley,171,11,56,43,12,2,124
Indiana,Ridgeville,590,77,207,96,19,2,401
Indiana,Richmond,36291,4685,8588,6619,2350,1846,24088
Indiana,Carmel,85367,1158,5648,10454,22001,17158,56419
Indiana,Aberdeen,1756,8,169,414,407,208,1206
Indiana,Advance,464,51,145,93,34,0,323
Indiana,Akron,1488,266,341,206,24,28,865
Indiana,Alamo,53,3,17,11,1,1,33
Indiana,Albany,2076,119,613,472,175,90,1469
Indiana,Albion,2468,287,712,457,131,26,1613
Indiana,Alexandria,5074,621,1353,944,304,132,3354
Indiana,Alfordsville,86,9,34,28,0,0,71
Indiana,Alton,52,13,14,8,3,0,38
Indiana,Altona,228,20,100,39,6,2,167
Indiana,Ambia,205,42,56,33,5,0,136
Indiana,Americus,409,25,112,60,51,26,274
Indiana,Cadiz,178,24,29,26,9,4,92
Indiana,Butlerville,136,69,34,0,17,0,120
Indiana,Butler,2870,297,903,344,118,45,1707
Indiana,Bloomfield,2507,254,610,517,164,131,1676
Indiana,Blanford,264,42,140,13,0,0,195
Indiana,Birdseye,420,53,151,60,12,4,280
Indiana,Bicknell,3080,408,863,660,68,59,2058
Indiana,Beverly Shores,547,13,44,75,174,182,488
Indiana,Bethany,94,9,30,22,6,0,67
Indiana,Berne,3863,220,1140,574,340,283,2557
Indiana,Beech Grove,14000,1275,3495,2877,819,421,8887
Indiana,Merom,184,16,46,52,5,9,128
Indiana,Meridian Hills,1660,11,68,136,463,478,1156
Indiana,Mentone,937,92,264,157,39,18,570
Indiana,Memphis,732,36,161,159,81,48,485
Indiana,Melody Hill,3866,108,910,999,382,282,2681
Indiana,Mellott,203,27,72,25,0,2,126
Indiana,Medora,548,66,228,51,0,7,352
Indiana,Medaryville,554,105,152,89,4,0,350
Indiana,Mecca,422,65,145,29,6,0,245
Indiana,Mauckport,59,6,12,15,1,0,34
Indiana,Matthews,593,88,177,107,28,5,405
Indiana,Martinsville,11739,1352,3595,2088,606,273,7914
Indiana,Marshall,277,11,130,59,16,10,226
Indiana,Markleville,514,29,157,110,39,23,358
Indiana,Markle,1164,41,463,248,64,20,836
Indiana,West Baden Springs,530,66,190,117,16,14,403
Indiana,West College Corner,782,105,189,129,18,19,460
Indiana,Bloomingdale,313,12,78,107,19,8,224
Indiana,Bloomington,82813,2498,5183,8397,9716,11794,37588
Indiana,Blountsville,122,16,37,22,4,3,82
Indiana,Bluffton,9536,728,2540,1925,685,379,6257
Indiana,Burns Harbor,1326,78,372,236,163,30,879
Indiana,Burns City,145,0,52,56,10,0,118
Indiana,Burnettsville,343,21,125,64,28,5,243
Indiana,Burlington,594,23,178,156,59,20,436
Indiana,Burket,148,12,69,19,0,0,100
Indiana,Bunker Hill,603,84,143,137,23,11,398
Indiana,Buffalo,1041,103,415,200,36,46,800
Indiana,Buck Creek,157,0,74,83,0,0,157
Indiana,Bryant,252,20,108,23,6,1,158
Indiana,Bruceville,525,35,156,131,21,4,347
Indiana,Brownstown,2958,308,823,576,166,94,1967
Indiana,Brownsburg,23484,1027,3783,5065,4233,1594,15702
Indiana,Rome City,1159,130,412,248,102,49,941
Indiana,Brookville,2573,239,602,422,257,117,1637
Indiana,Brooksburg,77,8,33,13,3,0,57
Indiana,Brooklyn,1635,173,405,374,76,34,1062
Indiana,Brook,1012,160,309,141,45,10,665
Indiana,Bristol,1809,171,502,418,143,103,1337
Indiana,Bright,4946,188,1490,990,555,227,3450
Indiana,Bremen,4588,495,1051,856,288,188,2878
Indiana,Brazil,8028,1172,2365,1124,422,213,5296
Indiana,Bourbon,1697,167,489,318,109,25,1108
Indiana,Boswell,733,63,245,126,42,16,492
Indiana,Boston,150,21,39,46,1,5,112
Indiana,Borden,755,37,239,142,59,18,495
Indiana,Boonville,6213,517,1827,1478,281,208,4311
Indiana,Brookston,1526,87,430,255,116,31,919
Indiana,Shelbyville,19250,2114,5449,3470,1011,654,12698
Indiana,Rosedale,656,17,169,182,47,24,439
Indiana,Knox,3723,610,1069,625,83,63,2450
Indiana,Russellville,383,38,148,49,7,4,246
Indiana,Rushville,6192,779,1782,1087,302,228,4178
Indiana,Royal Center,919,66,275,158,55,26,580
Indiana,Rossville,1623,120,446,335,89,60,1050
Indiana,Roselawn,4087,365,1311,758,84,51,2569
Indiana,Greens Fork,482,52,118,99,16,5,290
Indiana,Greentown,2710,234,685,700,187,44,1850
Indiana,Greenville,666,23,159,142,73,31,428
Indiana,Greenwood,53828,2983,11920,10780,6537,2973,35193
Indiana,Griffin,164,22,45,58,2,0,127
Indiana,Griffith,16643,877,4280,4048,1399,439,11043
Indiana,Grissom AFB,2779,365,640,621,113,44,1783
Indiana,Hagerstown,1584,81,370,411,129,84,1075
Indiana,Hamilton,1665,141,457,359,105,83,1145
Indiana,Hamlet,890,105,212,143,50,22,532
Indiana,Hammond,78983,10120,18287,14288,4682,2059,49436
Indiana,Hanna,311,1,117,112,19,14,263
Indiana,Hanover,3495,274,714,477,125,89,1679
Indiana,Hardinsburg,185,19,79,26,1,3,128
Indiana,Harlan,1669,245,468,271,151,47,1182
Indiana,Harmony,719,58,252,181,51,5,547
Indiana,Harrodsburg,769,72,167,106,55,47,447
Indiana,Hartford City,6156,687,2040,1045,277,152,4201
Indiana,Hartsville,363,20,117,74,34,0,245
Indiana,Hatfield,788,66,359,95,34,5,559
Indiana,Russiaville,1104,46,230,296,118,56,746
Indiana,Haubstadt,1587,67,454,331,142,74,1068
Indiana,St. Bernice,432,27,154,99,30,0,310
Indiana,St. John,15789,312,2748,3601,2780,1233,10674
Indiana,Shelburn,1200,193,381,173,47,17,811
Indiana,Sharpsville,695,46,231,93,67,31,468
Indiana,Shamrock Lakes,261,8,82,69,9,21,189
Indiana,Shadeland,1746,87,507,382,204,78,1258
Indiana,Seymour,18861,1814,5385,2984,1485,797,12465
Indiana,Selma,735,44,242,166,38,13,503
Indiana,Sellersburg,8675,470,1960,1858,767,493,5548
Indiana,Seelyville,919,61,309,241,65,23,699
Indiana,Scottsburg,6677,721,1789,1347,509,165,4531
Indiana,Scotland,149,12,37,16,9,0,74
Indiana,Scipio,63,10,37,9,0,7,63
Indiana,Schneider,278,24,111,37,12,1,185
Indiana,Schererville,28987,1473,6430,5974,3699,2637,20213
Indiana,Saratoga,197,39,60,36,5,1,141
Indiana,Santa Claus,2671,72,533,589,304,260,1758
Indiana,San Pierre,96,0,62,27,7,0,96
Indiana,Sandborn,385,49,94,91,38,7,279
Indiana,Saltillo,100,30,23,22,2,2,79
Indiana,Salt Creek Commons,2380,123,636,479,144,48,1430
Indiana,Salem,6256,750,1823,1095,333,271,4272
Indiana,Salamonia,232,21,31,52,0,0,104
Indiana,St. Paul,1112,102,373,180,38,10,703
Indiana,St. Meinrad,550,31,219,57,53,41,401
Indiana,St. Mary of the Woods,781,61,271,127,67,33,559
Indiana,St. Leon,666,40,226,136,60,28,490
Indiana,St. Joe,511,40,140,54,22,1,257
Indiana,Hayden,1299,13,399,206,33,0,651
Indiana,Hazleton,291,21,76,98,7,3,205
Indiana,Hebron,3723,300,863,844,211,46,2264
Indiana,Roseland,561,38,163,98,64,37,400
Indiana,Crane,215,17,63,53,4,8,145
Indiana,Jasonville,2370,318,730,390,101,72,1611
Indiana,Jasper,15538,1260,3953,3121,1655,679,10668
Indiana,Jeffersonville,46259,3623,10387,10965,4839,2072,31886
Indiana,Jonesboro,1621,222,561,247,78,17,1125
Indiana,Jonesville,158,15,60,29,7,10,121
Indiana,Kempton,368,57,102,76,15,1,251
Indiana,Kendallville,9870,720,2666,2077,708,229,6400
Indiana,Jalapa,204,18,100,25,10,16,169
Indiana,Kennard,435,55,147,52,27,5,286
Indiana,Kentland,1886,157,692,311,68,35,1263
Indiana,Kewanna,797,119,238,110,31,14,512
Indiana,Kimmell,528,60,157,103,27,0,347
Indiana,Kingman,517,72,137,86,24,6,325
Indiana,Kingsbury,309,24,117,58,5,10,214
Indiana,Kingsford Heights,1477,253,374,262,49,7,945
Indiana,Kirklin,791,93,261,111,49,10,524
Indiana,Knightstown,2123,118,729,422,113,71,1453
Indiana,Knightsville,805,79,288,161,65,26,619
Indiana,Kent,110,0,61,12,0,10,83
Indiana,Ingalls,2123,175,430,483,169,33,1290
Indiana,Crandall,171,27,37,23,13,9,109
Indiana,Indianapolis city (balance),841449,82805,156620,153733,100908,53944,548010
Indiana,Henryville,1837,312,487,418,85,33,1335
Indiana,Herbst,47,0,28,7,6,6,47
Indiana,Heritage Lake,2885,87,845,668,225,191,2016
Indiana,Hidden Valley,5138,125,1262,1009,565,324,3285
Indiana,Highland,23285,1269,5848,5303,2953,1255,16628
Indiana,Highland,4226,76,912,1036,680,346,3050
Indiana,Hillsboro,668,37,208,146,23,14,428
Indiana,Hoagland,887,52,265,176,87,44,624
Indiana,Hobart,28943,2379,8072,6404,2618,1098,20571
Indiana,Holland,738,42,204,146,46,14,452
Indiana,Holton,610,87,186,71,9,11,364
Indiana,Homecroft,685,26,112,162,157,59,516
Indiana,Hope,2306,120,689,490,147,56,1502
Indiana,Howe,716,134,110,77,37,41,399
Indiana,Hudson,594,37,170,92,35,9,343
Indiana,Hudson Lake,1424,122,447,349,37,57,1012
Indiana,Huntertown,5260,121,904,1457,582,319,3383
Indiana,Huntingburg,6446,1006,1407,1009,363,172,3957
Indiana,Huntington,17231,1530,4955,2771,969,739,10964
Indiana,Idaville,686,22,182,63,18,7,292
Indiana,Hymera,680,92,203,141,29,14,479
Indiana,Indian Village,118,11,34,14,17,14,90
Iowa,La Motte,239,15,97,52,13,3,180
Iowa,Lamont,378,36,150,69,20,2,277
Iowa,Lambs Grove,196,8,34,58,18,14,132
Iowa,Lake View,1124,78,311,335,119,67,910
Iowa,Lakeside,662,87,154,129,83,44,497
Iowa,Lake Park,1112,39,276,300,105,29,749
Iowa,Lake Panorama,1097,0,239,320,260,107,926
Iowa,Lake Mills,2010,148,503,519,236,77,1483
Iowa,Lake City,1766,171,412,465,132,112,1292
Iowa,Lakota,235,32,64,68,15,5,184
Iowa,Lamoni,2559,124,309,344,225,184,1186
Iowa,Nichols,392,37,130,97,12,5,281
Iowa,Lansing,953,37,366,227,57,49,736
Iowa,South Amana,124,0,32,76,6,0,114
Iowa,Somers,129,6,29,44,7,0,86
Iowa,Solon,2302,30,251,524,386,220,1411
Iowa,Soldier,154,5,59,36,7,9,116
Iowa,Smithland,160,10,69,31,4,6,120
Iowa,Sloan,1067,37,250,236,110,72,705
Iowa,Slater,1612,8,202,344,312,77,943
Iowa,Sioux Rapids,663,29,189,166,64,16,464
Iowa,Sioux City,82792,8586,17851,15203,7081,3545,52266
Iowa,Sioux Center,7312,511,1096,1072,846,518,4043
Iowa,Silver City,177,19,39,57,21,4,140
Iowa,Sigourney,2071,152,619,467,156,116,1510
Iowa,Sidney,1001,72,249,223,99,41,684
Iowa,Sibley,2687,335,618,505,265,99,1822
Iowa,Shueyville,594,9,88,108,101,86,392
Iowa,Sherrill,202,17,70,27,6,6,126
Iowa,Shenandoah,5062,546,1171,1209,443,243,3612
Iowa,South English,269,20,70,60,9,3,162
Iowa,Shellsburg,1143,41,294,297,54,28,714
Iowa,Spencer,11186,508,2998,2746,1199,361,7812
Iowa,Spirit Lake,4948,250,1002,1503,702,278,3735
Iowa,Stout,191,10,55,51,13,3,132
Iowa,Story City,3435,239,716,751,494,165,2365
Iowa,Storm Lake,10814,2053,1628,1405,527,498,6111
Iowa,Stone City,298,24,77,97,24,0,222
Iowa,Stockton,209,11,58,40,7,1,117
Iowa,Stockport,254,15,84,60,15,1,175
Iowa,Steamboat Rock,292,7,103,90,22,3,225
Iowa,State Center,1355,52,322,346,125,47,892
Iowa,Stanwood,572,40,162,119,55,6,382
Iowa,Stanton,694,37,171,190,75,33,506
Iowa,Stanley,114,5,42,17,7,0,71
Iowa,Stanhope,401,33,131,99,29,8,300
Iowa,Stacyville,545,57,202,126,26,2,413
Iowa,Springville,1034,31,253,323,112,30,749
Iowa,Spring Hill,63,8,23,2,2,0,35
Iowa,Springbrook,175,9,70,33,6,4,122
Iowa,Spragueville,93,12,18,24,0,3,57
Iowa,Spillville,409,62,98,76,32,14,282
Iowa,Stratford,632,56,203,132,42,12,445
Iowa,Shell Rock,1188,42,359,346,90,27,864
Iowa,Sheldahl,266,14,92,58,29,3,196
Iowa,Lincoln,128,9,43,28,4,4,88
Iowa,Linden,186,30,50,55,10,1,146
Iowa,Lineville,197,27,79,42,9,7,164
Iowa,Linn Grove,137,6,43,36,16,11,112
Iowa,Lisbon,1990,108,450,433,222,122,1335
Iowa,Liscomb,317,10,111,74,10,2,207
Iowa,Little Cedar,45,0,33,12,0,0,45
Iowa,Little Rock,492,41,136,113,38,2,330
Iowa,Little Sioux,140,29,43,44,1,0,117
Iowa,Livermore,451,26,122,122,16,7,293
Iowa,Lockridge,272,18,98,42,14,12,184
Iowa,Logan,1627,117,341,376,188,55,1077
Iowa,Lohrville,371,26,93,75,42,12,248
Iowa,Lone Rock,136,19,46,32,10,2,109
Iowa,Lone Tree,1374,47,294,386,169,43,939
Iowa,Long Grove,894,11,141,196,147,81,576
Iowa,Lorimor,378,26,102,80,8,5,221
Iowa,Lime Springs,429,37,173,83,9,3,305
Iowa,Sheldon,5024,287,1189,1155,594,284,3509
Iowa,Lidderdale,139,4,68,30,12,1,115
Iowa,Ladora,320,26,111,68,10,3,218
Iowa,Shelby,578,41,145,137,46,8,377
Iowa,Sheffield,1146,50,282,310,116,29,787
Iowa,Sharpsburg,76,2,22,25,3,0,52
Iowa,Shannon City,73,1,35,7,6,0,49
Iowa,Shambaugh,189,9,57,64,3,3,136
Iowa,Seymour,664,73,194,140,52,4,463
Iowa,Sexton,41,0,9,7,8,0,24
Iowa,Sergeant Bluff,4356,114,549,809,692,264,2428
Iowa,Searsboro,161,12,49,28,9,0,98
Iowa,Scranton,563,48,140,160,37,6,391
Iowa,Schleswig,808,45,247,228,47,18,585
Iowa,Schaller,802,48,240,152,68,26,534
Iowa,Scarville,63,2,21,16,4,4,47
Iowa,Saylorville,3485,51,903,677,523,217,2371
Iowa,Sandyville,82,15,17,8,7,3,50
Iowa,Sanborn,1306,96,358,294,123,37,908
Iowa,Salix,372,14,93,104,33,2,246
Iowa,Libertyville,335,18,125,80,26,0,249
Iowa,Strawberry Point,1407,108,423,328,90,32,981
Iowa,Struble,86,5,33,22,4,1,65
Iowa,Stuart,1593,130,438,332,127,47,1074
Iowa,Lewis,470,51,158,94,15,0,318
Iowa,Anthon,728,42,185,153,57,21,458
Iowa,Aplington,1152,96,255,262,96,46,755
Iowa,Arcadia,512,25,161,95,28,16,325
Iowa,Archer,167,7,44,40,13,1,105
Iowa,Aredale,53,9,26,7,1,0,43
Iowa,Arion,185,39,56,27,1,0,123
Iowa,Arispe,63,5,22,15,7,0,49
Iowa,Arlington,520,41,153,119,29,19,361
Iowa,Armstrong,918,69,262,252,68,13,664
Iowa,Arnolds Park,1128,42,321,286,122,84,855
Iowa,Arthur,210,9,71,58,10,4,152
Iowa,Asbury,5014,117,667,996,896,451,3127
Iowa,Ashton,435,30,123,96,33,12,294
Iowa,Aspinwall,18,2,3,9,1,0,15
Iowa,Atalissa,327,34,121,71,8,1,235
Iowa,Athelstan,49,8,8,7,0,0,23
Iowa,Letts,407,32,119,98,8,2,259
Iowa,Atkins,1839,64,307,468,271,86,1196
Iowa,Lester,268,10,85,61,24,7,187
Iowa,Leon,1999,181,623,334,166,35,1339
Iowa,La Porte City,2315,93,609,485,197,89,1473
Iowa,Larchwood,952,60,240,184,105,37,626
Iowa,Larrabee,187,15,63,58,3,1,140
Iowa,Latimer,463,58,105,108,37,13,321
Iowa,Laurel,316,17,95,51,18,4,185
Iowa,Laurens,1271,91,342,303,102,17,855
Iowa,Lawler,331,17,109,74,34,7,241
Iowa,Lawton,851,25,183,178,122,42,550
Iowa,Leando,64,0,16,48,0,0,64
Iowa,Le Claire,3888,35,761,885,563,517,2761
Iowa,Ledyard,117,7,46,26,8,2,89
Iowa,Le Grand,1041,33,269,260,71,23,656
Iowa,Lehigh,407,23,164,109,10,5,311
Iowa,Leighton,168,7,52,23,21,4,107
Iowa,Leland,275,14,87,59,20,4,184
Iowa,Le Mars,9757,715,2247,2628,1081,242,6913
Iowa,Lenox,1433,143,393,334,90,33,993
Iowa,Le Roy,6,0,3,3,0,0,6
Iowa,Atlantic,6929,485,2175,1260,621,329,4870
Iowa,Auburn,278,32,98,59,3,8,200
Iowa,Audubon,2054,148,633,407,165,78,1431
Iowa,Beaverdale,1435,84,393,257,81,43,858
Iowa,Bedford,1491,78,432,372,96,49,1027
Iowa,Belle Plaine,2528,198,701,489,240,38,1666
Iowa,Bellevue,2134,153,636,506,224,72,1591
Iowa,Belmond,2438,138,670,649,149,73,1679
Iowa,Bennett,384,44,134,69,26,10,283
Iowa,Bentley,136,0,65,14,21,0,100
Iowa,Benton,43,3,16,8,10,0,37
Iowa,Berkley,22,6,9,4,1,0,20
Iowa,Bernard,123,6,43,28,14,2,93
Iowa,Swan,78,4,24,21,0,2,51
Iowa,Swaledale,187,6,71,46,3,0,126
Iowa,Sutherland,582,31,193,167,38,17,446
Iowa,Superior,184,20,50,43,2,0,115
Iowa,Sun Valley Lake,223,0,70,47,51,46,214
Iowa,Sumner,2114,74,564,495,243,87,1463
Iowa,Sully,812,34,267,162,55,29,547
Iowa,Beaver,125,5,10,30,9,0,54
Iowa,Beaman,234,14,58,53,20,2,147
Iowa,Beaconsfield,25,4,19,2,0,0,25
Iowa,Beacon,573,95,165,98,26,3,387
Iowa,Aurelia,1002,52,280,313,86,20,751
Iowa,Aurora,233,20,57,37,27,6,147
Iowa,Avoca,1378,99,327,354,153,43,976
Iowa,Ayrshire,152,10,56,34,10,1,111
Iowa,Badger,572,8,144,179,36,7,374
Iowa,Bagley,330,18,103,67,20,15,223
Iowa,Baldwin,110,12,37,22,8,3,82
Iowa,Balltown,68,12,28,13,2,0,55
Iowa,Lanesboro,114,8,40,24,1,5,78
Iowa,Bancroft,747,41,186,170,63,19,479
Iowa,Barnes City,286,38,92,66,5,4,205
Iowa,Barnum,271,12,42,54,13,1,122
Iowa,Bartlett,0,0,0,0,0,0,0
Iowa,Bassett,69,2,38,16,1,0,57
Iowa,Batavia,669,53,207,179,13,2,454
Iowa,Battle Creek,701,54,231,169,56,16,526
Iowa,Baxter,929,66,212,264,90,42,674
Iowa,Bayard,470,45,121,116,30,2,314
Iowa,Bankston,79,2,7,29,4,3,45
Iowa,Lacona,446,31,137,84,30,12,294
Iowa,Ankeny,51489,892,5804,10953,10878,3948,32475
Iowa,Knierim,81,0,15,25,8,2,50
Iowa,Hardy,98,22,8,6,6,0,42
Iowa,Harlan,5029,372,1309,1137,671,209,3698
Iowa,Harper,93,4,24,16,12,1,57
Iowa,Harpers Ferry,291,30,129,58,32,10,259
Iowa,Harris,155,30,53,38,8,0,129
Iowa,Hartford,847,36,216,196,39,6,493
Iowa,Hartley,1695,118,486,477,119,14,1214
Iowa,Hartwick,99,1,36,22,4,5,68
Iowa,Harvey,269,24,113,43,0,0,180
Iowa,Hastings,172,12,45,27,9,2,95
Iowa,Havelock,152,10,46,49,2,1,108
Iowa,Haverhill,204,15,46,67,23,1,152
Iowa,Hawarden,2551,360,555,538,223,94,1770
Iowa,Hawkeye,549,32,140,132,25,7,336
Iowa,Hayesville,40,5,24,5,1,0,35
Iowa,Hayfield,7,0,7,0,0,0,7
Iowa,Hazleton,902,43,230,240,26,0,539
Iowa,Hedrick,849,62,206,196,34,3,501
Iowa,Henderson,165,8,51,41,4,0,104
Iowa,Wellman,1395,70,376,375,145,62,1028
Iowa,Wellsburg,939,39,199,236,106,14,594
Iowa,Welton,127,3,48,36,4,2,93
Iowa,Wesley,354,24,93,89,21,3,230
Iowa,Whittemore,474,8,149,146,26,9,338
Iowa,Whiting,874,38,236,177,100,31,582
Iowa,Wheatland,685,49,156,190,48,11,454
Iowa,What Cheer,701,73,200,134,27,2,436
Iowa,Westwood,146,3,9,33,34,22,101
Iowa,West Union,2692,105,721,549,343,129,1847
Iowa,Westside,333,20,99,102,24,5,250
Iowa,West Point,1113,35,388,240,84,51,798
Iowa,Westphalia,126,9,25,41,6,2,83
Iowa,Hepburn,56,2,15,15,0,0,32
Iowa,Weston,96,11,38,0,10,10,69
Iowa,West Liberty,3737,688,824,652,198,117,2479
Iowa,Westgate,187,6,66,61,13,7,153
Iowa,Westfield,172,19,34,25,5,12,95
Iowa,West Des Moines,61266,1669,6187,11664,15222,7011,41753
Iowa,West Chester,106,17,43,22,4,2,88
Iowa,West Burlington,3021,188,820,858,170,40,2076
Iowa,West Branch,2716,76,534,620,443,189,1862
Iowa,West Bend,890,49,199,302,73,9,632
Iowa,West Amana,243,0,0,20,52,0,72
Iowa,West Okoboji,290,15,67,79,55,34,250
Iowa,Hiawatha,7150,262,1293,1604,1228,467,4854
Iowa,High Amana,111,0,23,21,26,5,75
Iowa,Hills,810,38,181,194,103,33,549
Iowa,Iowa City,71832,1835,5061,8557,10069,11768,37290
Iowa,Iowa Falls,5198,273,1271,1334,451,194,3523
Iowa,Ireton,667,34,197,143,64,19,457
Iowa,Irvington,26,0,7,6,0,0,13
Iowa,Irwin,380,23,113,86,42,11,275
Iowa,Jackson Junction,46,1,15,13,1,1,31
Iowa,Jacksonville,31,0,23,8,0,0,31
Iowa,Jamaica,215,24,52,62,10,1,149
Iowa,Janesville,880,31,243,217,96,20,607
Iowa,Ionia,351,14,139,63,7,10,233
Iowa,Jefferson,4272,285,1036,1108,473,173,3075
Iowa,Jewell Junction,1281,72,254,296,129,71,822
Iowa,Johnston,19550,456,1926,2988,4856,3061,13287
Iowa,Joice,190,7,36,78,10,9,140
Iowa,Jolley,37,3,21,2,5,0,31
Iowa,Kalona,2447,273,540,526,263,105,1707
Iowa,Kamrar,184,19,81,39,4,2,145
Iowa,Kanawha,690,64,233,139,42,5,483
Iowa,Kellerton,278,16,92,66,9,1,184
Iowa,Kelley,323,12,70,92,52,11,237
Iowa,Jesup,2691,46,717,645,272,87,1767
Iowa,Whitten,153,14,34,42,5,0,95
Iowa,Inwood,817,73,242,202,57,27,601
Iowa,Independence,5986,321,1662,1274,648,162,4067
Iowa,Hillsboro,228,27,63,58,15,0,163
Iowa,Hinton,864,28,171,201,130,36,566
Iowa,Holiday Lake,340,16,157,82,40,18,313
Iowa,Holland,235,11,58,65,16,6,156
Iowa,Holstein,1454,61,369,365,198,59,1052
Iowa,Holy Cross,376,23,112,80,14,13,242
Iowa,Homestead,201,0,17,47,37,9,110
Iowa,Hopkinton,567,45,226,118,24,3,416
Iowa,Hornick,273,29,87,57,9,2,184
Iowa,Indianola,15165,405,2989,2966,1678,979,9017
Iowa,Hospers,793,53,162,190,69,8,482
Iowa,Hubbard,961,94,210,269,74,23,670
Iowa,Hudson,2391,35,401,634,404,175,1649
Iowa,Hull,2317,277,505,354,228,59,1423
Iowa,Humboldt,4635,258,1123,1198,448,163,3190
Iowa,Humeston,493,28,147,145,25,11,356
Iowa,Hutchins,11,0,11,0,0,0,11
Iowa,Huxley,3430,148,537,738,533,251,2207
Iowa,Ida Grove,2199,173,683,409,249,56,1570
Iowa,Imogene,34,3,4,10,8,1,26
Iowa,Houghton,151,16,56,18,16,4,110
Iowa,Kellogg,746,54,188,190,44,0,476
Iowa,Willey,108,5,25,23,7,0,60
Iowa,Williamsburg,3128,179,706,798,324,204,2211
Iowa,Geneva,142,6,53,31,5,2,97
Iowa,George,1065,127,276,251,122,48,824
Iowa,Gibson,57,2,14,16,4,4,40
Iowa,Gilbert,1237,10,118,270,213,92,703
Iowa,Gilbertville,700,37,261,161,60,21,540
Iowa,Gillett Grove,56,6,13,18,0,0,37
Iowa,Gilman,696,35,183,171,44,6,439
Iowa,Gilmore City,417,29,152,84,29,8,302
Iowa,Gladbrook,839,23,251,233,82,41,630
Iowa,Glenwood,5243,365,1454,1020,521,275,3635
Iowa,Glidden,1336,52,302,324,99,44,821
Iowa,Goldfield,658,49,193,199,34,6,481
Iowa,Goodell,129,13,42,23,1,0,79
Iowa,Goose Lake,263,9,66,52,25,3,155
Iowa,Gowrie,1093,88,232,306,77,36,739
Iowa,Graettinger,702,44,199,148,70,14,475
Iowa,Graf,77,4,17,12,11,4,48
Iowa,Grafton,326,23,99,93,12,3,230
Iowa,Grand Junction,854,59,219,179,43,8,508
Iowa,Garwin,464,17,156,114,16,8,311
Iowa,Garrison,384,21,110,102,16,5,254
Iowa,Garner,3100,106,617,832,362,117,2034
Iowa,Garnavillo,855,84,281,180,57,25,627
Iowa,New Virginia,472,17,103,118,38,22,298
Iowa,Fontanelle,667,52,276,149,33,11,521
Iowa,Forest City,4110,161,955,985,390,116,2607
Iowa,Fort Atkinson,267,26,89,52,20,4,191
Iowa,Fort Dodge,24789,1705,5116,6256,2286,1032,16395
Iowa,Fort Madison,10832,627,3113,2853,791,191,7575
Iowa,Fostoria,163,14,47,41,12,2,116
Iowa,Franklin,114,8,40,32,8,5,93
Iowa,Fraser,165,13,30,62,13,0,118
Iowa,Grand Mound,507,13,155,137,41,9,355
Iowa,Fredericksburg,1123,69,329,189,73,48,708
Iowa,Fredonia,388,68,76,50,2,0,196
Iowa,Fremont,691,41,202,163,48,7,461
Iowa,Fruitland,1281,60,279,274,92,29,734
Iowa,Frytown,79,0,31,0,32,0,63
Iowa,Galt,80,1,26,15,14,0,56
Iowa,Galva,519,36,116,114,25,7,298
Iowa,Garber,141,6,47,37,0,2,92
Iowa,Garden City,64,0,13,26,17,0,56
Iowa,Garden Grove,228,19,61,45,15,3,143
Iowa,Frederika,192,9,49,49,18,8,133
Iowa,Grand River,247,31,74,55,19,0,179
Iowa,Grandview,512,45,128,122,47,6,348
Iowa,Granger,1587,63,237,332,318,66,1016
Iowa,Harcourt,246,21,76,49,28,3,177
Iowa,Zwingle,125,12,30,33,5,0,80
Iowa,Zearing,591,26,155,144,56,18,399
Iowa,Yorktown,78,4,20,18,6,1,49
Iowa,Yetter,25,4,11,5,0,0,20
Iowa,Yale,289,28,92,71,20,6,217
Iowa,Wyoming,442,31,135,103,38,12,319
Iowa,Worthington,406,25,146,65,46,13,295
Iowa,Woolstock,195,11,63,68,5,4,151
Iowa,Hansell,86,4,45,16,3,0,68
Iowa,Woodward,1623,213,301,310,72,27,923
Iowa,Woodbine,1660,112,404,361,180,46,1103
Iowa,Woden,257,19,68,62,7,7,163
Iowa,Wiota,92,7,30,41,6,0,84
Iowa,Winthrop,922,28,264,205,103,15,615
Iowa,Winterset,5159,291,1602,1123,364,165,3545
Iowa,Winfield,1001,69,205,261,106,20,661
Iowa,Windsor Heights,4888,124,634,1094,1149,459,3460
Iowa,Wilton,2791,101,747,632,328,94,1902
Iowa,Williamson,108,10,32,29,3,1,75
Iowa,Woodburn,273,15,106,58,26,0,205
Iowa,Williams,506,15,138,94,46,4,297
Iowa,Hanlontown,215,10,53,67,21,6,157
Iowa,Hampton,4371,523,1034,851,374,136,2918
Iowa,Grant,90,3,29,29,0,0,61
Iowa,Granville,384,23,96,108,34,12,273
Iowa,Gravity,162,25,51,40,2,1,119
Iowa,Gray,155,5,48,24,16,0,93
Iowa,Greeley,263,41,100,35,3,0,179
Iowa,Greene,1194,85,307,302,136,19,849
Iowa,Greenfield,2007,131,558,507,144,69,1409
Iowa,Green Mountain,113,3,44,32,11,0,90
Iowa,Greenville,89,9,17,31,1,1,59
Iowa,Hancock,169,12,56,57,12,0,137
Iowa,Grimes,9509,238,1197,1625,2315,656,6031
Iowa,Griswold,1111,87,323,237,79,23,749
Iowa,Grundy Center,2706,116,646,689,345,129,1925
Iowa,Gruver,98,5,29,33,3,4,74
Iowa,Guernsey,68,3,26,15,6,0,50
Iowa,Guthrie Center,1715,128,508,372,104,32,1144
Iowa,Guttenberg,1823,95,548,474,173,63,1353
Iowa,Halbur,262,11,69,47,16,10,153
Iowa,Hamburg,1111,79,280,205,92,30,686
Iowa,Hamilton,183,6,50,10,2,25,93
Iowa,Grinnell,9132,364,1484,1679,958,794,5279
Iowa,Kensett,274,20,102,74,22,1,219
Iowa,Kent,52,5,8,22,0,0,35
Iowa,Keokuk,10705,767,2989,2272,862,369,7259
Iowa,Exira,871,98,310,191,32,18,649
Iowa,Everly,564,56,129,128,39,11,363
Iowa,Evansdale,4777,309,1438,1017,306,71,3141
Iowa,Estherville,6091,489,1286,1461,438,194,3868
Iowa,Essex,924,46,281,217,64,27,635
Iowa,Epworth,2057,34,461,413,293,65,1266
Iowa,Emmetsburg,3817,190,627,1141,413,205,2576
Iowa,Emerson,478,18,150,96,24,5,293
Iowa,Ely,1994,25,259,559,349,89,1281
Iowa,Elma,654,41,232,138,44,22,477
Iowa,Ellsworth,596,21,96,131,89,12,349
Iowa,Ellston,23,0,6,6,4,1,17
Iowa,Elliott,417,45,117,93,9,5,269
Iowa,Elk Run Heights,942,115,331,245,58,17,766
Iowa,Elkport,30,7,8,2,0,0,17
Iowa,Elk Horn,543,58,190,118,46,18,430
Iowa,Elkhart,653,35,129,181,93,20,458
Iowa,Elkader,1252,35,449,208,197,75,964
Iowa,Elgin,785,35,193,208,72,22,530
Iowa,Exline,135,28,41,35,3,0,107
Iowa,Fairbank,1109,31,379,243,111,17,781
Iowa,Fairfax,2300,33,356,569,395,178,1531
Iowa,Fairfield,9739,334,1689,2322,1207,1178,6730
Iowa,Thayer,52,2,14,15,2,0,33
Iowa,Terril,399,28,98,79,33,14,252
Iowa,Tennant,60,6,24,15,5,0,50
Iowa,Templeton,368,38,96,85,35,2,256
Iowa,Tama,2830,283,756,516,165,93,1813
Iowa,Tabor,1237,75,272,277,103,38,765
Iowa,Swisher,838,13,142,235,160,45,595
Iowa,Swea City,525,39,127,124,44,14,348
Iowa,Fonda,575,29,169,114,62,19,393
Iowa,Eldridge,6017,127,935,1231,929,506,3728
Iowa,Floyd,403,48,119,75,19,2,263
Iowa,Fertile,336,23,118,75,25,7,248
Iowa,Ferguson,133,13,62,34,4,0,113
Iowa,Fenton,325,18,94,86,14,6,218
Iowa,Fayette,1137,69,162,133,66,72,502
Iowa,Farragut,461,19,142,134,48,21,364
Iowa,Farnhamville,337,8,111,99,32,6,256
Iowa,Farmington,783,110,227,131,47,13,528
Iowa,Farmersburg,264,9,83,58,17,4,171
Iowa,Farley,1590,54,453,372,118,64,1061
Iowa,Floris,177,14,53,48,4,1,120
Iowa,Eldora,2717,199,619,596,238,137,1789
Iowa,Eldon,999,115,318,225,34,12,704
Iowa,Elberon,156,16,59,29,2,2,108
Iowa,Douds,52,0,16,28,0,0,44
Iowa,Doon,538,43,149,141,28,8,369
Iowa,Donnellson,856,50,230,215,59,27,581
Iowa,Donahue,366,19,92,93,30,21,255
Iowa,Dolliver,64,13,23,10,2,0,48
Iowa,Dixon,225,5,65,51,16,3,140
Iowa,Dike,1376,29,269,337,209,79,923
Iowa,Dickens,188,13,62,38,4,1,118
Iowa,Diamondhead Lake,359,41,73,77,45,16,252
Iowa,Dougherty,91,6,12,24,10,9,61
Iowa,Keosauqua,1059,34,340,252,128,56,810
Iowa,Keswick,252,10,65,77,9,6,167
Iowa,Keystone,656,31,193,190,49,20,483
Iowa,Kimballton,296,27,94,64,14,13,212
Iowa,Kingsley,1456,52,314,357,99,76,898
Iowa,Kinross,42,8,21,8,1,0,38
Iowa,Kirkman,72,0,40,20,2,0,62
Iowa,Kirkville,177,15,66,48,6,0,135
Iowa,Kiron,229,14,66,63,12,5,160
Iowa,Klemme,498,16,166,94,12,9,297
Iowa,Keota,954,59,264,194,56,46,619
Iowa,Thompson,463,52,188,94,26,1,361
Iowa,Dow City,514,48,172,86,22,6,334
Iowa,Drakesville,177,22,51,58,7,4,142
Iowa,Edgewood,818,69,284,159,44,19,575
Iowa,Eddyville,1333,37,404,249,101,35,826
Iowa,East Peru,93,15,45,9,3,0,72
Iowa,East Amana,38,10,7,0,7,6,30
Iowa,Early,683,14,179,166,73,12,444
Iowa,Earlville,805,58,264,184,41,14,561
Iowa,Earling,476,45,137,86,42,11,321
Iowa,Earlham,1752,16,296,439,215,69,1035
Iowa,Eagle Grove,3483,391,856,788,269,125,2429
Iowa,Dows,453,33,165,112,36,18,364
Iowa,Dysart,1609,74,415,381,150,49,1069
Iowa,Durant,1983,93,499,493,220,66,1371
Iowa,Durango,14,2,11,0,0,0,13
Iowa,Dunlap,1252,125,307,311,108,11,862
Iowa,Dunkerton,879,39,239,181,64,12,535
Iowa,Dundee,165,8,64,29,5,1,107
Iowa,Duncombe,363,30,111,96,12,2,251
Iowa,Duncan,95,42,23,13,17,0,95
Iowa,Dumont,734,62,260,135,20,22,499
Iowa,Dubuque,58409,3360,13181,10682,7512,4102,38837
Iowa,Dyersville,4214,323,1193,814,437,138,2905
Iowa,Thor,163,7,54,47,10,0,118
Iowa,Thornburg,95,4,27,24,12,0,67
Iowa,Thornton,494,24,116,149,38,9,336
Iowa,Ames,62815,714,3481,6391,8876,8072,27534
Iowa,Anamosa,5518,389,1630,1436,308,177,3940
Iowa,Anderson,0,0,0,0,0,0,0
Iowa,Andover,88,6,29,16,5,0,56
Iowa,Andrew,441,41,109,73,23,6,252
Iowa,Anita,954,43,287,238,89,25,682
Iowa,Lost Nation,506,31,129,101,25,22,308
Iowa,Weldon,156,11,74,19,10,0,114
Iowa,Webster City,7869,660,1879,2173,688,279,5679
Iowa,Amana,404,4,100,104,70,36,314
Iowa,Webster,127,12,42,26,3,0,83
Iowa,Wayland,1133,134,268,249,82,48,781
Iowa,Waverly,10013,280,1602,1838,1489,757,5966
Iowa,Waukon,3818,407,1003,858,329,121,2718
Iowa,Waukee,16956,214,1867,3382,3933,1200,10596
Iowa,Waucoma,281,22,92,56,14,0,184
Iowa,Watkins,93,11,56,14,0,0,81
Iowa,Waterville,137,9,44,34,3,6,96
Iowa,Waterloo,68432,5825,15697,13928,6733,2834,45017
Iowa,Washta,196,26,73,26,17,2,144
Iowa,Webb,158,12,40,49,8,5,114
Iowa,Washington,7348,447,1825,1891,735,273,5171
Iowa,Alvord,231,7,91,44,12,1,155
Iowa,Alton,1285,98,293,258,152,77,878
Iowa,Keomah Village,64,0,19,19,15,7,60
Iowa,Ackley,1706,170,451,486,166,46,1319
Iowa,Ackworth,40,8,11,8,6,0,33
Iowa,Adair,854,29,267,190,75,28,589
Iowa,Adel,4055,219,924,868,598,190,2799
Iowa,Afton,970,77,285,207,76,4,649
Iowa,Agency,655,52,200,155,47,8,462
Iowa,Ainsworth,568,64,158,62,47,10,341
Iowa,Albert City,631,35,172,167,69,13,456
Iowa,Altoona,15808,520,2948,3444,2226,963,10101
Iowa,Albia,3799,325,961,592,438,142,2458
Iowa,Alburnett,607,17,142,161,65,20,405
Iowa,Alden,803,95,284,165,54,2,600
Iowa,Alexander,157,15,46,25,7,3,96
Iowa,Algona,5494,223,1389,1473,670,232,3987
Iowa,Alleman,524,11,101,135,78,33,358
Iowa,Allerton,536,37,144,123,24,10,338
Iowa,Allison,1160,48,303,322,54,92,819
Iowa,Alta,2056,161,443,498,189,64,1355
Iowa,Alta Vista,288,12,99,50,14,0,175
Iowa,Albion,468,29,153,110,37,6,335
Iowa,Knoxville,7245,496,1871,1667,626,237,4897
Iowa,Washburn,997,67,261,282,79,36,725
Iowa,Walnut,688,51,241,158,36,25,511
Iowa,University Heights,1222,0,48,80,206,380,714
Iowa,Unionville,64,3,41,12,1,1,58
Iowa,Union,517,34,158,116,38,7,353
Iowa,Underwood,884,30,162,196,114,41,543
Iowa,Udell,37,8,7,14,0,3,32
Iowa,Twin Lakes,247,0,78,76,16,68,238
Iowa,Turin,111,4,38,17,10,5,74
Iowa,Truro,512,27,114,123,18,5,287
Iowa,Truesdale,139,20,55,25,4,0,104
Iowa,University Park,594,28,105,119,63,10,325
Iowa,Tripoli,1350,135,349,314,93,19,910
Iowa,Traer,1726,95,470,420,178,70,1233
Iowa,Toronto,136,10,41,47,0,0,98
Iowa,Toledo,2146,254,525,519,129,41,1468
Iowa,Toeterville,40,0,16,9,11,0,36
Iowa,Titonka,500,48,126,106,44,7,331
Iowa,Tipton,3202,194,1005,600,289,96,2184
Iowa,Tingley,178,4,61,46,13,1,125
Iowa,Tiffin,2358,40,335,620,315,175,1485
Iowa,Thurman,209,19,70,29,9,3,130
Iowa,Treynor,1013,9,165,243,171,66,654
Iowa,Wapello,2017,208,542,453,120,81,1404
Iowa,Urbana,1402,60,324,318,167,47,916
Iowa,Ute,411,49,177,66,19,3,314
Iowa,Wall Lake,664,54,191,144,62,21,472
Iowa,Wallingford,128,9,39,39,8,3,98
Iowa,Walker,775,33,213,230,67,0,543
Iowa,Walford,1563,17,212,434,222,95,980
Iowa,Walcott,1575,97,343,356,191,76,1063
Iowa,Wahpeton,323,10,70,83,84,39,286
Iowa,Wadena,325,27,73,72,14,5,191
Iowa,Volga,204,15,66,33,20,3,137
Iowa,Vinton,5197,199,1482,986,704,214,3585
Iowa,Urbandale,42099,862,5601,8366,10057,3910,28796
Iowa,Vining,69,4,30,14,6,0,54
Iowa,Villisca,1249,85,316,350,81,28,860
Iowa,Victor,1087,46,328,239,80,23,716
Iowa,Ventura,738,9,182,230,112,54,587
Iowa,Varina,79,11,25,4,5,0,45
Iowa,Van Wert,178,35,40,43,7,0,125
Iowa,Van Meter,1549,11,269,358,243,53,934
Iowa,Van Horne,717,22,149,178,53,18,420
Iowa,Valeria,52,2,11,13,4,1,31
Iowa,Vail,470,73,167,66,19,2,327
Iowa,Vincent,165,14,54,35,7,2,112
Iowa,Loveland,40,18,12,0,0,0,30
Iowa,Akron,1454,123,419,280,120,31,973
Iowa,New Vienna,393,32,131,98,27,7,295
Iowa,Norwalk,9671,192,1383,2415,1639,550,6179
Iowa,Northwood,2028,158,597,490,203,49,1497
Iowa,North Washington,143,2,63,18,7,3,93
Iowa,North Liberty,14972,255,1731,3045,3023,1476,9530
Iowa,North English,1232,67,295,294,74,52,782
Iowa,North Buena Vista,73,17,38,10,3,0,68
Iowa,Northboro,40,3,15,17,1,0,36
Iowa,Nora Springs,1553,100,362,414,104,64,1044
Iowa,Milton,576,84,101,111,18,2,316
Iowa,Minburn,330,13,107,72,27,7,226
Iowa,Minden,629,22,161,140,67,26,416
Iowa,Mineola,118,0,21,52,8,0,81
Iowa,Mingo,216,6,69,60,25,6,166
Iowa,Missouri Valley,2723,182,799,670,157,79,1887
Iowa,Mitchell,128,17,41,33,4,2,97
Iowa,Mitchellville,2303,146,814,473,89,78,1600
Iowa,Modale,283,14,90,78,10,4,196
Iowa,Mona,115,0,25,29,0,0,54
Iowa,Mondamin,348,24,115,103,31,2,275
Iowa,Monmouth,144,16,42,33,1,4,96
Iowa,Monona,1632,131,538,361,179,33,1242
Iowa,Monroe,1805,80,387,522,151,64,1204
Iowa,Montezuma,1576,64,456,387,180,34,1121
Iowa,Monticello,3800,194,1186,863,282,90,2615
Iowa,Montour,238,28,92,57,15,2,194
Iowa,Norway,613,22,138,186,54,12,412
Iowa,Numa,68,18,22,12,3,1,56
Iowa,Oakland,1585,79,410,298,187,55,1029
Iowa,Oakland Acres,111,0,22,34,23,8,87
Iowa,Maxwell,919,24,202,238,105,19,588
Iowa,Maynard,563,38,120,104,79,21,362
Iowa,Maysville,139,8,59,30,20,0,117
Iowa,Mechanicsville,1082,57,313,225,91,33,719
Iowa,Mediapolis,1342,70,339,343,160,49,961
Iowa,Melbourne,891,28,256,194,71,26,575
Iowa,Melcher-Dallas,1203,102,379,200,89,31,801
Iowa,Melrose,133,18,45,33,8,0,104
Iowa,Melvin,237,18,66,64,17,8,173
Iowa,Menlo,410,31,124,71,26,2,254
Iowa,Meriden,206,8,55,52,15,4,134
Iowa,Merrill,845,37,240,217,67,10,571
Iowa,Montrose,925,46,312,229,32,13,632
Iowa,Meservey,226,6,90,53,10,5,164
Iowa,Middle Amana,495,35,94,107,105,42,383
Iowa,Middletown,313,11,74,92,21,5,203
Iowa,Miles,454,27,131,76,33,23,290
Iowa,Milford,2971,129,745,821,272,108,2075
Iowa,Miller,0,0,0,0,0,0,0
Iowa,Millersburg,198,13,54,53,5,3,128
Iowa,Millerton,14,0,5,4,0,2,11
Iowa,Milo,829,22,263,193,59,12,549
Iowa,Newton,15147,870,4135,3530,1585,277,10397
Iowa,Odebolt,1090,65,305,220,108,40,738
Iowa,Ocheyedan,504,31,188,104,50,12,385
Iowa,Oakville,131,15,38,28,4,0,85
Iowa,Meyer,0,0,0,0,0,0,0
Iowa,Moorhead,248,5,91,69,16,5,186
Iowa,Moorland,205,24,46,47,14,1,132
Iowa,Moravia,814,50,248,187,67,9,561
Iowa,Pleasant Hill,9099,496,1553,1861,1619,655,6184
Iowa,Plano,60,4,19,19,2,0,44
Iowa,Plainfield,428,18,137,95,36,5,291
Iowa,Pisgah,240,19,69,64,7,3,162
Iowa,Pioneer,7,0,1,0,2,0,3
Iowa,Pilot Mound,174,21,64,45,8,0,138
Iowa,Pierson,426,22,96,112,35,9,274
Iowa,Peterson,300,27,104,75,25,13,244
Iowa,Persia,266,16,72,80,15,1,184
Iowa,Perry,8086,1118,1727,1386,537,248,5016
Iowa,Percival,24,0,10,4,5,5,24
Iowa,Peosta,1747,38,248,394,210,65,955
Iowa,Pleasanton,18,2,8,5,0,0,15
Iowa,Pella,10316,553,1706,1717,1414,587,5977
Iowa,Patterson,150,11,54,31,7,0,103
Iowa,Paton,268,6,67,75,14,3,165
Iowa,Parnell,213,6,63,75,10,8,162
Iowa,Park View,2438,60,542,458,316,158,1534
Iowa,Parkersburg,1877,88,459,439,221,66,1273
Iowa,Panorama Park,102,14,43,26,2,4,89
Iowa,Panora,1117,90,246,261,104,43,744
Iowa,Panama,199,13,51,56,14,3,137
Iowa,Palo,1050,21,241,270,96,37,665
Iowa,Palmer,149,19,54,30,8,0,111
Iowa,Packwood,286,30,64,54,19,4,171
Iowa,Pacific Junction,350,67,95,75,16,2,255
Iowa,Paullina,982,56,292,235,93,23,699
Iowa,Maurice,286,17,84,56,22,4,183
Iowa,Pleasant Plain,47,6,14,15,3,0,38
Iowa,Plover,41,2,10,18,2,0,32
Iowa,Morley,107,10,24,35,7,0,76
Iowa,Morning Sun,877,91,214,210,68,17,600
Iowa,Morrison,97,3,30,25,6,0,64
Iowa,Moulton,608,55,190,113,49,5,412
Iowa,Mount Auburn,100,7,30,39,3,0,79
Iowa,Mount Ayr,1799,167,422,454,209,82,1334
Iowa,Mount Pleasant,8575,453,2250,1875,914,224,5716
Iowa,Mount Sterling,36,0,7,5,20,0,32
Iowa,Climbing Hill,166,16,57,29,0,0,102
Iowa,Clermont,653,44,201,134,56,28,463
Iowa,Protivin,284,21,100,75,21,12,229
Iowa,Promise City,203,9,63,106,3,0,181
Iowa,Pleasantville,1819,75,459,471,155,46,1206
Iowa,Princeton,1106,49,279,297,113,46,784
Iowa,Marquette,399,37,107,107,46,11,308
Iowa,Prescott,292,10,88,60,14,10,182
Iowa,Prairie City,1848,80,543,351,212,44,1230
Iowa,Prairieburg,156,21,49,44,0,2,116
Iowa,Postville,2281,353,468,315,78,57,1271
Iowa,Portsmouth,154,11,65,35,5,1,117
Iowa,Portland,12,0,12,0,0,0,12
Iowa,Popejoy,56,0,15,12,3,0,30
Iowa,Pomeroy,835,43,168,191,69,26,497
Iowa,Polk City,3953,65,714,848,773,202,2602
Iowa,Pocahontas,1717,91,479,486,194,50,1300
Iowa,Plymouth,352,31,82,115,34,7,269
Iowa,Primghar,995,64,230,216,95,18,623
Iowa,Oyens,87,0,16,33,4,0,53
Iowa,Matlock,85,4,33,22,1,0,60
Iowa,Masonville,92,10,47,17,3,0,77
Iowa,Luxemburg,189,19,72,44,15,2,152
Iowa,Lu Verne,336,38,88,73,13,4,216
Iowa,Luther,161,3,52,53,10,9,127
Iowa,Lucas,196,17,67,58,11,0,153
Iowa,Luana,317,24,79,68,22,6,199
Iowa,Low Moor,195,9,55,34,14,5,117
Iowa,Lowden,823,47,256,183,52,27,565
Iowa,Lovilia,608,41,218,98,12,4,373
Iowa,Pulaski,258,12,95,48,27,10,192
Iowa,Quasqueton,511,26,225,109,33,0,393
Iowa,Quimby,376,57,97,74,15,0,243
Iowa,Radcliffe,560,51,140,111,64,12,378
Iowa,Rake,172,21,33,53,10,15,132
Iowa,Ralston,81,6,29,15,5,0,55
Iowa,Randalia,61,4,20,22,2,0,48
Iowa,Randall,174,12,37,48,20,13,130
Iowa,Randolph,188,13,63,44,13,0,133
Iowa,Rathbun,87,1,35,18,8,2,64
Iowa,Raymond,824,26,229,191,105,23,574
Iowa,Readlyn,885,46,248,176,79,29,578
Iowa,Reasnor,185,13,50,40,15,1,119
Iowa,Redding,61,8,25,11,2,0,46
Iowa,Redfield,782,54,296,199,36,12,597
Iowa,Red Oak,5588,582,1488,1253,376,119,3818
Iowa,Reinbeck,1750,57,546,405,209,57,1274
Iowa,Luzerne,102,2,30,24,1,0,57
Iowa,Lynnville,482,34,228,86,16,8,372
Iowa,Lytton,315,22,104,82,15,7,230
Iowa,McCallsburg,329,17,60,93,31,3,204
Iowa,Marne,131,5,48,24,6,0,83
Iowa,Marion,36311,884,6492,8964,6049,2408,24797
Iowa,Marengo,2518,170,661,541,111,47,1530
Iowa,Marcus,1309,81,352,277,159,47,916
Iowa,Marble Rock,304,38,88,88,6,4,224
Iowa,Marathon,276,38,72,55,15,4,184
Iowa,Maquoketa,6029,346,1740,1347,398,181,4012
Iowa,Mapleton,1430,109,454,250,107,81,1001
Iowa,Manson,1843,74,519,501,141,52,1287
Iowa,Manning,1558,76,497,266,171,55,1065
Iowa,Manly,1464,69,360,361,64,28,882
Iowa,Manilla,979,94,293,227,62,12,688
Iowa,Rembrandt,146,18,36,32,9,2,97
Iowa,Manchester,5106,362,1465,1018,310,311,3466
Iowa,Maloy,24,0,4,8,3,1,16
Iowa,Mallard,308,20,119,76,15,3,233
Iowa,Malcom,282,24,111,49,26,4,214
Iowa,Maharishi Vedic City,738,7,62,162,98,117,446
Iowa,Magnolia,157,17,81,24,8,4,134
Iowa,Madrid,2554,158,725,581,205,77,1746
Iowa,Macksburg,130,12,39,25,12,2,90
Iowa,McIntire,117,23,47,25,0,2,97
Iowa,McGregor,776,35,233,221,48,50,587
Iowa,Macedonia,254,18,77,77,13,5,190
Iowa,McClelland,129,5,32,36,14,2,89
Iowa,McCausland,338,18,70,120,30,7,245
Iowa,Malvern,1063,72,254,261,108,55,750
Iowa,Remsen,1878,95,459,416,133,35,1138
Iowa,Renwick,291,23,81,78,27,5,214
Iowa,Rhodes,283,18,86,72,22,0,198
Iowa,Royal,429,13,120,118,33,4,288
Iowa,Rudd,373,26,115,96,27,4,268
Iowa,Runnells,541,9,168,131,32,6,346
Iowa,Russell,552,33,152,131,16,4,336
Iowa,Ruthven,721,50,142,197,60,7,456
Iowa,Rutland,115,13,31,25,2,3,74
Iowa,Ryan,355,38,125,77,26,5,271
Iowa,Sabula,496,34,228,86,20,10,378
Iowa,Sac City,2232,115,625,550,250,96,1636
Iowa,Sageville,82,3,27,32,5,3,70
Iowa,St. Ansgar,1057,43,314,219,130,54,760
Iowa,St. Anthony,115,8,19,27,7,0,61
Iowa,Rowley,316,6,102,70,15,13,206
Iowa,St. Benedict,24,0,4,6,4,2,16
Iowa,St. Donatus,132,2,58,32,12,0,104
Iowa,St. Joseph,78,5,12,4,4,0,25
Iowa,St. Lucas,164,20,45,39,22,6,132
Iowa,St. Marys,138,2,41,50,17,2,112
Iowa,St. Olaf,140,8,30,30,7,3,78
Iowa,St. Paul,89,3,20,34,10,5,72
Iowa,Salem,478,49,164,122,19,1,355
Iowa,Martelle,255,13,82,78,16,1,190
Iowa,Martensdale,463,20,103,158,14,5,300
Iowa,Martinsburg,148,9,35,32,4,3,83
Iowa,Marysville,64,5,24,5,0,0,34
Iowa,Mason City,27643,1391,5998,7820,2838,1172,19219
Iowa,St. Charles,659,18,154,147,73,16,408
Iowa,Massena,342,20,94,102,15,9,240
Iowa,Rowan,178,13,69,28,9,0,119
Iowa,Roseville,0,0,0,0,0,0,0
Iowa,Riceville,811,60,309,145,73,17,604
Iowa,Richland,665,39,145,158,61,13,416
Iowa,Rickardsville,166,8,61,30,16,5,120
Iowa,Ricketts,178,7,52,38,6,0,103
Iowa,Ridgeway,283,23,97,64,21,9,214
Iowa,Rinard,65,4,16,16,9,0,45
Iowa,Ringsted,432,20,100,137,39,7,303
Iowa,Rippey,210,18,69,51,8,4,150
Iowa,Riverdale,476,16,79,147,77,29,348
Iowa,Riverside,1060,49,288,248,65,64,714
Iowa,River Sioux,119,19,44,13,0,0,76
Iowa,Riverton,331,23,98,83,13,4,221
Iowa,Rossie,54,0,11,29,3,0,43
Iowa,Robins,3357,60,344,698,807,414,2323
Iowa,Rock Falls,168,6,47,59,5,2,119
Iowa,Rockford,824,38,225,185,73,26,547
Iowa,Rock Rapids,2592,202,595,447,330,112,1686
Iowa,Rock Valley,3553,261,734,675,364,75,2109
Iowa,Rockwell,1130,55,286,364,99,10,814
Iowa,Rockwell City,2155,113,603,570,215,28,1529
Iowa,Rodman,47,3,17,15,0,2,37
Iowa,Rodney,63,19,16,15,0,0,50
Iowa,Roland,1398,23,174,328,230,87,842
Iowa,Rolfe,568,58,150,120,50,10,388
Iowa,Rome,165,18,40,30,5,0,93
Iowa,Rose Hill,145,23,45,37,9,1,115
Iowa,Rochester,40,0,0,40,0,0,40
Iowa,Oxford Junction,516,45,155,139,12,4,355
Iowa,Preston,1079,106,315,233,52,24,730
Iowa,Owasa,53,0,25,7,3,1,36
Iowa,Dakota City,781,54,232,209,41,11,547
Iowa,Cylinder,72,1,14,25,4,1,45
Iowa,Cushing,195,7,58,41,14,0,120
Iowa,Curlew,71,1,35,11,4,0,51
Iowa,Cumming,435,4,71,101,91,37,304
Iowa,Cumberland,330,20,82,46,36,3,187
Iowa,Crystal Lake,185,6,92,45,3,5,151
Iowa,Cromwell,93,2,33,25,5,5,70
Iowa,Creston,7886,318,2089,2035,612,175,5229
Iowa,Cresco,3865,226,1173,760,227,192,2578
Iowa,Crescent,542,45,114,141,54,32,386
Iowa,Crawfordsville,287,34,58,92,12,7,203
Iowa,Craig,118,6,28,15,13,0,62
Iowa,Dallas Center,1734,52,341,350,298,100,1141
Iowa,Council Bluffs,62309,5357,14382,13985,5270,2034,41028
Iowa,Cotter,48,2,24,10,2,0,38
Iowa,Corydon,1431,111,428,316,107,87,1049
Iowa,Corwith,234,19,65,85,18,11,198
Iowa,Correctionville,806,57,269,140,63,22,551
Iowa,Corning,1570,106,463,373,134,66,1142
Iowa,Corley,43,8,9,0,26,0,43
Iowa,Coralville,20038,593,2226,2699,3836,3182,12536
Iowa,Coppock,69,5,12,18,6,0,41
Iowa,Coon Rapids,1395,73,337,319,181,23,933
Iowa,Conway,16,0,7,4,1,0,12
Iowa,Conroy,304,16,140,57,9,32,254
Iowa,Conrad,1099,65,222,324,102,44,757
Iowa,Conesville,534,117,134,51,5,4,311
Iowa,Coulter,276,32,74,78,12,4,200
Iowa,Dana,69,7,19,16,2,0,44
Iowa,Danbury,357,31,110,85,18,7,251
Iowa,Danville,1062,29,271,253,75,36,664
Iowa,Boone,12631,500,3134,3250,1509,351,8744
Iowa,Bondurant,4555,195,776,803,613,146,2533
Iowa,Bonaparte,398,24,102,109,13,1,249
Iowa,Bolan,37,0,0,13,0,0,13
Iowa,Bode,285,31,102,79,10,4,226
Iowa,Blue Grass,1439,113,375,354,107,80,1029
Iowa,Bloomfield,2615,139,739,705,211,106,1900
Iowa,Blockton,157,10,40,40,7,8,105
Iowa,Blencoe,239,15,72,46,14,10,157
Iowa,Blanchard,36,6,14,8,0,0,28
Iowa,Blakesburg,291,29,86,68,20,2,205
Iowa,Blairstown,757,69,233,152,25,6,485
Iowa,Blairsburg,112,6,39,31,10,5,91
Iowa,Oxford,895,57,237,199,82,41,616
Iowa,Birmingham,545,19,168,129,41,11,368
Iowa,Bevington,43,6,11,12,0,0,29
Iowa,Bettendorf,34663,713,4720,6842,6963,4690,23928
Iowa,Bertram,394,10,56,118,45,23,252
Iowa,Delhi,412,28,155,87,51,14,335
Iowa,Delaware,138,14,51,31,12,6,114
Iowa,Defiance,228,15,102,39,12,4,172
Iowa,Deep River,302,29,84,66,21,2,202
Iowa,Dedham,242,8,68,49,12,0,137
Iowa,Decorah,8009,236,1337,1063,1056,854,4546
Iowa,Decatur City,202,28,59,39,9,0,135
Iowa,Dayton,785,74,185,232,56,19,566
Iowa,Dawson,197,24,30,53,10,0,117
Iowa,Davis City,252,35,94,40,5,0,174
Iowa,Davenport,101863,6325,20369,22305,12151,6103,67253
Iowa,Colwell,83,2,21,19,5,1,48
Iowa,Columbus Junction,2120,438,423,324,85,50,1320
Iowa,Camanche,4387,99,1230,1212,417,177,3135
Iowa,Calumet,208,4,63,61,21,0,149
Iowa,Clive,16634,672,1527,2620,4242,2045,11106
Iowa,Clio,114,5,37,15,14,2,73
Iowa,Clinton,26413,1986,6551,6152,2415,1088,18192
Iowa,Brandon,312,38,101,73,16,2,230
Iowa,Bradgate,67,2,21,30,1,0,54
Iowa,Bradford,78,9,61,8,0,0,78
Iowa,Braddyville,154,3,55,49,9,5,121
Iowa,Mount Union,99,10,31,23,5,0,69
Iowa,Mount Vernon,4523,70,194,492,732,603,2091
Iowa,Moville,1481,29,324,344,170,92,959
Iowa,Murray,590,40,185,183,19,10,437
Iowa,Muscatine,23888,2241,5279,5046,1991,782,15339
Iowa,Mystic,410,54,148,73,13,2,290
Iowa,Nashua,1614,63,465,366,98,61,1053
Iowa,Nemaha,78,12,19,12,5,0,48
Iowa,Neola,909,18,189,271,90,28,596
Iowa,Nevada,6799,416,1403,1900,682,259,4660
Iowa,New Albin,646,21,183,166,54,1,425
Iowa,Newell,1174,64,284,228,103,27,706
Iowa,Newhall,944,18,228,246,104,36,632
Iowa,New Hampton,3510,289,948,698,341,92,2368
Iowa,New Hartford,586,15,180,148,42,8,393
Iowa,New Haven,51,0,23,21,7,0,51
Iowa,New Liberty,148,6,49,31,9,2,97
Iowa,New London,1819,84,509,510,133,53,1289
Iowa,New Market,382,17,135,94,25,10,281
Iowa,New Providence,226,7,48,50,39,6,150
Iowa,New Sharon,1298,52,379,258,99,49,837
Iowa,Nodaway,122,8,19,37,13,1,78
Iowa,Clutier,205,32,40,64,10,3,149
Iowa,Bouton,190,9,56,40,9,1,115
Iowa,Coalville,542,11,168,131,20,0,330
Iowa,Coggon,730,54,169,141,55,21,440
Iowa,Calmar,1049,49,229,226,79,40,623
Iowa,Callender,425,41,93,100,26,5,265
Iowa,California Junction,117,26,17,48,6,0,97
Iowa,Calamus,422,12,122,131,18,2,285
Iowa,Bussey,482,35,147,95,25,14,316
Iowa,Burt,550,44,148,127,20,7,346
Iowa,Burr Oak,306,20,112,59,11,0,202
Iowa,Burlington,25537,1805,6146,6010,2471,1125,17557
Iowa,Burchinal,67,0,13,25,6,0,44
Iowa,Buffalo Center,886,34,243,216,106,32,631
Iowa,Buffalo,1217,143,402,307,38,13,903
Iowa,Buck Grove,21,1,12,8,0,0,21
Iowa,Buckeye,88,10,39,7,3,0,59
Iowa,Brunsville,93,2,38,24,14,1,79
Iowa,Brooklyn,1476,72,432,234,122,55,915
Iowa,Bronson,339,6,85,77,33,6,207
Iowa,Britt,1966,147,520,553,147,67,1434
Iowa,Bristow,183,18,50,34,5,0,107
Iowa,Brighton,606,38,267,110,11,5,431
Iowa,Bridgewater,141,2,45,44,11,8,110
Iowa,Breda,478,5,131,121,50,7,314
Iowa,Brayton,132,14,41,37,1,6,99
Iowa,Columbus City,405,98,95,64,18,7,282
Iowa,Colo,884,37,210,209,78,17,551
Iowa,Collins,462,16,113,103,43,8,283
Iowa,College Springs,223,12,59,48,16,9,144
Iowa,Colfax,1848,81,518,366,178,75,1218
Iowa,Colesburg,402,44,141,85,29,3,302
Iowa,Coin,213,28,53,51,7,15,154
Iowa,Coburg,47,6,7,8,2,2,25
Iowa,Boxholm,230,8,86,41,18,0,153
Iowa,Marshalltown,27770,3923,5298,5286,2296,1150,17953
Iowa,Dexter,911,28,210,203,99,43,583
Iowa,Charles City,7500,753,1763,1754,749,167,5186
Iowa,Charlotte,398,14,86,119,23,9,251
Iowa,Charter Oak,601,57,166,145,42,17,427
Iowa,Chatsworth,69,9,18,19,0,3,49
Iowa,Chelsea,204,42,42,39,6,4,133
Iowa,Cherokee,5147,471,1176,1307,490,156,3600
Iowa,Chester,241,12,63,52,2,8,137
Iowa,Chillicothe,102,12,23,17,11,2,65
Iowa,Churdan,370,22,122,73,26,10,253
Iowa,Cincinnati,329,40,118,61,22,2,243
Iowa,Chariton,4240,352,1366,902,286,88,2994
Iowa,Clare,232,4,47,84,14,0,149
Iowa,Clarinda,5476,461,1202,1342,589,250,3844
Iowa,Clarion,2788,172,674,566,293,71,1776
Iowa,Clarksville,1335,121,423,272,52,35,903
Iowa,Delta,260,28,74,72,13,2,189
Iowa,Delphos,20,7,3,0,0,0,10
Iowa,Deloit,395,72,104,62,3,12,253
Iowa,Delmar,497,26,159,104,47,2,338
Iowa,Boyden,752,63,154,190,43,12,462
Iowa,Clayton,42,4,18,10,4,6,42
Iowa,Clearfield,378,49,116,68,25,0,258
Iowa,Clarence,945,87,262,216,63,32,660
Iowa,Chapin,153,16,52,41,0,0,109
Iowa,Centralia,133,4,46,30,6,3,89
Iowa,Central City,1373,41,396,311,57,35,840
Iowa,Carson,845,58,187,186,91,25,547
Iowa,Carroll,10020,612,2634,2099,1194,446,6985
Iowa,Carpenter,117,8,23,40,10,0,81
Iowa,Carlisle,4120,78,842,980,607,175,2682
Iowa,Carbon,27,2,14,6,5,0,27
Iowa,Cantril,227,25,65,44,16,2,152
Iowa,Cambridge,806,36,172,174,105,19,506
Iowa,Diagonal,332,39,112,67,20,5,243
Iowa,Casey,394,22,126,70,20,4,242
Iowa,De Witt,5283,119,931,1404,743,306,3503
Iowa,De Soto,1159,47,255,285,133,18,738
Iowa,Des Moines,208020,17028,41288,42024,23652,9959,133951
Iowa,Derby,132,14,32,43,2,0,91
Iowa,Denver,1789,28,430,433,255,84,1230
Iowa,Denmark,350,33,76,94,30,16,249
Iowa,Denison,8383,1662,1406,1188,465,163,4884
Iowa,Castalia,170,20,66,31,20,3,140
Iowa,Castana,105,7,43,38,0,2,90
Iowa,Cedar Falls,40439,994,4798,6152,5791,3810,21545
Iowa,Cedar Rapids,128829,5453,22952,29946,17591,8128,84070
Iowa,Center Junction,93,11,42,23,1,4,81
Iowa,Center Point,2478,67,576,599,255,86,1583
Iowa,Centerville,5431,501,1187,1508,470,189,3855
Iowa,Clear Lake,7675,263,1631,2057,1128,350,5429
Iowa,Carter Lake,3771,305,1015,777,337,100,2534
Iowa,Cleghorn,218,7,65,73,11,12,168
Iowa,Cascade,1984,160,615,352,233,77,1437
Iowa,Oelwein,6275,612,1689,1358,411,222,4292
Iowa,Ogden,2114,70,539,522,225,77,1433
Iowa,Okoboji,833,20,103,232,200,80,635
Iowa,Olds,200,9,61,36,16,10,132
Iowa,Olin,718,43,278,130,16,8,475
Iowa,Ollie,225,39,77,54,7,4,181
Iowa,Onawa,2921,145,869,734,227,54,2029
Iowa,Onslow,201,11,77,53,9,6,156
Iowa,Orange City,6147,160,981,1064,850,425,3480
Iowa,Orient,369,15,124,102,30,3,274
Iowa,Orchard,34,2,9,17,1,0,29
Iowa,Osage,3640,147,1177,787,331,136,2578
Iowa,Osceola,4985,478,1441,751,278,129,3077
Iowa,Oskaloosa,11558,689,2753,2477,1313,499,7731
Iowa,Ossian,979,44,265,240,67,40,656
Iowa,Osterdock,68,3,27,23,3,0,56
Iowa,Otho,505,46,138,161,17,2,364
Iowa,Oto,106,12,20,27,2,4,65
Iowa,Otranto,7,0,7,0,0,0,7
Iowa,Ottosen,56,6,19,13,3,1,42
Iowa,Ottumwa,24758,2585,5892,5266,1657,907,16307
Iowa,Orleans,465,10,104,144,96,65,419
Iowa,Clemons,125,6,42,27,7,2,84
Kansas,Lyndon,1068,72,213,210,149,58,702
Kansas,Great Bend,15850,1613,3309,3446,1176,448,9992
Kansas,Lyons,3731,409,727,875,260,132,2403
Kansas,Leonardville,410,15,137,99,30,22,303
Kansas,Lowell,344,49,80,122,0,0,251
Kansas,Leoti,1502,259,300,280,82,39,960
Kansas,LeRoy,612,33,150,155,41,8,387
Kansas,Levant,71,0,15,10,0,0,25
Kansas,Lewis,396,80,88,82,23,8,281
Kansas,Liberal,20819,4271,2968,3182,981,378,11780
Kansas,Liberty,225,16,30,94,6,0,146
Kansas,Liebenthal,117,12,42,36,5,1,96
Kansas,Lincoln Center,1312,94,334,370,102,45,945
Kansas,Protection,502,56,107,132,60,6,361
Kansas,Lindsborg,3441,94,431,742,568,293,2128
Kansas,Linn,471,106,97,88,29,11,331
Kansas,Linn Valley,811,62,217,207,104,54,644
Kansas,Linwood,407,42,150,63,25,2,282
Kansas,Little River,553,31,129,127,56,9,352
Kansas,Logan,498,31,120,147,52,25,375
Kansas,Lone Elm,23,6,7,5,5,0,23
Kansas,Longford,222,6,29,51,49,0,135
Kansas,Long Island,177,6,40,41,18,3,108
Kansas,Longton,340,31,79,90,30,7,237
Kansas,Lorraine,187,10,48,42,12,2,114
Kansas,Lost Springs,86,13,42,13,0,1,69
Kansas,Louisburg,4294,161,730,1145,541,237,2814
Kansas,Louisville,287,32,79,42,11,2,166
Kansas,Lucas,444,15,110,145,41,8,319
Kansas,Luray,276,12,76,51,33,15,187
Kansas,Deerfield,742,166,89,163,12,16,446
Kansas,Sterling,2313,109,354,404,273,174,1314
Kansas,Cottonwood Falls,939,78,259,194,97,30,658
Kansas,Corning,151,3,26,24,22,1,76
Kansas,Copeland,294,41,61,65,29,6,202
Kansas,Coolidge,122,12,23,23,24,3,85
Kansas,Conway Springs,1551,96,314,308,77,74,869
Kansas,Concordia,5289,354,1194,1377,321,300,3546
Kansas,Colwich,1385,18,225,252,215,70,780
Kansas,Dresden,66,19,10,10,6,0,45
Kansas,Colony,408,18,143,105,20,10,296
Kansas,Collyer,83,1,22,26,7,1,57
Kansas,Coldwater,824,60,210,230,57,36,593
Kansas,Colby,5450,274,1066,1177,529,366,3412
Kansas,Coffeyville,9921,1091,2078,2588,529,283,6569
Kansas,Coats,169,37,28,29,0,3,97
Kansas,Clyde,782,49,193,219,59,14,534
Kansas,Climax,38,12,11,7,2,0,32
Kansas,Clifton,574,31,163,149,40,17,400
Kansas,Council Grove,2319,236,545,600,163,106,1650
Kansas,Courtland,371,23,60,104,47,12,246
Kansas,Coyville,37,4,7,11,0,1,23
Kansas,Cuba,192,8,53,64,14,4,143
Kansas,Delia,149,9,46,31,3,0,89
Kansas,Delphos,437,25,109,127,36,12,309
Kansas,Denison,183,17,38,45,11,3,114
Kansas,Denton,162,2,42,47,29,6,126
Kansas,Derby,23731,577,2955,5537,4329,1837,15235
Kansas,De Soto,5941,369,916,1334,665,399,3683
Kansas,Detroit,388,53,56,23,31,0,163
Kansas,Dexter,370,39,102,114,24,14,293
Kansas,Clearwater,2566,95,459,628,406,102,1690
Kansas,Dighton,961,32,208,286,94,31,651
Kansas,Dorrance,184,1,59,62,6,5,133
Kansas,Douglass,1895,128,446,370,144,74,1162
Kansas,Downs,974,60,293,251,71,63,738
Kansas,Danville,50,2,12,17,3,1,35
Kansas,Damar,158,13,18,44,16,3,94
Kansas,Cunningham,416,18,82,120,43,22,285
Kansas,Culver,100,13,34,28,4,2,81
Kansas,Cullison,44,8,8,19,0,2,37
Kansas,Dodge City,28045,5445,3574,4237,1954,724,15934
Kansas,Dearing,523,39,73,139,59,23,333
Kansas,Clayton,88,16,15,22,5,2,60
Kansas,Claflin,606,37,153,165,62,18,435
Kansas,Sharon,147,16,57,34,6,0,113
Kansas,Sharon Springs,701,68,182,157,70,30,507
Kansas,Shawnee,64125,2224,8870,12353,12111,6310,41868
Kansas,Silver Lake,1780,29,347,410,202,62,1050
Kansas,Simpson,59,5,17,29,5,0,56
Kansas,Smith Center,1558,101,386,513,118,55,1173
Kansas,Smolan,185,12,45,44,23,8,132
Kansas,Soldier,115,7,40,22,4,0,73
Kansas,Solomon,1173,74,273,283,62,31,723
Kansas,South Haven,287,33,48,92,26,6,205
Kansas,South Hutchinson,2392,323,628,579,141,83,1754
Kansas,Spearville,733,40,139,184,110,42,515
Kansas,Speed,49,2,15,10,4,1,32
Kansas,Spivey,45,9,22,10,0,0,41
Kansas,Spring Hill,5739,165,1092,1326,682,244,3509
Kansas,Stafford,1130,92,232,286,125,38,773
Kansas,Stark,81,3,21,34,1,0,59
Kansas,Seward,38,5,19,9,0,0,33
Kansas,Severy,286,28,104,67,10,5,214
Kansas,Severance,91,9,30,17,0,1,57
Kansas,Seneca,2006,152,651,373,187,83,1446
Kansas,Circleville,160,4,47,26,20,9,106
Kansas,Cimarron,2093,189,289,455,211,73,1217
Kansas,Dunlap,15,1,3,4,2,0,10
Kansas,Chicopee,551,30,84,99,65,104,382
Kansas,Chetopa,1275,124,343,228,67,32,794
Kansas,Durham,118,18,44,14,8,3,87
Kansas,Dwight,232,23,62,41,9,11,146
Kansas,Earlton,48,9,9,18,0,0,36
Kansas,Clay Center,4240,123,1006,1119,469,299,3016
Kansas,Eastborough,736,12,33,103,185,193,526
Kansas,Edgerton,1706,99,322,366,170,71,1028
Kansas,Edmond,55,0,30,12,0,0,42
Kansas,Edna,435,15,98,124,41,22,300
Kansas,Scranton,637,65,164,151,39,14,433
Kansas,Sedan,1129,111,322,196,103,26,758
Kansas,Sedgwick,1867,69,315,506,171,83,1144
Kansas,Cherryvale,2221,210,541,474,166,103,1494
Kansas,Selden,321,14,45,105,29,6,199
Kansas,Easton,352,54,104,48,25,11,242
Kansas,Columbus,3207,385,917,644,208,204,2358
Kansas,Lincolnville,244,22,75,31,21,17,166
Kansas,Cheney,1929,70,390,413,291,133,1297
Kansas,La Crosse,1295,98,325,347,102,100,972
Kansas,Labette,44,7,15,12,4,0,38
Kansas,Kismet,297,33,63,68,19,5,188
Kansas,Kirwin,182,8,80,20,12,2,122
Kansas,Kipp,151,0,27,30,0,0,57
Kansas,Kiowa,998,80,235,196,90,83,684
Kansas,Kinsley,1402,200,364,331,106,46,1047
Kansas,Kingman,3128,322,823,751,239,89,2224
Kansas,Kincaid,174,15,28,51,3,0,97
Kansas,Kickapoo Tribal Center,201,14,43,50,10,14,131
Kansas,Kickapoo Site 7,43,2,14,14,0,0,30
Kansas,Kickapoo Site 6,20,0,2,7,3,0,12
Kansas,Kickapoo Site 5,67,3,29,3,3,2,40
Kansas,Kickapoo Site 2,44,0,10,11,0,0,21
Kansas,Kickapoo Site 1,93,20,3,23,0,0,46
Kansas,Kensington,468,41,136,102,47,25,351
Kansas,Kechi,2180,39,345,442,384,256,1466
Kansas,Kansas City,148855,20613,30019,27480,9894,4739,92745
Kansas,Kanorado,141,41,31,36,3,0,111
Kansas,Abbyville,92,3,30,32,2,0,67
Kansas,Abilene,6671,679,1515,1340,620,425,4579
Kansas,Ada,53,15,12,26,0,0,53
Kansas,Admire,128,6,50,28,11,3,98
Kansas,Agenda,75,2,9,27,8,3,49
Kansas,Agra,255,10,65,76,22,7,180
Kansas,Albert,166,5,65,43,28,2,143
Kansas,Alden,96,7,33,25,4,3,72
Kansas,Alexander,31,3,8,13,4,3,31
Kansas,Allen,286,25,46,67,14,6,158
Kansas,La Cygne,1284,112,273,319,73,14,791
Kansas,La Harpe,542,50,167,143,26,4,390
Kansas,Lake Quivira,911,6,47,101,274,225,653
Kansas,Lakin,2028,271,356,455,132,99,1313
Kansas,Palco,169,4,40,31,27,6,108
Kansas,Palmer,179,25,30,40,9,5,109
Kansas,Paola,5570,197,1122,1333,396,226,3274
Kansas,Paradise,37,0,6,18,10,1,35
Kansas,Park,99,19,25,24,3,3,74
Kansas,Park City,7290,448,1352,1637,778,337,4552
Kansas,Parker,435,36,91,97,29,3,256
Kansas,Parkerfield,339,19,71,111,40,24,265
Kansas,Parkerville,70,1,23,11,4,2,41
Kansas,Parsons,10223,857,2021,2355,888,542,6663
Kansas,Partridge,265,51,81,33,18,3,186
Kansas,Pawnee Rock,221,16,56,59,12,2,145
Kansas,Leona,51,8,9,10,1,0,28
Kansas,Leon,678,47,143,169,22,17,398
Kansas,Alma,837,39,234,184,72,61,590
Kansas,Lenora,238,10,46,87,31,15,189
Kansas,Lehigh,182,4,46,42,16,5,113
Kansas,Lecompton,598,44,151,102,54,34,385
Kansas,Lebo,886,35,250,199,65,34,583
Kansas,Lebanon,309,30,84,67,21,4,206
Kansas,Leawood,33339,171,1405,4223,9529,7389,22717
Kansas,Leavenworth,35861,2097,6557,7148,3654,3332,22788
Kansas,Lawrence,91305,2342,8393,12349,13313,12645,49042
Kansas,Latimer,42,2,18,6,1,1,28
Kansas,Latham,128,11,34,38,0,0,83
Kansas,Larned,4011,258,656,1106,426,295,2741
Kansas,Lansing,11623,813,2355,2514,1299,945,7926
Kansas,Langdon,30,5,9,11,0,0,25
Kansas,Lane,218,16,110,59,3,1,189
Kansas,Lancaster,315,9,122,63,26,7,227
Kansas,Lenexa,50412,1546,4381,9456,11884,6861,34128
Kansas,Almena,493,23,117,143,43,10,336
Kansas,Altamont,1206,43,191,273,110,55,672
Kansas,Alta Vista,473,27,157,99,61,4,348
Kansas,Neodesha,2245,280,563,411,176,92,1522
Kansas,Neosho Falls,132,19,36,33,2,0,90
Kansas,Neosho Rapids,195,23,63,39,21,4,150
Kansas,Ness City,1520,95,436,357,199,43,1130
Kansas,Netawaka,176,13,53,36,10,3,115
Kansas,New Albany,32,6,11,4,1,1,23
Kansas,New Cambria,145,18,31,40,7,3,99
Kansas,New Strawn,388,4,67,103,87,19,280
Kansas,Peabody,1262,71,344,318,65,36,834
Kansas,Penalosa,15,0,7,8,0,0,15
Kansas,Perry,916,36,312,156,109,30,643
Kansas,Peru,161,29,53,31,3,0,116
Kansas,Phillipsburg,2525,175,603,631,187,108,1704
Kansas,Piqua,186,3,85,15,3,0,106
Kansas,Natoma,310,31,75,80,36,7,229
Kansas,Pittsburg,20382,1104,2366,3540,2115,1433,10558
Kansas,Plainville,1930,113,528,472,131,113,1357
Kansas,Pleasanton,1206,92,266,398,76,13,845
Kansas,Plevna,90,2,19,29,12,2,64
Kansas,Pomona,824,37,273,191,27,15,543
Kansas,Portis,101,8,13,32,8,0,61
Kansas,Potwin,458,19,116,98,22,10,265
Kansas,Powhattan,81,6,19,13,7,0,45
Kansas,Prairie View,183,9,42,38,35,0,124
Kansas,Prairie Village,21814,229,1406,3459,6488,4329,15911
Kansas,Pratt,6887,514,1260,1691,739,301,4505
Kansas,Prescott,238,29,77,51,17,6,180
Kansas,Preston,175,13,39,54,8,6,120
Kansas,Pretty Prairie,715,44,163,181,38,21,447
Kansas,Princeton,281,27,50,56,19,11,163
Kansas,Plains,1099,203,180,129,67,68,647
Kansas,Ozawkie,757,17,159,152,84,62,474
Kansas,Nashville,67,1,10,29,10,1,51
Kansas,Muscotah,201,10,61,42,6,2,121
Kansas,Alton,141,15,45,24,13,6,103
Kansas,Altoona,418,53,96,78,16,1,244
Kansas,Americus,841,65,279,190,48,23,605
Kansas,Andale,830,19,113,157,129,39,457
Kansas,Andover,12293,202,1029,2756,2175,1323,7485
Kansas,Anthony,2340,209,610,495,263,98,1675
Kansas,Arcadia,454,59,136,76,11,4,286
Kansas,Argonia,697,20,111,154,48,29,362
Kansas,Arkansas City,12253,950,2308,2938,882,350,7428
Kansas,Arlington,524,50,142,148,20,21,381
Kansas,Paxico,309,9,62,80,16,5,172
Kansas,Hugoton,3864,402,935,698,312,63,2410
Kansas,Humboldt,1826,141,423,535,113,68,1280
Kansas,Hunnewell,74,8,18,18,1,0,45
Kansas,Narka,113,6,40,32,3,0,81
Kansas,Hunter,68,0,30,17,0,1,48
Kansas,Hutchinson,41808,3527,7985,11239,3833,1795,28379
Kansas,Independence,9179,612,1718,2370,753,378,5831
Kansas,Ingalls,311,11,39,83,50,19,202
Kansas,Inman,1303,152,297,305,137,64,955
Kansas,Iola,5602,370,1154,1363,499,238,3624
Kansas,Isabel,98,5,57,20,0,0,82
Kansas,Iuka,207,20,43,41,22,5,131
Kansas,Jamestown,353,22,56,84,19,5,186
Kansas,Jennings,130,17,35,30,15,6,103
Kansas,Jetmore,879,45,153,294,108,36,636
Kansas,Jewell,434,26,119,111,36,16,308
Kansas,Johnson City,1339,177,258,258,126,31,850
Kansas,Junction City,24823,1184,4153,5622,2021,921,13901
Kansas,Kanopolis,415,57,122,113,29,8,329
Kansas,Huron,76,13,14,15,0,1,43
Kansas,Cherokee,846,48,152,200,43,27,470
Kansas,Oxford,1135,31,314,276,99,64,784
Kansas,Overbrook,977,74,231,211,94,82,692
Kansas,Healy,265,17,49,72,23,9,170
Kansas,Hepler,137,23,47,25,1,4,100
Kansas,Herington,2241,143,716,570,135,87,1651
Kansas,Herndon,133,12,45,32,10,1,100
Kansas,Hesston,3566,17,577,854,623,266,2337
Kansas,Hiawatha,3132,128,831,667,284,274,2184
Kansas,Highland,1053,27,101,140,57,29,354
Kansas,Hill City,1464,72,362,393,202,68,1097
Kansas,Hillsboro,2916,282,485,498,290,226,1781
Kansas,Hillsdale,270,15,59,57,35,36,202
Kansas,Hoisington,2666,230,593,615,187,90,1715
Kansas,Holcomb,2434,237,338,493,144,79,1291
Kansas,Hollenberg,21,4,5,10,2,0,21
Kansas,Holton,3284,196,878,753,337,149,2313
Kansas,Holyrood,400,13,83,149,39,6,290
Kansas,Home,164,0,93,40,0,5,138
Kansas,Hope,488,26,116,108,52,5,307
Kansas,Horace,152,14,46,29,15,0,104
Kansas,Horton,1746,119,520,354,84,50,1127
Kansas,Howard,741,48,217,183,62,42,552
Kansas,Hoxie,1251,120,307,314,121,61,923
Kansas,Hoyt,639,26,148,144,32,32,382
Kansas,Hudson,137,10,37,32,9,7,95
Kansas,Scottsville,10,3,5,2,0,0,10
Kansas,Scott City,3930,451,848,816,459,143,2717
Kansas,Schoenchen,193,7,61,33,28,4,133
Kansas,Scandia,430,27,94,95,40,25,281
Kansas,Scammon,454,47,104,96,39,10,296
Kansas,Sawyer,92,5,23,21,8,0,57
Kansas,Hazelton,144,9,56,30,3,3,101
Kansas,Haysville,11234,563,2503,2490,960,284,6800
Kansas,Haviland,797,38,75,176,75,72,436
Kansas,Havensville,148,4,68,37,10,4,123
Kansas,Chautauqua,68,17,34,4,2,2,59
Kansas,Chase,565,93,133,91,24,12,353
Kansas,Chapman,1441,71,319,354,152,83,979
Kansas,Chanute,9217,627,2000,2291,711,312,5941
Kansas,Centralia,550,54,105,116,45,21,341
Kansas,Cedar Vale,527,37,118,125,45,15,340
Kansas,Cedar Point,27,0,5,14,1,0,20
Kansas,Cedar,6,0,6,0,0,0,6
Kansas,Greeley,282,10,95,83,8,0,196
Kansas,Greeley County unified government (balance),388,41,71,127,63,18,320
Kansas,Green,125,13,24,38,9,4,88
Kansas,Greenleaf,390,52,122,64,20,10,268
Kansas,Greensburg,896,56,179,234,123,58,650
Kansas,Grenola,164,23,60,36,14,6,139
Kansas,Savonburg,139,20,16,25,32,2,95
Kansas,Gridley,294,13,91,74,33,2,213
Kansas,Gypsum,378,18,115,123,20,8,284
Kansas,Haddam,64,11,24,17,3,2,57
Kansas,Halstead,2305,168,330,551,239,79,1367
Kansas,Hamilton,239,7,51,67,27,1,153
Kansas,Hamlin,48,1,21,3,6,0,31
Kansas,Hanover,586,40,130,135,65,30,400
Kansas,Hanston,265,33,51,54,27,9,174
Kansas,Hardtner,147,17,27,34,25,3,106
Kansas,Harper,1309,140,333,325,54,49,901
Kansas,Harris,11,11,0,0,0,0,11
Kansas,Hartford,384,30,109,75,35,10,259
Kansas,Harveyville,212,12,64,48,14,5,143
Kansas,Havana,144,42,21,29,14,0,106
Kansas,Haven,1243,45,305,332,102,41,825
Kansas,Grinnell,276,15,79,76,31,6,207
Kansas,Satanta,1019,178,156,204,54,45,637
Kansas,Salina,47840,3509,10355,10077,4648,2544,31133
Kansas,St. Paul,689,41,116,157,49,51,414
Kansas,Newton,19139,1499,4191,3978,1853,1093,12614
Kansas,Nickerson,1181,88,260,277,59,58,742
Kansas,Niotaze,105,10,31,30,2,0,73
Kansas,Norcatur,185,21,52,43,9,3,128
Kansas,North Newton,1782,53,202,294,285,256,1090
Kansas,Norton,2856,258,580,766,291,57,1952
Kansas,Nortonville,529,35,148,102,35,22,342
Kansas,Norwich,489,15,99,118,67,13,312
Kansas,Oak Hill,51,1,6,11,0,0,18
Kansas,Oaklawn-Sunview,2906,414,889,505,33,10,1851
Kansas,Oakley,1914,64,506,524,158,81,1333
Kansas,Oberlin,1890,117,612,345,233,127,1434
Kansas,Odin,78,3,47,16,0,0,66
Kansas,Offerle,255,17,30,55,40,6,148
Kansas,Quinter,1007,32,247,240,132,44,695
Kansas,Ogden,2010,157,226,524,115,61,1083
Kansas,Olathe,131508,4957,14528,24969,25425,12094,81973
Kansas,Olivet,84,2,29,26,2,1,60
Kansas,Olmitz,138,21,48,27,9,4,109
Kansas,Olpe,595,21,184,115,57,35,412
Kansas,Olsburg,238,8,63,69,15,6,161
Kansas,Onaga,746,35,234,190,57,22,538
Kansas,Oneida,59,10,28,8,2,0,48
Kansas,Osage City,2885,199,783,593,306,108,1989
Kansas,Osawatomie,4373,175,1125,1253,155,27,2735
Kansas,Osborne,1463,126,338,331,176,47,1018
Kansas,Oskaloosa,1338,70,448,270,106,16,910
Kansas,Oswego,1847,118,512,477,105,73,1285
Kansas,Otis,334,29,91,79,28,4,231
Kansas,Ottawa,12487,794,2719,2730,1112,567,7922
Kansas,Oketo,69,2,37,10,3,2,54
Kansas,Overland Park,181464,4182,15393,32586,45259,27202,124622
Kansas,Radium,35,1,18,4,4,0,27
Kansas,Randall,90,4,33,16,4,0,57
Kansas,St. Marys,2797,57,493,552,154,138,1394
Kansas,St. John,1414,137,217,362,151,56,923
Kansas,St. George,852,21,76,216,86,33,432
Kansas,St. Francis,1239,87,282,345,163,66,943
Kansas,Sabetha,2557,207,595,530,319,146,1797
Kansas,Russell Springs,34,0,4,14,0,0,18
Kansas,Russell,4499,411,973,939,389,450,3162
Kansas,Rush Center,137,10,34,48,2,7,101
Kansas,Rozel,171,13,34,50,11,11,119
Kansas,Roxbury,57,17,27,13,0,0,57
Kansas,Rossville,1177,86,283,249,145,43,806
Kansas,Roseland,64,7,21,11,4,0,43
Kansas,Rose Hill,3961,178,698,1032,421,270,2599
Kansas,Rosalia,86,9,23,6,10,0,48
Kansas,Ramona,116,17,27,18,9,0,71
Kansas,Rolla,463,41,64,98,36,20,259
Kansas,Robinson,234,13,60,54,16,6,149
Kansas,Riverton,934,38,294,252,110,40,734
Kansas,Riley,971,46,183,240,107,41,617
Kansas,Richmond,540,33,156,136,20,14,359
Kansas,Richfield,34,1,10,13,4,0,28
Kansas,Rexford,235,20,37,57,23,3,140
Kansas,Reserve,68,19,19,14,3,0,55
Kansas,Republic,86,7,21,38,0,1,67
Kansas,Redfield,81,9,28,15,0,0,52
Kansas,Reading,298,25,54,49,12,10,150
Kansas,Raymond,65,4,24,24,1,0,53
Kansas,Rantoul,121,16,39,23,15,4,97
Kansas,Ransom,295,12,82,99,8,26,227
Kansas,Randolph,166,1,41,46,19,9,116
Kansas,Roeland Park,6819,170,915,1375,1656,937,5053
Kansas,Hays,20992,671,3026,4050,2868,1511,12126
Kansas,Quenemo,424,70,161,53,3,0,287
Kansas,Atchison,10858,416,2093,2087,774,585,5955
Kansas,Wilroads Gardens,388,124,54,62,19,5,264
Kansas,Wilmore,26,0,15,6,1,0,22
Kansas,Stockton,1334,72,350,288,158,87,955
Kansas,Strong City,495,49,144,113,46,11,363
Kansas,Sublette,1540,165,241,352,154,82,994
Kansas,Summerfield,138,10,60,27,13,1,111
Kansas,Sun City,38,4,10,22,2,0,38
Kansas,Susank,32,4,13,12,3,0,32
Kansas,Sylvan Grove,297,16,78,80,31,19,224
Kansas,Sylvia,256,31,44,68,4,2,149
Kansas,Syracuse,1791,261,342,398,100,32,1133
Kansas,Talmage,90,0,11,41,0,0,52
Kansas,Tampa,107,4,39,14,14,3,74
Kansas,Tescott,298,10,72,64,22,13,181
Kansas,Thayer,577,17,110,183,19,9,338
Kansas,Timken,87,5,8,21,0,6,40
Kansas,Tipton,210,3,54,69,27,4,157
Kansas,Tonganoxie,4681,250,1239,792,551,329,3161
Kansas,Topeka,127672,9608,26298,25360,14468,8671,84405
Kansas,Wilsey,164,13,62,40,4,3,122
Kansas,Wilson,750,54,185,197,65,36,537
Kansas,Winchester,565,61,163,121,40,21,406
Kansas,Edwardsville,4372,357,1116,907,275,138,2793
Kansas,Esbon,147,12,24,47,6,6,95
Kansas,Erie,1092,49,249,288,85,60,731
Kansas,Enterprise,975,65,224,270,46,18,623
Kansas,Ensign,218,63,53,31,10,5,162
Kansas,Englewood,84,1,31,23,0,0,55
Kansas,Emporia,24739,1983,4270,3959,2399,1204,13815
Kansas,Emmett,128,14,43,17,1,0,75
Kansas,Elwood,1027,114,393,179,17,11,714
Kansas,Elsmore,93,15,25,21,0,0,61
Kansas,Toronto,273,14,97,80,18,4,213
Kansas,Elmdale,49,16,5,24,4,0,49
Kansas,Ellis,2120,181,501,396,258,132,1468
Kansas,Ellinwood,2520,254,609,551,164,77,1655
Kansas,Elkhart,2159,207,489,520,127,32,1375
Kansas,Elk Falls,57,11,14,13,0,7,45
Kansas,Elk City,285,29,90,53,12,2,186
Kansas,Elgin,98,18,37,15,3,0,73
Kansas,El Dorado,12910,676,2465,3272,1145,531,8089
Kansas,Elbing,285,4,40,66,45,15,170
Kansas,Effingham,621,30,208,109,38,18,403
Kansas,Ellsworth,3075,293,848,707,373,112,2333
Kansas,Towanda,1625,34,261,414,127,35,871
Kansas,Tribune,684,51,154,133,104,28,470
Kansas,Troy,991,64,228,274,64,9,639
Kansas,Waterville,674,24,199,207,46,18,494
Kansas,Wathena,1312,120,342,323,135,77,997
Kansas,Waverly,607,36,139,124,93,17,409
Kansas,Webber,20,2,7,9,2,0,20
Kansas,Weir,585,66,134,140,67,9,416
Kansas,Welda,73,0,51,22,0,0,73
Kansas,Wellington,7997,465,2135,1791,729,369,5489
Kansas,Wellsville,1880,50,375,497,195,39,1156
Kansas,Weskan,207,9,52,44,23,2,130
Kansas,Washington,1166,57,375,298,84,19,833
Kansas,West Mineral,239,29,49,71,11,0,160
Kansas,Westphalia,173,15,59,28,8,2,112
Kansas,Westwood,1795,44,144,231,527,364,1310
Kansas,Westwood Hills,446,5,18,50,136,132,341
Kansas,Wetmore,345,7,82,67,18,17,191
Kansas,Wheaton,156,4,39,27,4,5,79
Kansas,White City,524,34,179,135,19,3,370
Kansas,White Cloud,242,23,65,40,7,3,138
Kansas,Whitewater,700,44,142,152,84,49,471
Kansas,Bentley,542,50,103,135,36,13,337
Kansas,Westmoreland,868,43,223,188,61,53,568
Kansas,Eskridge,531,30,202,104,52,10,398
Kansas,Wamego,4349,85,614,1060,641,358,2758
Kansas,Walnut,301,38,54,67,6,2,167
Kansas,Turon,313,58,69,83,13,1,224
Kansas,Tyro,258,24,50,67,27,5,173
Kansas,Udall,738,61,189,166,49,35,500
Kansas,Ulysses,6022,1062,1019,792,511,176,3560
Kansas,Uniontown,441,19,46,100,36,20,221
Kansas,Utica,137,11,44,39,9,5,108
Kansas,Valley Center,6586,216,1413,1391,975,330,4325
Kansas,Valley Falls,1060,97,343,238,72,25,775
Kansas,Vassar,723,29,266,192,56,26,569
Kansas,Walton,255,12,90,74,13,5,194
Kansas,Vermillion,127,13,32,27,16,3,91
Kansas,Vining,45,0,5,17,1,0,23
Kansas,Viola,131,14,39,40,5,1,99
Kansas,Virgil,28,10,12,4,0,0,26
Kansas,Wakarusa,323,22,85,101,46,30,284
Kansas,WaKeeney,1889,102,428,463,227,96,1316
Kansas,Wakefield,1000,15,197,283,75,33,603
Kansas,Waldo,45,3,14,15,1,7,40
Kansas,Waldron,16,2,4,8,0,0,14
Kansas,Wallace,52,0,10,13,9,0,32
Kansas,Victoria,1357,39,311,343,172,45,910
Kansas,Eudora,6276,321,1234,1078,871,375,3879
Kansas,Eureka,2419,164,682,604,171,90,1711
Kansas,Everest,296,19,94,63,28,4,208
Kansas,Buffalo,312,35,63,92,8,5,203
Kansas,Buhler,1400,44,220,360,206,67,897
Kansas,Bunker Hill,113,17,38,21,3,4,83
Kansas,Burden,533,24,121,136,45,15,341
Kansas,Burdett,304,12,33,72,44,34,195
Kansas,Burlingame,886,74,271,167,51,21,584
Kansas,Burlington,2629,184,728,597,262,92,1863
Kansas,Burns,366,66,86,50,18,4,224
Kansas,Burr Oak,166,27,56,41,19,2,145
Kansas,Bucyrus,264,9,94,59,36,0,198
Kansas,Burrton,1046,39,294,207,88,25,653
Kansas,Bushton,264,16,75,78,19,11,199
Kansas,Byers,38,0,9,9,0,0,18
Kansas,Caldwell,1085,72,304,285,81,40,782
Kansas,Cambridge,118,6,13,63,4,0,86
Kansas,Caney,2052,182,442,560,135,54,1373
Kansas,Canton,827,73,233,207,40,16,569
Kansas,Carbondale,1409,64,297,329,100,19,809
Kansas,Carlton,14,1,6,3,2,0,12
Kansas,Cassoday,103,3,25,35,8,2,73
Kansas,Bushong,42,9,5,4,4,0,22
Kansas,Catharine,53,0,0,32,0,0,32
Kansas,Bucklin,894,66,139,290,76,40,611
Kansas,Brookville,311,21,53,80,21,7,182
Kansas,Winona,240,11,63,60,18,10,162
Kansas,Woodbine,188,31,33,34,23,0,121
Kansas,Woodston,140,28,34,34,4,0,100
Kansas,Wright,102,26,4,37,13,5,85
Kansas,Yates Center,1284,72,349,316,176,37,950
Kansas,Yoder,242,19,8,70,44,0,141
Kansas,Zenda,97,14,34,24,6,2,80
Kansas,Zurich,104,7,53,23,1,0,84
Kansas,Benton,949,27,125,238,175,46,611
Kansas,Brownell,46,2,6,15,10,2,35
Kansas,Bern,192,14,44,34,23,10,125
Kansas,Bird City,499,43,73,141,60,4,321
Kansas,Bison,196,16,56,41,15,18,146
Kansas,Blue Mound,262,37,67,79,2,6,191
Kansas,Blue Rapids,1018,62,335,189,51,17,654
Kansas,Bluff City,74,15,17,18,0,1,51
Kansas,Bogue,298,21,56,52,36,6,171
Kansas,Bonner Springs,7498,519,1990,1524,633,344,5010
Kansas,Brewster,250,16,52,82,25,9,184
Kansas,Bronson,378,23,109,87,17,1,237
Kansas,Beverly,160,6,52,39,2,0,99
Kansas,Bennington,772,27,96,203,74,37,437
Kansas,Grantville,48,0,33,15,0,0,48
Kansas,Grainfield,329,23,98,67,29,5,222
Kansas,Galatia,14,0,4,8,1,1,14
Kansas,Fulton,137,10,37,25,9,1,82
Kansas,Frontenac,3445,156,606,951,459,242,2414
Kansas,Freeport,0,0,0,0,0,0,0
Kansas,Fredonia,2455,205,570,584,176,87,1622
Kansas,Frederick,8,6,0,2,0,0,8
Kansas,Franklin,715,92,126,250,28,15,511
Kansas,Frankfort,746,67,213,201,76,20,577
Kansas,Fowler,441,60,95,90,47,19,311
Kansas,Galena,2988,374,594,649,207,124,1948
Kansas,Fort Scott,7893,612,1577,1781,704,499,5173
Kansas,Fort Dodge,215,16,125,38,22,14,215
Kansas,Formoso,111,7,27,21,3,2,60
Kansas,Ford,281,18,75,51,21,0,165
Kansas,Fontana,145,18,47,31,11,0,107
Kansas,Florence,415,30,143,100,25,11,309
Kansas,Falun,109,16,47,19,0,0,82
Kansas,Fall River,179,13,62,35,12,2,124
Kansas,Fairway,3964,10,217,555,1203,886,2871
Kansas,Fairview,261,20,78,70,14,2,184
Kansas,Fort Riley,7015,30,761,1317,251,36,2395
Kansas,Grandview Plaza,2110,131,337,518,57,3,1046
Kansas,Galesburg,102,8,15,27,9,10,69
Kansas,Garden City,27007,4632,3649,4722,1887,921,15811
Kansas,Gove City,96,0,30,25,10,3,68
Kansas,Gorham,351,16,81,78,19,4,198
Kansas,Goodland,4834,383,1087,1334,277,132,3213
Kansas,Goff,111,9,24,28,5,0,66
Kansas,Goessel,605,35,150,151,52,33,421
Kansas,Cawker City,511,40,140,143,47,24,394
Kansas,Goddard,4256,230,558,879,593,198,2458
Kansas,Glen Elder,507,13,115,141,51,8,328
Kansas,Glasco,460,28,115,111,54,21,329
Kansas,Galva,903,55,218,233,63,25,594
Kansas,Glade,65,6,16,33,2,0,57
Kansas,Geuda Springs,193,26,53,50,1,6,136
Kansas,Geneseo,282,18,82,81,8,7,196
Kansas,Gem,86,1,19,24,16,1,61
Kansas,Gaylord,136,15,34,20,7,2,78
Kansas,Gas,606,44,126,151,12,24,357
Kansas,Garnett,3306,193,780,848,206,215,2242
Kansas,Garfield,243,49,59,60,9,9,186
Kansas,Gardner,20466,671,2941,4633,2722,1116,12083
Kansas,Garden Plain,805,45,176,145,103,47,516
Kansas,Girard,2788,169,680,607,264,136,1856
Kansas,Winfield,12286,809,2573,2798,1086,639,7905
Kansas,Benedict,57,19,9,21,0,0,49
Kansas,Belvue,241,6,56,58,6,0,126
Kansas,Bendena,69,0,6,29,8,14,57
Kansas,Mayetta,337,18,59,55,17,13,162
Kansas,Mayfield,94,11,17,27,6,1,62
Kansas,Meade,1702,96,418,375,226,54,1169
Kansas,Medicine Lodge,2056,117,474,500,175,128,1394
Kansas,Melvern,510,42,142,90,26,17,317
Kansas,Marysville,3301,107,932,743,267,160,2209
Kansas,Menlo,34,2,1,8,2,0,13
Kansas,Merriam,11232,460,1897,3082,1755,842,8036
Kansas,Milan,72,14,8,28,0,4,54
Kansas,Mildred,26,4,8,0,0,0,12
Kansas,Milford,507,9,111,117,28,16,281
Kansas,Milton,46,7,16,15,0,0,38
Kansas,Miltonvale,449,33,124,136,24,14,331
Kansas,Meriden,899,30,313,163,29,20,555
Kansas,Marquette,747,49,196,167,63,8,483
Kansas,Marion,1857,222,493,359,146,87,1307
Kansas,Marienthal,16,5,0,11,0,0,16
Kansas,McCune,510,23,156,133,34,2,348
Kansas,McDonald,163,18,49,35,12,8,122
Kansas,McFarland,364,25,114,62,23,4,228
Kansas,Macksville,492,68,91,96,36,16,307
Kansas,McLouth,1282,49,259,309,93,36,746
Kansas,McPherson,13212,503,2625,3257,1924,708,9017
Kansas,Madison,917,59,243,208,37,25,572
Kansas,Mahaska,53,0,25,10,4,0,39
Kansas,Maize,4054,74,565,811,483,195,2128
Kansas,Manchester,162,10,75,18,7,1,111
Kansas,Manhattan,55769,1308,3790,8269,7017,6456,26840
Kansas,Mankato,812,56,253,211,55,12,587
Kansas,Manter,183,13,40,65,14,13,145
Kansas,Maple Hill,700,10,120,134,75,34,373
Kansas,Mapleton,99,6,15,16,7,2,46
Kansas,Minneapolis,2099,123,448,529,212,97,1409
Kansas,McCracken,195,10,55,61,17,7,150
Kansas,Minneola,733,67,152,155,88,27,489
Kansas,Mission Hills,3572,5,47,248,1166,890,2356
Kansas,Baldwin City,4588,101,760,744,687,268,2560
Kansas,Baileyville,173,16,90,5,27,0,138
Kansas,Arma,1469,117,426,229,118,115,1005
Kansas,Asherville,0,0,0,0,0,0,0
Kansas,Ashland,748,42,140,179,115,57,533
Kansas,Assaria,504,13,93,135,54,22,317
Kansas,Barnard,55,2,18,18,7,4,49
Kansas,Axtell,401,21,154,70,39,9,293
Kansas,Atlanta,225,7,39,79,23,1,149
Kansas,Aurora,52,10,11,11,1,1,34
Kansas,Augusta,9242,600,1811,2095,912,402,5820
Kansas,Auburn,1293,63,315,337,142,10,867
Kansas,Atwood,1021,58,246,269,149,46,768
Kansas,Attica,769,67,153,162,58,11,451
Kansas,Athol,50,4,28,13,1,0,46
Kansas,Munjor,198,18,111,31,0,10,170
Kansas,Munden,131,6,34,26,12,6,84
Kansas,Mulvane,5607,120,802,1346,1044,356,3668
Kansas,Mission Woods,183,1,10,13,62,57,143
Kansas,Moline,333,24,88,108,15,11,246
Kansas,Montezuma,978,288,115,211,70,19,703
Kansas,Moran,545,52,165,150,28,11,406
Kansas,Morganville,160,9,40,41,14,4,108
Kansas,Morland,103,1,42,20,10,11,84
Kansas,Morrill,310,25,105,39,22,1,192
Kansas,Morrowville,159,20,45,23,13,0,101
Kansas,Moscow,322,33,64,53,29,5,184
Kansas,Mound City,742,35,154,182,81,14,466
Kansas,Moundridge,1814,162,457,436,188,74,1317
Kansas,Mound Valley,452,49,116,105,14,10,294
Kansas,Mount Hope,755,54,154,217,100,21,546
Kansas,Mulberry,485,60,165,117,8,11,361
Kansas,Mullinville,190,13,28,65,14,0,120
Kansas,Mission,9481,340,1023,1846,2543,1071,6823
Kansas,McConnell AFB,1360,36,75,333,56,20,520
Kansas,Matfield Green,50,12,10,11,9,2,44
Kansas,Windom,106,12,34,20,12,0,78
Kansas,Barnes,104,9,37,33,1,1,81
Kansas,Bassett,9,0,0,5,2,0,7
Kansas,Baxter Springs,4114,300,836,1023,345,147,2651
Kansas,Bazine,389,35,96,60,24,6,221
Kansas,Beattie,223,23,93,26,32,9,183
Kansas,Bel Aire,7059,221,641,1267,1677,954,4760
Kansas,Belle Plaine,1706,69,363,400,142,41,1015
Kansas,Belleville,1902,126,552,508,189,109,1484
Kansas,Beloit,3780,115,865,880,409,244,2513
Kansas,Whiting,217,14,62,41,20,6,143
Kansas,Wichita,387147,30757,66175,79897,46321,23601,246751
Kansas,Willard,90,5,17,23,4,0,49
Kansas,Williamsburg,318,36,81,59,31,8,215
Kansas,Willis,25,0,9,8,0,5,22
Kansas,Willowbrook,83,4,5,13,28,16,66
Kansas,Belpre,188,34,39,16,4,2,95
Kansas,Bartlett,90,3,41,21,2,5,72
Kansas,Basehor,4980,196,887,1065,648,569,3365
Kentucky,Ironville,435,0,140,133,29,13,315
Kentucky,Crestwood,4705,167,627,496,987,540,2817
Kentucky,Irvine,2223,494,604,354,103,29,1584
Kentucky,Crittenden,3833,262,833,795,290,47,2227
Kentucky,Frankfort,27535,2654,6104,5145,3128,1771,18802
Kentucky,Francisville,9315,135,1109,1355,2069,892,5560
Kentucky,Fox Chase,458,37,138,109,45,40,369
Kentucky,Fountain Run,231,44,68,29,3,9,153
Kentucky,Fort Wright,5754,150,739,1194,1252,718,4053
Kentucky,Fort Thomas,16326,577,2143,3239,3087,1999,11045
Kentucky,Fort Mitchell,8247,248,1223,1694,1206,1063,5434
Kentucky,Crestview Hills,3320,38,660,595,591,420,2304
Kentucky,Irvington,1030,154,338,211,28,16,747
Kentucky,Jeff,281,42,73,51,25,0,191
Kentucky,Jackson,2079,438,430,401,114,120,1503
Kentucky,Lewisburg,789,114,254,133,33,19,553
Kentucky,Leitchfield,6819,1073,1807,1190,168,203,4441
Kentucky,Ledbetter,1704,53,577,345,74,90,1139
Kentucky,Lebanon Junction,1861,178,757,292,105,27,1359
Kentucky,Lebanon,5620,871,1459,895,252,197,3674
Kentucky,Lawrenceburg,11038,896,2938,2230,884,466,7414
Kentucky,Langdon Place,913,22,80,139,201,155,597
Kentucky,Lancaster,3814,729,1029,440,146,114,2458
Kentucky,Lakeview Heights,309,8,34,43,38,91,214
Kentucky,Lakeside Park,2757,92,292,803,539,158,1884
Kentucky,La Grange,8387,527,1551,2132,857,400,5467
Kentucky,Island,442,70,144,76,5,2,297
Kentucky,LaFayette,150,21,22,32,11,3,89
Kentucky,Kuttawa,698,85,219,147,95,64,610
Kentucky,Kingsley,381,4,46,53,86,103,292
Kentucky,Kevil,521,45,184,124,12,25,390
Kentucky,Kenvir,359,73,62,58,8,0,201
Kentucky,Kenton Vale,86,13,30,19,3,8,73
Kentucky,Junction City,2494,268,781,443,93,23,1608
Kentucky,Jenkins,2330,353,517,495,76,40,1481
Kentucky,Jeffersonville,1761,356,546,274,56,31,1263
Kentucky,Jeffersontown,26953,1241,4438,6091,4372,2677,18819
Kentucky,Fort Knox,9449,169,876,2032,613,558,4248
Kentucky,Jamestown,2075,436,553,272,84,38,1383
Kentucky,La Center,1080,156,269,195,49,38,707
Kentucky,Fort Campbell North,13936,280,1202,2551,625,78,4736
Kentucky,Flat Lick,936,297,256,132,15,4,704
Kentucky,Fordsville,536,95,108,149,6,2,360
Kentucky,Ekron,203,5,100,29,6,1,141
Kentucky,Elizabethtown,29657,2233,5472,5979,2816,2648,19148
Kentucky,Elizaville,223,27,25,39,62,10,163
Kentucky,Elk Creek,1603,25,320,323,340,94,1102
Kentucky,Elkhorn City,898,246,213,158,60,63,740
Kentucky,Elkton,2081,235,473,437,79,59,1283
Kentucky,Elsmere,8489,884,1726,1878,734,282,5504
Kentucky,Eminence,2515,370,720,276,95,63,1524
Kentucky,Emlyn,349,13,140,33,28,30,244
Kentucky,Erlanger,18510,1080,4270,4264,1901,1028,12543
Kentucky,Eubank,317,32,79,75,6,12,204
Kentucky,Edmonton,1656,329,560,217,35,90,1231
Kentucky,Evarts,905,231,175,100,25,22,553
Kentucky,Ezel,225,67,45,52,6,0,170
Kentucky,Fairfield,125,16,36,24,1,8,85
Kentucky,Fairview,235,46,53,0,9,0,108
Kentucky,Fairview,183,16,71,38,18,2,145
Kentucky,Falmouth,2349,427,673,287,104,87,1578
Kentucky,Fancy Farm,593,32,134,179,36,31,412
Kentucky,Farley,4588,760,1325,857,141,64,3147
Kentucky,Farmers,102,26,53,0,0,0,79
Kentucky,Farmington,106,16,0,50,21,0,87
Kentucky,Ferguson,1090,119,312,247,73,19,770
Kentucky,Fincastle,891,42,113,221,122,86,584
Kentucky,Ewing,259,45,60,55,11,6,177
Kentucky,Forest Hills,385,13,69,102,64,39,287
Kentucky,Edgewood,8699,180,1046,1947,1790,1103,6066
Kentucky,East Bernstadt,920,200,188,126,37,28,579
Kentucky,Florence,31428,2148,6341,6905,3621,2114,21129
Kentucky,Flatwoods,7407,537,2047,1943,637,243,5407
Kentucky,Fleming-Neon,926,254,190,160,29,40,673
Kentucky,Crofton,778,106,209,130,29,15,489
Kentucky,Crossgate,270,4,10,38,83,46,181
Kentucky,Cumberland,2245,431,500,410,60,104,1505
Kentucky,Cunningham,200,21,47,57,31,0,156
Kentucky,Cynthiana,6380,711,1998,1216,359,192,4476
Kentucky,Danville,16542,1409,3324,3283,1372,1357,10745
Kentucky,Dawson Springs,2737,309,953,495,72,81,1910
Kentucky,Dayton,5381,588,1481,982,266,143,3460
Kentucky,Eddyville,2603,354,899,616,72,67,2008
Kentucky,Dexter,364,62,120,140,0,11,333
Kentucky,Dixon,1121,184,260,213,41,44,742
Kentucky,Doe Valley,1601,59,335,299,263,345,1301
Kentucky,Douglass Hills,5592,276,774,1237,1196,600,4083
Kentucky,Dover,232,30,67,58,0,2,157
Kentucky,Drakesboro,469,69,140,76,20,18,323
Kentucky,Druid Hills,335,4,16,36,86,76,218
Kentucky,Dry Ridge,2341,244,652,382,90,73,1441
Kentucky,Dunmor,319,74,72,39,9,7,201
Kentucky,Dwale,279,25,83,120,0,23,251
Kentucky,Dycusburg,15,0,0,0,0,0,0
Kentucky,Earlington,1547,156,358,349,60,64,987
Kentucky,Diablock,334,42,72,52,0,30,196
Kentucky,Flemingsburg,2880,522,719,617,218,74,2150
Kentucky,South Carrollton,120,19,41,19,7,5,91
Kentucky,Somerset,11358,1666,2864,1983,867,396,7776
Kentucky,Union,5635,163,503,945,966,683,3260
Kentucky,Trenton,414,43,85,102,51,20,301
Kentucky,Tompkinsville,2061,504,602,320,86,134,1646
Kentucky,Tolu,212,27,54,49,0,0,130
Kentucky,Thornhill,219,0,6,31,54,46,137
Kentucky,Ten Broeck,103,2,10,23,16,35,86
Kentucky,Taylorsville,1126,146,300,182,36,21,685
Kentucky,Taylor Mill,6701,386,1221,1688,865,424,4584
Kentucky,Symsonia,596,69,155,162,18,40,444
Kentucky,Sycamore,159,8,32,44,25,26,135
Kentucky,Summersville,539,155,109,70,25,36,395
Kentucky,Summer Shade,263,32,109,40,0,0,181
Kentucky,Sturgis,2098,223,543,463,43,49,1321
Kentucky,Strathmoor Village,631,2,51,130,149,133,465
Kentucky,Uniontown,732,102,245,160,0,10,517
Kentucky,Strathmoor Manor,356,0,8,54,86,108,256
Kentucky,Stanton,2707,572,733,348,131,147,1931
Kentucky,Stanford,3680,389,975,698,187,148,2397
Kentucky,Stamping Ground,822,126,270,138,19,16,569
Kentucky,Spring Valley,782,2,21,127,178,151,479
Kentucky,Spring Mill,286,7,45,69,54,28,203
Kentucky,Springfield,2955,327,668,554,172,150,1871
Kentucky,Spottsville,284,24,124,63,16,0,227
Kentucky,Sparta,284,32,96,43,1,7,179
Kentucky,South Williamson,628,136,147,102,33,43,461
Kentucky,South Wallins,632,89,249,26,30,32,426
Kentucky,South Shore,1196,197,268,234,59,25,783
Kentucky,South Park View,4,2,1,1,0,0,4
Kentucky,Smithland,354,37,91,76,9,20,233
Kentucky,Smithfield,79,11,23,16,1,4,55
Kentucky,Stearns,1335,292,281,165,60,89,887
Kentucky,Slaughters,252,43,71,42,0,2,158
Kentucky,Upton,751,143,191,105,27,10,476
Kentucky,Vanceburg,1491,436,349,219,50,35,1089
Kentucky,Wildwood,277,7,38,57,80,31,213
Kentucky,Wilder,3063,167,426,762,492,399,2246
Kentucky,Wickliffe,705,112,192,120,44,13,481
Kentucky,Whitley City,953,321,234,185,9,0,749
Kentucky,Whitesville,473,76,128,84,18,12,318
Kentucky,Whitesburg,2053,318,489,392,236,128,1563
Kentucky,White Plains,944,116,262,204,58,14,654
Kentucky,Wheelwright,937,183,320,189,28,10,730
Kentucky,Wheatcroft,153,28,69,7,0,0,104
Kentucky,Westwood,611,7,74,96,136,98,411
Kentucky,Westwood,4783,446,1584,1173,285,42,3530
Kentucky,Westport,202,44,62,34,10,10,160
Kentucky,West Point,955,89,285,208,14,12,608
Kentucky,West Liberty,3298,568,1184,646,182,151,2731
Kentucky,Utica,97,0,39,42,0,0,81
Kentucky,West Buechel,1196,118,241,216,94,52,721
Kentucky,Wayland,370,68,74,103,11,12,268
Kentucky,Waverly,296,17,102,72,11,5,207
Kentucky,Watterson Park,1409,146,349,229,48,54,826
Kentucky,Water Valley,328,58,78,70,1,0,207
Kentucky,Warsaw,2022,315,565,292,120,27,1319
Kentucky,Warfield,318,69,73,63,6,0,211
Kentucky,Walton,4063,164,983,793,352,180,2472
Kentucky,Wallins Creek,142,37,46,16,1,0,100
Kentucky,Virgie,269,8,130,0,0,10,148
Kentucky,Vine Grove,5534,193,941,1445,667,561,3807
Kentucky,Villa Hills,7399,228,1144,1367,1512,1096,5347
Kentucky,Vicco,326,78,53,36,21,2,190
Kentucky,Versailles,8985,1061,1891,1573,841,529,5895
Kentucky,Verona,1141,114,281,220,114,136,865
Kentucky,Wellington,506,8,33,97,123,130,391
Kentucky,Smiths Grove,811,72,181,115,72,61,501
Kentucky,Simpsonville,2618,120,445,506,322,220,1613
Kentucky,Shively,15570,1810,3819,3728,730,443,10530
Kentucky,Richmond,32574,2370,4404,4972,3280,2163,17189
Kentucky,Richlawn,417,6,28,71,133,66,304
Kentucky,Reidland,4419,139,1025,1086,421,277,2948
Kentucky,Raywick,137,20,70,15,0,0,105
Kentucky,Ravenna,473,56,147,84,42,30,359
Kentucky,Radcliff,22913,1585,4494,5453,1893,1065,14490
Kentucky,Raceland,2932,268,763,612,180,125,1948
Kentucky,Rabbit Hash,426,0,45,79,83,31,238
Kentucky,Pryorsburg,207,5,123,17,0,0,145
Kentucky,Providence,3125,441,885,584,77,52,2039
Kentucky,Prospect,4806,21,289,653,1356,1235,3554
Kentucky,Princeton,6251,546,1947,990,306,367,4156
Kentucky,Prestonville,107,26,40,16,0,2,84
Kentucky,Prestonsburg,3398,542,754,650,214,201,2361
Kentucky,Rineyville,3399,132,646,903,456,135,2272
Kentucky,Powderly,694,132,272,109,16,27,556
Kentucky,Poole,285,52,45,47,0,10,154
Kentucky,Plum Springs,472,65,104,126,40,17,352
Kentucky,Pleasureville,883,119,266,137,35,3,560
Kentucky,Pleasant View,395,119,90,65,0,20,294
Kentucky,Plantation,822,20,118,144,129,105,516
Kentucky,Plano,1194,36,158,286,241,153,874
Kentucky,Pippa Passes,527,1,7,13,30,40,91
Kentucky,Pioneer Village,2765,303,858,594,195,66,2016
Kentucky,Pineville,1629,353,346,317,91,125,1232
Kentucky,Pine Knot,1810,301,553,283,13,16,1166
Kentucky,Pikeville,7038,943,1027,1071,729,865,4635
Kentucky,Southgate,3821,196,804,944,398,186,2528
Kentucky,Lewisport,1522,141,465,282,91,59,1038
Kentucky,Sonora,638,20,164,122,26,35,367
Kentucky,Poplar Hills,439,56,90,99,3,8,256
Kentucky,Silver Grove,1154,55,362,204,45,14,680
Kentucky,River Bluff,417,2,32,109,91,53,287
Kentucky,Robards,609,28,159,148,31,30,396
Kentucky,Shepherdsville,11695,1112,2808,2248,698,326,7192
Kentucky,Shelbyville,14782,1673,2984,2909,1023,611,9200
Kentucky,Sharpsburg,405,102,101,50,17,7,277
Kentucky,Seneca Gardens,621,2,30,67,208,158,465
Kentucky,Sedalia,352,84,68,68,37,8,265
Kentucky,Sebree,1556,293,326,227,65,53,964
Kentucky,Scottsville,4335,760,1064,761,282,128,2995
Kentucky,Science Hill,610,88,180,102,29,23,422
Kentucky,Sardis,120,29,43,22,1,0,95
Kentucky,Sandy Hook,548,126,119,76,48,14,383
Kentucky,Sanders,274,51,114,23,5,0,193
Kentucky,Salyersville,1754,351,455,275,41,85,1207
Kentucky,Salvisa,562,63,110,118,9,5,305
Kentucky,Salt Lick,353,50,43,58,28,15,194
Kentucky,Riverwood,503,1,6,31,152,156,346
Kentucky,Salem,809,149,212,194,39,30,624
Kentucky,St. Matthews,17837,681,2176,3671,4369,2635,13532
Kentucky,St. Charles,293,79,89,29,0,0,197
Kentucky,Sadieville,294,32,64,48,26,8,178
Kentucky,Sacramento,406,56,105,82,16,12,271
Kentucky,Ryland Heights,1072,152,288,191,49,25,705
Kentucky,Russellville,7015,1285,1812,1157,445,310,5009
Kentucky,Russell Springs,2491,473,615,467,147,108,1810
Kentucky,Russell,3307,138,587,737,611,338,2411
Kentucky,Rosine,40,40,0,0,0,0,40
Kentucky,Rolling Hills,832,33,153,178,135,74,573
Kentucky,Rolling Fields,743,0,17,52,216,170,455
Kentucky,Rockport,245,52,75,46,3,6,182
Kentucky,Rockholds,622,143,150,20,0,31,344
Kentucky,Rochester,275,15,97,36,1,9,158
Kentucky,St. Regis Park,1412,31,170,332,285,244,1062
Kentucky,Lexington-Fayette urban,308306,20222,41083,55791,46887,35059,199042
Kentucky,Coldstream,1238,13,156,329,201,117,816
Kentucky,Lincolnshire,147,2,30,31,34,11,108
Kentucky,Cambridge,170,9,28,31,39,19,126
Kentucky,Camargo,1297,235,355,223,46,18,877
Kentucky,Calvert City,2543,226,629,519,149,86,1609
Kentucky,California,121,18,37,10,5,4,74
Kentucky,Calhoun,894,168,236,210,45,20,679
Kentucky,Cadiz,2618,428,576,502,209,138,1853
Kentucky,Butler,495,85,169,95,30,0,379
Kentucky,Campbellsburg,789,67,215,175,17,33,507
Kentucky,Burnside,888,146,213,179,57,33,628
Kentucky,Burlington,16892,653,3313,4108,2031,698,10803
Kentucky,Burkesville,1414,294,377,236,43,46,996
Kentucky,Burgin,1238,207,338,246,43,12,846
Kentucky,Buffalo,482,69,118,122,0,63,372
Kentucky,Buckner,5693,861,1315,1265,565,354,4360
Kentucky,Buckhorn,125,1,18,15,6,19,59
Kentucky,Brownsville,857,246,239,152,32,20,689
Kentucky,Burna,351,14,176,53,15,0,258
Kentucky,Campbellsville,10983,1236,2528,1694,808,547,6813
Kentucky,Campton,574,75,166,103,18,25,387
Kentucky,Caneyville,649,133,167,119,17,12,448
Kentucky,Clay City,1283,344,261,198,11,13,827
Kentucky,Clay,1048,134,345,192,15,32,718
Kentucky,Claryville,2446,139,497,418,227,135,1416
Kentucky,Clarkson,1036,180,263,176,41,14,674
Kentucky,Chaplin,259,38,114,24,8,18,202
Kentucky,Cerulean,219,24,39,77,0,54,194
Kentucky,Central City,5918,854,1989,946,119,134,4042
Kentucky,Centertown,367,63,125,38,4,2,232
Kentucky,Cecilia,429,52,28,68,43,54,245
Kentucky,Cayce,82,57,7,11,0,0,75
Kentucky,Cawood,703,254,215,73,0,12,554
Kentucky,Cave City,2210,268,718,401,83,76,1546
Kentucky,Catlettsburg,1959,267,603,496,32,38,1436
Kentucky,Carrsville,34,7,19,6,0,0,32
Kentucky,Carrollton,3933,507,1170,741,145,114,2677
Kentucky,Carlisle,2163,332,739,409,32,73,1585
Kentucky,Cannonsburg,658,81,154,96,43,28,402
Kentucky,Brownsboro Village,314,3,25,62,102,82,274
Kentucky,Phelps,1068,302,170,175,19,47,713
Kentucky,Brownsboro Farm,674,5,41,87,162,125,420
Kentucky,Brooks,2505,365,645,670,134,14,1828
Kentucky,Woodlawn Park,952,26,110,144,234,163,677
Kentucky,Woodlawn,252,14,57,61,16,20,168
Kentucky,Woodland Hills,774,15,100,189,131,79,514
Kentucky,Woodbury,102,11,22,15,8,6,62
Kentucky,Woodburn,304,46,102,56,24,17,245
Kentucky,Wingo,790,72,211,149,103,13,548
Kentucky,Windy Hills,2348,46,166,509,669,529,1919
Kentucky,Worthington,1320,73,407,311,131,52,974
Kentucky,Winchester,18388,2439,4421,3398,1721,796,12775
Kentucky,Willisburg,360,29,112,75,9,4,229
Kentucky,Williamstown,3927,462,964,596,218,132,2372
Kentucky,Williamsburg,5250,544,1074,437,440,468,2963
Kentucky,Blaine,69,21,24,5,0,2,52
Kentucky,Blackey,233,27,50,26,9,6,118
Kentucky,Big Clifty,340,53,131,41,18,0,243
Kentucky,Betsy Layne,782,0,135,220,48,45,448
Kentucky,Wilmore,6057,280,494,691,840,868,3173
Kentucky,Worthington Hills,1597,44,206,368,243,168,1029
Kentucky,Worthville,227,54,56,31,5,4,150
Kentucky,Crab Orchard,1002,199,362,113,14,8,696
Kentucky,Bromley,790,113,207,190,30,7,547
Kentucky,Broeck Pointe,299,2,24,58,56,56,196
Kentucky,Brodhead,1324,341,318,178,52,32,921
Kentucky,Briarwood,608,28,69,153,112,74,436
Kentucky,Bremen,137,13,67,23,13,3,119
Kentucky,Brandenburg,2855,239,736,460,168,144,1747
Kentucky,Bradfordsville,317,30,118,47,17,2,214
Kentucky,Bowling Green,61617,5111,10022,9373,5448,3659,33613
Kentucky,Boston,426,108,59,77,0,0,244
Kentucky,Booneville,82,13,26,17,0,11,67
Kentucky,Bonnieville,249,43,64,28,5,8,148
Kentucky,Blue Ridge Manor,827,15,81,206,226,103,631
Kentucky,Bloomfield,965,155,269,153,43,39,659
Kentucky,Blandville,56,18,0,11,0,9,38
Kentucky,Crescent Springs,3976,275,516,448,589,466,2294
Kentucky,Crestview,378,11,69,90,59,22,251
Kentucky,Liberty,1862,409,395,331,109,130,1374
Kentucky,Brooksville,536,60,115,78,39,29,321
Kentucky,Berry,280,63,98,27,5,17,210
Kentucky,Pewee Valley,1615,73,269,214,340,210,1106
Kentucky,Perryville,1037,150,287,174,55,21,687
Kentucky,Meadowview Estates,340,12,68,65,89,35,269
Kentucky,Melbourne,408,51,99,99,20,63,332
Kentucky,Mentor,224,10,62,40,30,6,148
Kentucky,Middlesborough,9934,2492,2340,1334,366,334,6866
Kentucky,Middletown,7788,212,1046,1825,1407,1284,5774
Kentucky,Midway,1733,84,219,266,318,168,1055
Kentucky,Millersburg,911,144,206,165,67,20,602
Kentucky,Meadow Vale,721,18,129,162,157,62,528
Kentucky,Millstone,33,0,24,9,0,0,33
Kentucky,Mockingbird Valley,149,0,3,8,50,48,109
Kentucky,Monterey,84,20,28,18,2,0,68
Kentucky,Monticello,6141,1287,1649,905,149,275,4265
Kentucky,Moorland,392,17,87,126,44,19,293
Kentucky,Morehead,6938,435,785,607,392,754,2973
Kentucky,Morganfield,3572,411,1123,823,153,167,2677
Kentucky,Morgantown,2681,724,691,335,65,38,1853
Kentucky,Milton,728,95,212,143,24,21,495
Kentucky,Meadowbrook Farm,99,0,14,25,12,16,67
Kentucky,Maytown,321,43,81,46,0,16,186
Kentucky,Maysville,8924,1027,2249,1991,433,554,6254
Kentucky,Coxton,218,37,112,14,7,11,181
Kentucky,Covington,40845,4633,8665,8346,3703,1961,27308
Kentucky,Corydon,783,114,229,145,23,14,525
Kentucky,Corinth,231,38,58,51,11,6,164
Kentucky,Corbin,6923,842,1453,1441,546,377,4659
Kentucky,Concord,16,3,8,1,0,0,12
Kentucky,Combs,266,164,19,16,0,0,199
Kentucky,Columbus,156,22,69,35,0,0,126
Kentucky,Columbia,4561,741,823,736,274,196,2770
Kentucky,Creekside,308,0,38,79,80,38,235
Kentucky,Cold Spring,6111,227,1119,1409,1056,736,4547
Kentucky,Coldiron,137,17,34,56,0,0,107
Kentucky,Coal Run Village,1761,185,337,451,111,84,1168
Kentucky,Cloverport,1110,196,315,233,8,2,754
Kentucky,Clinton,1293,265,355,214,68,44,946
Kentucky,Cleaton,98,28,32,5,0,4,69
Kentucky,Mays Lick,157,11,63,43,3,0,120
Kentucky,Mortons Gap,1049,293,260,155,34,39,781
Kentucky,Petersburg,462,95,166,62,25,0,348
Kentucky,Mount Olivet,397,61,81,82,38,8,270
Kentucky,Mount Vernon,2814,499,549,509,117,108,1782
Kentucky,Olive Hill,1863,289,423,372,116,88,1288
Kentucky,Oneida,203,5,44,10,33,0,92
Kentucky,Onton,28,0,14,3,0,0,17
Kentucky,Orchard Grass Hills,1836,61,287,397,267,156,1168
Kentucky,Owensboro,58350,5654,13667,11825,4578,3164,38888
Kentucky,Owenton,1688,281,586,183,42,13,1105
Kentucky,Owingsville,1776,205,453,195,87,125,1065
Kentucky,Old Brownsboro Place,393,5,20,37,114,99,275
Kentucky,Paducah,25001,2534,5145,6063,2408,1699,17849
Kentucky,Paris,9831,1112,2371,2107,621,302,6513
Kentucky,Park City,475,71,142,94,27,10,344
Kentucky,Park Hills,2990,211,504,620,450,318,2103
Kentucky,Parkway Village,662,33,127,139,120,59,478
Kentucky,Pathfork,510,128,133,44,22,13,340
Kentucky,Payne Gap,347,83,99,46,7,4,239
Kentucky,Pembroke,852,89,160,189,62,32,532
Kentucky,Paintsville,4251,753,928,850,175,311,3017
Kentucky,Oakland,204,20,33,35,34,8,130
Kentucky,Oak Grove,7496,360,1015,1565,460,54,3454
Kentucky,Oakbrook,8749,253,1533,2245,1360,644,6035
Kentucky,Mount Washington,13736,843,3135,3068,1279,656,8981
Kentucky,Muldraugh,1063,141,307,190,16,17,671
Kentucky,Munfordville,1723,356,526,248,29,52,1211
Kentucky,Murray,18515,1432,2164,2424,1703,1363,9086
Kentucky,Murray Hill,556,12,113,116,120,103,464
Kentucky,Nebo,191,12,42,51,18,9,132
Kentucky,New Castle,1071,144,329,136,60,42,711
Kentucky,New Haven,669,78,195,166,19,11,469
Kentucky,New Hope,207,26,95,17,0,0,138
Kentucky,Newport,15428,2392,3687,2410,1366,773,10628
Kentucky,Nicholasville,28843,3147,6002,5284,2633,1566,18632
Kentucky,Norbourne Estates,409,0,17,31,114,125,287
Kentucky,North Corbin,1735,361,462,245,71,39,1178
Kentucky,Northfield,1008,35,74,186,272,141,708
Kentucky,North Middletown,921,154,259,93,22,25,553
Kentucky,Nortonville,1120,190,309,196,28,39,762
Kentucky,Norwood,340,2,46,52,77,69,246
Kentucky,Mount Sterling,7078,855,1976,1250,686,445,5212
Kentucky,Berea,14454,1147,2811,2152,1308,1098,8516
Kentucky,Wurtland,1073,152,287,279,54,29,801
Kentucky,Benham,529,69,106,134,37,54,400
Kentucky,Hazard,5415,858,921,1079,518,534,3910
Kentucky,Hazel,505,58,132,106,48,20,364
Kentucky,Hazel Green,233,38,87,18,15,42,200
Kentucky,Hebron,6102,142,1178,1536,631,329,3816
Kentucky,Hebron Estates,1167,120,355,255,83,44,857
Kentucky,Henderson,28889,3057,7326,6357,2024,1369,20133
Kentucky,Hendron,4760,234,1045,1069,517,498,3363
Kentucky,Heritage Creek,1026,151,319,246,37,24,777
Kentucky,Hickman,2385,586,609,440,93,55,1783
Kentucky,Hickory,140,0,14,0,12,0,26
Kentucky,Hickory Hill,138,1,29,33,16,19,98
Kentucky,High Bridge,246,42,113,74,0,0,229
Kentucky,Highland Heights,7152,311,1025,1336,733,432,3837
Kentucky,Hills and Dales,167,2,7,21,61,37,128
Kentucky,Hillview,7904,748,2180,1736,388,156,5208
Kentucky,Hindman,786,112,139,80,66,43,440
Kentucky,Hiseville,167,63,57,32,0,0,152
Kentucky,Hodgenville,3226,565,860,581,169,45,2220
Kentucky,Hollow Creek,933,25,182,199,169,69,644
Kentucky,Hawesville,1033,100,263,241,40,12,656
Kentucky,Hollyvilla,424,47,154,79,11,2,293
Kentucky,Hartford,2709,349,647,461,135,148,1740
Kentucky,Harlan,1607,211,382,281,155,97,1126
Kentucky,Glenview,460,0,28,60,127,158,373
Kentucky,Glenview Hills,392,0,18,38,107,92,255
Kentucky,Glenview Manor,175,2,24,40,42,31,139
Kentucky,Goose Creek,301,3,27,62,80,36,208
Kentucky,Goshen,1054,28,112,230,177,113,660
Kentucky,Gracey,11,0,11,0,0,0,11
Kentucky,Grand Rivers,360,38,84,102,25,37,286
Kentucky,Gratz,64,14,16,9,3,1,43
Kentucky,Benton,4379,425,1146,822,270,330,2993
Kentucky,Grayson,4097,288,1095,543,278,168,2372
Kentucky,Greensburg,2298,336,727,310,107,118,1598
Kentucky,Green Spring,659,9,44,129,190,107,479
Kentucky,Greenup,1180,124,304,282,92,55,857
Kentucky,Greenville,4416,784,995,844,252,237,3112
Kentucky,Guthrie,1682,238,401,300,67,26,1032
Kentucky,Hanson,826,101,194,190,70,38,593
Kentucky,Hardin,625,74,186,84,5,18,367
Kentucky,Hardinsburg,2225,258,688,389,65,162,1562
Kentucky,Hardyville,391,73,64,30,0,76,243
Kentucky,Harrodsburg,8380,1159,2115,1311,637,409,5631
Kentucky,Glencoe,471,69,133,78,2,3,285
Kentucky,Hopkinsville,32483,3247,6708,7588,2192,1698,21433
Kentucky,Houston Acres,475,20,73,112,103,41,349
Kentucky,McKinney,344,37,83,59,0,0,179
Kentucky,McKee,958,182,217,67,6,30,502
Kentucky,McHenry,418,90,104,63,17,5,279
Kentucky,Maceo,382,13,190,78,0,0,281
Kentucky,McDowell,824,156,157,174,8,24,519
Kentucky,McCarr,131,22,25,51,4,1,103
Kentucky,Lynnview,1055,93,338,252,65,22,770
Kentucky,Lyndon,11244,530,1464,2803,2068,1128,7993
Kentucky,Lynch,649,66,146,219,58,20,509
Kentucky,Ludlow,4547,406,1031,850,430,221,2938
Kentucky,Loyall,605,119,157,136,13,24,449
Kentucky,Lowes,115,0,17,18,40,0,75
Kentucky,Lovelaceville,141,21,24,37,0,0,82
Kentucky,Louisville/Jefferson County metro government (balance),608732,50702,121111,124005,66734,48130,410682
Kentucky,Louisa,2961,410,648,533,179,139,1909
Kentucky,Loretto,734,96,256,112,32,10,506
Kentucky,London,8090,1335,1877,1503,572,367,5654
Kentucky,Livingston,121,36,26,27,2,5,96
Kentucky,Livermore,1435,149,428,243,40,19,879
Kentucky,Mackville,246,6,55,47,22,39,169
Kentucky,Horse Cave,2238,409,506,400,92,68,1475
Kentucky,McRoberts,847,143,332,62,88,11,636
Kentucky,Magnolia,392,51,135,75,13,0,274
Kentucky,Hunters Hollow,367,51,119,75,4,9,258
Kentucky,Hurstbourne,4302,133,431,657,1041,1035,3297
Kentucky,Hurstbourne Acres,1799,65,214,342,410,378,1409
Kentucky,Hustonville,602,57,156,129,18,24,384
Kentucky,Hyden,429,126,102,63,28,39,358
Kentucky,Independence,26062,1670,5167,4972,3182,1351,16342
Kentucky,Indian Hills,2930,24,91,280,824,897,2116
Kentucky,Inez,657,189,168,118,8,11,494
Kentucky,Mayking,231,11,22,92,21,15,161
Kentucky,Mayfield,10101,1420,2651,1445,506,426,6448
Kentucky,Massac,3938,235,632,862,555,275,2559
Kentucky,Masonville,1075,61,284,194,62,105,706
Kentucky,Maryhill Estates,164,0,4,14,48,40,106
Kentucky,Martin,713,161,132,68,21,35,417
Kentucky,Marrowbone,52,13,22,8,0,0,43
Kentucky,Marion,3004,493,741,755,150,48,2187
Kentucky,Manor Creek,304,0,31,36,49,73,189
Kentucky,Manitou,114,17,48,21,20,0,106
Kentucky,Manchester,1489,290,371,257,92,74,1084
Kentucky,Madisonville,19687,1817,4920,4262,1329,1022,13350
Kentucky,Glasgow,14224,2071,3786,2306,1069,668,9900
Kentucky,Graymoor-Devondale,2922,89,384,643,812,377,2305
Kentucky,Ghent,399,37,124,56,13,14,244
Kentucky,Augusta,1102,160,221,186,117,28,712
Kentucky,Gilbertsville,187,15,27,43,0,31,116
Kentucky,Auxier,472,15,141,185,0,0,341
Kentucky,Bancroft,451,1,55,74,93,106,329
Kentucky,Bandana,147,0,55,62,0,30,147
Kentucky,Barbourmeade,1372,16,74,254,340,264,948
Kentucky,Barbourville,3172,433,644,468,242,243,2030
Kentucky,Bardstown,12930,1129,3221,2197,644,644,7835
Kentucky,Bardwell,760,127,186,172,43,24,552
Kentucky,Barlow,675,92,202,138,28,17,477
Kentucky,Audubon Park,1445,31,223,338,285,237,1114
Kentucky,Beattyville,1501,293,290,231,52,16,882
Kentucky,Bedford,747,85,154,133,23,5,400
Kentucky,Beech Grove,477,85,124,98,0,22,329
Kentucky,Beechmont,897,151,221,138,0,8,518
Kentucky,Beechwood Village,1302,24,142,307,275,182,930
Kentucky,Belfry,219,36,65,47,10,7,165
Kentucky,Bellefonte,883,28,116,220,160,172,696
Kentucky,Bellemeade,807,7,94,156,184,166,607
Kentucky,Belleview,530,40,132,143,27,18,360
Kentucky,Bellevue,5921,410,1569,1119,829,450,4377
Kentucky,Bellewood,335,0,6,58,106,67,237
Kentucky,Beaver Dam,3557,647,973,542,59,116,2337
Kentucky,Auburn,1491,215,240,309,79,43,886
Kentucky,Crayne,144,11,28,49,17,0,105
Kentucky,Artemus,583,112,198,109,26,18,463
Kentucky,Arlington,380,79,87,104,11,1,282
Kentucky,Anthoston,140,0,103,37,0,0,140
Kentucky,Annville,694,177,176,146,2,55,556
Kentucky,Anchorage,2172,5,66,150,530,599,1350
Kentucky,Allensville,137,15,51,5,12,10,93
Kentucky,Allen,211,50,44,22,17,0,133
Kentucky,Alexandria,8735,379,1770,1910,1248,480,5787
Kentucky,Albany,1874,485,488,282,45,68,1368
Kentucky,Ages,289,69,26,52,0,0,147
Kentucky,Adairville,1048,181,292,112,67,14,666
Kentucky,Arjay,557,126,73,92,0,0,291
Kentucky,Franklin,8643,1109,2447,1363,570,255,5744
Kentucky,Germantown,149,18,51,17,11,4,101
Kentucky,Breckinridge Center,2479,247,301,126,5,3,682
Kentucky,Georgetown,30968,1924,5773,6108,3295,1841,18941
Kentucky,Garrison,549,44,230,81,9,9,373
Kentucky,Gamaliel,406,52,142,46,15,9,264
Kentucky,Ashland,21391,1576,4653,5404,1764,1355,14752
Kentucky,Fulton,2592,331,582,473,142,69,1597
Kentucky,Frenchburg,517,107,96,71,11,20,305
Kentucky,Freeburn,380,20,176,25,0,0,221
Kentucky,Fredonia,494,42,174,101,17,8,342
Louisiana,Maurice,1498,242,335,308,196,36,1117
Louisiana,Melville,1383,270,323,152,36,3,784
Louisiana,Meraux,6397,693,1651,1153,466,67,4030
Louisiana,Mermentau,696,125,177,50,2,47,401
Louisiana,Morse,890,118,250,103,29,17,517
Louisiana,Mer Rouge,602,56,180,61,29,39,365
Louisiana,Merrydale,9008,711,1877,1836,929,369,5722
Louisiana,Merryville,1069,204,386,158,5,14,767
Louisiana,Metairie,142715,11476,26977,30305,22548,12575,103881
Louisiana,Milton,2854,137,486,617,433,163,1836
Louisiana,Morganza,932,109,268,153,32,15,577
Louisiana,Minden,12887,1506,3632,2089,920,329,8476
Louisiana,Minorca,1942,378,618,318,13,21,1348
Louisiana,Montegut,1560,285,363,107,74,15,844
Louisiana,Monterey,693,26,160,76,84,15,361
Louisiana,Montgomery,631,82,236,89,35,4,446
Louisiana,Monticello,5260,221,1135,1093,721,314,3484
Louisiana,Montpelier,299,30,91,48,11,2,182
Louisiana,Mathews,2387,275,793,288,188,26,1570
Louisiana,Midway,1458,152,280,164,57,0,653
Louisiana,Monroe,49529,5217,8215,7237,5031,3257,28957
Louisiana,Marrero,31738,4807,8363,5594,1570,622,20956
Louisiana,Moss Bluff,12595,695,2501,2812,1397,534,7939
Louisiana,Mansfield,4995,889,1155,795,277,83,3199
Louisiana,Mangham,711,98,182,82,32,19,413
Louisiana,Mandeville,12187,692,1782,2144,2630,1356,8604
Louisiana,Mamou,3209,644,624,309,39,20,1636
Louisiana,Madisonville,756,19,121,156,168,85,549
Louisiana,McNary,181,21,50,25,16,4,116
Louisiana,Lydia,611,97,294,54,0,4,449
Louisiana,Lutcher,3415,443,967,737,231,135,2513
Louisiana,Mansura,1702,293,411,208,54,26,992
Louisiana,Montz,2033,151,529,328,236,96,1340
Louisiana,Lucky,281,37,97,33,14,6,187
Louisiana,Loreauville,722,96,240,78,29,24,467
Louisiana,Longville,663,42,155,49,16,0,262
Louisiana,Longstreet,99,8,33,30,4,0,75
Louisiana,Logansport,1937,192,360,408,62,36,1058
Louisiana,Lockport Heights,1386,243,478,133,93,24,971
Louisiana,Lockport,2556,424,980,217,96,62,1779
Louisiana,Livonia,1619,163,468,307,108,2,1048
Louisiana,Luling,12825,856,2893,2491,1540,361,8141
Louisiana,Martin,595,68,205,58,41,7,379
Louisiana,Many,2810,343,832,449,142,84,1850
Louisiana,Marion,823,101,197,142,61,26,527
Louisiana,Mound,14,1,1,2,4,0,8
Louisiana,Mount Lebanon,45,2,12,12,10,3,39
Louisiana,Napoleonville,653,144,133,68,13,24,382
Louisiana,Natalbany,2587,508,447,351,305,136,1747
Louisiana,Natchez,486,66,139,64,9,10,288
Louisiana,Natchitoches,18460,1846,2978,2769,1101,1215,9909
Louisiana,Newellton,1331,158,387,216,65,22,848
Louisiana,New Iberia,30782,4654,7407,4363,2028,915,19367
Louisiana,Maringouin,871,133,268,163,30,27,621
Louisiana,New Llano,2443,231,486,560,175,66,1518
Louisiana,New Roads,4754,799,1004,732,487,165,3187
Louisiana,Noble,280,36,78,38,27,3,182
Louisiana,Norco,2994,273,972,684,104,64,2097
Louisiana,North Hodge,507,80,121,95,17,1,314
Louisiana,North Vacherie,2462,205,887,344,246,75,1757
Louisiana,Mooringsport,740,115,217,132,44,11,519
Louisiana,Moonshine,130,20,36,12,0,0,68
Louisiana,Marksville,5594,1289,1157,701,237,267,3651
Louisiana,New Orleans,376738,38392,59882,69088,51838,39454,258654
Louisiana,New Sarpy,1453,187,455,235,38,13,928
Louisiana,Varnado,355,59,109,40,12,6,226
Louisiana,Waggaman,9334,1088,2052,2285,829,217,6471
Louisiana,Spokane,266,6,78,97,59,6,246
Louisiana,Spearsville,122,21,25,24,13,4,87
Louisiana,South Vacherie,3577,438,1305,475,268,147,2633
Louisiana,South Mansfield,371,67,86,35,12,9,209
Louisiana,Sorrento,1457,203,410,301,61,19,994
Louisiana,Sorrel,620,97,258,58,6,8,427
Louisiana,Slidell,27567,2364,5478,6471,3136,1405,18854
Louisiana,Slaughter,1297,130,369,272,72,28,871
Louisiana,Siracusaville,463,54,148,68,0,0,270
Louisiana,Singer,632,0,306,104,68,0,478
Louisiana,Simsboro,1239,116,313,189,40,53,711
Louisiana,Simpson,706,43,142,175,70,45,475
Louisiana,Simmesport,2003,510,465,142,15,38,1170
Louisiana,Sikes,146,13,52,17,3,4,89
Louisiana,Sicily Island,470,77,137,53,18,12,297
Louisiana,Sibley,1358,227,328,280,95,18,948
Louisiana,Shreveport,200015,18896,40389,37809,20538,12637,130269
Louisiana,St. Francisville,1960,124,307,406,265,142,1244
Louisiana,Moreauville,927,136,293,107,33,26,595
Louisiana,St. Gabriel,6872,1633,1764,1228,389,196,5210
Louisiana,St. James,877,101,241,154,54,12,562
Louisiana,St. Joseph,978,103,286,161,8,26,584
Louisiana,St. Martinville,6105,1111,1545,981,233,265,4135
Louisiana,Springfield,418,46,136,72,28,20,302
Louisiana,St. Maurice,439,112,94,114,0,0,320
Louisiana,Saline,348,56,67,54,14,8,199
Louisiana,Sarepta,944,72,236,210,55,22,595
Louisiana,Schriever,7142,1000,1878,1025,389,324,4616
Louisiana,Scott,8865,883,2306,1802,885,243,6119
Louisiana,Shenandoah,18874,511,2264,3868,4707,1717,13067
Louisiana,Shongaloo,175,17,34,39,28,2,120
Louisiana,St. Rose,8868,794,1877,2062,631,124,5488
Louisiana,Gretna,17827,2817,4405,2883,1469,712,12286
Louisiana,Springhill,5194,855,1565,753,395,146,3714
Louisiana,Starks,601,173,204,73,34,0,484
Louisiana,Vivian,3664,607,1194,573,141,67,2582
Louisiana,Violet,6119,876,1660,975,225,16,3752
Louisiana,Vinton,3379,689,1038,676,120,24,2547
Louisiana,Ville Platte,7327,1766,1566,878,397,112,4719
Louisiana,Village St. George,7294,299,934,1285,1416,915,4849
Louisiana,Vienna Bend,1335,64,196,277,134,16,687
Louisiana,Vienna,480,46,64,93,75,60,338
Louisiana,Vidalia,4195,496,1043,740,222,166,2667
Louisiana,Ventress,1121,64,303,420,23,3,813
Louisiana,Venice,257,67,28,27,4,25,151
Louisiana,Urania,1130,264,402,169,27,9,871
Louisiana,Union,1051,178,199,125,31,0,533
Louisiana,Turkey Creek,357,46,97,47,16,7,213
Louisiana,Tullos,435,64,145,37,11,5,262
Louisiana,Triumph,215,18,77,43,6,21,165
Louisiana,Timberlane,10996,1346,2450,1926,1102,376,7200
Louisiana,Tickfaw,646,94,153,97,28,8,380
Louisiana,Start,1041,78,123,264,141,13,619
Louisiana,Sterlington,1873,142,437,330,209,56,1174
Louisiana,Stonewall,2236,178,488,496,265,125,1552
Louisiana,Sugartown,0,0,0,0,0,0,0
Louisiana,Sulphur,20199,1716,4974,3602,1877,822,12991
Louisiana,Sun,323,61,86,67,10,7,231
Louisiana,Stanley,182,18,78,44,4,7,151
Louisiana,Sunset,2919,285,699,380,264,66,1694
Louisiana,Swartz,4936,171,1205,1224,369,349,3318
Louisiana,Taft,78,17,32,0,29,0,78
Louisiana,Tallulah,7187,1135,1808,1266,361,220,4790
Louisiana,Tangipahoa,607,69,195,137,13,24,438
Louisiana,Terrytown,24910,2487,5299,4656,1925,785,15152
Louisiana,Thibodaux,14579,2169,2572,2005,1506,813,9065
Louisiana,Supreme,1036,190,171,114,34,8,517
Louisiana,Morgan City,12019,1561,3276,1864,797,349,7847
Louisiana,Greenwood,3223,200,781,792,400,164,2337
Louisiana,Iota,1707,221,445,292,68,19,1045
Louisiana,Amite City,4283,720,992,631,556,252,3151
Louisiana,Amelia,2408,740,609,151,62,19,1581
Louisiana,Ama,1241,115,352,252,118,47,884
Louisiana,Alexandria,47985,5697,10773,8425,3696,2599,31190
Louisiana,Albany,1481,76,396,206,127,69,874
Louisiana,Addis,4194,288,824,801,465,143,2521
Louisiana,Abita Springs,2529,139,437,555,413,305,1849
Louisiana,Abbeville,12381,2205,2878,1584,514,171,7352
Louisiana,Hackberry,1211,150,292,298,46,6,792
Louisiana,Ruston,22185,1240,2102,2363,2512,1886,10103
Louisiana,Rosepine,1979,248,483,373,172,20,1296
Louisiana,Roseland,1027,215,244,105,34,31,629
Louisiana,Rosedale,982,139,275,220,60,25,719
Louisiana,Romeville,257,74,46,40,0,0,160
Louisiana,Rodessa,241,46,71,50,7,1,175
Louisiana,Rock Hill,216,16,132,24,23,0,195
Louisiana,Robeline,100,28,21,30,9,0,88
Louisiana,Anacoco,1046,53,259,237,91,71,711
Louisiana,Roanoke,441,66,219,64,9,27,385
Louisiana,Angie,252,21,67,35,20,13,156
Louisiana,Arcadia,2897,523,665,545,150,132,2015
Louisiana,Bayou Cane,21067,2406,5231,4008,1546,463,13654
Louisiana,Bayou Blue,12574,2007,3283,1958,549,178,7975
Louisiana,Bawcomville,3404,804,863,510,35,44,2256
Louisiana,Baton Rouge,229186,18229,36655,38118,26163,18327,137492
Louisiana,Bastrop,10949,1587,2806,1559,580,206,6738
Louisiana,Baskin,310,36,94,45,10,0,185
Louisiana,Basile,1852,491,400,229,55,31,1206
Louisiana,Barataria,859,260,273,146,19,6,704
Louisiana,Banks Springs,1568,224,344,144,93,37,842
Louisiana,Ball,4000,306,1132,998,250,167,2853
Louisiana,Baldwin,2236,387,644,329,106,48,1514
Louisiana,Baker,13800,1193,3296,2465,898,644,8496
Louisiana,Avondale,5117,855,1384,776,113,12,3140
Louisiana,Atlanta,99,26,17,23,4,4,74
Louisiana,Athens,298,30,77,69,23,9,208
Louisiana,Ashland,245,41,53,51,21,14,180
Louisiana,Arnaudville,1267,157,471,123,47,17,815
Louisiana,Arabi,4544,363,1067,945,366,91,2832
Louisiana,River Ridge,13636,650,2859,2854,2396,1259,10018
Louisiana,Ringgold,1536,255,439,193,37,34,958
Louisiana,Ridgecrest,616,92,188,101,34,2,417
Louisiana,Cut Off,5857,987,1919,620,304,150,3980
Louisiana,Cullen,873,268,129,163,24,0,584
Louisiana,Crowley,13193,2989,2726,1780,673,327,8495
Louisiana,Raceland,10556,1869,2862,1440,902,172,7245
Louisiana,Quitman,156,7,35,41,16,7,106
Louisiana,Provencal,632,99,138,108,34,28,407
Louisiana,Prospect,525,39,39,109,27,20,234
Louisiana,Prien,8114,487,1231,1740,1257,529,5244
Louisiana,Presquille,1730,116,604,196,199,24,1139
Louisiana,Prairieville,29721,1307,4481,5405,5366,1673,18232
Louisiana,Poydras,2271,453,776,267,58,10,1564
Louisiana,Powhatan,126,52,25,21,2,0,100
Louisiana,Port Vincent,871,122,261,148,115,18,664
Louisiana,Port Sulphur,2053,434,455,149,24,12,1074
Louisiana,Port Barre,1848,299,579,160,46,8,1092
Louisiana,Port Allen,5137,619,1533,908,583,124,3767
Louisiana,Ponchatoula,6845,582,1469,1385,588,250,4274
Louisiana,Delcambre,2232,375,627,336,105,33,1476
Louisiana,Delhi,2954,280,955,449,219,77,1980
Louisiana,Delta,191,22,94,23,11,0,150
Louisiana,Denham Springs,10126,1136,2446,2225,696,366,6869
Louisiana,Richwood,5993,1550,1786,725,86,35,4182
Louisiana,Richmond,544,91,158,100,38,26,413
Louisiana,Reserve,9615,1060,2803,1572,521,192,6148
Louisiana,Reeves,266,30,74,32,9,0,145
Louisiana,Reddell,628,34,140,60,9,57,300
Louisiana,Red Chute,6206,434,1238,1516,622,471,4281
Louisiana,Rayville,3724,619,920,379,143,124,2185
Louisiana,Rayne,7988,1544,1767,1469,235,98,5113
Louisiana,Bayou Corne,132,0,36,32,38,0,106
Louisiana,Doyline,894,104,200,170,48,13,535
Louisiana,Donaldsonville,7577,1079,2139,946,486,170,4820
Louisiana,Dodson,403,65,74,43,10,1,193
Louisiana,Dixie Inn,240,20,70,51,18,3,162
Louisiana,Deville,1577,269,404,228,125,31,1057
Louisiana,Destrehan,10994,442,2114,2394,1694,735,7379
Louisiana,Des Allemands,2054,401,909,279,31,24,1644
Louisiana,DeRidder,10861,1000,2408,1937,855,480,6680
Louisiana,DeQuincy,3179,544,925,477,107,97,2150
Louisiana,Downsville,131,4,47,12,16,14,93
Louisiana,Pollock,425,42,118,79,19,6,264
Louisiana,Bayou Country Club,1375,19,163,334,281,249,1046
Louisiana,Bayou Goula,553,106,155,6,58,14,339
Louisiana,Kinder,2870,266,586,499,118,103,1572
Louisiana,Killona,747,112,192,46,0,0,350
Louisiana,Killian,1030,87,278,256,83,47,751
Louisiana,Kilbourne,427,73,115,61,7,22,278
Louisiana,Kentwood,2213,375,693,322,61,46,1497
Louisiana,Kenner,66993,7100,14965,13455,7691,3156,46367
Louisiana,Keachi,403,50,104,63,30,6,253
Louisiana,Kaplan,4599,1133,1046,732,199,72,3182
Louisiana,Junction City,409,56,197,62,7,4,326
Louisiana,Joyce,212,86,58,32,0,0,176
Louisiana,Jordan Hill,115,15,28,6,0,0,49
Louisiana,Jonesville,2342,355,580,351,123,23,1432
Louisiana,Jonesboro,4653,888,1390,604,219,99,3200
Louisiana,Jennings,10226,1677,2524,1591,543,247,6582
Louisiana,Jena,3401,553,1169,596,302,80,2700
Louisiana,Jefferson,11061,1426,2753,2443,1357,686,8665
Louisiana,Jean Lafitte,2055,337,511,339,94,12,1293
Louisiana,Kraemer,954,251,282,92,28,14,667
Louisiana,Jeanerette,5549,807,1835,782,274,93,3791
Louisiana,Krotz Springs,1028,261,330,81,35,0,707
Louisiana,Lacassine,431,35,104,23,42,18,222
Louisiana,Lillie,165,34,42,35,20,1,132
Louisiana,Leonville,845,129,298,104,31,14,576
Louisiana,Lemannville,795,188,257,72,52,4,573
Louisiana,Leesville,6608,738,1436,1334,522,199,4229
Louisiana,Lecompte,972,110,356,199,24,7,696
Louisiana,Lawtell,1744,333,578,169,261,0,1341
Louisiana,Larose,7217,1398,1837,1067,422,155,4879
Louisiana,Laplace,28640,3377,6265,5393,2479,1018,18532
Louisiana,Lakeview,1072,86,265,355,54,49,809
Louisiana,Lakeshore,1717,84,382,424,228,32,1150
Louisiana,Lake Providence,3830,624,878,580,218,68,2368
Louisiana,Lake Charles,74190,7247,13924,14651,7793,3738,47353
Louisiana,Lake Arthur,2732,522,566,317,206,88,1699
Louisiana,Lafourche Crossing,2035,241,487,271,206,178,1383
Louisiana,Lafitte,878,178,274,66,32,8,558
Louisiana,Lafayette,124982,11229,19287,21449,18749,9346,80060
Louisiana,Lacombe,8038,1182,1934,1756,744,338,5954
Louisiana,Labadieville,2149,200,661,360,120,23,1364
Louisiana,Jamestown,218,31,61,36,19,3,150
Louisiana,Jackson,3794,1153,1079,624,122,37,3015
Louisiana,Iowa,3110,306,789,597,219,59,1970
Louisiana,Bourg,2444,292,533,493,138,64,1520
Louisiana,Bossier City,66093,4884,11997,14453,6963,3788,42085
Louisiana,Bordelonville,711,110,233,36,44,0,423
Louisiana,Boothville,883,303,230,30,10,0,573
Louisiana,Bonita,178,52,51,24,1,2,130
Louisiana,Bogalusa,12006,1862,3300,1696,576,261,7695
Louisiana,Blanchard,2920,149,696,750,297,108,2000
Louisiana,Bienville,219,36,61,44,18,6,165
Louisiana,Berwick,4830,809,1136,716,300,66,3027
Louisiana,Bernice,1270,196,326,214,16,10,762
Louisiana,Benton,1864,138,437,413,88,47,1123
Louisiana,Belmont,489,13,103,140,72,40,368
Louisiana,Belle Rose,1722,192,563,258,29,48,1090
Louisiana,Belle Chasse,13610,1173,3227,2755,1169,383,8707
Louisiana,Belcher,288,27,72,47,40,20,206
Louisiana,Bayou Vista,5103,985,1425,651,167,85,3313
Louisiana,Bayou L'Ourse,1563,302,348,227,70,21,968
Louisiana,Boutte,2450,183,667,458,269,89,1666
Louisiana,Hahnville,3540,485,868,632,220,148,2353
Louisiana,Hall Summit,377,56,89,65,22,1,233
Louisiana,Hammond,20272,2082,3299,2714,1796,1136,11027
Louisiana,Inniswold,6583,139,940,1376,1288,605,4348
Louisiana,Independence,1613,286,421,199,81,40,1027
Louisiana,Ida,181,22,74,48,8,5,157
Louisiana,Houma,33982,4465,8328,5738,2552,1180,22263
Louisiana,Hosston,310,47,114,37,16,7,221
Louisiana,Hornbeck,424,48,95,88,24,17,272
Louisiana,Homer,3092,419,908,460,139,68,1994
Louisiana,Hodge,352,31,131,70,24,7,263
Louisiana,Bayou Gauche,2154,131,587,405,175,160,1458
Louisiana,Hester,308,26,97,41,17,38,219
Louisiana,Henderson,1877,581,521,172,50,31,1355
Louisiana,Heflin,220,7,53,34,30,7,131
Louisiana,Haynesville,2506,444,612,425,107,84,1672
Louisiana,Hayes,886,0,267,16,47,49,379
Louisiana,Haughton,3439,552,874,756,282,54,2518
Louisiana,Harvey,21085,3165,4268,3981,1663,813,13890
Louisiana,Harrisonburg,380,37,114,35,29,13,228
Louisiana,Harahan,9328,698,2157,1978,1305,654,6792
Louisiana,Hessmer,838,119,315,123,34,14,605
Louisiana,Lisbon,194,34,56,31,13,15,149
Louisiana,Point Place,365,26,124,81,46,12,289
Louisiana,Pleasure Bend,376,74,105,75,0,0,254
Louisiana,Duson,1950,431,429,228,69,0,1157
Louisiana,East Hodge,322,19,90,72,8,9,198
Louisiana,Eastwood,4986,249,811,1107,437,325,2929
Louisiana,Eden Isle,7183,295,1765,1755,996,756,5567
Louisiana,Edgard,2531,138,555,656,188,149,1686
Louisiana,Edgefield,191,28,43,30,13,7,121
Louisiana,Egan,559,77,299,64,68,0,508
Louisiana,Elizabeth,555,54,138,73,34,5,304
Louisiana,Elmwood,4552,121,731,1146,930,629,3557
Louisiana,Elton,1278,238,406,214,15,20,893
Louisiana,Empire,999,160,299,200,19,16,694
Louisiana,Epps,1221,385,406,132,29,7,959
Louisiana,Erath,2144,361,626,283,162,27,1459
Louisiana,Eros,173,30,57,24,4,0,115
Louisiana,Erwinville,2010,228,836,199,124,24,1411
Louisiana,Estelle,15355,2406,3795,2556,1002,461,10220
Louisiana,Estherwood,1025,158,250,113,82,9,612
Louisiana,Dulac,1088,372,328,155,24,0,879
Louisiana,Eunice,10252,1775,2578,1503,367,237,6460
Louisiana,Dubberly,209,37,79,38,2,12,168
Louisiana,Dry Prong,520,49,83,119,33,20,304
Louisiana,Cameron,392,81,116,27,29,25,278
Louisiana,Calvin,230,6,87,37,2,4,136
Louisiana,Calhoun,621,141,111,108,14,64,438
Louisiana,Cade,1428,203,233,476,76,56,1044
Louisiana,Buras,1001,172,292,132,33,45,674
Louisiana,Bunkie,4099,805,891,467,297,96,2556
Louisiana,Bryceland,89,9,18,14,13,9,63
Louisiana,Brusly,2653,97,688,588,240,206,1819
Louisiana,Brownsville,4193,688,1412,514,111,25,2750
Louisiana,Brownfields,5456,353,1189,1072,555,211,3380
Louisiana,Broussard,9637,617,1982,1915,1217,722,6453
Louisiana,Bridge City,7027,1020,1868,1253,288,20,4449
Louisiana,Breaux Bridge,8286,1270,1918,1028,544,148,4908
Louisiana,Branch,255,27,126,0,33,0,186
Louisiana,Boyce,1441,186,403,249,73,49,960
Louisiana,Gueydan,1559,319,522,207,51,13,1112
Louisiana,Grosse Tete,738,64,254,144,59,10,531
Louisiana,Dubach,929,95,292,97,50,31,565
Louisiana,Campti,862,146,192,87,26,20,471
Louisiana,Evergreen,262,113,67,31,3,6,220
Louisiana,Fenton,434,63,156,35,48,4,306
Louisiana,Gilliam,119,9,31,25,25,5,95
Louisiana,Gillis,495,57,282,77,0,0,416
Louisiana,Glencoe,313,24,44,82,26,0,176
Louisiana,Glenmora,1272,255,276,148,53,31,763
Louisiana,Gloster,101,0,0,0,0,75,75
Louisiana,Golden Meadow,1783,397,505,229,64,41,1236
Louisiana,Goldonna,373,64,141,49,20,7,281
Louisiana,Gonzales,10319,740,2776,2420,806,435,7177
Louisiana,Grambling,5067,430,481,703,382,430,2426
Louisiana,Gramercy,3493,380,954,598,233,79,2244
Louisiana,Grand Cane,273,35,94,36,24,11,200
Louisiana,Grand Coteau,889,127,279,118,70,8,602
Louisiana,Grand Isle,1002,181,277,153,19,12,642
Louisiana,Grand Point,2383,108,779,490,170,37,1584
Louisiana,Gray,5515,898,1346,763,276,49,3332
Louisiana,Grayson,382,67,127,61,24,5,284
Louisiana,Greensburg,713,117,206,125,35,28,511
Louisiana,Gilbert,427,76,108,71,14,0,269
Louisiana,Farmerville,3877,457,834,718,125,83,2217
Louisiana,Gibsland,938,66,268,178,58,17,587
Louisiana,Garyville,2314,265,814,358,109,54,1600
Louisiana,Ferriday,3438,496,685,456,233,84,1954
Louisiana,Fifth Ward,735,139,228,140,20,28,555
Louisiana,Fisher,248,48,77,40,1,8,174
Louisiana,Florien,420,32,112,78,40,13,275
Louisiana,Folsom,697,79,192,121,64,24,480
Louisiana,Fordoche,917,178,368,109,48,32,735
Louisiana,Forest,301,48,75,39,21,11,194
Louisiana,Forest Hill,713,104,192,78,25,13,412
Louisiana,Fort Jesup,291,25,124,12,41,10,212
Louisiana,Fort Polk North,2391,20,135,448,289,43,935
Louisiana,Fort Polk South,9684,74,901,1877,813,356,4021
Louisiana,Franklin,7435,1017,2211,1049,355,186,4818
Louisiana,Franklinton,3793,684,883,683,255,175,2680
Louisiana,French Settlement,1349,90,411,278,74,15,868
Louisiana,Frierson,530,113,70,113,0,0,296
Louisiana,Galliano,7510,1859,2066,906,129,94,5054
Louisiana,Gardere,10908,1083,1594,1647,1081,188,5593
Louisiana,Georgetown,389,36,101,63,8,0,208
Louisiana,Pointe a la Hache,188,16,74,23,0,18,131
Louisiana,Cankton,641,82,190,44,14,0,330
Louisiana,Carlyss,4896,449,1247,931,404,82,3113
Louisiana,Oil City,958,162,220,134,31,14,561
Louisiana,Oberlin,1969,270,595,302,48,35,1250
Louisiana,Oak Ridge,118,7,13,14,19,20,73
Louisiana,Oak Hills Place,8487,164,882,1333,2317,1462,6158
Louisiana,Oak Grove,1497,282,373,204,117,45,1021
Louisiana,Oakdale,7722,1199,2473,1617,339,290,5918
Louisiana,Norwood,285,44,80,48,25,13,210
Louisiana,Crescent,409,116,92,90,12,37,347
Louisiana,Walker,6205,377,1464,1433,585,202,4061
Louisiana,Wallace,662,63,207,144,15,19,448
Louisiana,Wallace Ridge,286,33,113,23,35,0,204
Louisiana,Washington,725,93,195,73,73,41,475
Louisiana,Waterproof,854,188,236,117,11,5,557
Louisiana,Watson,905,124,308,102,182,14,730
Louisiana,Welcome,971,90,217,166,14,30,517
Louisiana,Welsh,3223,450,750,609,141,64,2014
Louisiana,Westlake,4606,420,1482,886,209,131,3128
Louisiana,Old Jefferson,6999,137,1350,1388,1267,360,4502
Louisiana,Westminster,2996,11,187,699,734,574,2205
Louisiana,Olla,1165,141,323,210,85,6,765
Louisiana,Oretta,542,57,215,54,35,0,361
Louisiana,Pleasant Hill,704,121,225,118,29,8,501
Louisiana,Plaucheville,178,23,39,36,14,6,118
Louisiana,Plaquemine,6993,845,1592,1203,296,363,4299
Louisiana,Plain Dealing,1009,149,211,153,85,45,643
Louisiana,Pitkin,493,91,145,81,37,0,354
Louisiana,Pioneer,163,19,48,18,8,3,96
Louisiana,Pineville,14455,1379,2936,2258,1219,738,8530
Louisiana,Pine Prairie,1319,320,342,198,30,19,909
Louisiana,Pierre Part,2555,483,809,444,142,51,1929
Louisiana,Pearl River,2466,355,694,453,89,59,1650
Louisiana,Paulina,1149,20,391,191,83,22,707
Louisiana,Patterson,6106,1039,1666,788,349,88,3930
Louisiana,Parks,668,80,219,103,58,34,494
Louisiana,Paradis,1304,115,261,264,57,11,708
Louisiana,Palmetto,152,51,45,7,8,2,113
Louisiana,Paincourtville,1017,107,199,235,40,20,601
Louisiana,Ossun,2528,284,518,371,182,0,1355
Louisiana,Opelousas,16638,2908,4354,1892,653,387,10194
Louisiana,Carencro,8269,1414,1792,1633,706,174,5719
Louisiana,West Monroe,13032,1233,3172,2493,1094,574,8566
Louisiana,White Castle,2241,360,481,349,65,37,1292
Louisiana,Clarence,358,27,110,54,10,14,215
Louisiana,Claiborne,11760,711,2426,1933,1836,574,7480
Louisiana,Church Point,4525,981,1119,893,57,17,3067
Louisiana,Choudrant,1200,41,250,160,138,99,688
Louisiana,Choctaw,842,357,176,84,13,15,645
Louisiana,Cheneyville,492,99,136,81,33,6,355
Louisiana,Chauvin,2945,711,817,224,52,9,1813
Louisiana,Chatham,671,118,159,74,44,40,435
Louisiana,Chataignier,363,62,97,49,12,8,228
Louisiana,Charenton,1731,266,716,220,75,20,1297
Louisiana,Chalmette,21311,2287,5387,3897,1503,494,13568
Louisiana,Chackbay,5162,725,1338,791,328,133,3315
Louisiana,Central,27768,1226,7345,6349,3158,1113,19191
Louisiana,Center Point,332,77,80,78,42,0,277
Louisiana,Cecilia,1183,110,268,254,86,13,731
Louisiana,Catahoula,923,116,300,108,9,0,533
Louisiana,Castor,299,59,52,37,9,1,158
Louisiana,Clarks,995,339,230,139,4,3,715
Louisiana,Westwego,8564,1441,2482,1565,403,95,5986
Louisiana,Clayton,571,118,136,70,23,2,349
Louisiana,Colfax,1706,244,439,319,71,26,1099
Louisiana,Wilson,548,95,157,71,38,0,361
Louisiana,Winnfield,4666,544,1230,727,309,79,2889
Louisiana,Winnsboro,4811,1013,1088,523,110,159,2893
Louisiana,Wisner,923,193,192,139,38,38,600
Louisiana,Woodmere,12161,1141,2481,2455,880,374,7331
Louisiana,Woodworth,1121,88,250,323,121,64,846
Louisiana,Youngsville,10109,342,1593,1980,2013,481,6409
Louisiana,Zachary,15868,709,2393,3252,1992,1350,9696
Louisiana,Clinton,1401,106,378,271,106,61,922
Louisiana,Zwolle,2134,318,559,266,66,43,1252
Louisiana,Covington,9350,1215,1462,1577,1464,768,6486
Louisiana,Coushatta,2539,513,553,212,86,27,1391
Louisiana,Cotton Valley,1055,190,290,106,62,18,666
Louisiana,Cottonport,1997,329,382,274,99,20,1104
Louisiana,Converse,412,58,131,51,20,7,267
Louisiana,Convent,628,123,157,78,44,21,423
Louisiana,Columbia,432,57,129,83,13,19,301
Louisiana,Collinston,216,53,79,39,8,2,181
Louisiana,Creola,278,20,57,62,3,2,144
Louisiana,Livingston,2035,257,571,329,155,53,1365
Maine,Ashland,606,67,168,160,43,22,460
Maine,Auburn,22916,1748,5291,4667,2643,1362,15711
Maine,Blaine,438,21,86,126,50,1,284
Maine,Mechanic Falls,1649,179,581,204,157,61,1182
Maine,Mexico,1574,147,551,410,101,4,1213
Maine,Milford,2239,84,604,580,239,116,1623
Maine,Millinocket,4419,465,1446,1056,167,214,3348
Maine,Milo,1923,126,587,410,116,89,1328
Maine,Naples,462,0,177,136,72,29,414
Maine,Newcastle,697,23,97,133,162,127,542
Maine,Newport,1616,142,471,332,160,45,1150
Maine,Norridgewock,1198,164,417,203,154,32,970
Maine,North Berwick,1792,81,482,451,154,59,1227
Maine,North Windham,4671,177,1010,908,665,283,3043
Maine,Mars Hill,956,116,290,232,78,13,729
Maine,Norway,2341,212,837,459,74,42,1624
Maine,Old Orchard Beach,8697,535,2315,2204,1556,530,7140
Maine,Old Town,7726,539,1642,1749,776,590,5296
Maine,Orono,9522,242,534,642,858,1086,3362
Maine,Oxford,1538,118,492,394,108,33,1145
Maine,Pittsfield,3110,172,737,638,292,112,1951
Maine,Portland,66490,3651,10059,12384,13684,8712,48490
Maine,Presque Isle,9378,689,2265,2190,788,468,6400
Maine,Randolph,1792,116,522,414,180,44,1276
Maine,Richmond,1942,155,352,544,256,79,1386
Maine,Rockland,7233,396,2154,1179,1159,606,5494
Maine,Rumford,4214,307,1585,703,282,72,2949
Maine,Oakland,2448,148,667,504,237,233,1789
Maine,Mapleton,763,24,143,226,81,22,496
Maine,Madison,2372,232,828,507,121,62,1750
Maine,Madawaska,2623,327,886,486,333,57,2089
Maine,Anson,791,58,211,198,36,27,530
Maine,Fryeburg,1797,73,417,432,155,123,1200
Maine,Gardiner,5697,304,1272,1625,549,300,4050
Maine,Gorham,6445,161,901,1086,1113,586,3847
Maine,Gray,1225,79,155,224,162,59,679
Maine,Greenville,1453,99,366,248,74,90,877
Maine,Guilford,1031,65,355,263,41,9,733
Maine,Hallowell,2514,98,437,427,518,401,1881
Maine,Hartland,768,87,227,170,17,16,517
Maine,Houlton,4778,415,1539,1047,434,196,3631
Maine,Howland,1193,128,367,229,104,31,859
Maine,Kennebunk,5621,160,993,966,1200,916,4235
Maine,Kennebunkport,1078,2,86,230,251,265,834
Maine,Kittery,4515,166,714,1188,847,393,3308
Maine,Kittery Point,1112,78,334,142,313,165,1032
Maine,Lake Arrowhead,2477,53,455,596,222,159,1485
Maine,Lewiston,36356,3543,9064,7897,2548,1436,24488
Maine,Limestone,1257,142,282,194,66,43,727
Maine,Lincoln,2688,378,793,599,110,132,2012
Maine,Lisbon Falls,4128,119,838,1074,488,116,2635
Maine,Little Falls,382,60,18,105,95,0,278
Maine,Littlejohn Island,78,0,24,29,25,0,78
Maine,Livermore Falls,1366,136,536,193,105,10,980
Maine,Lubec,377,17,131,108,29,27,312
Maine,Machias,1206,86,363,251,103,68,871
Maine,Saco,18874,1050,4356,3762,2914,1373,13455
Maine,Alfred,658,24,197,220,84,58,583
Maine,Sanford,20864,1763,5515,3992,2225,843,14338
Maine,Searsport,1059,85,161,257,213,107,823
Maine,Cumberland Center,2664,0,175,300,602,524,1601
Maine,Cousins Island,565,0,44,58,157,149,408
Maine,Clinton,1076,135,392,203,54,13,797
Maine,Chisholm,1209,17,445,237,103,67,869
Maine,Castine,959,0,47,53,80,79,259
Maine,Casco,646,45,251,123,42,0,461
Maine,Caribou,7960,940,1984,1764,788,343,5819
Maine,Cape Neddick,2780,26,562,716,583,387,2274
Maine,Camden,3304,97,389,842,872,565,2765
Maine,Calais,3038,338,793,701,235,124,2191
Maine,Bucksport,2481,52,603,620,332,183,1790
Maine,Damariscotta,1095,65,118,255,181,204,823
Maine,Brunswick Station,510,30,55,149,49,52,335
Maine,Bridgton,2214,60,567,349,340,144,1460
Maine,Brewer,9341,445,1977,2364,1527,532,6845
Maine,Bowdoinham,520,36,97,114,57,44,348
Maine,Boothbay Harbor,922,43,283,206,148,104,784
Maine,Blue Hill,1000,26,244,255,158,112,795
Maine,Bingham,605,44,187,180,68,2,481
Maine,Biddeford,21289,1593,4799,4044,2334,1020,13790
Maine,Berwick,2412,81,406,632,419,67,1605
Maine,Belfast,6668,433,1212,1062,1098,898,4703
Maine,Bath,8349,408,1693,1814,1231,672,5818
Maine,Bar Harbor,2585,89,375,395,536,233,1628
Maine,Brunswick,15453,771,2407,3011,2411,1918,10518
Maine,Dexter,2087,155,671,481,145,75,1527
Maine,Dixfield,1039,21,292,238,89,11,651
Maine,Dover-Foxcroft,2445,323,543,552,296,156,1870
Maine,Skowhegan,6260,626,1778,1178,393,277,4252
Maine,South Eliot,3740,141,776,916,601,299,2733
Maine,South Paris,2854,203,1126,637,233,45,2244
Maine,South Portland,25304,819,4279,5231,5057,2317,17703
Maine,Southwest Harbor,753,33,161,159,142,105,600
Maine,South Windham,1140,124,501,286,86,0,997
Maine,Standish,393,0,154,43,44,89,330
Maine,Steep Falls,1227,41,389,170,181,58,839
Maine,Thomaston,2031,126,509,445,328,116,1524
Maine,Topsham,6483,233,1287,1235,1262,627,4644
Maine,Unity,529,35,113,76,39,50,313
Maine,Van Buren,1877,338,576,375,102,50,1441
Maine,Waldoboro,1135,14,401,230,186,41,872
Maine,Freeport,1507,59,294,287,295,170,1105
Maine,Fort Kent,2345,242,585,355,290,151,1623
Maine,Fort Fairfield,1763,176,604,274,115,113,1282
Maine,Farmington,3795,261,599,465,436,309,2070
Maine,Farmingdale,1969,201,443,333,345,116,1438
Maine,Falmouth Foreside,1702,40,147,254,378,395,1214
Maine,Falmouth,2051,18,130,317,701,414,1580
Maine,Fairfield,3105,237,712,769,271,105,2094
Maine,Ellsworth,7832,304,1882,1990,1114,567,5857
Maine,Eastport,1365,103,390,306,219,102,1120
Maine,East Millinocket,1717,117,515,433,144,36,1245
Maine,Eagle Lake,530,95,181,92,44,13,425
Maine,Scarborough,4601,254,825,717,1035,556,3387
Maine,Washburn,948,114,290,211,75,16,706
Maine,Hampden,3468,25,705,705,740,544,2719
Maine,Wiscasset,1193,20,354,364,180,43,961
Maine,Winthrop,2651,23,503,799,333,287,1945
Maine,Winslow,7661,332,1965,1765,873,448,5383
Maine,Woodland,869,30,229,216,76,22,573
Maine,Wilton,2036,82,617,322,235,140,1396
Maine,Yarmouth,5628,160,790,784,1430,959,4123
Maine,York Harbor,3003,22,469,508,941,379,2319
Maine,West Kennebunk,1062,2,236,138,226,109,711
Maine,Winterport,1110,36,211,178,257,135,817
Maine,Westbrook,17754,1115,4178,4006,2441,979,12719
Maine,Augusta,18772,1563,4757,3862,2320,1048,13550
Maine,Waterville,15989,1093,3385,3150,1302,1456,10386
Maine,Bangor,32695,1879,6593,7004,3683,2644,21803
Maine,Winter Harbor,398,40,114,66,46,14,280
Maryland,Peppermill Village,4785,341,1110,1068,353,187,3059
Maryland,Pecktonville,170,0,69,7,9,0,85
Maryland,Pasadena,25895,1383,5752,4930,3562,1653,17280
Maryland,Parsonsburg,309,108,29,53,59,0,249
Maryland,Martin's Additions,976,6,8,50,186,373,623
Maryland,Easton,16599,1623,3366,3500,1979,1628,12096
Maryland,Perry Hall,28633,1281,5320,5178,5473,3153,20405
Maryland,Perryman,2811,350,660,556,281,44,1891
Maryland,Perryville,4427,180,1345,758,531,249,3063
Maryland,Pikesville,32149,944,4271,4499,7354,7050,24118
Maryland,Pinesburg,365,41,195,34,17,0,287
Maryland,Piney Point,803,45,220,164,135,95,659
Maryland,Marlton,9391,252,1609,1834,1508,1155,6358
Maryland,Marlow Heights,5676,422,1383,1326,382,160,3673
Maryland,Marlboro Village,10457,365,1656,2324,1219,889,6453
Maryland,Parole,16764,554,2449,3272,3631,3758,13664
Maryland,Parkville,32163,2530,7265,6405,3665,1926,21791
Maryland,Paramount-Long Meadow,2605,130,434,530,503,309,1906
Maryland,Oxon Hill,18437,1642,4287,4061,1938,1180,13108
Maryland,National Harbor,3837,436,858,717,459,311,2781
Maryland,Naval Academy,5630,3,45,208,99,125,480
Maryland,Newark,329,10,122,56,38,8,234
Maryland,New Carrollton,12542,1395,2376,2379,1402,728,8280
Maryland,New Market,951,22,107,154,183,106,572
Maryland,New Windsor,1145,56,330,236,112,49,783
Maryland,Nikep,88,7,9,42,0,0,58
Maryland,North Beach,2311,136,557,382,289,191,1555
Maryland,North Bethesda,48818,1808,3285,5483,11025,14108,35709
Maryland,North Brentwood,518,102,97,100,72,23,394
Maryland,North Chevy Chase,486,2,13,40,100,198,353
Maryland,North East,3700,459,1015,538,470,93,2575
Maryland,Marlboro Meadows,3657,179,839,870,427,278,2593
Maryland,North Kensington,9768,857,997,1433,1944,1736,6967
Maryland,North Potomac,24087,313,1272,2186,5083,7124,15978
Maryland,Oakland,2102,206,573,496,172,196,1643
Maryland,Ocean,10,0,0,0,0,10,10
Maryland,Ocean City,7074,483,1859,1585,1308,813,6048
Maryland,Ocean Pines,11025,605,2184,2946,2147,1352,9234
Maryland,Odenton,38374,1229,4859,7716,7111,5001,25916
Maryland,Oldtown,114,32,36,31,0,0,99
Maryland,Olney,35090,1126,2292,5533,7684,6785,23420
Maryland,Overlea,12206,812,2907,2715,1406,1097,8937
Maryland,Owings,2638,96,484,588,290,142,1600
Maryland,Owings Mills,33732,1746,4061,5651,5917,3819,21194
Maryland,Oxford,545,3,48,83,176,150,460
Maryland,North Laurel,22217,736,3115,3819,3424,3043,14137
Maryland,Mardela Springs,308,4,102,46,12,28,192
Maryland,Lutherville,6600,269,755,1100,1418,1077,4619
Maryland,Manchester,4814,256,1025,1039,456,325,3101
Maryland,Langley Park,21049,8828,2688,1215,1040,261,14032
Maryland,Landover Hills,1903,306,389,373,92,43,1203
Maryland,Landover,23218,2926,5406,4249,1282,644,14507
Maryland,Lake Shore,19375,990,3718,4577,2620,1425,13330
Maryland,Lake Arbor,10414,248,1159,2503,1913,1476,7299
Maryland,Konterra,2416,178,432,378,420,333,1741
Maryland,Klondike,132,0,49,10,0,0,59
Maryland,Kitzmiller,275,37,99,37,14,11,198
Maryland,Kingsville,4387,156,845,863,841,572,3277
Maryland,Kingstown,1923,152,547,332,184,195,1410
Maryland,Kettering,13195,490,1895,3782,2140,1526,9833
Maryland,Kent Narrows,441,0,105,107,98,113,423
Maryland,Kensington,1990,50,101,147,439,599,1336
Maryland,Kennedyville,177,0,22,9,45,9,85
Maryland,Kemps Mill,107,0,107,0,0,0,107
Maryland,Kemp Mill,12285,849,1105,1676,2280,2622,8532
Maryland,Keedysville,1185,24,249,278,154,68,773
Maryland,Jugtown,212,0,78,82,14,0,174
Maryland,Joppatowne,12684,807,2844,2539,1744,1002,8936
Maryland,Jesterville,323,105,126,47,14,31,323
Maryland,Jessup,7671,1687,2575,1535,360,127,6284
Maryland,Lanham,10967,1380,1763,1788,1019,601,6551
Maryland,Mapleville,229,17,60,48,15,55,195
Maryland,Lansdowne,8490,1323,2300,1267,377,147,5414
Maryland,Largo,11015,278,1595,3087,1736,1126,7822
Maryland,Madison,204,21,33,49,26,29,158
Maryland,McCoole,355,34,161,87,9,0,291
Maryland,National,58,0,13,22,0,0,35
Maryland,Lusby,1632,100,307,386,144,141,1078
Maryland,Luke,97,8,27,17,3,1,56
Maryland,Long Beach,2219,79,428,504,327,155,1493
Maryland,Lonaconing,1088,65,375,213,79,52,784
Maryland,Loch Lynn Heights,681,76,201,81,40,10,408
Maryland,Lochearn,26070,2004,5253,6399,3430,1814,18900
Maryland,Little Orleans,28,0,28,0,0,0,28
Maryland,Linthicum,10699,800,2417,2233,1265,817,7532
Maryland,Linganore,9082,223,957,1496,1707,1512,5895
Maryland,Libertytown,1261,37,416,157,195,78,883
Maryland,Lexington Park,12642,841,2039,2642,1348,513,7383
Maryland,Leonardtown,3392,360,643,579,360,344,2286
Maryland,Leitersburg,621,56,204,147,61,0,468
Maryland,Leisure World,9227,732,2129,1853,2125,1947,8786
Maryland,Laytonsville,337,9,47,52,74,65,247
Maryland,Layhill,5051,404,764,740,796,1033,3737
Maryland,La Vale,3265,193,689,954,287,286,2409
Maryland,Laurel,25849,2181,3795,4208,4168,3137,17489
Maryland,La Plata,8994,499,1405,2259,1000,874,6037
Maryland,Nanticoke Acres,228,37,19,18,0,0,74
Maryland,Mount Airy,9353,307,1300,1685,1715,858,5865
Maryland,Myersville,1812,45,163,337,303,237,1085
Maryland,Crofton,27934,558,2682,4437,6362,4590,18629
Maryland,Crisfield,2685,394,797,332,110,96,1729
Maryland,Cresaptown,6127,1037,2045,1292,274,291,4939
Maryland,Crellin,203,28,91,14,34,0,167
Maryland,Cottage City,1151,220,239,230,112,50,851
Maryland,Corriganville,424,81,104,75,9,9,278
Maryland,Cordova,682,49,202,186,26,29,492
Maryland,Coral Hills,9842,1136,2388,1989,595,182,6290
Maryland,Mercersville,61,18,33,10,0,0,61
Maryland,Croom,3107,369,708,617,351,256,2301
Maryland,Melwood,2763,239,590,586,331,312,2058
Maryland,Mays Chapel,11774,184,1272,1605,2822,2551,8434
Maryland,Jennings,110,13,40,20,0,0,73
Maryland,East Riverdale,16242,3922,2591,1955,828,302,9598
Maryland,Eckhart Mines,891,134,309,190,35,29,697
Maryland,Eden,670,188,161,71,50,8,478
Maryland,Edesville,182,75,41,34,0,10,160
Maryland,Edgemere,8443,952,2484,1986,524,265,6211
Maryland,Edgemont,178,14,60,55,25,24,178
Maryland,Edgewater,9583,381,2030,2096,1426,758,6691
Maryland,Mechanicsville,1937,146,376,288,321,102,1233
Maryland,Crownsville,1967,115,308,338,271,348,1380
Maryland,Cumberland,20449,1707,5595,4033,1343,1106,13784
Maryland,Damascus,15267,655,2008,2512,2787,1981,9943
Maryland,East New Market,458,34,94,84,46,17,275
Maryland,Eakles Mill,0,0,0,0,0,0,0
Maryland,Eagle Harbor,41,7,11,10,0,0,28
Maryland,Dunkirk,2303,70,464,528,366,185,1613
Maryland,Dundalk,62349,8754,18818,11296,2950,1353,43171
Maryland,Drum Point,3149,118,633,903,280,174,2108
Maryland,Downsville,347,44,60,98,0,25,227
Maryland,District Heights,6036,413,1557,1461,310,208,3949
Maryland,Detmold,36,0,18,18,0,0,36
Maryland,Derwood,2169,170,145,103,521,433,1372
Maryland,Denton,4357,400,927,1065,269,173,2834
Maryland,Delmar,3026,203,747,587,271,201,2009
Maryland,Deer Park,474,64,142,85,21,5,317
Maryland,Deal Island,353,31,158,59,42,15,305
Maryland,Deale,5095,293,1000,1137,767,486,3683
Maryland,Dawson,143,18,48,20,9,9,104
Maryland,Darnestown,6784,76,529,636,1597,1648,4486
Maryland,Darlington,481,31,134,99,66,51,381
Maryland,Dargan,157,0,40,71,0,0,111
Maryland,Danville,364,9,136,103,0,0,248
Maryland,Dames Quarter,152,35,16,41,10,10,112
Maryland,Edgewood,26060,1478,5750,5973,1825,1231,16257
Maryland,Edmonston,1445,375,266,192,72,68,973
Maryland,Eldersburg,31494,1411,5004,5834,5994,2990,21233
Maryland,Eldorado,57,11,15,7,0,0,33
Maryland,Maugansville,3573,253,697,828,432,122,2332
Maryland,Maryland City,17060,1022,2579,3406,2263,2493,11763
Maryland,Marydel,204,84,21,13,1,5,124
Maryland,Middle River,25816,2650,6414,5010,1745,1040,16859
Maryland,Middletown,4432,31,460,631,1039,649,2810
Maryland,Midland,651,27,301,150,21,12,511
Maryland,Midlothian,344,0,92,106,10,0,208
Maryland,Milford Mill,30085,1446,6258,6025,3975,2060,19764
Maryland,Millington,620,115,216,101,43,18,493
Maryland,Mitchellville,10475,292,1328,2701,1930,1453,7704
Maryland,Monrovia,285,0,38,66,52,50,206
Maryland,Montgomery Village,33337,2317,4551,5557,5217,4223,21865
Maryland,Morningside,1525,170,353,252,170,136,1081
Maryland,Moscow,232,42,83,31,18,0,174
Maryland,Mount Aetna,650,10,96,254,27,79,466
Maryland,Mountain Lake Park,2641,187,660,534,282,153,1816
Maryland,Mount Briar,234,19,47,67,19,13,165
Maryland,Mount Lena,523,48,192,86,12,11,349
Maryland,Mount Rainier,8329,1467,1319,1221,918,566,5491
Maryland,Mount Savage,776,50,282,163,24,56,575
Maryland,Mount Vernon,810,45,265,190,28,27,555
Maryland,Mayo,8779,295,1577,1807,1417,853,5949
Maryland,Nanticoke,302,0,74,86,37,18,215
Maryland,Middleburg,15,0,0,15,0,0,15
Maryland,Forest Glen,7374,476,992,958,1279,1609,5314
Maryland,Elkridge,17550,939,2288,2550,3419,2450,11646
Maryland,Elkton,15718,1491,3621,2734,1283,781,9910
Maryland,Ellerslie,485,53,175,77,28,22,355
Maryland,Ellicott City,68513,1900,5712,8276,14750,15511,46149
Maryland,Elliott,20,0,15,5,0,0,20
Maryland,Emmitsburg,2951,196,688,552,335,150,1921
Maryland,Ernstville,14,0,0,0,7,7,14
Maryland,Essex,38256,4080,11073,7273,2302,986,25714
Maryland,Fairland,23673,993,3151,4163,4277,3412,15996
Maryland,Fairlee,338,49,0,81,23,10,163
Maryland,Fairmount,272,49,171,26,0,7,253
Maryland,Fairmount Heights,1602,211,472,336,59,41,1119
Maryland,Fairplay,467,32,103,145,20,39,339
Maryland,Fairview,0,0,0,0,0,0,0
Maryland,Fairwood,5707,98,238,879,1202,1206,3623
Maryland,Fallston,9418,119,1416,2167,1786,843,6331
Maryland,Federalsburg,2676,372,676,331,133,66,1578
Maryland,Ferndale,18612,2217,4047,3949,1566,880,12659
Maryland,Finzel,699,54,218,123,41,11,447
Maryland,Fishing Creek,136,19,52,32,22,11,136
Maryland,Flintstone,83,0,45,9,0,23,77
Maryland,Forest Heights,2530,246,711,552,147,89,1745
Maryland,Jefferson,2143,50,360,445,421,204,1480
Maryland,Hillcrest Heights,15383,1112,3611,4117,1290,586,10716
Maryland,Indian Springs,49,0,31,0,0,0,31
Maryland,San Mar,219,48,82,41,22,0,193
Maryland,Savage,6058,642,677,1095,970,851,4235
Maryland,Scaggsville,9348,240,979,1263,1929,1729,6140
Maryland,Seabrook,17839,1388,2751,3637,2295,1177,11248
Maryland,Seat Pleasant,4699,532,1131,788,249,140,2840
Maryland,Secretary,759,78,206,172,44,2,502
Maryland,Severn,47432,2711,7979,9572,7262,4471,31995
Maryland,Severna Park,38364,1015,3960,5545,8753,6285,25558
Maryland,Shady Side,6440,291,1186,1574,583,548,4182
Maryland,Shaft,426,12,86,117,59,0,274
Maryland,Sharpsburg,811,72,174,242,78,14,580
Maryland,Sharptown,959,95,200,167,70,41,573
Maryland,Silver Hill,5182,354,1225,1136,358,324,3397
Maryland,Silver Spring,77460,8572,7090,9198,12172,16820,53852
Maryland,Smith Island,180,35,70,32,8,5,150
Maryland,Smithsburg,3010,99,622,659,308,186,1874
Maryland,Snow Hill,2343,267,601,322,145,140,1475
Maryland,Solomons,1833,161,266,394,501,365,1687
Maryland,Ilchester,26304,986,2340,3192,5090,5159,16767
Maryland,Hyattsville,18225,2882,2537,2633,2220,1915,12187
Maryland,Hutton,60,32,0,7,0,7,46
Maryland,Sandy Hook,205,28,97,0,0,0,125
Maryland,Hurlock,1958,283,573,333,39,56,1284
Maryland,Salisbury,31883,2484,4996,4783,2920,2079,17262
Maryland,St. Leonard,458,20,105,80,24,43,272
Maryland,Reisterstown,27637,1819,4281,5479,4039,2612,18230
Maryland,Ridgely,1379,158,304,295,86,77,920
Maryland,Ringgold,165,44,64,9,0,19,136
Maryland,Rising Sun,2869,211,729,474,142,112,1668
Maryland,Pittsville,1426,111,400,258,70,30,869
Maryland,Riva,3817,100,582,706,979,493,2860
Maryland,Riverdale Park,7169,1627,833,857,702,426,4445
Maryland,Riverside,6799,297,1163,1585,1058,464,4567
Maryland,Riviera Beach,13466,900,3588,2931,1190,552,9161
Maryland,Robinwood,7769,314,1478,1732,765,813,5102
Maryland,Rock Hall,1157,99,335,245,160,109,948
Maryland,Rock Point,127,33,44,33,8,0,118
Maryland,Rockville,64331,3033,5675,7822,12040,17322,45892
Maryland,Rohrersville,18,0,0,18,0,0,18
Maryland,Rosaryville,11348,423,1720,2651,1718,1151,7663
Maryland,Rosedale,19029,1949,5105,3984,1506,682,13226
Maryland,Rosemont,360,9,112,36,48,39,244
Maryland,Rossville,15368,1202,2961,3596,2075,1022,10856
Maryland,Sabillasville,264,17,63,66,13,28,187
Maryland,St. George Island,297,49,55,78,45,45,272
Maryland,St. James,3160,178,773,559,344,275,2129
Maryland,St. Michaels,1084,79,222,230,197,111,839
Maryland,Reid,60,31,7,0,8,0,46
Maryland,Huntingtown,4025,61,763,640,534,508,2506
Maryland,Friendship Heights Village,4872,63,188,511,1323,2178,4263
Maryland,Goldsboro,221,47,66,19,2,7,141
Maryland,Gorman,31,16,15,0,0,0,31
Maryland,Grahamtown,388,0,108,140,57,14,319
Maryland,Grantsville,819,65,229,205,54,40,593
Maryland,Grasonville,3349,146,784,513,497,200,2140
Maryland,Greenbelt,23827,1743,2901,4268,3701,3197,15810
Maryland,Greensboro,2020,227,428,338,105,68,1166
Maryland,Greensburg,329,19,122,26,41,32,240
Maryland,Hagerstown,40210,4451,9500,7927,2644,1632,26154
Maryland,Halfway,10596,605,3048,2109,877,467,7106
Maryland,Hampstead,6351,196,1202,1294,911,440,4043
Maryland,Hampton,4897,106,555,733,992,1262,3648
Maryland,Hancock,1649,155,580,256,56,30,1077
Maryland,Havre de Grace,13445,843,2693,2628,1987,1741,9892
Maryland,Hebron,1046,49,230,190,131,39,639
Maryland,Henderson,172,58,69,2,0,1,130
Maryland,Herald Harbor,2726,53,320,551,679,283,1886
Maryland,Highfield-Cascade,897,84,324,145,67,21,641
Maryland,Highland,1113,9,38,53,404,301,805
Maryland,Highland Beach,110,2,11,16,16,43,88
Maryland,Hillandale,5936,527,771,871,893,1187,4249
Maryland,Golden Beach,3380,179,1084,653,196,141,2253
Maryland,Hughesville,2206,176,482,481,253,246,1638
Maryland,Glenn Dale,13108,751,1515,2969,2176,1735,9146
Maryland,Glen Echo,286,1,7,12,85,86,191
Maryland,Friendsville,582,62,140,102,25,24,353
Maryland,Frostburg,8759,417,1410,1074,489,785,4175
Maryland,Fruitland,5110,298,1064,809,554,410,3135
Maryland,Fulton,2758,47,489,260,556,554,1906
Maryland,Funkstown,863,76,243,181,58,28,586
Maryland,Gaithersburg,64945,5084,6349,9308,11806,11305,43852
Maryland,Galena,835,70,195,127,107,49,548
Maryland,Galestown,155,14,59,33,15,4,125
Maryland,Galesville,574,56,144,185,29,51,465
Maryland,Gambrills,2583,126,461,503,448,346,1884
Maryland,Gapland,111,0,29,33,14,0,76
Maryland,Garrett Park,998,5,24,90,239,322,680
Maryland,Garretts Mill,460,62,138,59,36,0,295
Maryland,Garrison,8549,332,903,1737,1719,1163,5854
Maryland,Georgetown,148,25,90,0,0,0,115
Maryland,Germantown,89826,5184,9227,15441,15781,12788,58421
Maryland,Gilmore,190,11,84,88,0,0,183
Maryland,Girdletree,142,23,42,10,8,0,83
Maryland,Glassmanor,17552,2193,4185,3693,1081,603,11755
Maryland,Glenarden,6212,372,1179,1299,711,370,3931
Maryland,Glen Burnie,68550,6597,15853,15370,6519,3204,47543
Maryland,Glenmont,15716,2041,2539,1972,2188,2013,10753
Maryland,Redland,17175,1223,2272,2262,3048,2722,11527
Maryland,Rawlings,605,24,111,177,68,37,417
Maryland,Randallstown,34088,1527,6055,7781,4999,3181,23543
Maryland,Waterview,14,0,14,0,0,0,14
Maryland,Washington Grove,636,15,66,65,121,213,480
Maryland,Walkersville,5965,319,1020,1213,835,615,4002
Maryland,Walker Mill,11293,1117,2502,2427,1022,818,7886
Maryland,Waldorf,71399,2910,13846,15743,7943,4799,45241
Maryland,Vienna,284,20,73,86,39,6,224
Maryland,Vale Summit,74,0,40,9,5,0,54
Maryland,Urbana,10750,184,585,1345,2567,1648,6329
Maryland,Upper Marlboro,699,14,154,154,113,96,531
Maryland,University Park,2624,30,123,158,578,1015,1904
Maryland,Union Bridge,894,93,276,111,72,42,594
Maryland,Tyaskin,244,54,20,0,0,114,188
Maryland,Trego-Rohrersville Station,116,0,32,84,0,0,116
Maryland,Travilah,12106,359,474,1041,2057,4186,8117
Maryland,Trappe,1228,116,302,287,88,62,855
Maryland,Towson,57725,1738,5382,6108,10176,11305,34709
Maryland,Tolchester,268,11,141,58,0,28,238
Maryland,Timonium,10436,380,1499,1784,2158,1847,7668
Maryland,Tilghmanton,683,39,251,98,19,0,407
Maryland,Tilghman Island,952,163,241,152,108,98,762
Maryland,Thurmont,6392,375,1502,1351,750,420,4398
Maryland,West Denton,107,19,21,14,0,0,54
Maryland,Templeville,159,80,10,21,0,0,111
Maryland,Westernport,2059,175,655,386,103,55,1374
Maryland,Westminster,18646,1304,3511,3283,2190,1240,11528
Maryland,Indian Head,3903,156,818,808,243,175,2200
Maryland,Zihlman,328,21,139,75,19,6,260
Maryland,Yarrowsburg,15,0,15,0,0,0,15
Maryland,Worton,94,13,9,32,0,16,70
Maryland,Woodsboro,1168,84,249,217,125,111,786
Maryland,Woodmore,3911,52,389,682,802,732,2657
Maryland,Woodlawn CDP (Prince George's County),7973,1790,1477,1152,318,341,5078
Maryland,Woodlawn CDP (Baltimore County),40390,2837,6618,8520,5461,3883,27319
Maryland,Woodland,52,28,11,13,0,0,52
Maryland,Wilson-Conococheague,2144,355,942,236,89,65,1687
Maryland,Williston,98,0,0,47,20,21,88
Maryland,Williamsport,2218,306,652,494,94,77,1623
Maryland,Willards,999,107,235,163,47,23,575
Maryland,White Oak,17975,1396,2458,3024,3151,2432,12461
Maryland,White Marsh,9797,353,2072,1884,1595,947,6851
Maryland,Whitehaven,107,0,31,16,25,0,72
Maryland,Wheaton,50688,7565,7511,6941,6504,5416,33937
Maryland,Whaleyville,129,38,16,15,35,0,104
Maryland,West Pocomoke,473,18,151,59,70,24,322
Maryland,Westphalia,7349,340,1459,1642,974,713,5128
Maryland,West Ocean City,4554,215,1042,1056,838,312,3463
Maryland,West Laurel,4388,188,758,857,781,665,3249
Maryland,Temple Hills,8023,419,1573,1856,823,447,5118
Maryland,Taylors Island,195,14,70,18,23,18,143
Maryland,Taneytown,6740,461,1712,1245,793,349,4560
Maryland,Queensland,1812,163,115,312,249,389,1228
Maryland,Stevensville,6372,183,1131,1362,912,577,4165
Maryland,Spring Ridge,5899,81,659,887,1315,725,3667
Maryland,Spring Gap,67,15,36,8,0,0,59
Maryland,Springdale,2992,151,556,475,451,235,1868
Maryland,Spencerville,1746,13,226,189,397,266,1091
Maryland,South Laurel,26394,2019,3892,4331,4243,2612,17097
Maryland,South Kensington,8394,150,396,801,1686,2668,5701
Maryland,Somerset,1215,0,11,60,215,529,815
Maryland,Forestville,11298,1102,2762,2468,1008,445,7785
Maryland,Fort Meade,10137,165,638,2298,1010,389,4500
Maryland,Fort Ritchie,278,10,27,49,29,0,115
Maryland,Fort Washington,23611,1453,3663,5318,4039,3279,17752
Maryland,Fountainhead-Orchard Hills,5737,207,932,1509,1015,489,4152
Maryland,Four Corners,8421,615,590,1005,1318,2092,5620
Maryland,Franklin,297,35,166,55,5,0,261
Maryland,Frederick,67421,4906,10119,13345,9937,7209,45516
Maryland,Frenchtown-Rumbly,94,12,31,11,0,16,70
Maryland,Friendly,9708,868,1995,2219,1179,703,6964
Maryland,Friendship,311,37,109,53,38,20,257
Maryland,Queenstown,620,39,118,115,88,66,426
Maryland,Queen Anne,328,10,87,67,20,22,206
Maryland,Queen Anne,1132,29,203,188,158,197,775
Maryland,Quantico,43,0,0,6,18,19,43
Maryland,Pylesville,872,24,242,171,149,20,606
Maryland,Tall Timbers,245,0,15,24,52,129,220
Maryland,Takoma Park,17478,1311,1917,2016,2796,4078,12118
Maryland,Sykesville,4429,212,615,795,871,516,3009
Maryland,Swanton,52,0,24,7,21,0,52
Maryland,Hillsboro,105,12,19,21,20,2,74
Maryland,Summerfield,12403,489,2589,2790,1239,1052,8159
Maryland,Suitland,23824,1539,6124,4929,1596,720,14908
Maryland,Sudlersville,464,38,130,75,51,14,308
Maryland,Stockton,107,16,23,50,9,0,98
Maryland,Point of Rocks,1582,61,316,213,262,165,1017
Maryland,Jarrettsville,3258,30,731,500,558,319,2138
Maryland,Pomfret,549,12,160,155,35,0,362
Maryland,Poolesville,5100,90,397,972,994,687,3140
Maryland,Port Deposit,560,85,119,89,62,31,386
Maryland,Port Tobacco Village,2,0,0,2,0,0,2
Maryland,Potomac,45945,687,1774,3405,9589,16485,31940
Maryland,Potomac Heights,1258,68,372,285,66,22,813
Maryland,Potomac Park,927,65,243,281,62,73,724
Maryland,Powellville,80,8,29,17,0,0,54
Maryland,Preston,936,44,247,131,102,40,564
Maryland,Prince Frederick,3240,391,883,521,275,191,2261
Maryland,Princess Anne,3325,406,581,600,189,97,1873
Maryland,Pondsville,82,17,22,0,21,0,60
Maryland,Pleasant Grove,341,60,67,112,26,0,265
Maryland,Pleasant Hills,3555,118,566,731,588,402,2405
Maryland,Capitol Heights,4482,582,1066,798,306,121,2873
Maryland,Charlestown,1152,86,274,241,131,76,808
Maryland,Columbia,103055,3076,8105,14726,22628,22453,70988
Maryland,Colmar Manor,1693,331,271,240,82,62,986
Maryland,College Park,31730,1446,2107,2066,2535,2962,11116
Maryland,Colesville,14190,1043,1696,2368,2380,2661,10148
Maryland,Cockeysville,20603,951,2642,3776,3864,2953,14186
Maryland,Cobb Island,731,31,244,171,34,28,508
Maryland,Cloverly,15485,688,1895,2314,2862,3191,10950
Maryland,Clinton,39336,1979,8589,9395,4665,2887,27515
Maryland,Clear Spring,378,34,125,59,15,5,238
Maryland,Clarysville,56,14,15,0,0,0,29
Maryland,Clarksburg,18709,706,1047,2667,3706,3505,11631
Maryland,Church Hill,858,98,162,131,81,40,512
Maryland,Church Creek,149,3,45,27,18,7,100
Maryland,Choptank,210,10,73,19,16,22,140
Maryland,Chillum,37150,8168,6764,5471,2851,1714,24968
Maryland,Chewsville,127,8,43,29,22,0,102
Maryland,Chevy Chase Village,1993,28,36,82,345,872,1363
Maryland,Chevy Chase View,978,0,7,38,249,310,604
Maryland,Chevy Chase Section Three,787,3,10,20,179,315,527
Maryland,Chevy Chase Section Five,628,2,5,25,116,271,419
Maryland,Chance,283,10,131,75,9,37,262
Maryland,Centreville,4507,220,581,945,787,563,3096
Maryland,Cedarville,633,83,184,198,43,24,532
Maryland,Cecilton,883,143,310,89,26,59,627
Maryland,Broomes Island,460,36,101,126,44,41,348
Maryland,Brownsville,199,0,0,0,98,0,98
Maryland,Brunswick,6055,374,1235,1129,627,481,3846
Maryland,Bryans Road,7458,443,1481,1769,798,321,4812
Maryland,Bryantown,759,69,174,148,56,44,491
Maryland,Buckeystown,1069,11,203,160,319,198,891
Maryland,Burkittsville,150,10,33,35,20,16,114
Maryland,Burtonsville,9488,511,1050,1353,1667,1487,6068
Maryland,Butlertown,387,32,127,66,13,0,238
Maryland,Cabin John,2174,55,179,202,357,676,1469
Maryland,Chevy Chase,9450,90,343,589,2112,3550,6684
Maryland,California,12228,610,1836,2608,1894,1294,8242
Maryland,Calverton,18747,1516,2311,2923,3752,3044,13546
Maryland,Cambridge,12534,1312,3126,1919,1061,634,8052
Maryland,Camp Springs,20339,1054,4324,4206,2830,1430,13844
Maryland,Cape St. Claire,8862,189,1309,1896,1370,1056,5820
Maryland,Charlton,163,0,16,29,10,27,82
Maryland,Carlos,142,0,88,15,0,0,103
Maryland,Carney,29196,1599,6080,6656,4011,2934,21280
Maryland,Catonsville,42265,1751,6501,6849,7390,5954,28445
Maryland,Cavetown,1529,149,320,302,236,47,1054
Maryland,Cearfoss,71,0,29,28,0,0,57
Maryland,Calvert Beach,701,29,183,172,87,15,486
Maryland,Brookview,42,2,16,8,6,0,32
Maryland,Chevy Chase,2927,4,51,71,613,1271,2010
Maryland,Chestertown,5186,492,717,691,673,602,3175
Maryland,Bartonsville,1448,165,160,310,220,122,977
Maryland,Barton,532,19,157,131,10,12,329
Maryland,Barrelville,91,11,41,4,7,0,63
Maryland,Barnesville,164,2,21,27,45,28,123
Maryland,Barclay,65,6,35,12,7,0,60
Maryland,Baltimore Highlands,7703,1359,2018,1179,305,56,4917
Maryland,Baltimore,622454,73363,125156,101075,64126,56436,420156
Maryland,Ballenger Creek,18490,581,2307,3957,3319,1520,11684
Maryland,Bakersville,74,32,0,10,0,0,42
Maryland,Bagtown,276,11,58,126,10,0,205
Maryland,Baden,2034,241,545,373,244,107,1510
Maryland,Aspen Hill,52607,5260,7250,8446,8048,6795,35799
Maryland,Ashton-Sandy Spring,5684,146,689,862,1070,1114,3881
Maryland,Arnold,22574,518,2501,4463,4290,3578,15350
Maryland,Arden on the Severn,2473,104,398,408,574,240,1724
Maryland,Arbutus,21662,1906,4359,5037,2474,1505,15281
Maryland,Aquasco,833,149,270,159,80,18,676
Maryland,Antietam,165,0,48,22,40,24,134
Maryland,Chesapeake Ranch Estates,10111,322,2045,2596,803,449,6215
Maryland,Chesapeake City,714,18,204,155,115,54,546
Maryland,Chesapeake Beach,5847,121,1006,1225,585,501,3438
Maryland,Beaver Creek,94,9,32,8,28,0,77
Maryland,Bel Air,1488,20,286,432,209,79,1026
Maryland,Bel Air,10247,322,1898,2271,1496,1135,7122
Maryland,Bel Air North,31871,1032,5023,6433,5449,3119,21056
Maryland,Chester,4952,285,993,1154,784,427,3643
Maryland,Braddock Heights,2831,178,477,553,428,436,2072
Maryland,Bowmans Addition,622,49,208,134,41,9,441
Maryland,Bowling Green,1109,59,284,264,58,63,728
Maryland,Bowleys Quarters,6124,340,1711,1577,402,338,4368
Maryland,Bowie,56885,1607,6921,10915,10872,8442,38757
Maryland,Boonsboro,3456,240,839,830,445,169,2523
Maryland,Bloomington,235,29,123,16,12,0,180
Maryland,Bladensburg,9461,1326,2423,1542,459,309,6059
Maryland,Bivalve,271,10,99,56,0,0,165
Maryland,Cheverly,6368,490,836,1199,1120,860,4505
Maryland,Bishopville,494,122,70,188,0,29,409
Maryland,Big Pool,50,13,37,0,0,0,50
Maryland,Bier,87,0,55,12,0,0,67
Maryland,Betterton,320,9,111,58,40,19,237
Maryland,Bethesda,62102,565,2318,4567,12402,24074,43926
Maryland,Berwyn Heights,3223,359,470,411,419,455,2114
Maryland,Berlin,4520,438,734,820,599,305,2896
Maryland,Bensville,12292,410,2129,2348,2056,1221,8164
Maryland,Benedict,473,116,169,77,54,57,473
Maryland,Beltsville,18306,2155,3048,3557,2442,1307,12509
Maryland,Bel Air South,46955,1577,7627,9733,7565,5818,32320
Maryland,Big Spring,120,7,36,52,0,0,95
Maryland,Brookmont,3767,28,178,229,614,1522,2571
Maryland,Charlotte Hall,1344,115,502,204,94,37,952
Maryland,Annapolis Neck,11084,343,826,1958,2842,2497,8466
Maryland,Pocomoke City,4162,587,774,609,347,217,2534
Maryland,Aberdeen,15238,1371,3455,3613,1206,702,10347
Maryland,Aberdeen Proving Ground,2351,0,247,380,248,196,1071
Maryland,Accident,265,26,65,61,19,18,189
Maryland,Accokeek,11617,438,1949,2260,1830,1590,8067
Maryland,Adamstown,2692,45,237,418,571,382,1653
Maryland,Algonquin,1518,84,490,277,177,120,1148
Maryland,Allen,106,0,0,0,54,52,106
Maryland,Adelphi,15547,2373,2153,2511,2057,1826,10920
Maryland,Annapolis,38841,3264,5609,5940,6698,5358,26869
Maryland,Brandywine,9309,382,1819,2096,1195,562,6054
Maryland,Breathedsville,270,16,33,17,30,54,150
Maryland,Brentwood,3139,680,473,503,221,183,2060
Maryland,Brock Hall,10635,232,1128,1795,2211,1798,7164
Maryland,Brookeville,167,1,18,19,46,38,122
Maryland,Andrews AFB,3226,44,216,815,297,129,1501
Maryland,Brooklyn Park,14042,1797,4242,2646,826,402,9913
Massachusetts,Palmer Town,12168,946,3261,2593,1382,637,8819
Massachusetts,Pinehurst,7441,398,1806,1554,926,425,5109
Massachusetts,Petersham,252,0,42,51,56,61,210
Massachusetts,Pepperell,2245,190,410,490,341,109,1540
Massachusetts,West Falmouth,2018,45,231,331,473,389,1469
Massachusetts,Peabody,52065,3687,12894,10392,7246,3923,38142
Massachusetts,Oxford,6108,310,1612,1205,862,225,4214
Massachusetts,Orange,4160,396,1180,917,278,93,2864
Massachusetts,Provincetown,2744,183,443,615,681,531,2453
Massachusetts,Stoneham,21752,1037,4300,4447,4000,2534,16318
Massachusetts,Sturbridge,2515,100,202,592,424,287,1605
Massachusetts,Swampscott,14036,419,1697,2213,2840,2729,9898
Massachusetts,Taunton,56276,7122,13818,11308,5057,2404,39709
Massachusetts,West Brookfield,1333,131,481,174,240,30,1056
Massachusetts,West Chatham,1337,70,280,305,222,217,1094
Massachusetts,West Concord,7320,633,1073,662,1304,1878,5550
Massachusetts,Northfield,1170,68,175,275,124,233,875
Massachusetts,North Lakeville,2464,131,671,385,401,278,1866
Massachusetts,North Pembroke,3257,130,514,659,517,336,2156
Massachusetts,North Plymouth,3803,311,1118,732,274,185,2620
Massachusetts,North Scituate,5077,48,635,729,1350,633,3395
Massachusetts,North Seekonk,2703,198,659,714,324,163,2058
Massachusetts,Northwest Harwich,3950,227,663,892,667,464,2913
Massachusetts,North Westport,4585,700,1110,940,435,211,3396
Massachusetts,Norton Center,2868,70,256,313,251,103,993
Massachusetts,Norwood,28962,1162,5400,5191,5918,3253,20924
Massachusetts,Ocean Bluff-Brant Rock,5420,106,642,1662,1006,514,3930
Massachusetts,Ocean Grove,2667,232,689,730,278,84,2013
Massachusetts,Onset,1062,49,404,313,44,0,810
Massachusetts,Orleans,1669,9,384,532,374,185,1484
Massachusetts,Pittsfield,43926,3303,10616,9656,4846,3366,31787
Massachusetts,Blandford,382,22,105,82,50,45,304
Massachusetts,Pocasset,3045,50,513,1046,554,351,2514
Massachusetts,Quincy,93177,7835,17798,15693,17993,10047,69366
Massachusetts,Randolph,33409,3102,6669,6672,4836,2391,23670
Massachusetts,Raynham Center,4534,213,817,801,733,391,2955
Massachusetts,Reading,25357,564,2993,3604,5797,4406,17364
Massachusetts,Revere,53095,6972,15113,9464,5220,2414,39183
Massachusetts,Rockport,4846,123,1020,944,1122,684,3893
Massachusetts,Rowley,1511,62,525,347,202,110,1246
Massachusetts,Russell,485,23,180,97,91,25,416
Massachusetts,Rutland,2433,14,579,545,433,181,1752
Massachusetts,Sagamore,3660,32,991,982,311,430,2746
Massachusetts,Salem,42499,2651,7454,7872,6988,4048,29013
Massachusetts,Salisbury,4595,258,1057,1090,717,396,3518
Massachusetts,Sandwich,2988,118,633,600,573,392,2316
Massachusetts,Saugus,27620,2023,7377,6000,3399,1694,20493
Massachusetts,Plymouth,7532,388,2135,1607,951,537,5618
Massachusetts,Scituate,5355,108,534,1151,1325,775,3893
Massachusetts,Seconsett Island,23,0,0,0,7,16,23
Massachusetts,Sharon,5932,55,259,547,1358,1484,3703
Massachusetts,Shelburne Falls,1674,94,318,520,217,205,1354
Massachusetts,Shirley,1283,56,408,382,146,73,1065
Massachusetts,Siasconset,203,8,27,91,10,4,140
Massachusetts,Smith Mills,4534,521,893,937,669,282,3302
Massachusetts,Somerset,18271,2094,3912,4024,2141,1322,13493
Massachusetts,Somerville,78595,6172,10573,7847,16908,16124,57624
Massachusetts,South Amherst,5071,101,226,415,687,769,2198
Massachusetts,South Ashburnham,908,42,129,129,130,55,485
Massachusetts,Southbridge Town,16802,2120,4170,3136,1171,671,11268
Massachusetts,Hatfield,1506,30,378,250,295,195,1148
Massachusetts,Popponesset,208,0,15,17,132,44,208
Massachusetts,Spencer,5578,790,1574,988,534,184,4070
Massachusetts,Seabrook,461,0,59,142,117,48,366
Massachusetts,Beverly,40670,1639,6460,6977,7865,4885,27826
Massachusetts,South Yarmouth,11532,666,2507,3467,1529,993,9162
Massachusetts,Southfield,0,0,0,0,0,0,0
Massachusetts,Athol,8427,938,2175,1608,618,284,5623
Massachusetts,Arlington,44128,1358,4484,4802,10039,12149,32832
Massachusetts,Andover,8783,270,797,948,1711,1999,5725
Massachusetts,Amherst Center,19543,116,419,457,650,1627,3269
Massachusetts,Amesbury Town,16907,783,2904,3340,3203,2065,12295
Massachusetts,Agawam Town,28688,1580,6344,6916,3736,2157,20733
Massachusetts,Adams,5475,475,1581,995,566,275,3892
Massachusetts,Acushnet Center,2859,463,763,507,178,131,2042
Massachusetts,Westfield,41480,2282,7534,7763,5747,2801,26127
Massachusetts,West Springfield Town,28600,2246,5687,5790,3739,2040,19502
Massachusetts,West Wareham,2850,247,696,768,198,54,1963
Massachusetts,Newburyport,17766,384,2052,2921,4562,3437,13356
Massachusetts,New Seabury,867,0,53,186,311,172,722
Massachusetts,Newton,87675,1495,5667,6352,16243,27925,57682
Massachusetts,North Adams,13459,1422,3188,2549,1302,889,9350
Massachusetts,North Amherst,7500,77,172,430,731,922,2332
Massachusetts,Northampton,28602,1081,3267,3783,4701,6308,19140
Massachusetts,Attleboro,43953,3553,8564,8714,6668,2744,30243
Massachusetts,Northborough,6528,246,757,1202,1138,1029,4372
Massachusetts,Ayer,3103,165,863,576,415,287,2306
Massachusetts,Barnstable Town,44591,1878,8719,10232,7305,5172,33306
Massachusetts,Bliss Corner,5757,1301,1376,952,472,448,4549
Massachusetts,Boston,650281,64276,93732,79743,107947,88777,434475
Massachusetts,Bourne,1202,31,173,233,214,255,906
Massachusetts,Boxford,2366,40,273,355,773,261,1702
Massachusetts,Braintree Town,36905,1583,7565,6702,6119,3823,25792
Massachusetts,Brewster,2280,38,301,429,766,388,1922
Massachusetts,Bridgewater,8516,232,1345,944,589,365,3475
Massachusetts,Brockton,94532,11650,21113,17570,7577,3262,61172
Massachusetts,Brookfield,786,16,275,212,155,26,684
Massachusetts,Brookline,59132,1372,2886,3619,11468,21340,40685
Massachusetts,Burlington,25467,1114,4244,4346,4837,3793,18334
Massachusetts,Buzzards Bay,3057,122,823,598,328,332,2203
Massachusetts,Cambridge,107916,4113,6874,7120,20872,33639,72618
Massachusetts,Belmont,25337,538,1598,2578,5150,7820,17684
Massachusetts,Bellingham,5396,177,1412,1292,772,229,3882
Massachusetts,Belchertown,3289,323,578,568,326,415,2210
Massachusetts,Barre,1075,9,302,174,104,102,691
Massachusetts,Baldwinville,2174,174,671,512,145,170,1672
Massachusetts,South Lancaster,1862,26,361,305,506,202,1400
Massachusetts,North Brookfield,2132,121,558,350,103,129,1261
Massachusetts,North Falmouth,2800,133,367,566,529,607,2202
Massachusetts,East Harwich,4573,277,768,942,831,618,3436
Massachusetts,East Pepperell,1999,69,419,543,207,74,1312
Massachusetts,East Sandwich,3840,15,462,793,869,696,2835
Massachusetts,Edgartown,681,17,238,146,72,122,595
Massachusetts,Essex,1613,15,204,351,303,258,1131
Massachusetts,Everett,43885,5933,11195,7350,3529,1400,29407
Massachusetts,Fall River,88727,17725,20620,15169,6032,2516,62062
Massachusetts,Falmouth,3487,147,892,783,622,603,3047
Massachusetts,Fiskdale,2361,40,437,505,507,279,1768
Massachusetts,Fitchburg,40462,4601,8579,7299,3659,1679,25817
Massachusetts,Forestdale,4443,37,723,1193,589,298,2840
Massachusetts,Foxborough,5326,458,783,1376,925,409,3951
Massachusetts,Framingham,70443,5328,11375,8996,13732,9046,48477
Massachusetts,Abington,16112,419,3312,4001,2664,861,11257
Massachusetts,South Deerfield,1715,71,245,454,312,236,1318
Massachusetts,South Dennis,3428,146,889,901,556,330,2822
Massachusetts,South Duxbury,3594,28,179,496,1085,616,2404
Massachusetts,Easthampton Town,16060,677,3964,3658,2745,1414,12458
Massachusetts,North Eastham,1821,104,318,421,417,258,1518
Massachusetts,East Falmouth,6091,510,1158,1378,814,820,4680
Massachusetts,East Dennis,2849,83,379,754,688,359,2263
Massachusetts,Chatham,1516,27,238,364,340,203,1172
Massachusetts,Chelsea,37581,8381,7904,3858,2441,1659,24243
Massachusetts,Cheshire,593,40,106,171,49,0,366
Massachusetts,Chester,754,38,246,151,64,21,520
Massachusetts,Chicopee,56186,5862,14966,11929,4438,2428,39623
Massachusetts,Clinton,7386,697,1529,1223,1120,582,5151
Massachusetts,Cochituate,6893,113,345,577,1707,1990,4732
Massachusetts,Cordaville,2594,13,241,207,552,567,1580
Massachusetts,Danvers,27400,1129,4736,5773,5280,2849,19767
Massachusetts,Dedham,25224,1084,4276,4294,4953,3627,18234
Massachusetts,Deerfield,900,3,0,103,187,252,545
Massachusetts,Dennis,2551,62,465,603,554,491,2175
Massachusetts,Dennis Port,2888,122,769,694,441,303,2329
Massachusetts,Devens,1733,122,497,420,232,134,1405
Massachusetts,Dover,2441,15,73,191,544,763,1586
Massachusetts,Duxbury,1375,9,27,118,364,445,963
Massachusetts,East Brookfield,1169,63,346,218,176,52,855
Massachusetts,East Douglas,2821,66,533,563,426,115,1703
Massachusetts,Harwich Port,1969,25,265,404,427,512,1633
Massachusetts,Springfield,153947,21860,29205,25424,9917,6280,92686
Massachusetts,Popponesset Island,26,0,0,9,0,17,26
Massachusetts,Medford,57136,3525,10245,9009,9771,8704,41254
Massachusetts,Melrose,27681,1147,3575,4774,6200,4496,20192
Massachusetts,Methuen Town,48607,3743,10327,9453,6095,3471,33089
Massachusetts,Middleborough Center,7257,430,1766,1493,972,388,5049
Massachusetts,Milford,25729,1560,5102,5067,3809,2071,17609
Massachusetts,Millers Falls,974,68,287,211,117,34,717
Massachusetts,Millis-Clicquot,4089,99,877,614,775,514,2879
Massachusetts,Milton,27303,542,2726,3300,5329,5359,17256
Massachusetts,Monomoscoy Island,169,10,54,20,10,28,122
Massachusetts,Monson Center,1677,152,439,372,206,102,1271
Massachusetts,Monument Beach,2903,19,576,819,496,289,2199
Massachusetts,Nahant,3454,77,643,650,693,632,2695
Massachusetts,Nantucket,7475,340,1579,1381,1278,829,5407
Massachusetts,Needham,29853,409,2052,2562,6458,8523,20004
Massachusetts,New Bedford,94909,18500,20790,15322,6851,3511,64974
Massachusetts,Malden,60612,6057,12870,9955,7854,6305,43041
Massachusetts,Teaticket,1440,28,363,351,306,217,1265
Massachusetts,West Yarmouth,5639,363,1238,1567,830,488,4486
Massachusetts,Weweantic,1938,84,520,462,202,114,1382
Massachusetts,Weymouth Town,55304,2700,12153,12507,9115,4139,40614
Massachusetts,White Island Shores,1636,97,569,254,95,65,1080
Massachusetts,Whitinsville,6690,313,1200,1459,944,440,4356
Massachusetts,Wilbraham,3892,279,493,860,727,584,2943
Massachusetts,Williamstown,4437,116,136,286,425,703,1666
Massachusetts,Wilmington,23141,721,4834,4389,3269,2585,15798
Massachusetts,Winchendon,3369,393,1062,798,225,102,2580
Massachusetts,Winchester,22075,391,1627,2079,4317,6274,14688
Massachusetts,Winthrop Town,17962,704,3981,4124,3109,1585,13503
Massachusetts,Woburn,39104,1737,9335,7020,6490,3989,28571
Massachusetts,Medfield,6322,139,702,726,1493,1174,4234
Massachusetts,Maynard,10459,343,1944,1572,2098,1729,7686
Massachusetts,Mattapoisett Center,3429,66,394,671,668,571,2370
Massachusetts,Mashpee Neck,774,0,86,227,175,95,583
Massachusetts,Mansfield Center,7806,234,1450,1345,1395,1002,5426
Massachusetts,Marblehead,20270,312,1571,2681,5125,4706,14395
Massachusetts,Marion Center,1388,56,204,234,266,237,997
Massachusetts,Marlborough,39425,3054,8131,6218,6272,4371,28046
Massachusetts,Marshfield,4362,180,629,965,919,412,3105
Massachusetts,Marshfield Hills,2277,53,100,471,641,301,1566
Massachusetts,Lynnfield,12270,252,1780,2227,2690,1887,8836
Massachusetts,Lynn,91626,11773,19175,16369,7850,3529,58696
Massachusetts,Lunenburg,1798,137,396,233,459,137,1362
Massachusetts,Lowell,109349,14921,23379,16891,9613,5853,70657
Massachusetts,Longmeadow,15877,472,1314,1948,3093,4075,10902
Massachusetts,Littleton Common,2701,82,485,394,625,315,1901
Massachusetts,Lexington,32700,676,1818,2564,5831,11618,22507
Massachusetts,Leominster,41176,3935,9317,7962,5232,2627,29073
Massachusetts,Woods Hole,963,16,97,77,178,330,698
Massachusetts,Lenox,1599,52,301,275,316,327,1271
Massachusetts,Lawrence,78804,14876,15878,11067,3621,1723,47165
Massachusetts,Kingston,6211,258,1308,970,1045,614,4195
Massachusetts,Ipswich,4235,213,752,810,831,538,3144
Massachusetts,Huntington,679,41,174,192,52,18,477
Massachusetts,Hull,10403,345,2267,2264,2139,1384,8399
Massachusetts,Hudson,15340,1174,3407,3108,2310,1267,11266
Massachusetts,Housatonic,854,43,130,77,102,236,588
Massachusetts,Hopkinton,2656,95,401,489,593,310,1888
Massachusetts,Hopedale,3875,161,559,831,787,249,2587
Massachusetts,Holyoke,40342,5979,7504,6684,3842,2320,26329
Massachusetts,Holland,1433,72,351,274,231,152,1080
Massachusetts,Holbrook,10975,293,2765,3019,1595,651,8323
Massachusetts,Hingham,5416,51,410,462,1543,1150,3616
Massachusetts,Haverhill,62079,5099,12247,13366,8041,4263,43016
Massachusetts,Lee,1773,116,428,281,195,197,1217
Massachusetts,Worcester,183382,18682,34910,29205,21755,13087,117639
Massachusetts,Madaket,296,0,38,43,86,63,230
Massachusetts,Turners Falls,4356,494,948,860,534,280,3116
Massachusetts,The Pinehills,1033,31,84,294,323,279,1011
Massachusetts,Topsfield,3029,67,385,380,618,719,2169
Massachusetts,Townsend,1294,63,302,256,159,64,844
Massachusetts,Upton,3028,73,574,666,566,315,2194
Massachusetts,Vineyard Haven,2223,47,261,536,537,157,1538
Massachusetts,Wakefield,26157,1205,4904,4051,5545,3300,19005
Massachusetts,Walpole,5881,257,897,1283,1161,632,4230
Massachusetts,Waltham,62438,4288,9966,7858,11734,9290,43136
Massachusetts,Ware,5772,404,1542,1175,501,263,3885
Massachusetts,Wareham Center,3506,184,908,778,236,144,2250
Massachusetts,Warren,1271,83,407,395,65,0,950
Massachusetts,Watertown Town,33350,1537,4503,4271,7887,7334,25532
Massachusetts,Webster,12522,1743,3223,2070,1110,378,8524
Massachusetts,Yarmouth Port,4792,100,894,1376,999,792,4161
Massachusetts,Westborough,4158,155,647,648,893,731,3074
Massachusetts,Wellesley,28832,286,912,1446,5332,7951,15927
Massachusetts,Harwich Center,1705,128,429,260,371,176,1364
Massachusetts,Hanson,1772,23,452,392,161,206,1234
Massachusetts,Groton,1081,19,117,234,281,223,874
Massachusetts,Green Harbor-Cedar Crest,2873,82,703,550,610,170,2115
Massachusetts,Greenfield Town,17514,1102,3655,4113,2090,1874,12834
Massachusetts,Hanscom AFB,2074,2,47,377,278,240,944
Massachusetts,Granby,1431,118,266,253,169,200,1006
Massachusetts,Gloucester,29399,2472,6387,5479,4697,2828,21863
Massachusetts,Gardner,20306,2217,5310,4343,1457,882,14209
Massachusetts,Franklin Town,32731,802,4122,4748,7058,4397,21127
Massachusetts,West Dennis,2347,122,556,566,441,235,1920
Massachusetts,Great Barrington,2344,281,543,306,321,400,1851
Michigan,Madison Heights,30123,3539,6511,6521,3299,1231,21101
Michigan,Luna Pier,1341,133,302,379,113,76,1003
Michigan,Mackinaw City,702,44,135,232,78,30,519
Michigan,Mackinac Island,710,31,130,179,83,42,465
Michigan,McBride,164,11,49,40,12,0,112
Michigan,McBain,671,75,220,121,29,21,466
Michigan,Lyons,903,58,285,191,48,21,603
Michigan,Luther,365,62,91,66,5,0,224
Michigan,Lupton,255,40,76,81,10,4,211
Michigan,Ludington,8055,439,2015,2020,862,473,5809
Michigan,Lincoln Park,37362,5027,9733,8132,1463,639,24994
Michigan,Lost Lake Woods,344,4,110,121,47,35,317
Michigan,Loomis,194,17,72,33,3,0,125
Michigan,Livonia,95312,4149,17010,23452,16260,8808,69679
Michigan,Litchfield,1281,91,330,328,69,29,847
Michigan,Linden,3886,95,892,928,483,296,2694
Michigan,Lincoln,300,29,83,81,9,8,210
Michigan,Lexington,1167,71,328,328,130,73,930
Michigan,Galien,562,71,159,127,14,9,380
Michigan,Galesburg,1953,195,562,470,73,29,1329
Michigan,Mancelona,1466,172,369,325,54,24,944
Michigan,Lowell,3859,328,812,884,387,176,2587
Michigan,Douglas,1113,92,262,153,217,157,881
Michigan,Manchester,2124,70,388,533,237,160,1388
Michigan,Manistee Lake,345,53,126,97,13,17,306
Michigan,Marine City,4172,247,1272,1056,234,155,2964
Michigan,Marion,721,64,193,191,23,28,499
Michigan,Marlette,1565,97,423,402,83,44,1049
Michigan,Marquette,21444,755,3245,3720,2914,1448,12082
Michigan,Greenville,8443,851,1691,2046,577,386,5551
Michigan,Martin,417,21,118,75,24,19,257
Michigan,Marysville,9797,534,2229,2501,913,828,7005
Michigan,Greilickville,1834,51,289,544,238,399,1521
Michigan,Mason,8317,489,1586,2039,949,629,5692
Michigan,Grosse Pointe,5295,51,311,736,1376,1115,3589
Michigan,Marenisco,194,12,63,60,11,12,158
Michigan,Grosse Pointe Farms,9307,71,525,1260,2263,2057,6176
Michigan,Grosse Pointe Woods,15859,290,1311,3014,3547,3005,11167
Michigan,Gwinn,1987,58,749,446,175,64,1492
Michigan,Hamtramck,22150,3758,4427,2458,1002,579,12224
Michigan,Hancock,4601,251,934,695,605,425,2910
Michigan,Hanover,363,20,106,66,24,5,221
Michigan,Harbor Beach,1802,153,548,353,148,56,1258
Michigan,Harbor Springs,1044,29,221,291,202,118,861
Michigan,Hardwood Acres,613,37,233,85,33,0,388
Michigan,Dowling,394,28,95,119,27,6,275
Michigan,Dowagiac,5866,482,1379,1294,235,95,3485
Michigan,Grosse Pointe Park,11343,289,629,1803,2497,2516,7734
Michigan,Marcellus,1052,72,325,228,48,32,705
Michigan,Maple Rapids,688,44,207,167,39,10,467
Michigan,Maple Grove,32,0,16,0,0,16,32
Michigan,Manistique,3035,409,1014,512,182,46,2163
Michigan,Manitou Beach-Devils Lake,2050,86,584,634,333,130,1767
Michigan,Garden,183,27,55,52,11,7,152
Michigan,Garden City,27161,2264,7635,6996,1620,526,19041
Michigan,Gaylord,3640,291,1007,841,228,199,2566
Michigan,Gibraltar,4566,350,1160,1154,362,164,3190
Michigan,Gladstone,4902,231,1123,1258,634,154,3400
Michigan,Gladwin,2904,264,764,542,188,167,1925
Michigan,Glen Arbor,237,0,24,44,82,54,204
Michigan,Gobles,816,50,234,168,40,3,495
Michigan,Goodrich,1823,53,371,411,225,142,1202
Michigan,Grand Beach,280,2,17,54,100,65,238
Michigan,Grand Blanc,8088,261,1229,1603,1181,990,5264
Michigan,Grand Haven,10819,561,1932,2739,1771,843,7846
Michigan,Grand Ledge,7792,221,1451,2109,955,612,5348
Michigan,Grand Rapids,192416,17875,28032,35884,24720,13124,119635
Michigan,Grandville,15739,803,2805,3581,2288,1230,10707
Michigan,Grant,859,91,242,173,50,19,575
Michigan,Grass Lake,1285,33,229,342,153,71,828
Michigan,Grawn,727,127,143,92,19,15,396
Michigan,Grayling,1834,256,502,320,77,49,1204
Michigan,Manton,1240,80,318,283,71,12,764
Michigan,Maple City,202,3,54,66,7,5,135
Michigan,Manistee,6136,336,1430,1402,717,411,4296
Michigan,Marshall,7038,321,1630,1595,974,607,5127
Michigan,Saline,9020,165,1073,1855,1891,1332,6316
Michigan,Levering,204,19,74,30,10,20,153
Michigan,Shepherd,1525,65,353,419,162,84,1083
Michigan,Shelby,1908,322,342,317,98,41,1120
Michigan,Sebewaing,1703,145,556,430,113,48,1292
Michigan,Scottville,1283,95,277,278,65,45,760
Michigan,Schoolcraft,1496,75,374,370,158,40,1017
Michigan,Sault Ste. Marie,14048,955,2833,2822,1189,711,8510
Michigan,Saugatuck,842,38,124,152,217,141,672
Michigan,Saranac,1312,114,288,329,66,44,841
Michigan,Sanford,952,44,256,260,71,47,678
Michigan,Sandusky,2618,295,800,583,142,101,1921
Michigan,Sand Lake,569,56,129,112,32,11,340
Michigan,Sand Lake,1370,141,616,305,77,42,1181
Michigan,Lake City,1071,66,337,195,48,28,674
Michigan,Lake Ann,272,19,70,75,26,26,216
Michigan,Comstock Park,10431,1107,1818,2444,1086,321,6776
Michigan,Concord,1127,54,201,287,113,62,717
Michigan,Constantine,1736,126,547,423,53,43,1192
Michigan,Conway,327,32,18,140,8,11,209
Michigan,Coopersville,4329,233,913,1032,334,165,2677
Michigan,Copemish,134,12,37,31,14,0,94
Michigan,Copper City,246,26,46,49,13,9,143
Michigan,Sheridan,586,22,200,171,37,21,451
Michigan,Sherwood,336,36,76,82,4,2,200
Michigan,Shields,6192,438,1559,1522,721,368,4608
Michigan,Shoreham,888,21,109,189,173,169,661
Michigan,Sterling,523,25,192,149,21,14,401
Michigan,Stephenson,964,91,331,187,45,17,671
Michigan,Stanwood,200,15,80,32,10,6,143
Michigan,Stanton,1543,166,348,385,52,40,991
Michigan,Standish,1701,203,491,339,66,47,1146
Michigan,Springport,740,50,218,142,24,17,451
Michigan,Spring Lake,2438,75,425,657,423,215,1795
Michigan,Springfield,5216,506,1669,790,257,82,3304
Michigan,Spring Arbor,2928,87,335,466,328,142,1358
Michigan,Sparta,4235,287,1078,955,396,66,2782
Michigan,Copper Harbor,80,0,19,42,16,2,79
Michigan,South Rockwood,1978,233,480,435,129,63,1340
Michigan,South Monroe,6177,629,1646,1353,416,303,4347
Michigan,South Lyon,11616,683,1914,2594,1971,914,8076
Michigan,South Haven,4357,294,855,1095,575,355,3174
Michigan,South Gull Lake,1363,10,72,238,458,251,1029
Michigan,Southgate,29518,2438,7436,7830,2491,1132,21327
Michigan,Southfield,72859,3808,10601,18470,10853,8042,51774
Michigan,South Boardman,572,42,163,106,17,7,335
Michigan,Snover,451,47,113,82,20,3,265
Michigan,Skidway Lake,3340,624,1032,484,67,50,2257
Michigan,Shorewood-Tower Hills-Harbert,1199,9,282,355,271,160,1077
Michigan,South Range,858,40,186,142,99,36,503
Michigan,Lewiston,1342,208,355,371,41,51,1026
Michigan,Corunna,3415,271,802,773,244,182,2272
Michigan,Croswell,2578,234,687,564,64,62,1611
Michigan,St. Ignace,2548,224,609,633,224,115,1805
Michigan,St. Helen,2786,445,874,622,108,49,2098
Michigan,St. Clair Shores,59888,3623,13553,16992,7039,3584,44791
Michigan,St. Clair,5394,319,1152,1446,550,361,3828
Michigan,St. Charles,1971,108,576,492,96,88,1360
Michigan,Saginaw,50288,6757,10893,10045,2314,1233,31242
Michigan,Royal Oak,58689,1749,7488,11882,13927,9390,44436
Michigan,Rothbury,335,34,109,67,15,6,231
Michigan,Roseville,47529,4399,12659,11922,2481,1024,32485
Michigan,Rose City,612,87,132,151,32,4,406
Michigan,Rosebush,358,33,79,67,20,17,216
Michigan,Roscommon,1179,79,229,307,59,17,691
Michigan,Roosevelt Park,3819,197,791,964,467,96,2515
Michigan,Romulus,23557,1949,5761,5472,1196,434,14812
Michigan,Romeo,3799,307,831,898,404,243,2683
Michigan,Rogers City,2751,236,877,541,263,163,2080
Michigan,Rockwood,3227,267,1074,794,167,101,2403
Michigan,Rockford,5956,156,728,1282,1005,461,3632
Michigan,Rochester Hills,72643,2171,7762,13392,15509,11906,50740
Michigan,Rochester,12909,226,1134,2203,3035,2264,8862
Michigan,Robin Glen-Indiantown,1045,66,167,272,36,25,566
Michigan,St. James,226,18,56,42,26,22,164
Michigan,St. Johns,7954,566,1852,1924,591,481,5414
Michigan,St. Joseph,8311,278,1463,1826,1636,1093,6296
Michigan,St. Louis,7355,846,2529,1638,279,104,5396
Michigan,Crystal Downs Country Club,71,0,5,8,27,25,65
Michigan,Crystal Falls,1683,93,456,339,172,64,1124
Michigan,Crystal Mountain,42,0,3,7,11,17,38
Michigan,Custer,281,22,91,57,16,5,191
Michigan,Cutlerville,15142,1184,3471,3380,1455,569,10059
Michigan,Daggett,196,11,61,48,17,3,140
Michigan,Dansville,526,23,133,133,35,10,334
Michigan,Davison,5029,223,1070,1555,405,251,3504
Michigan,Dearborn,96069,11066,12844,17420,10228,6778,58336
Michigan,Dearborn Heights,56656,5318,12562,11957,4741,2921,37499
Michigan,Cross Village,93,1,35,22,12,2,72
Michigan,Decatur,2063,233,572,322,117,43,1287
Michigan,Deerfield,841,70,223,193,39,22,547
Michigan,Delton,1022,100,158,355,94,67,774
Michigan,De Tour Village,236,31,69,73,16,21,210
Michigan,Detroit,690074,94399,141413,140107,34865,23604,434388
Michigan,Detroit Beach,2007,123,517,580,119,39,1378
Michigan,DeWitt,4631,72,631,822,865,617,3007
Michigan,Dexter,4682,124,486,495,1009,774,2888
Michigan,Dimondale,1162,51,250,330,165,67,863
Michigan,Dollar Bay,788,18,164,154,108,29,473
Michigan,Gaines,374,14,141,91,24,2,272
Michigan,Deckerville,850,71,281,158,40,14,564
Michigan,Gagetown,357,60,109,81,13,5,268
Michigan,Pearl Beach,2895,162,886,926,244,227,2445
Michigan,Fruitport,1345,61,317,328,118,82,906
Michigan,Woodhaven,12645,427,2667,3810,1216,685,8805
Michigan,Woodland,409,34,137,86,15,7,279
Michigan,Woodland Beach,1896,71,608,376,92,65,1212
Michigan,Wyandotte,25376,1970,6754,6323,2006,1249,18302
Michigan,Wyoming,74105,7632,15264,15139,7114,2549,47698
Michigan,Yale,1931,232,440,453,105,69,1299
Michigan,Ypsilanti,19874,946,1545,3334,2012,1727,9564
Michigan,Zeba,314,49,73,87,18,12,239
Michigan,Zeeland,5591,447,1214,878,661,369,3569
Michigan,Zilwaukee,1922,77,522,433,122,61,1215
Michigan,Wolverine Lake,4372,279,833,1135,752,253,3252
Michigan,Riverview,12266,1132,3106,2920,1088,568,8814
Michigan,Richmond,5825,550,1222,1465,348,254,3839
Michigan,Richland,845,23,93,242,158,97,613
Michigan,Republic,401,23,144,114,25,13,319
Michigan,Reese,1690,66,420,422,134,76,1118
Michigan,Reed City,2828,244,722,589,174,58,1787
Michigan,Reading,1215,94,322,255,35,14,720
Michigan,Ravenna,1190,51,288,230,161,45,775
Michigan,Rapid City,1473,122,458,337,91,51,1059
Michigan,Quinnesec,999,56,347,193,89,59,744
Michigan,Quincy,1647,112,465,369,49,13,1008
Michigan,River Rouge,7673,1349,1858,1278,209,159,4853
Michigan,Prudenville,1578,106,466,543,87,112,1314
Michigan,Wolverine,242,14,85,55,10,7,171
Michigan,Wixom,13690,521,1692,3032,2436,1241,8922
Michigan,Ironwood,5153,356,1435,1402,439,175,3807
Michigan,Ishpeming,6517,316,1697,1651,699,246,4609
Michigan,Ithaca,2856,202,771,566,192,131,1862
Michigan,Jackson,33255,3146,7000,6739,2283,864,20032
Michigan,Jasper,326,49,81,94,9,5,238
Michigan,Jenison,17004,743,3065,4113,2215,900,11036
Michigan,Jennings,207,38,106,24,0,0,168
Michigan,Jonesville,2173,118,581,486,157,96,1438
Michigan,Kalamazoo,75499,3810,7968,14448,7229,5516,38971
Michigan,Kaleva,467,38,153,141,23,6,361
Michigan,Wolf Lake,4475,469,1056,958,115,104,2702
Michigan,Kalkaska,2113,195,691,445,139,0,1470
Michigan,Kent City,1156,165,248,229,54,10,706
Michigan,Kentwood,50286,3356,8507,9677,7066,3815,32421
Michigan,Kinde,490,54,149,108,20,11,342
Michigan,Kingsford,5104,227,1572,1224,478,298,3799
Michigan,Kingsley,1605,104,454,399,104,43,1104
Michigan,Kingston,432,41,142,71,26,9,289
Michigan,K. I. Sawyer,3114,132,766,658,186,52,1794
Michigan,Laingsburg,1296,59,291,292,140,30,812
Michigan,Lake Angelus,269,2,23,38,95,80,238
Michigan,Williamston,3855,215,614,926,436,359,2550
Michigan,Keego Harbor,3016,218,630,678,358,270,2154
Michigan,Presque Isle Harbor,567,10,96,206,142,54,508
Michigan,Prescott,296,15,64,92,15,4,190
Michigan,Powers,484,93,161,91,32,19,396
Michigan,Omer,315,46,97,66,7,6,222
Michigan,Onaway,791,61,240,189,28,9,527
Michigan,Onekama,448,19,94,127,50,24,314
Michigan,Onsted,935,52,224,261,37,41,615
Michigan,Ontonagon,1399,91,435,417,134,55,1132
Michigan,Orchard Lake Village,2488,73,170,414,495,600,1752
Michigan,Ortonville,1635,63,268,436,141,83,991
Michigan,Oscoda,803,64,154,231,50,116,615
Michigan,Ossineke,977,106,198,265,75,30,674
Michigan,Otisville,920,112,353,175,51,12,703
Michigan,Omena,198,0,57,22,28,32,139
Michigan,Otsego,3975,285,1064,940,340,147,2776
Michigan,Ovid,1596,121,464,401,95,37,1118
Michigan,Owendale,210,13,82,25,8,2,130
Michigan,Owosso,14826,904,3214,3925,888,504,9435
Michigan,Oxford,3495,193,683,993,409,278,2556
Michigan,Palmer,417,22,133,102,32,2,291
Michigan,Parchment,2016,137,297,598,212,109,1353
Michigan,Parkdale,640,93,243,148,61,18,563
Michigan,Parma,870,65,196,169,57,33,520
Michigan,Paw Paw,3445,389,949,777,244,61,2420
Michigan,Paw Paw Lake,4037,359,976,954,567,130,2986
Michigan,Otter Lake,398,47,84,100,12,15,258
Michigan,Olivet,1570,41,228,214,208,49,740
Michigan,Pellston,861,85,207,200,30,15,537
Michigan,Pentwater,881,33,163,211,185,82,674
Michigan,Potterville,2612,154,407,819,238,83,1701
Michigan,Posen,222,25,51,54,11,3,144
Michigan,Port Sanilac,546,39,134,125,56,57,411
Michigan,Portland,3910,155,504,997,330,233,2219
Michigan,Port Huron,29508,2398,6437,7399,1951,1191,19376
Michigan,Port Hope,251,30,115,46,13,5,209
Michigan,Port Austin,712,79,178,204,66,45,572
Michigan,Portage,47496,1317,6882,10487,8124,4670,31480
Michigan,Pontiac,59928,7876,12012,12626,2850,1354,36718
Michigan,Ponshewaing,43,0,21,14,0,4,39
Michigan,Plymouth,8952,255,1061,1696,2114,1478,6604
Michigan,Pleasant Ridge,2555,29,208,446,642,648,1973
Michigan,Plainwell,3810,286,927,992,356,189,2750
Michigan,Pinconning,1348,159,358,263,80,48,908
Michigan,Pinckney,2672,88,475,671,300,130,1664
Michigan,Pilgrim,50,0,0,0,19,27,46
Michigan,Pigeon,1262,119,357,258,111,47,892
Michigan,Pierson,190,22,59,24,0,0,105
Michigan,Pewamo,515,39,189,98,30,7,363
Michigan,Petoskey,5725,189,903,1393,1145,719,4349
Michigan,Petersburg,1315,37,410,297,51,63,858
Michigan,Perry,1994,159,426,533,137,63,1318
Michigan,Perrinton,575,39,179,84,15,8,325
Michigan,Ironton,162,3,34,56,32,6,131
Michigan,Gaastra,352,29,113,75,32,10,259
Michigan,Iron River,2944,240,1182,532,308,58,2320
Michigan,Ionia,11384,1455,3144,2195,662,248,7704
Michigan,Fair Plain,7706,756,1540,2027,572,338,5233
Michigan,Fairgrove,529,32,152,131,39,8,362
Michigan,Haring,515,15,119,63,19,0,216
Michigan,Harper Woods,13964,1190,2698,3297,1097,799,9081
Michigan,Harrietta,134,29,39,30,6,0,104
Michigan,Peck,683,82,198,159,16,6,461
Michigan,Harrisville,380,56,94,117,37,34,338
Michigan,Hart,2105,287,501,405,98,76,1367
Michigan,Hartford,2634,299,651,431,75,35,1491
Michigan,Harvey,1734,86,398,397,248,90,1219
Michigan,Farmington,10509,195,1088,2022,2345,1931,7581
Michigan,Haslett,20057,584,1640,3654,3920,3958,13756
Michigan,Hazel Park,16600,1990,4506,3256,1150,315,11217
Michigan,Hemlock,1625,62,537,378,87,60,1124
Michigan,Henderson,410,33,89,91,24,17,254
Michigan,Hersey,355,25,93,88,15,13,234
Michigan,Hesperia,893,86,219,218,47,17,587
Michigan,Hickory Corners,187,0,0,88,8,19,115
Michigan,Dryden,1198,53,399,245,78,35,810
Michigan,Dundee,3950,287,1053,926,369,168,2803
Michigan,Durand,3369,416,963,800,165,83,2427
Michigan,Eagle,93,5,19,23,8,1,56
Michigan,Hastings,7304,668,1542,2005,324,447,4986
Michigan,Eagle Harbor,128,5,13,38,41,28,125
Michigan,Farmington Hills,80971,3159,9257,14944,17173,14028,58561
Michigan,Fennville,1777,247,391,219,51,33,941
Michigan,Fremont,4051,212,973,904,342,268,2699
Michigan,Free Soil,143,33,36,50,4,1,124
Michigan,Freeport,512,24,168,100,32,5,329
Michigan,Freeland,7241,492,1278,1583,1153,437,4943
Michigan,Fraser,14582,1010,2999,4335,1372,776,10492
Michigan,Franklin,3198,55,196,387,715,811,2164
Michigan,Frankfort,1396,150,323,256,201,139,1069
Michigan,Frankenmuth,4947,243,971,1147,863,448,3672
Michigan,Fowlerville,2887,82,723,746,165,37,1753
Michigan,Fowler,1229,47,281,281,154,37,800
Michigan,Farwell,816,119,273,185,33,21,631
Michigan,Fountain,146,14,35,48,0,3,100
Michigan,Forestville,71,5,22,14,1,9,51
Michigan,Forest Hills,27415,458,1797,3761,6671,5184,17871
Michigan,Flushing,8199,298,1686,2248,858,638,5728
Michigan,Flint,99802,10780,22212,22916,4524,2554,62986
Michigan,Flat Rock,9879,561,2213,2471,910,536,6691
Michigan,Filer City,133,14,44,14,0,0,72
Michigan,Fife Lake,318,21,113,86,11,9,240
Michigan,Ferrysburg,2955,165,488,691,620,361,2325
Michigan,Ferndale,20160,836,3319,4879,3757,2130,14921
Michigan,Fenton,11538,802,2210,2496,1296,760,7564
Michigan,Fostoria,600,67,195,136,48,5,451
Michigan,Eagle River,69,4,11,28,9,10,62
Michigan,East Grand Rapids,11128,147,325,1027,2999,2733,7231
Michigan,East Jordan,2474,274,752,426,126,42,1620
Michigan,Hillsdale,8203,564,1524,1469,508,367,4432
Michigan,Holland,33526,2700,5162,5389,3481,2060,18792
Michigan,Holly,6171,414,1296,1544,414,234,3902
Michigan,Holt,24289,837,3398,6533,3638,1999,16405
Michigan,Homer,1857,130,531,342,92,47,1142
Michigan,Honor,235,13,52,62,25,11,163
Michigan,Hopkins,661,20,179,118,53,10,380
Michigan,Horton Bay,462,26,108,105,69,49,357
Michigan,Houghton,7942,182,595,727,821,782,3107
Michigan,Houghton Lake,3236,417,1014,937,171,61,2600
Michigan,Hillman,703,130,245,138,17,39,569
Michigan,Howard City,1724,148,403,372,63,11,997
Michigan,Hubbard Lake,868,67,235,287,116,104,809
Michigan,Hubbardston,338,27,130,65,13,1,236
Michigan,Hubbell,1012,53,304,182,102,20,661
Michigan,Hudson,2413,117,631,490,118,88,1444
Michigan,Hudsonville,7271,482,1372,1427,914,287,4482
Michigan,Huntington Woods,6333,50,289,546,1573,1991,4449
Michigan,Imlay City,3582,621,740,539,224,99,2223
Michigan,Indian River,1771,165,366,480,255,140,1406
Michigan,Inkster,24897,2573,5414,5852,1327,479,15645
Michigan,Interlochen,471,27,162,133,14,0,336
Michigan,Howell,9502,589,1993,2425,1086,331,6424
Michigan,Highland Park,11102,1930,2402,2279,539,242,7392
Michigan,Whittemore,444,58,152,92,6,2,310
Michigan,Whitmore Lake,6653,253,1129,1781,865,486,4514
Michigan,Eastlake,490,39,219,100,13,16,387
Michigan,East Lansing,48669,486,1254,2644,4339,5950,14673
Michigan,Eastpointe,32585,2716,7200,7914,1999,904,20733
Michigan,Eastport,212,0,95,49,30,19,193
Michigan,East Tawas,2761,166,677,599,374,171,1987
Michigan,Eastwood,6254,385,1115,1699,390,279,3868
Michigan,Eaton Rapids,5221,289,1040,1338,315,205,3187
Michigan,Eau Claire,602,63,104,119,38,22,346
Michigan,Ecorse,9338,1528,2261,1583,366,239,5977
Michigan,Edgemont Park,2199,46,391,507,314,180,1438
Michigan,Edmore,1287,84,382,191,68,46,771
Michigan,Edwardsburg,1161,93,283,171,64,14,625
Michigan,Elberta,208,20,85,42,7,20,174
Michigan,Elk Rapids,1541,63,347,356,261,203,1230
Michigan,Elkton,862,55,227,165,76,5,528
Michigan,Ellsworth,399,51,109,97,31,5,293
Michigan,Elsie,1080,92,379,258,29,14,772
Michigan,Emmett,299,21,85,55,15,8,184
Michigan,Empire,358,8,48,65,73,101,295
Michigan,Escanaba,12468,876,2941,3402,1203,400,8822
Michigan,Essexville,3432,178,661,990,363,226,2418
Michigan,Estral Beach,397,45,103,106,38,5,297
Michigan,Evart,1515,144,496,261,66,32,999
Michigan,Iron Mountain,7571,440,2082,1607,758,306,5193
Michigan,Harrison,2011,255,402,535,133,67,1392
Michigan,Sterling Heights,131139,12144,26366,28670,15710,9164,92054
Michigan,Mendon,896,73,175,182,62,45,537
Michigan,Taylor,62021,7085,16456,13879,2897,1169,41486
Michigan,Tecumseh,8393,459,1884,2437,976,390,6146
Michigan,Tekonsha,648,47,225,140,15,22,449
Michigan,Thompsonville,576,81,162,121,9,2,375
Michigan,Three Oaks,1598,85,402,389,98,75,1049
Michigan,Three Rivers,7787,655,1952,1674,396,173,4850
Michigan,Traverse City,15168,571,1972,3875,2588,1878,10884
Michigan,Trenton,18522,1104,4206,4556,2014,1467,13347
Michigan,Trowbridge Park,2291,113,459,466,232,235,1505
Michigan,Troy,82542,3495,8262,12570,16946,16171,57444
Michigan,Turner,82,18,31,14,2,0,65
Michigan,Tustin,242,8,73,54,19,4,158
Michigan,Twining,171,28,47,17,2,1,95
Michigan,Twin Lake,1928,27,453,651,169,105,1405
Michigan,Ubly,755,41,274,160,66,21,562
Michigan,Tawas City,1888,137,601,490,117,92,1437
Michigan,Sylvan Lake,1701,37,236,353,457,223,1306
Michigan,Swartz Creek,5632,477,1507,1502,350,223,4059
Michigan,Suttons Bay,584,16,67,133,95,143,454
Michigan,Mesick,407,48,101,88,20,10,267
Michigan,Merrill,706,54,207,131,34,24,450
Michigan,Menominee,8456,611,2132,2107,706,218,5774
Michigan,Memphis,1230,61,281,336,50,40,768
Michigan,Melvindale,10510,1521,2454,2175,350,211,6711
Michigan,Melvin,187,28,54,36,10,1,129
Michigan,Mecosta,620,76,190,100,12,3,381
Michigan,Union City,1618,97,455,339,116,22,1029
Michigan,Mayville,962,102,255,183,70,9,619
Michigan,Mattawan,2081,121,490,565,148,33,1357
Michigan,Stevensville,1282,61,296,341,213,78,989
Michigan,Stockbridge,1043,67,264,253,113,45,742
Michigan,Stony Point,1498,55,356,433,95,80,1019
Michigan,Stronach,211,4,44,62,1,0,111
Michigan,Sturgis,10916,1222,2458,1864,620,307,6471
Michigan,Sunfield,588,50,144,163,21,0,378
Michigan,Maybee,516,40,135,124,58,17,374
Michigan,Metamora,597,26,108,150,54,35,373
Michigan,Unionville,423,26,165,101,27,17,336
Michigan,Vandalia,406,93,103,61,7,7,271
Michigan,Wayland,4109,400,867,707,398,123,2495
Michigan,Wayne,17251,1969,4229,4286,1005,360,11849
Michigan,Webberville,1308,98,313,393,103,26,933
Michigan,Lakeview,1073,129,294,196,66,38,723
Michigan,Lake Odessa,1746,174,472,504,96,58,1304
Michigan,Lake Michigan Beach,1167,108,282,290,101,68,849
Michigan,Lake Linden,1120,58,315,236,131,59,799
Michigan,Lake Leelanau,176,0,33,44,24,16,117
Michigan,Lake Isabella,1883,75,413,470,268,146,1372
Michigan,Lake Fenton,5512,119,925,1595,907,471,4017
Michigan,Lakewood Club,1230,94,411,313,41,12,871
Michigan,Lambertville,9731,338,1984,2745,1234,648,6949
Michigan,L'Anse,2129,162,596,551,171,57,1537
Michigan,Lansing,114485,9013,18463,26509,11964,6749,72698
Michigan,Lapeer,8790,629,2605,1960,592,287,6073
Michigan,Waverly,24535,766,4357,6408,3892,2141,17564
Michigan,Watervliet,1773,224,390,416,78,46,1154
Michigan,Watersmeet,415,23,150,85,45,12,315
Michigan,Warren,134857,14638,32381,29268,11213,4849,92349
Michigan,Vanderbilt,583,102,220,85,19,4,430
Michigan,Vandercook Lake,4681,292,1221,1189,212,140,3054
Michigan,Vassar,2648,205,581,551,175,79,1591
Michigan,Vermontville,828,44,235,175,26,12,492
Michigan,Vernon,973,46,294,262,45,46,693
Michigan,Vicksburg,3089,133,580,873,275,133,1994
Michigan,Village of Clarkston,922,14,122,183,167,205,691
Michigan,Utica,4794,316,1165,1355,495,212,3543
Michigan,Village of Grosse Pointe Shores,2995,6,325,413,673,827,2244
Michigan,Wacousta,1342,9,262,358,379,149,1157
Michigan,Wakefield,1729,77,522,555,150,60,1364
Michigan,Waldron,594,43,222,92,14,9,380
Michigan,Walker,24242,950,4441,5527,3536,1476,15930
Michigan,Walkerville,175,24,55,43,4,0,126
Michigan,Walled Lake,7091,449,1474,1763,983,528,5197
Michigan,Walloon Lake,378,20,64,114,80,46,324
Michigan,Vineyard Lake,875,35,437,205,38,41,756
Michigan,Michiana,198,0,15,28,75,72,190
Michigan,Michigamme,275,11,71,67,37,29,215
Michigan,Michigan Center,4704,545,1244,970,475,140,3374
Michigan,Boyne City,3766,177,782,975,316,296,2546
Michigan,Boyne Falls,340,30,101,65,10,21,227
Michigan,Breckenridge,1180,68,438,264,45,12,827
Michigan,Okemos,22073,322,1397,2583,4632,5490,14424
Michigan,Oden,454,44,120,53,37,19,273
Michigan,Oak Park,29727,1621,4927,7175,3815,1989,19527
Michigan,Oakley,196,27,73,51,10,4,165
Michigan,Oak Hill,741,17,165,228,56,11,477
Michigan,Novi,57577,1978,5450,9456,12405,10127,39416
Michigan,Norwood,156,0,27,33,34,10,104
Michigan,Norway,2820,170,800,591,416,141,2118
Michigan,Norton Shores,23982,1182,5169,5941,3183,1753,17228
Michigan,Northville,5990,93,550,950,1582,1227,4402
Michigan,Northview,15278,487,3228,3476,2332,1100,10623
Michigan,Northport,633,11,63,165,161,68,468
Michigan,Boon,241,18,100,49,2,4,173
Michigan,Bloomingdale,655,57,203,102,19,12,393
Michigan,Bloomfield Hills,3956,79,173,355,933,1131,2671
Michigan,Blissfield,3154,83,756,801,450,143,2233
Michigan,Addison,573,25,188,99,39,16,367
Michigan,Adrian,20878,2240,4358,3348,1591,944,12481
Michigan,Advance,269,7,61,78,51,41,238
Michigan,Ahmeek,109,18,29,25,12,0,84
Michigan,Akron,413,39,108,91,15,4,257
Michigan,Alanson,675,43,196,199,49,0,487
Michigan,Alba,337,52,126,62,6,3,249
Michigan,North Muskegon,3778,143,552,791,732,495,2713
Michigan,Albion,8316,654,1746,1453,444,332,4629
Michigan,Algonac,4063,363,1176,1046,368,175,3128
Michigan,Allegan,5036,415,1456,837,338,228,3274
Michigan,Allen,243,23,91,52,8,3,177
Michigan,Big Rapids,10532,471,886,1392,717,591,4057
Michigan,Bingham Farms,1158,4,130,141,294,331,900
Michigan,Birch Run,1558,96,409,389,134,48,1076
Michigan,Birmingham,20489,164,957,2161,5563,5540,14385
Michigan,Alden,112,11,27,22,25,11,96
Michigan,North Branch,1003,56,297,257,33,30,673
Michigan,North Adams,574,38,187,120,13,14,372
Michigan,Niles,11450,1346,2568,2326,623,295,7158
Michigan,Morrice,1172,63,263,302,83,35,746
Michigan,Morley,729,80,174,134,24,16,428
Michigan,Morenci,2512,175,649,530,75,43,1472
Michigan,Montrose,1659,108,437,398,105,25,1073
Michigan,Montgomery,300,30,101,48,2,1,182
Michigan,Montague,2408,108,594,564,235,113,1614
Michigan,Monroe,20335,1376,4783,4744,1406,1041,13350
Michigan,Mount Clemens,16381,1801,3582,4036,1420,760,11599
Michigan,Mio,1740,167,470,434,88,21,1180
Michigan,Millington,886,49,285,185,51,24,594
Michigan,Millersburg,182,25,50,24,22,8,129
Michigan,Milford,6390,298,905,1325,1305,740,4573
Michigan,Milan,5929,190,1091,1432,660,433,3806
Michigan,Midland,41995,1450,6276,8486,6871,5178,28261
Michigan,Middleville,3304,109,881,593,236,46,1865
Michigan,Middletown,689,79,217,230,21,14,561
Michigan,Minden City,216,20,51,43,8,1,123
Michigan,Lathrup Village,4137,156,304,764,811,915,2950
Michigan,Mount Morris,3003,395,793,536,114,8,1846
Michigan,Muir,672,52,202,145,12,0,411
Michigan,New Troy,627,36,221,105,31,0,393
Michigan,New Lothrop,516,21,110,141,46,25,343
Michigan,New Haven,4679,294,922,1116,277,174,2783
Michigan,New Era,486,8,78,133,50,53,322
Michigan,New Buffalo,1893,155,327,455,249,192,1378
Michigan,Newberry,1729,145,511,404,105,47,1212
Michigan,New Baltimore,12212,391,2256,3206,1404,741,7998
Michigan,Mount Pleasant,26134,690,2183,2955,2170,2214,10212
Michigan,Newaygo,1870,117,405,458,103,53,1136
Michigan,Negaunee,4609,114,1059,1169,572,241,3155
Michigan,Nashville,1761,171,418,403,58,26,1076
Michigan,Napoleon,1103,88,390,199,32,9,718
Michigan,Muskegon Heights,10809,1311,2334,2214,259,118,6236
Michigan,Muskegon,37861,4082,9769,7943,2261,731,24786
Michigan,Munising,2303,206,657,658,234,96,1851
Michigan,Mulliken,588,33,160,154,19,3,369
Michigan,Nessen City,161,7,43,47,0,6,103
Michigan,Laurium,1906,128,347,462,225,72,1234
Michigan,Temperance,9369,463,1993,2242,1122,663,6483
Michigan,Lawton,1712,145,444,366,109,73,1137
Michigan,Columbiaville,800,48,189,170,34,21,462
Michigan,Comstock Northwest,5140,133,914,1378,739,370,3534
Michigan,Berrien Springs,1318,66,163,299,174,166,868
Michigan,Berkley,15178,440,1739,3517,3266,1946,10908
Michigan,Benzonia,431,15,98,104,16,38,271
Michigan,Benton Heights,4235,698,802,616,74,65,2255
Michigan,Benton Harbor,10014,1679,2158,1570,162,128,5697
Michigan,Colon,1136,133,295,239,86,55,808
Michigan,Bendon,191,7,78,52,15,6,158
Michigan,Belleville,3919,396,837,844,301,180,2558
Michigan,Bellaire,917,42,216,296,83,33,670
Michigan,Belding,5771,653,1494,1222,331,59,3759
Michigan,Beechwood,2839,398,483,666,180,164,1891
Michigan,Beecher,10184,1221,2095,2080,312,118,5826
Michigan,Beaverton,1019,77,321,235,66,31,730
Michigan,Bear Lake,275,16,66,72,30,1,185
Michigan,Bellevue,1382,94,467,287,81,32,961
Michigan,Bear Lake,370,28,91,118,46,20,303
Michigan,Coloma,1600,86,455,338,94,56,1029
Michigan,Coldwater,10866,933,2688,2422,609,321,6973
Michigan,Centreville,1582,124,510,344,88,43,1109
Michigan,Charlevoix,2523,138,487,565,504,264,1958
Michigan,Charlotte,9057,581,2137,2520,614,374,6226
Michigan,Chatham,204,6,101,30,13,0,150
Michigan,Cheboygan,4783,538,1283,1009,311,127,3268
Michigan,Chelsea,5126,260,697,1132,865,760,3714
Michigan,Chesaning,2471,209,615,528,203,94,1649
Michigan,Coleman,1291,91,393,231,96,28,839
Michigan,Chums Corner,1072,0,234,257,49,90,630
Michigan,Clarksville,402,20,107,101,31,16,275
Michigan,Lawrence,980,101,276,185,45,30,637
Michigan,Clayton,360,42,82,68,7,4,203
Michigan,Clifford,329,36,135,67,4,2,244
Michigan,Climax,736,27,170,217,81,20,515
Michigan,Clinton,2237,56,517,528,296,92,1489
Michigan,Clio,2582,235,533,669,276,58,1771
Michigan,Clare,3042,228,738,567,312,213,2058
Michigan,Beal City,438,16,162,48,37,34,297
Michigan,Bay View,221,0,25,46,50,85,206
Michigan,Bay Shore,841,49,222,148,81,43,543
Michigan,Ashley,494,69,158,127,14,8,376
Michigan,Armada,1998,128,481,414,211,94,1328
Michigan,Argentine,2567,155,560,588,212,334,1849
Michigan,Arcadia,236,16,47,69,42,38,212
Michigan,Applegate,308,28,103,49,8,0,188
Michigan,Ann Arbor,116194,2317,5234,10696,19191,27526,64964
Michigan,Amasa,299,22,113,72,23,0,230
Michigan,Athens,1109,50,310,266,61,21,708
Michigan,Alpha,75,8,33,15,1,11,68
Michigan,Almont,2685,185,727,610,170,104,1796
Michigan,Alma,9264,494,1662,1997,598,622,5373
Michigan,Allen Park,27676,1650,6182,6842,3100,1657,19431
Michigan,Allendale,18456,503,1880,2334,1286,720,6723
Michigan,Lake Orion,3038,115,492,870,529,278,2284
Michigan,Lakes of the North,716,62,191,243,60,26,582
Michigan,Lake Victoria,885,38,110,271,108,111,638
Michigan,Alpena,10273,733,2262,2835,756,455,7041
Michigan,Atlanta,776,135,327,133,25,0,620
Michigan,Attica,671,34,254,161,21,13,483
Michigan,Auburn,2175,104,406,631,252,122,1515
Michigan,Bay Port,403,30,160,111,22,10,333
Michigan,Bay City,34402,3041,8075,8222,2392,1087,22817
Michigan,Battle Creek,51830,3621,11262,11655,4940,2352,33830
Michigan,Bath,2142,15,454,545,237,181,1432
Michigan,Barton Hills,289,0,9,25,44,141,219
Michigan,Barryton,404,47,128,71,17,7,270
Michigan,Baroda,871,72,233,239,69,24,637
Michigan,Barnes Lake-Millers Lake,921,48,264,235,38,43,628
Michigan,Baraga,3031,720,1363,220,51,29,2383
Michigan,Bangor,1849,283,399,413,85,40,1220
Michigan,Bancroft,635,35,176,155,28,6,400
Michigan,Baldwin,1497,243,386,408,14,24,1075
Michigan,Bad Axe,3052,310,833,703,147,197,2190
Michigan,Au Sable,1401,115,438,419,117,30,1119
Michigan,Augusta,878,61,228,204,62,27,582
Michigan,Au Gres,832,124,202,216,55,35,632
Michigan,Auburn Hills,22085,1114,3031,4167,3500,2274,14086
Michigan,Central Lake,1068,56,280,256,93,45,730
Michigan,Center Line,8306,931,2245,2033,465,173,5847
Michigan,Clawson,11988,572,2497,2982,2012,1036,9099
Michigan,Byron Center,6391,420,1016,1040,915,579,3970
Michigan,Caspian,723,67,320,107,68,25,587
Michigan,Cass City,2542,177,556,703,182,128,1746
Michigan,Cassopolis,1901,179,400,385,42,22,1028
Michigan,Wedgewood,198,4,32,28,46,41,151
Michigan,Weidman,934,35,268,249,58,15,625
Michigan,Wellston,304,71,56,89,33,4,253
Michigan,West Branch,2300,222,593,502,216,84,1617
Michigan,West Ishpeming,2873,83,936,614,428,143,2204
Michigan,Westland,82642,6937,19019,20751,7586,3220,57513
Michigan,West Monroe,3345,453,980,492,163,47,2135
Michigan,Westphalia,933,49,263,193,98,19,622
Michigan,Westwood,9372,188,925,2141,1755,1346,6355
Michigan,White Cloud,1351,189,389,293,44,24,939
Michigan,Whitehall,2701,176,550,751,314,106,1897
Michigan,White Pigeon,1519,185,410,329,34,24,982
Michigan,White Pine,395,34,128,139,26,6,333
Michigan,Brownlee Park,2016,300,601,392,58,0,1351
Michigan,Beverly Hills,10403,59,605,1477,2622,2448,7211
Michigan,Beulah,236,9,70,59,41,39,218
Michigan,Bessemer,1935,74,475,558,218,62,1387
Michigan,Cedar,80,12,9,25,5,7,58
Michigan,Casnovia,457,55,90,101,23,3,272
Michigan,Caseville,773,95,223,204,63,38,623
Michigan,Carsonville,462,65,123,68,15,9,280
Michigan,Carson City,1124,61,275,327,33,45,741
Michigan,Brutus,174,15,48,39,8,10,120
Michigan,Buchanan,4401,222,1356,1088,243,136,3045
Michigan,Buckley,774,38,159,177,57,12,443
Michigan,Brooklyn,1309,65,308,344,112,52,881
Michigan,Buena Vista,6192,762,1501,1315,220,92,3890
Michigan,Burlington,263,10,91,65,10,5,181
Michigan,Burr Oak,870,115,262,130,22,7,536
Michigan,Burt,1103,95,336,235,52,18,736
Michigan,Burton,29223,2078,7146,7481,2064,924,19693
Michigan,Byron,576,26,136,129,32,16,339
Michigan,Cedar Springs,3570,239,985,722,276,58,2280
Michigan,Caberfae,20,1,2,3,9,4,19
Michigan,Caledonia,1509,38,206,287,239,109,879
Michigan,Calumet,684,39,198,129,68,20,454
Michigan,Camden,573,63,165,85,11,4,328
Michigan,Canada Creek Ranch,302,7,94,92,23,36,252
Michigan,Canadian Lakes,2768,90,488,874,529,367,2348
Michigan,Capac,1909,171,473,377,84,23,1128
Michigan,Carleton,2447,183,650,525,134,91,1583
Michigan,Carney,237,28,53,64,28,4,177
Michigan,Caro,4142,355,1149,902,314,248,2968
Michigan,Carp Lake,454,57,90,157,37,19,360
Michigan,Cadillac,10327,694,2585,2531,909,405,7124
Michigan,Cement City,466,86,116,94,16,10,322
Michigan,Big Bay,187,4,70,26,33,16,149
Michigan,Brown City,1193,68,448,239,45,26,826
Michigan,Leland,511,41,30,91,155,94,411
Michigan,Lennon,458,34,120,128,28,9,319
Michigan,Leonard,390,28,86,93,38,17,262
Michigan,Le Roy,309,7,88,67,19,10,191
Michigan,Level Park-Oak Park,3595,266,1038,1007,231,166,2708
Michigan,Breedsville,249,50,53,69,3,2,177
Michigan,Brethren,349,42,122,71,14,3,252
Michigan,Bridgeport,6574,758,2113,1404,376,149,4800
Michigan,Bridgman,1997,98,380,528,208,210,1424
Michigan,Brighton,7555,360,1263,1831,1514,821,5789
Michigan,Leslie,1720,116,414,446,88,51,1115
Michigan,Bronson,2437,235,661,417,86,40,1439
Michigan,Britton,666,26,159,156,72,4,417
Minnesota,Wheaton,1526,121,396,358,157,66,1098
Minnesota,Whipholt,97,4,14,33,16,4,71
Minnesota,White Bear Lake,24709,748,4414,6287,3702,2090,17241
Minnesota,White Earth,567,80,159,75,11,3,328
Minnesota,Wilder,45,6,21,7,1,0,35
Minnesota,Willernie,576,17,122,108,67,24,338
Minnesota,Ironton,799,68,162,189,60,16,495
Minnesota,Isanti,5415,236,1441,1172,498,107,3454
Minnesota,Isle,762,85,212,202,63,16,578
Minnesota,Ivanhoe,535,55,157,121,53,10,396
Minnesota,Jackson,3268,286,728,874,320,159,2367
Minnesota,Janesville,2667,122,586,651,259,109,1727
Minnesota,Wilmont,387,31,87,109,15,3,245
Minnesota,Willow River,381,30,62,88,44,12,236
Minnesota,Willmar,19685,2086,3459,4564,1653,881,12643
Minnesota,Williams,197,15,53,42,26,4,140
Minnesota,Iron Junction,104,13,28,26,8,4,79
Minnesota,Kandiyohi,581,20,105,160,30,9,324
Minnesota,Jordan,5900,143,1108,1305,840,286,3682
Minnesota,Johnson,3,0,3,0,0,0,3
Minnesota,Jenkins,448,14,99,92,48,6,259
Minnesota,Jeffers,419,43,109,78,11,4,245
Minnesota,Jasper,598,63,225,100,54,4,446
Minnesota,Whalan,82,12,22,14,14,4,66
Minnesota,International Falls,6270,549,1522,1463,678,133,4345
Minnesota,West St. Paul,19709,1389,3940,4373,2534,1221,13457
Minnesota,Inger,251,22,17,60,28,0,127
Minnesota,Independence,3671,45,548,871,840,306,2610
Minnesota,Ihlen,44,6,23,7,3,3,42
Minnesota,Hutchinson,13941,572,3414,3424,1333,608,9351
Minnesota,Humboldt,18,1,7,7,0,0,15
Minnesota,Hugo,14053,299,1954,3419,2355,1041,9068
Minnesota,Hoyt Lakes,2002,122,554,626,199,54,1555
Minnesota,Howard Lake,2115,163,524,468,150,35,1340
Minnesota,Iona,128,19,38,31,3,0,91
Minnesota,Viking,130,7,32,29,15,1,84
Minnesota,Victoria,8103,75,550,1187,2300,924,5036
Minnesota,Vesta,322,27,92,49,23,6,197
Minnesota,Vernon Center,338,17,73,78,40,15,223
Minnesota,Verndale,733,28,194,204,41,20,487
Minnesota,Vermillion,471,17,124,131,38,24,334
Minnesota,Vergas,308,14,96,89,29,15,243
Minnesota,Vadnais Heights,12968,599,2217,2712,2830,1123,9481
Minnesota,Utica,308,27,71,55,23,0,176
Minnesota,Inver Grove Heights,34417,1596,6073,7447,5651,2143,22910
Minnesota,Westbrook,756,90,215,174,45,35,559
Minnesota,West Concord,812,70,200,148,61,10,489
Minnesota,Westport,37,4,9,14,0,0,27
Minnesota,West Roy Lake,52,6,7,22,0,0,35
Minnesota,West Union,142,4,24,44,8,5,85
Minnesota,Urbank,68,6,16,13,7,3,45
Minnesota,Waltham,167,8,55,40,4,4,111
Minnesota,Kasota,820,57,251,188,41,7,544
Minnesota,Lafayette,479,29,139,106,40,8,322
Minnesota,Lake Benton,685,36,167,165,67,23,458
Minnesota,Lake Bronson,228,33,108,32,6,4,183
Minnesota,Lake City,5111,341,1502,1140,525,283,3791
Minnesota,Lake Crystal,2545,112,524,656,308,59,1659
Minnesota,Lake Elmo,8199,205,1191,1478,1752,803,5429
Minnesota,Lakefield,1527,92,429,379,135,38,1073
Minnesota,Lake George,186,11,49,59,17,9,145
Minnesota,Lake Henry,78,8,34,18,0,0,60
Minnesota,Lakeland,1741,51,303,412,267,203,1236
Minnesota,Lakeland Shores,304,11,46,76,58,28,219
Minnesota,Lake Lillian,271,13,85,56,10,2,166
Minnesota,Lake Park,725,65,159,157,65,15,461
Minnesota,Lake St. Croix Beach,1135,31,225,356,154,53,819
Minnesota,Lake Shore,1025,21,195,338,221,67,842
Minnesota,Lakeville,58592,1336,6973,11044,12822,4845,37020
Minnesota,Lake Wilson,253,22,84,73,22,2,203
Minnesota,Lamberton,844,95,244,197,50,9,595
Minnesota,Lancaster,372,24,98,64,51,9,246
Minnesota,Landfall,752,138,203,91,13,4,449
Minnesota,Lanesboro,755,34,147,201,115,84,581
Minnesota,Lansing,184,23,56,39,3,0,121
Minnesota,Waseca,9324,584,2356,2445,933,297,6615
Minnesota,Warsaw,764,25,207,208,105,20,565
Minnesota,Warroad,1862,115,368,479,182,27,1171
Minnesota,Warren,1576,184,359,289,207,78,1117
Minnesota,Warba,108,10,31,34,5,0,80
Minnesota,Wanda,59,3,22,20,2,0,47
Minnesota,Wanamingo,1179,88,265,287,125,16,781
Minnesota,La Crescent,4815,172,899,1380,545,264,3260
Minnesota,Kinney,160,15,40,50,8,2,115
Minnesota,Kingston,157,10,28,33,5,0,76
Minnesota,Kinbrae,2,0,2,0,0,0,2
Minnesota,Kasson,6049,148,1134,1581,750,185,3798
Minnesota,Keewatin,1080,86,232,323,93,6,740
Minnesota,Kelliher,303,25,72,86,27,10,220
Minnesota,Kellogg,385,30,141,109,10,5,295
Minnesota,Kennedy,241,18,42,61,30,6,157
Minnesota,Kenneth,69,2,17,25,2,0,46
Minnesota,Kensington,298,28,94,84,5,2,213
Minnesota,Kent,69,4,23,9,7,3,46
Minnesota,Kenyon,1724,126,430,469,167,61,1253
Minnesota,Kerkhoven,793,51,175,194,39,22,481
Minnesota,Kerrick,52,8,22,7,0,0,37
Minnesota,Walters,121,16,30,19,0,0,65
Minnesota,Wilton,184,15,19,42,26,19,121
Minnesota,Villard,216,19,60,54,8,6,147
Minnesota,Karlstad,783,80,192,134,63,25,494
Minnesota,Vineland,962,102,196,176,26,14,514
Minnesota,Virginia,8658,400,1852,2821,743,264,6080
Minnesota,Wabasha,2659,212,780,631,245,223,2091
Minnesota,Wabasso,636,51,154,130,87,10,432
Minnesota,Kettle River,156,1,36,67,8,0,112
Minnesota,Waconia,11494,370,1645,2154,2312,896,7377
Minnesota,Wadena,4056,367,1160,938,231,47,2743
Minnesota,Wahkon,205,18,98,38,4,7,165
Minnesota,Waite Park,7429,623,1294,1590,619,471,4597
Minnesota,Waldorf,192,19,81,28,17,3,148
Minnesota,Walker,1036,56,233,207,156,45,697
Minnesota,Walnut Grove,821,142,189,83,41,15,470
Minnesota,Kiester,449,22,168,132,43,7,372
Minnesota,Kilkenny,327,6,66,46,11,0,129
Minnesota,Kimball,884,69,212,180,84,11,556
Minnesota,Vining,41,1,15,8,7,0,31
Minnesota,Windom,4601,340,1154,1110,446,170,3220
Minnesota,Lastrup,151,4,55,30,17,8,114
Minnesota,Winnebago,1432,118,433,317,105,40,1013
Minnesota,Arden Hills,9797,205,934,1286,2177,1254,5856
Minnesota,Arco,116,11,28,23,11,1,74
Minnesota,Apple Valley,50309,1525,6172,11322,9930,4897,33846
Minnesota,Appleton,1540,133,491,271,117,25,1037
Minnesota,Anoka,17244,1291,4147,4483,1854,714,12489
Minnesota,Annandale,3296,262,792,613,451,112,2230
Minnesota,Argyle,569,56,149,120,77,15,417
Minnesota,Angle Inlet,22,0,22,0,0,0,22
Minnesota,Amboy,520,36,160,149,40,7,392
Minnesota,Alvarado,444,46,85,102,39,7,279
Minnesota,Altura,474,17,80,145,60,6,308
Minnesota,Alpha,269,2,79,58,6,0,145
Minnesota,Alexandria,11614,560,2219,2978,1397,443,7597
Minnesota,Aldrich,68,6,13,22,1,2,44
Minnesota,Andover,31553,820,4657,7722,4811,1615,19625
Minnesota,Alden,643,37,173,157,65,9,441
Minnesota,Arlington,2181,265,457,518,110,81,1431
Minnesota,Ashby,473,11,110,139,37,5,302
Minnesota,Balaton,524,23,161,134,66,13,397
Minnesota,Baker,66,0,14,18,4,2,38
Minnesota,Bagley,1410,168,395,273,111,41,988
Minnesota,Badger,425,34,105,117,29,5,290
Minnesota,Backus,319,55,74,62,16,3,210
Minnesota,Babbitt,1537,155,419,458,99,38,1169
Minnesota,Arnold,3071,93,668,984,255,160,2160
Minnesota,Upsala,480,36,123,108,28,12,307
Minnesota,Avoca,89,12,38,24,1,4,79
Minnesota,Austin,24687,2311,4703,5486,2319,986,15805
Minnesota,Aurora,1724,136,527,443,124,53,1283
Minnesota,Audubon,593,17,96,148,37,7,305
Minnesota,Atwater,1071,74,254,296,69,28,721
Minnesota,Askov,370,25,131,77,30,17,280
Minnesota,Avon,1592,70,319,400,163,75,1027
Minnesota,Ball Club,247,47,55,56,7,14,179
Minnesota,Albertville,7226,124,1184,1524,960,231,4023
Minnesota,Alberta,122,3,40,34,6,1,84
Minnesota,Danube,596,43,122,129,55,25,374
Minnesota,Dalton,292,30,64,59,23,2,178
Minnesota,Dakota,336,25,81,83,24,5,218
Minnesota,Cyrus,341,22,95,77,30,1,225
Minnesota,Wendell,116,7,61,31,9,0,108
Minnesota,Wells,2358,298,648,487,212,44,1689
Minnesota,Danvers,140,1,28,35,14,2,80
Minnesota,Welcome,774,66,226,182,43,5,522
Minnesota,Waverly,1565,79,334,387,163,41,1004
Minnesota,Waubun,511,23,129,78,16,9,255
Minnesota,Watson,176,26,59,37,6,0,128
Minnesota,Watkins,864,89,242,176,22,11,540
Minnesota,Waterville,1731,155,577,373,107,43,1255
Minnesota,Watertown,4257,245,874,997,610,155,2881
Minnesota,Wayzata,4166,144,404,922,1056,723,3249
Minnesota,Albert Lea,17843,1737,4501,4516,1444,637,12835
Minnesota,Darfur,115,23,39,12,1,2,77
Minnesota,Dassel,1447,114,353,349,142,35,993
Minnesota,Albany,2618,350,619,632,245,61,1907
Minnesota,Akeley,397,20,130,119,19,4,292
Minnesota,Aitkin,2279,229,609,504,173,69,1584
Minnesota,Afton,2932,54,388,536,753,470,2201
Minnesota,Adrian,1278,69,401,332,92,20,914
Minnesota,Adams,742,48,174,200,90,23,535
Minnesota,Darwin,350,29,84,90,17,1,221
Minnesota,Ada,1681,125,459,370,171,35,1160
Minnesota,Deerwood,455,30,157,95,19,30,331
Minnesota,Deer River,1027,90,245,272,55,13,675
Minnesota,Deer Creek,232,25,73,70,11,2,181
Minnesota,Deephaven,3769,4,230,544,1039,659,2476
Minnesota,Dayton,4857,124,1031,1217,699,262,3333
Minnesota,Dawson,1518,94,439,323,144,52,1052
Minnesota,De Graff,126,22,34,28,4,2,90
Minnesota,Winger,261,24,50,45,18,0,137
Minnesota,Barnesville,2571,163,587,576,273,99,1698
Minnesota,Barrett,339,43,89,79,24,3,238
Minnesota,Zumbrota,3325,136,572,904,353,113,2078
Minnesota,St. Leo,91,9,37,24,1,4,75
Minnesota,St. Joseph,6749,117,520,1128,566,382,2713
Minnesota,St. James,4508,563,1145,796,318,74,2896
Minnesota,St. Hilaire,283,38,84,62,14,4,202
Minnesota,St. Francis,7340,277,1777,1960,498,127,4639
Minnesota,Zumbro Falls,176,9,29,55,12,1,106
Minnesota,St. Cloud,66298,3302,9579,14563,7313,3861,38618
Minnesota,St. Charles,3710,184,646,1003,342,161,2336
Minnesota,St. Bonifacius,2472,94,424,573,396,137,1624
Minnesota,St. Augusta,3486,115,734,910,446,156,2361
Minnesota,St. Anthony city (Stearns County),106,4,28,23,8,5,68
Minnesota,St. Anthony city (Hennepin and Ramsey Counties),8662,246,1236,1851,1769,1072,6174
Minnesota,Sacred Heart,613,49,177,110,48,9,393
Minnesota,St. Clair,896,13,186,181,117,19,516
Minnesota,Sabin,582,11,123,146,49,13,342
Minnesota,Zimmerman,5280,211,701,1512,539,98,3061
Minnesota,Wyoming,7755,283,1559,1902,841,378,4963
Minnesota,Winona,27437,1347,4056,4730,3113,2003,15249
Minnesota,Winsted,2377,136,602,612,189,83,1622
Minnesota,Winthrop,1370,145,343,228,139,59,914
Minnesota,Winton,105,23,30,36,4,0,93
Minnesota,Wolf Lake,57,1,8,10,2,0,21
Minnesota,Wolverton,93,5,18,30,19,5,77
Minnesota,Zemple,92,7,21,26,9,1,64
Minnesota,Woodbury,65667,1139,6053,10890,15443,9437,42962
Minnesota,Woodland,443,6,12,61,145,102,326
Minnesota,Woodstock,149,10,30,30,5,3,78
Minnesota,Worthington,12990,2276,2431,2086,736,289,7818
Minnesota,Wrenshall,489,25,118,144,25,13,325
Minnesota,Wright,148,4,47,25,0,10,86
Minnesota,Wykoff,418,34,148,91,16,2,291
Minnesota,Wood Lake,388,16,106,115,34,5,276
Minnesota,Barnum,664,56,121,162,82,17,438
Minnesota,Rutledge,194,21,60,51,8,2,142
Minnesota,Russell,404,18,135,75,29,3,260
Minnesota,Rockford,4218,168,717,964,528,229,2606
Minnesota,Rock Creek,1653,93,491,432,131,29,1176
Minnesota,Rochester,110275,4792,14775,22509,18108,14039,74223
Minnesota,Robbinsdale,14289,797,2361,3158,2745,1174,10235
Minnesota,Riverton,116,9,24,33,7,3,76
Minnesota,Riverland,271,14,24,50,0,2,90
Minnesota,Rockville,2481,140,500,575,311,100,1626
Minnesota,Richville,75,7,26,26,4,0,63
Minnesota,Beardsley,170,14,60,30,13,2,119
Minnesota,Bayport,3648,243,1313,686,336,217,2795
Minnesota,Baxter,7768,242,1336,2238,926,465,5207
Minnesota,Baudette,1096,66,339,196,116,19,736
Minnesota,Battle Lake,868,25,159,284,120,50,638
Minnesota,Barry,9,0,3,4,0,0,7
Minnesota,Richmond,1498,139,457,342,65,15,1018
Minnesota,Ruthton,258,35,83,38,11,0,167
Minnesota,Rogers,12002,154,1624,2693,2268,637,7376
Minnesota,Ronneby,32,3,17,6,0,0,26
Minnesota,Rushmore,288,36,93,58,18,4,209
Minnesota,Rushford Village,946,42,184,246,127,55,654
Minnesota,Rushford,1916,84,483,501,145,60,1273
Minnesota,Rush City,3068,283,1068,585,154,71,2161
Minnesota,Roy Lake,15,3,3,7,2,0,15
Minnesota,Royalton,1230,89,203,332,117,26,767
Minnesota,Rollingstone,615,8,130,169,85,18,410
Minnesota,Round Lake,398,27,127,102,13,13,282
Minnesota,Roseville,34948,1623,4828,6691,6367,5064,24573
Minnesota,Rosemount,22741,601,2483,4845,4490,1981,14400
Minnesota,Rose Creek,382,25,114,99,38,6,282
Minnesota,Roseau,2647,167,509,581,337,177,1771
Minnesota,Roscoe,132,10,55,35,0,1,101
Minnesota,Roosevelt,131,16,46,22,13,0,97
Minnesota,Rothsay,461,27,134,110,53,18,342
Minnesota,Underwood,384,22,85,124,37,9,277
Minnesota,Beaver Creek,304,19,77,78,23,7,204
Minnesota,Tyler,1244,85,393,237,155,19,889
Minnesota,St. Marys Point,351,5,70,98,59,24,256
Minnesota,St. Michael,16911,364,2226,4391,2563,993,10537
Minnesota,St. Paul,295043,24633,38836,47712,42132,29750,183063
Minnesota,St. Paul Park,5341,329,1219,1363,531,189,3631
Minnesota,St. Peter,11492,569,1608,1851,1278,756,6062
Minnesota,St. Rosa,74,10,19,17,1,2,49
Minnesota,Dexter,288,20,87,75,17,6,205
Minnesota,Detroit Lakes,8897,475,1931,2121,1060,519,6106
Minnesota,Dent,162,18,58,41,7,2,126
Minnesota,St. Stephen,953,27,223,260,81,32,623
Minnesota,St. Vincent,35,3,16,7,3,3,32
Minnesota,Sanborn,337,39,117,91,9,3,259
Minnesota,Sandstone,2780,164,1043,702,171,56,2136
Minnesota,Sargeant,60,5,27,22,0,0,54
Minnesota,Sartell,16274,527,2063,3584,3010,1180,10364
Minnesota,Sauk Centre,4331,323,1268,866,389,149,2995
Minnesota,Sauk Rapids,13196,712,2204,3497,1624,554,8591
Minnesota,Savage,28713,786,3462,6167,5782,2028,18225
Minnesota,Scandia,3995,78,835,1094,689,275,2971
Minnesota,Scanlon,1209,55,285,318,99,40,797
Minnesota,Seaforth,89,2,26,11,5,0,44
Minnesota,St. Martin,364,24,105,73,14,2,218
Minnesota,St. Louis Park,47043,1450,4676,9115,13105,6387,34733
Minnesota,Dilworth,4166,170,739,1075,385,275,2644
Minnesota,Dodge Center,2680,160,486,608,224,38,1516
Minnesota,Edgerton,1217,155,251,266,121,77,870
Minnesota,Eden Valley,957,68,295,192,61,4,620
Minnesota,Eden Prairie,62626,1259,4545,10910,16646,9402,42762
Minnesota,Echo,299,6,88,61,14,4,173
Minnesota,Ebro,103,10,25,22,0,0,57
Minnesota,Easton,230,3,73,59,21,5,161
Minnesota,East Gull Lake,992,18,172,244,224,75,733
Minnesota,East Grand Forks,8611,407,1484,2115,1177,425,5608
Minnesota,East Bethel,11625,373,2891,3148,1323,371,8106
Minnesota,Eagle Lake,2612,80,421,690,409,110,1710
Minnesota,Searles,196,13,45,61,9,3,131
Minnesota,Eagle Bend,450,33,126,128,26,21,334
Minnesota,Dunnell,173,24,73,38,10,2,147
Minnesota,Dundee,123,14,71,6,0,0,91
Minnesota,Dundas,1647,58,342,326,161,131,1018
Minnesota,Dumont,98,9,24,19,3,2,57
Minnesota,Duluth,86178,3668,13391,17926,11746,6369,53100
Minnesota,Dovray,69,16,20,27,0,0,63
Minnesota,Dover,811,25,176,205,54,28,488
Minnesota,Doran,31,0,12,14,1,0,27
Minnesota,Donnelly,245,9,91,55,8,5,168
Minnesota,Donaldson,19,3,12,4,0,0,19
Minnesota,Eagan,65424,1574,6736,13553,14965,7458,44286
Minnesota,Sebeka,688,33,187,156,52,17,445
Minnesota,Sedan,42,0,18,14,2,0,34
Minnesota,Fertile,931,100,221,179,91,36,627
Minnesota,Garfield,251,29,42,90,35,5,201
Minnesota,Dennison,137,7,39,32,9,10,97
Minnesota,Denham,37,5,17,8,0,0,30
Minnesota,Dellwood,1164,10,65,142,313,234,764
Minnesota,Delhi,44,10,20,5,1,2,38
Minnesota,Delavan,245,18,56,46,29,2,151
Minnesota,Garrison,225,20,73,63,19,10,185
Minnesota,Garvin,120,11,47,21,3,2,84
Minnesota,Gary,266,16,75,62,14,4,171
Minnesota,Gaylord,2080,188,635,412,203,44,1482
Minnesota,Garden City,373,31,118,67,33,10,259
Minnesota,Gem Lake,465,15,66,92,85,60,318
Minnesota,Genola,73,11,16,11,0,4,42
Minnesota,Georgetown,113,8,28,18,13,0,67
Minnesota,Ghent,344,16,61,82,35,18,212
Minnesota,Gibbon,825,80,209,176,47,6,518
Minnesota,Gilbert,1809,36,526,573,181,34,1350
Minnesota,Gilman,183,10,30,72,13,0,125
Minnesota,Glencoe,5557,570,1322,1164,535,147,3738
Minnesota,Taconite,634,37,144,212,25,18,436
Minnesota,Tamarack,54,7,17,10,1,7,42
Minnesota,Taopi,54,5,27,9,2,0,43
Minnesota,Geneva,411,13,123,110,13,16,275
Minnesota,Edina,49373,834,3563,6654,14145,9832,35028
Minnesota,Funkley,5,1,2,2,0,0,5
Minnesota,Frost,227,15,58,69,10,2,154
Minnesota,Fifty Lakes,318,26,80,100,52,20,278
Minnesota,Finland,165,11,84,19,10,3,127
Minnesota,Finlayson,261,26,65,79,16,4,190
Minnesota,Fisher,464,18,68,111,49,27,273
Minnesota,Fish Lake,82,1,22,19,21,2,65
Minnesota,Flensburg,193,11,61,42,7,3,124
Minnesota,Floodwood,472,51,177,104,21,4,357
Minnesota,Florence,14,0,3,7,1,0,11
Minnesota,Foley,2636,236,541,646,136,115,1674
Minnesota,Forada,211,12,53,69,21,8,163
Minnesota,Fulda,1296,128,332,363,71,48,942
Minnesota,Forest Lake,19170,596,3441,5005,2406,1068,12516
Minnesota,Fort Ripley,103,4,22,33,5,1,65
Minnesota,Fosston,1624,126,423,314,173,79,1115
Minnesota,Fountain,421,7,106,108,44,21,286
Minnesota,Foxhome,127,18,34,30,1,1,84
Minnesota,Franklin,636,42,199,128,21,0,390
Minnesota,Frazee,1320,149,384,262,78,25,898
Minnesota,Freeborn,333,13,97,86,24,5,225
Minnesota,Freeport,607,41,176,148,43,18,426
Minnesota,Fridley,27592,1868,5674,6150,3562,1398,18652
Minnesota,Frontenac,197,30,75,34,16,10,165
Minnesota,Foreston,643,49,119,165,26,6,365
Minnesota,Taunton,161,10,40,43,4,4,101
Minnesota,Effie,83,8,10,22,11,0,51
Minnesota,Elba,139,16,42,38,5,0,101
Minnesota,Loretto,709,18,126,190,102,30,466
Minnesota,Louisburg,35,5,11,9,6,0,31
Minnesota,Lowry,339,21,60,86,38,5,210
Minnesota,Lucan,175,5,60,32,23,3,123
Minnesota,Lutsen,437,13,17,106,93,20,249
Minnesota,Luverne,4665,376,1226,907,555,238,3302
Minnesota,Lyle,504,56,111,132,31,5,335
Minnesota,Lynd,563,26,87,132,50,16,311
Minnesota,Mabel,741,80,225,169,61,16,551
Minnesota,McGrath,82,12,27,21,0,0,60
Minnesota,McGregor,456,50,112,78,26,3,269
Minnesota,McIntosh,537,41,166,127,28,12,374
Minnesota,McKinley,159,6,41,60,2,0,109
Minnesota,Madelia,2368,251,596,391,200,63,1501
Minnesota,Madison,1558,136,450,412,133,42,1173
Minnesota,Madison Lake,985,26,258,205,169,35,693
Minnesota,Magnolia,212,31,63,49,8,4,155
Minnesota,Mahnomen,1275,150,322,304,91,19,886
Minnesota,Mahnomen,266,17,33,59,3,0,112
Minnesota,Mahtomedi,7999,110,772,1777,1560,1036,5255
Minnesota,Mahtowa,428,7,103,135,18,13,276
Minnesota,Lonsdale,3781,89,677,972,454,77,2269
Minnesota,Longville,92,6,32,33,8,3,82
Minnesota,Long Prairie,3392,463,760,480,295,131,2129
Minnesota,Long Lake,1803,49,314,439,353,157,1312
Minnesota,Lauderdale,2468,213,196,282,583,510,1784
Minnesota,Le Center,2370,249,579,444,216,66,1554
Minnesota,Lengby,63,7,25,12,2,0,46
Minnesota,Leonard,42,11,13,8,0,0,32
Minnesota,Leonidas,39,1,15,16,1,0,33
Minnesota,Leota,192,23,65,49,4,5,146
Minnesota,Le Roy,819,69,267,191,77,27,631
Minnesota,Lester Prairie,1737,139,434,357,86,32,1048
Minnesota,Le Sueur,4020,334,884,983,491,117,2809
Minnesota,Lewiston,1562,122,310,386,169,46,1033
Minnesota,Manchester,39,1,18,14,0,0,33
Minnesota,Lewisville,222,19,77,53,6,2,157
Minnesota,Lilydale,750,15,77,184,224,200,700
Minnesota,Lindstrom,4417,182,1015,1047,678,248,3170
Minnesota,Lino Lakes,20819,601,3270,4319,3823,1566,13579
Minnesota,Lismore,250,21,52,68,11,4,156
Minnesota,Litchfield,6691,511,1769,1338,654,322,4594
Minnesota,Little Canada,10120,582,2003,2431,1598,665,7279
Minnesota,Little Falls,8721,724,2121,1948,917,494,6204
Minnesota,Littlefork,671,72,158,233,45,7,515
Minnesota,Little Rock,1170,107,113,183,59,12,474
Minnesota,Long Beach,334,5,85,105,57,35,287
Minnesota,Lexington,1969,168,534,444,167,23,1336
Minnesota,Manhattan Beach,69,0,38,11,1,1,51
Minnesota,Mankato,40557,1227,5038,7080,4845,2451,20641
Minnesota,Mantorville,1153,28,295,266,166,63,818
Minnesota,Farmington,22159,769,3066,5232,3706,1067,13840
Minnesota,Farwell,55,5,34,4,2,2,47
Minnesota,Federal Dam,94,9,23,21,8,2,63
Minnesota,Felton,150,7,66,33,17,1,124
Minnesota,Fergus Falls,13266,816,2152,3332,2143,806,9249
Minnesota,Erhard,117,15,45,25,10,0,95
Minnesota,Emmons,413,16,103,123,27,12,281
Minnesota,Emily,746,55,187,212,124,41,619
Minnesota,Elysian,604,60,135,125,81,21,422
Minnesota,Ely,3445,160,613,1002,533,148,2456
Minnesota,Faribault,23509,2471,5611,4819,1982,1009,15892
Minnesota,Elrosa,174,31,44,48,6,0,129
Minnesota,Elmdale,84,17,26,19,0,0,62
Minnesota,Ellsworth,470,67,105,124,37,10,343
Minnesota,Ellendale,685,65,179,127,81,11,463
Minnesota,Elkton,111,3,25,36,0,5,69
Minnesota,Elk River,23563,734,3821,5777,3508,1368,15208
Minnesota,Elko New Market,4529,21,423,910,875,434,2663
Minnesota,Elizabeth,172,7,35,62,7,2,113
Minnesota,Elgin,1184,45,258,252,123,44,722
Minnesota,Elbow Lake,1191,74,211,381,89,40,795
Minnesota,Elbow Lake,113,12,14,59,4,0,89
Minnesota,Elmore,614,65,206,104,39,3,417
Minnesota,Eitzen,229,16,71,51,19,7,164
Minnesota,Falcon Heights,5484,51,557,516,1169,1356,3649
Minnesota,Fairhaven,356,16,113,89,14,18,250
Minnesota,Maple Grove,65687,1195,7804,13496,15300,7513,45308
Minnesota,Maple Lake,2103,105,496,492,143,50,1286
Minnesota,Maple Plain,1851,75,358,454,312,89,1288
Minnesota,Mapleton,1759,87,417,441,138,49,1132
Minnesota,Mapleview,209,34,43,49,4,1,131
Minnesota,Maplewood,39775,2565,7888,9051,5392,2719,27615
Minnesota,Marble,567,27,217,142,28,9,423
Minnesota,Marietta,139,13,49,37,14,0,113
Minnesota,Marine on St. Croix,722,12,55,184,192,101,544
Minnesota,Marshall,13608,680,2671,2399,1705,761,8216
Minnesota,Fairmont,10387,1084,3010,1914,1258,269,7535
Minnesota,Martin Lake,1013,10,200,340,125,0,675
Minnesota,La Prairie,791,48,138,216,64,38,504
Minnesota,Laporte,178,17,37,32,6,6,98
Minnesota,Erskine,511,60,145,114,15,11,345
Minnesota,Esko,1638,18,284,344,340,128,1114
Minnesota,Evan,51,9,23,5,4,3,44
Minnesota,Evansville,603,37,172,189,37,4,439
Minnesota,Eveleth,3692,201,920,854,488,47,2510
Minnesota,Excelsior,2146,48,309,581,472,216,1626
Minnesota,Eyota,2092,66,391,536,244,105,1342
Minnesota,Fairfax,955,161,271,214,58,24,728
Minnesota,Mayer,1754,34,240,439,280,64,1057
Minnesota,Ulen,550,46,170,137,48,16,417
Minnesota,Taylors Falls,1019,25,241,274,85,68,693
Minnesota,The Lakes,687,40,179,186,106,50,561
Minnesota,Comfrey,359,23,71,93,40,18,245
Minnesota,Shafer,991,47,217,253,59,39,615
Minnesota,Shakopee,39137,1798,6010,7496,6535,2635,24474
Minnesota,Shelly,199,12,54,50,11,1,128
Minnesota,Sherburn,1027,58,299,242,94,20,713
Minnesota,Shevlin,177,5,40,56,3,0,104
Minnesota,Shoreview,25951,704,3206,4673,6503,3934,19020
Minnesota,Shorewood,7509,72,504,1285,2087,1060,5008
Minnesota,Silver Bay,1745,85,590,412,227,51,1365
Minnesota,Silver Creek,267,31,65,60,31,4,191
Minnesota,Silver Lake,964,28,285,201,52,20,586
Minnesota,Skyline,340,10,82,51,68,49,260
Minnesota,Slayton,2070,227,494,472,229,100,1522
Minnesota,Sleepy Eye,3498,315,847,658,302,121,2243
Minnesota,Sobieski,185,17,58,34,12,2,123
Minnesota,Solway,115,21,21,25,6,5,78
Minnesota,Soudan,435,8,61,183,83,4,339
Minnesota,South End,21,6,3,2,0,0,11
Minnesota,South Haven,236,9,65,28,9,4,115
Minnesota,South St. Paul,20413,1234,3819,5400,2553,756,13762
Minnesota,Spicer,1294,49,283,309,157,68,866
Minnesota,Beaulieu,54,5,27,7,6,0,45
Minnesota,Beaver Bay,126,5,44,22,15,14,100
Minnesota,La Salle,48,1,17,8,5,1,32
Minnesota,Becker,4647,266,611,1258,646,148,2929
Minnesota,Biwabik,933,36,248,316,81,25,706
Minnesota,Biscay,68,8,25,19,5,0,57
Minnesota,Bird Island,849,81,254,221,59,48,663
Minnesota,Birchwood Village,867,25,75,167,241,182,690
Minnesota,Bingham Lake,123,17,29,29,2,2,79
Minnesota,Big Lake,10285,545,1672,2493,966,401,6077
Minnesota,Big Lake,382,21,62,127,51,26,287
Minnesota,Bigfork,412,57,132,139,13,7,348
Minnesota,Big Falls,228,35,77,64,12,6,194
Minnesota,Bigelow,224,46,54,38,10,2,150
Minnesota,Springfield,2039,220,498,536,154,48,1456
Minnesota,Bethel,423,26,83,111,29,5,254
Minnesota,Benson,3139,343,862,734,288,104,2331
Minnesota,Bena,141,13,30,32,1,1,77
Minnesota,Bemidji,14417,698,1619,3246,1801,673,8037
Minnesota,Belview,412,47,129,89,18,6,289
Minnesota,Beltrami,120,3,28,53,13,0,97
Minnesota,Bellingham,144,8,55,32,8,4,107
Minnesota,Belle Plaine,6838,271,1495,1494,981,214,4455
Minnesota,Bellechester,217,8,62,45,13,2,130
Minnesota,Belgrade,714,44,171,204,40,15,474
Minnesota,Bejou,97,13,25,21,1,2,62
Minnesota,Bertha,512,29,123,136,39,16,343
Minnesota,Spring Grove,1241,145,341,331,106,24,947
Minnesota,Spring Hill,50,11,16,13,0,2,42
Minnesota,Spring Lake Park,6504,445,1542,1685,675,307,4654
Minnesota,Courtland,714,22,158,175,104,36,495
Minnesota,Cromwell,246,23,72,67,14,3,179
Minnesota,Crookston,7847,532,1383,1674,707,420,4716
Minnesota,Crosby,2324,258,673,556,94,79,1660
Minnesota,Crosslake,2030,20,502,653,395,148,1718
Minnesota,Crystal,22607,1275,4500,5615,3776,1212,16378
Minnesota,Sunburg,82,10,36,20,4,0,70
Minnesota,Currie,209,26,84,42,11,4,167
Minnesota,Cuyuna,283,23,67,78,8,15,191
Minnesota,Tonka Bay,1481,8,132,226,404,255,1025
Minnesota,Cottonwood,1257,61,331,184,156,73,805
Minnesota,Tower,620,8,119,273,35,9,444
Minnesota,Trail,69,5,16,18,4,0,43
Minnesota,Trimont,755,67,175,189,67,20,518
Minnesota,Trommald,92,11,24,27,6,0,68
Minnesota,Trosky,102,11,7,32,14,0,64
Minnesota,Truman,1145,87,328,255,108,17,795
Minnesota,Turtle River,107,3,17,33,17,9,79
Minnesota,Twin Lakes,176,18,51,35,8,1,113
Minnesota,Twin Lakes,176,11,24,55,21,7,118
Minnesota,Twin Valley,752,80,190,198,30,11,509
Minnesota,Two Harbors,3643,140,968,920,268,121,2417
Minnesota,Tracy,2110,147,542,501,185,34,1409
Minnesota,Blackduck,812,39,197,230,27,15,508
Minnesota,Cottage Grove,35405,1059,6080,8472,5084,1984,22679
Minnesota,Correll,22,2,10,6,0,0,18
Minnesota,Spring Park,1731,102,399,481,352,143,1477
Minnesota,Spring Valley,2555,165,708,622,153,56,1704
Minnesota,Squaw Lake,111,17,16,16,10,2,61
Minnesota,Stacy,1517,120,425,327,128,21,1021
Minnesota,Stanchfield,104,15,9,41,9,0,74
Minnesota,Staples,2848,206,569,654,277,99,1805
Minnesota,Starbuck,1197,63,355,344,111,35,908
Minnesota,Steen,226,14,46,48,8,2,118
Minnesota,Stephen,788,118,188,152,69,25,552
Minnesota,Stewart,518,36,184,122,22,2,366
Minnesota,Cosmos,494,36,153,176,14,0,379
Minnesota,Stewartville,6006,260,953,1745,695,244,3897
Minnesota,Stockton,690,33,169,145,45,30,422
Minnesota,Storden,248,11,76,58,25,7,177
Minnesota,Strandquist,90,10,29,11,3,0,53
Minnesota,Strathcona,30,6,23,0,1,0,30
Minnesota,Sturgeon Lake,441,24,125,99,17,10,275
Minnesota,Comstock,124,7,24,32,15,11,89
Minnesota,Conger,176,4,37,49,17,0,107
Minnesota,Cook,606,39,213,152,35,14,453
Minnesota,Coon Rapids,61946,2931,12147,16663,8053,3040,42834
Minnesota,Corcoran,5521,282,1010,1261,841,369,3763
Minnesota,Stillwater,18677,376,2532,4050,3815,1875,12648
Minnesota,Tenstrike,187,4,41,56,19,11,131
Minnesota,Blaine,60224,2208,9985,14638,9172,4157,40160
Minnesota,Blooming Prairie,1897,123,499,374,166,70,1232
Minnesota,Chokio,379,18,88,80,61,8,255
Minnesota,Circle Pines,4931,213,829,1311,827,374,3554
Minnesota,Clara City,1381,114,371,366,118,13,982
Minnesota,Claremont,551,62,187,93,9,3,354
Minnesota,Clarissa,834,91,270,148,37,19,565
Minnesota,Clarkfield,824,61,219,179,63,19,541
Minnesota,Clarks Grove,606,64,189,163,9,0,425
Minnesota,Clearbrook,503,33,136,121,26,13,329
Minnesota,Clear Lake,581,22,90,168,79,13,372
Minnesota,Clearwater,1783,63,307,515,223,54,1162
Minnesota,Clements,185,38,46,26,2,2,114
Minnesota,Cleveland,635,25,198,171,43,9,446
Minnesota,Climax,290,13,68,76,29,8,194
Minnesota,Clinton,364,37,122,81,21,12,273
Minnesota,Clitherall,76,26,26,8,4,0,64
Minnesota,Clontarf,125,9,48,24,9,0,90
Minnesota,Cloquet,12071,445,2754,2483,1537,556,7775
Minnesota,Coates,139,9,47,26,18,4,104
Minnesota,Cobden,23,7,6,4,2,0,19
Minnesota,Cohasset,2737,114,511,752,451,169,1997
Minnesota,Cokato,2724,110,671,623,231,114,1749
Minnesota,Chisholm,5006,175,1048,1349,604,81,3257
Minnesota,Chisago City,4930,298,1293,1272,588,266,3717
Minnesota,Chickamaw Beach,128,6,30,52,9,11,108
Minnesota,Chatfield,2935,160,546,697,319,188,1910
Minnesota,The Ranch,1,1,0,0,0,0,1
Minnesota,Thief River Falls,8711,538,2211,2363,665,192,5969
Minnesota,Tintah,49,0,19,13,2,0,34
Minnesota,Callaway,207,22,48,47,9,3,129
Minnesota,Delano,5671,186,1039,855,996,302,3378
Minnesota,Cambridge,8300,785,1844,1978,706,274,5587
Minnesota,Campbell,188,4,33,64,16,8,125
Minnesota,Canby,1696,201,461,434,137,39,1272
Minnesota,Cannon Falls,4075,185,993,985,457,123,2743
Minnesota,Canton,295,41,93,83,12,3,232
Minnesota,Cold Spring,4034,246,853,733,538,157,2527
Minnesota,Carlos,506,21,132,148,39,7,347
Minnesota,Carver,4136,73,356,639,871,467,2406
Minnesota,Cass Lake,586,51,113,177,38,2,381
Minnesota,Cedar Mills,47,9,11,9,6,4,39
Minnesota,Center City,679,16,144,194,80,39,473
Minnesota,Centerville,3865,113,466,892,603,249,2323
Minnesota,Ceylon,322,24,82,94,20,4,224
Minnesota,Champlin,23731,578,3407,5930,4122,1459,15496
Minnesota,Chandler,313,68,65,42,27,11,213
Minnesota,Chanhassen,24437,599,1924,3703,6503,3020,15749
Minnesota,Chaska,24524,997,3451,4862,4601,1888,15799
Minnesota,Carlton,1025,78,316,220,107,41,762
Minnesota,Coleraine,1881,77,307,566,247,66,1263
Minnesota,Cologne,1631,68,255,361,206,80,970
Minnesota,Columbia Heights,19632,1869,4144,4695,1903,914,13525
Minnesota,Brooten,644,50,185,115,70,20,440
Minnesota,Brookston,140,39,43,22,4,1,109
Minnesota,Brooks,120,34,40,22,2,0,98
Minnesota,Brook Park,102,3,41,16,0,4,64
Minnesota,Brooklyn Park,78195,4803,12352,17727,10403,3612,48897
Minnesota,Brooklyn Center,30684,3517,6027,6206,2754,1157,19661
Minnesota,Bricelyn,315,29,93,62,24,10,218
Minnesota,Brewster,461,40,90,119,31,7,287
Minnesota,Breezy Point,2197,37,345,639,353,75,1449
Minnesota,Breckenridge,3360,261,674,1018,266,108,2327
Minnesota,Browerville,742,55,160,150,84,59,508
Minnesota,Brandon,496,32,148,148,33,9,370
Minnesota,Braham,1944,161,478,408,102,29,1178
Minnesota,Boy River,31,2,12,11,0,0,25
Minnesota,Boyd,109,22,33,28,6,0,89
Minnesota,Bowlus,345,32,100,72,16,0,220
Minnesota,Bovey,830,58,140,286,77,2,563
Minnesota,Borup,83,2,38,25,5,0,70
Minnesota,Bock,89,20,37,8,4,0,69
Minnesota,Bluffton,223,10,77,32,7,5,131
Minnesota,Blue Earth,3279,202,1018,737,259,152,2368
Minnesota,Bloomington,85826,4343,13431,19937,17091,8282,63084
Minnesota,Brainerd,13462,703,2721,3487,1008,463,8382
Minnesota,Blomkest,98,12,28,33,5,3,81
Minnesota,Brownsdale,782,47,243,195,73,24,582
Minnesota,Brownsville,473,16,173,126,27,10,352
Minnesota,Columbus,3967,154,907,1122,479,220,2882
Minnesota,Glenville,586,34,206,140,37,10,427
Minnesota,Glenwood,2536,86,683,592,347,112,1820
Minnesota,Glyndon,1446,48,312,327,153,20,860
Minnesota,Golden Valley,20866,507,2489,4233,5044,3472,15745
Minnesota,Gonvick,220,28,63,53,7,4,155
Minnesota,Goodhue,1253,34,263,307,94,47,745
Minnesota,Goodridge,129,15,40,20,11,2,88
Minnesota,Good Thunder,518,26,156,134,55,21,392
Minnesota,Goodview,4052,156,807,1117,560,128,2768
Minnesota,Browns Valley,518,45,174,146,40,13,418
Minnesota,Graceville,607,51,228,130,43,15,467
Minnesota,Byron,5105,52,522,1310,736,335,2955
Minnesota,Butterfield,633,132,162,96,27,5,422
Minnesota,Burtrum,128,15,42,28,5,0,90
Minnesota,Burnsville,61255,2551,9540,14190,10707,4647,41635
Minnesota,Buhl,1144,57,352,312,63,28,812
Minnesota,Buffalo Lake,723,93,190,109,68,7,467
Minnesota,Buffalo,15825,688,2885,4100,1850,636,10159
Minnesota,Buckman,234,7,61,53,10,3,134
Minnesota,Bruno,89,4,35,18,4,0,61
Minnesota,Brownton,797,62,228,199,49,17,555
Minnesota,Caledonia,2806,167,795,765,196,70,1993
Minnesota,Calumet,425,22,98,143,13,0,276
Minnesota,Swanville,328,44,86,70,20,2,222
Minnesota,Hazel Run,24,4,12,7,1,0,24
Minnesota,Hayfield,1336,39,425,259,86,37,846
Minnesota,Hawley,1905,87,392,379,250,87,1195
Minnesota,Hatfield,39,2,15,13,0,0,30
Minnesota,Hastings,22423,912,4982,5437,3027,1264,15622
Minnesota,Hartland,343,26,80,90,20,16,232
Minnesota,Harris,997,57,263,295,88,7,710
Minnesota,Hayward,269,34,89,79,12,6,220
Minnesota,Harmony,1013,105,294,271,116,31,817
Minnesota,Harding,152,21,43,33,2,6,105
Minnesota,Hanska,378,25,149,79,26,9,288
Minnesota,Hanover,3006,0,379,747,690,184,2000
Minnesota,Hanley Falls,398,32,82,78,18,7,217
Minnesota,Hancock,835,50,128,192,108,29,507
Minnesota,Hampton,742,24,154,170,57,17,422
Minnesota,Hardwick,184,19,54,39,8,3,123
Minnesota,Nassau,49,4,15,10,3,0,32
Minnesota,Hector,1042,78,249,312,67,25,731
Minnesota,Heidelberg,130,6,35,20,18,3,82
Minnesota,Hinckley,1688,91,521,346,101,37,1096
Minnesota,Hilltop,847,185,255,145,24,11,620
Minnesota,Hills,741,68,216,140,45,7,476
Minnesota,Hillman,26,2,4,7,0,0,13
Minnesota,Hill City,554,46,106,165,27,19,363
Minnesota,Hibbing,16284,1103,3360,4741,1254,656,11114
Minnesota,Hewitt,248,12,70,64,15,1,162
Minnesota,Heron Lake,610,41,139,152,64,8,404
Minnesota,Hermantown,9627,411,2363,1897,1625,685,6981
Minnesota,Herman,371,20,132,109,26,14,301
Minnesota,Henriette,68,9,28,15,0,2,54
Minnesota,Henning,857,77,236,240,55,18,626
Minnesota,Hendrum,352,20,102,73,26,4,225
Minnesota,Hendricks,667,49,243,160,69,4,525
Minnesota,Henderson,842,53,258,181,57,26,575
Minnesota,Hammond,80,8,35,13,2,0,58
Minnesota,Ham Lake,15714,474,3001,3533,2510,902,10420
Minnesota,Hamburg,471,19,149,138,40,9,355
Minnesota,Halstad,611,101,114,141,54,10,420
Minnesota,Granada,299,17,87,76,8,0,188
Minnesota,Naytahwaush,505,56,90,63,5,2,216
Minnesota,Nelson,159,6,44,52,15,2,119
Minnesota,Nerstrand,269,8,68,84,26,7,193
Minnesota,Nett Lake,355,49,87,80,15,4,235
Minnesota,Nevis,415,23,93,115,32,14,277
Minnesota,New Auburn,500,38,156,120,23,2,339
Minnesota,New Brighton,22080,933,3025,4379,4464,2469,15270
Minnesota,Newfolden,368,19,73,87,32,12,223
Minnesota,New Germany,392,19,116,75,24,12,246
Minnesota,New Hope,20775,1492,3554,4603,3521,1254,14424
Minnesota,New London,1317,101,273,323,164,55,916
Minnesota,New Munich,363,41,137,60,14,0,252
Minnesota,Newport,3470,166,991,822,297,127,2403
Minnesota,New Prague,7500,359,1231,1411,1038,491,4530
Minnesota,Grand Marais,1039,35,284,213,176,111,819
Minnesota,Hitterdal,184,10,64,41,12,4,131
Minnesota,Grand Meadow,1170,97,262,299,60,9,727
Minnesota,Granite Falls,2471,175,776,636,173,84,1844
Minnesota,Halma,50,14,9,11,2,5,41
Minnesota,Hallock,1026,52,261,271,160,40,784
Minnesota,Hadley,43,4,14,9,4,0,31
Minnesota,Hackensack,360,29,64,90,22,5,210
Minnesota,Gully,101,2,29,24,4,3,62
Minnesota,Grygla,187,6,51,40,26,6,129
Minnesota,Grove City,624,29,169,127,20,25,370
Minnesota,Grey Eagle,349,40,97,72,29,5,243
Minnesota,Greenwood,790,4,52,141,305,129,631
Minnesota,Greenwald,242,13,102,62,6,2,185
Minnesota,Green Isle,555,25,134,133,31,13,336
Minnesota,Greenfield,2863,57,429,592,633,200,1911
Minnesota,Greenbush,819,44,190,213,55,3,505
Minnesota,Grasston,223,17,66,41,0,14,138
Minnesota,Grant,4126,80,636,985,791,438,2930
Minnesota,Grand Rapids,10996,495,2469,2739,1249,596,7548
Minnesota,Hoffman,710,60,166,167,73,23,489
Minnesota,Hokah,551,26,153,150,40,11,380
Minnesota,Nashwauk,869,60,239,265,51,8,623
Minnesota,Mendota,230,4,47,57,30,11,149
Minnesota,Menahga,1346,162,471,262,42,27,964
Minnesota,Melrose,3604,504,742,786,284,124,2440
Minnesota,Meire Grove,212,23,60,39,14,0,136
Minnesota,Medina,5378,40,453,772,1512,706,3483
Minnesota,Medicine Lake,345,2,25,65,93,77,262
Minnesota,Medford,1401,54,235,342,129,35,795
Minnesota,Meadowlands,84,17,31,9,0,2,59
Minnesota,Mazeppa,835,54,218,163,60,34,529
Minnesota,Maynard,347,27,140,57,14,7,245
Minnesota,Preston,1423,64,365,322,145,79,975
Minnesota,Princeton,4728,373,1382,995,279,212,3241
Minnesota,Prinsburg,496,31,83,134,54,22,324
Minnesota,Prior Lake,24402,688,2925,5554,5030,1564,15761
Minnesota,Proctor,3060,129,850,725,427,107,2238
Minnesota,Mendota Heights,11172,225,1051,1810,2875,2295,8256
Minnesota,Quamba,131,14,33,23,5,3,78
Minnesota,Mentor,191,34,50,43,6,0,133
Minnesota,Middle River,289,17,79,64,30,4,194
Minnesota,Minnetonka Beach,570,1,16,53,167,122,359
Minnesota,Minnetonka,51249,964,5132,10344,13437,8211,38088
Minnesota,Minnesota Lake,620,42,189,186,52,8,477
Minnesota,Minnesota City,217,4,49,55,12,2,122
Minnesota,Minneota,1407,128,364,288,166,45,991
Minnesota,Minneiska,98,2,19,40,19,8,88
Minnesota,Minneapolis,399950,30100,43760,64961,76310,48766,263897
Minnesota,Miltona,372,25,81,94,11,6,217
Minnesota,Milroy,231,14,59,64,11,8,156
Minnesota,Millville,131,11,50,34,1,2,98
Minnesota,Millerville,95,7,28,21,8,2,66
Minnesota,Milan,362,51,69,63,16,11,210
Minnesota,Milaca,2895,290,687,749,165,79,1970
Minnesota,Miesville,147,6,42,42,11,0,101
Minnesota,Midway,12,0,2,4,0,0,6
Minnesota,Merrifield,94,4,19,36,23,7,89
Minnesota,New Richland,1174,141,304,254,95,18,812
Minnesota,Racine,440,16,108,121,35,5,285
Minnesota,Randall,662,47,181,133,45,24,430
Minnesota,Moorhead,40935,1389,5767,7918,5986,2346,23406
Minnesota,Moose Lake,2763,142,1069,843,219,47,2320
Minnesota,Mora,3507,359,839,837,211,219,2465
Minnesota,Morgan,916,61,240,195,66,19,581
Minnesota,Morris,5349,335,658,955,613,335,2896
Minnesota,Morristown,950,117,297,204,37,9,664
Minnesota,Morton,341,26,111,95,12,5,249
Minnesota,Motley,688,65,182,147,43,2,439
Minnesota,Mound,9249,227,1684,2265,2003,620,6799
Minnesota,Mounds View,12584,697,2220,2937,1693,798,8345
Minnesota,Mountain Iron,2873,164,527,864,334,151,2040
Minnesota,Mountain Lake,2076,213,448,405,195,26,1287
Minnesota,Murdock,312,23,75,74,14,2,188
Minnesota,Myrtle,54,4,16,9,0,0,29
Minnesota,Nashua,29,2,9,3,2,0,16
Minnesota,Montrose,2999,128,459,846,287,43,1763
Minnesota,Ramsey,24846,580,4225,6633,3304,1216,15958
Minnesota,Monticello,13065,497,2415,3046,1697,550,8205
Minnesota,Montevideo,5240,476,1157,1426,416,168,3643
Minnesota,Randolph,432,20,109,106,35,11,281
Minnesota,Ranier,521,14,155,166,63,26,424
Minnesota,Raymond,695,33,157,191,68,10,459
Minnesota,Redby,1578,118,262,218,60,0,658
Minnesota,Red Lake,1508,187,186,326,30,0,729
Minnesota,Red Lake Falls,1229,62,363,289,101,44,859
Minnesota,Red Wing,16484,885,3837,4284,1913,763,11682
Minnesota,Redwood Falls,5128,445,1293,1202,465,225,3630
Minnesota,Regal,46,0,22,12,2,1,37
Minnesota,Remer,391,47,91,116,15,13,282
Minnesota,Renville,1487,144,321,270,143,16,894
Minnesota,Revere,100,16,39,18,6,0,79
Minnesota,Rice,1491,47,240,469,142,50,948
Minnesota,Rice Lake,299,52,40,54,1,0,147
Minnesota,Richfield,36059,2894,5755,7981,6158,2919,25707
Minnesota,Montgomery,2934,302,603,771,190,48,1914
Minnesota,Minnetrista,6810,189,848,1062,1514,872,4485
Minnesota,Mizpah,99,3,35,15,5,0,58
Minnesota,Pine Bend,20,10,0,5,0,0,15
Minnesota,Paynesville,2423,305,614,560,255,64,1798
Minnesota,Park Rapids,3907,253,1064,993,329,139,2778
Minnesota,Parkers Prairie,1035,94,269,198,70,12,643
Minnesota,Palisade,168,19,73,53,2,0,147
Minnesota,Owatonna,25552,1327,5691,5089,3513,1327,16947
Minnesota,Ottertail,436,20,131,148,58,26,383
Minnesota,Otsego,14634,678,2068,3905,1982,640,9273
Minnesota,Ostrander,207,23,76,71,3,4,177
Minnesota,Osseo,2555,105,615,772,319,134,1945
Minnesota,Oslo,227,19,89,39,13,0,160
Minnesota,Osakis,1669,84,403,446,155,53,1141
Minnesota,Osage,247,15,83,71,12,15,196
Minnesota,Ortonville,2020,169,562,431,225,82,1469
Minnesota,Orr,256,6,57,81,19,7,170
Minnesota,Oronoco,1522,21,170,296,283,158,928
Minnesota,Pease,276,19,69,63,7,2,160
Minnesota,Pelican Rapids,2510,468,530,434,147,36,1615
Minnesota,Pemberton,297,14,75,85,17,1,192
Minnesota,Pennock,631,42,80,176,16,11,325
Minnesota,Peterson,192,14,56,55,9,14,148
Minnesota,Pine City,3093,348,1019,672,178,175,2392
Minnesota,Pine Island,3375,149,539,816,480,225,2209
Minnesota,Pine Point,245,17,57,41,3,3,121
Minnesota,Pine River,713,103,244,121,48,11,527
Minnesota,Pine Springs,407,0,40,59,128,60,287
Minnesota,Pipestone,4186,446,956,897,382,161,2842
Minnesota,Orono,7795,47,815,1227,2200,1306,5595
Minnesota,Plainview,3269,71,818,755,326,102,2072
Minnesota,Plummer,436,12,79,117,37,10,255
Minnesota,Plymouth,73896,1409,7032,13989,19309,11086,52825
Minnesota,Ponemah,791,101,216,17,22,0,356
Minnesota,Porter,183,13,51,49,15,1,129
Minnesota,Perley,92,29,13,23,5,0,70
Minnesota,Perham,3106,269,704,791,324,122,2210
Minnesota,Pequot Lakes,2445,125,558,548,257,107,1595
Minnesota,Plato,313,16,80,98,33,8,235
Minnesota,Pillager,450,39,84,114,43,7,287
Minnesota,Ormsby,118,5,50,30,2,1,88
Minnesota,Holland,183,16,57,34,9,11,127
Minnesota,Northrop,276,6,71,79,10,0,166
Minnesota,Northome,229,22,52,69,12,11,166
Minnesota,North Oaks,4715,32,317,647,1305,1244,3545
Minnesota,North Mankato,13438,375,2133,3477,2472,1009,9466
Minnesota,Northfield,20309,574,2131,2715,2814,2147,10381
Minnesota,North Branch,10104,341,2350,2419,921,392,6423
Minnesota,Norcross,46,8,11,11,7,0,37
Minnesota,Nisswa,2068,38,440,505,378,215,1576
Minnesota,Nimrod,89,4,28,34,0,0,66
Minnesota,Nielsville,106,1,38,27,2,4,72
Minnesota,Nicollet,1136,36,316,311,118,19,800
Minnesota,New York Mills,1383,102,283,321,109,52,867
Minnesota,New Ulm,13287,735,3151,2776,1601,733,8996
Minnesota,New Trier,142,5,40,28,11,1,85
Minnesota,Sunfish Lake,518,0,38,69,138,129,374
Minnesota,North St. Paul,11966,747,2897,2842,1371,482,8339
Minnesota,Norwood Young America,3630,166,763,895,380,111,2315
Minnesota,Nowthen,4522,187,805,1217,482,162,2853
Minnesota,Oakdale,27850,1068,4768,6925,4203,1680,18644
Minnesota,Hollandale,297,15,51,87,21,2,176
Minnesota,Holloway,95,10,38,28,3,1,80
Minnesota,Holt,111,6,38,21,4,3,72
Minnesota,Homer,155,10,24,51,28,15,128
Minnesota,Hopkins,17992,1034,2573,3521,3695,1254,12077
Minnesota,Houston,1074,82,275,198,107,52,714
Minnesota,Onamia,905,107,243,203,66,29,648
Minnesota,Holdingford,593,17,197,134,41,12,401
Minnesota,Olivia,2327,155,615,566,255,108,1699
Minnesota,Okabena,170,10,33,63,17,6,129
Minnesota,Ogilvie,427,51,118,74,16,1,260
Minnesota,Ogema,182,11,36,35,13,2,97
Minnesota,Odin,109,0,30,41,9,2,82
Minnesota,Odessa,157,9,54,34,7,1,105
Minnesota,Oak Park Heights,4737,193,1018,1284,895,360,3750
Minnesota,Oak Grove,8215,415,1987,2017,873,302,5594
Minnesota,Oklee,463,37,156,92,17,4,306
Minnesota,Pierz,1429,151,390,334,68,35,978
Mississippi,Anguilla,542,64,59,154,53,15,345
Mississippi,Bassfield,272,14,41,55,31,18,159
Mississippi,Mize,305,49,56,53,8,16,182
Mississippi,Monticello,1559,127,358,309,98,70,962
Mississippi,Mooreville,822,33,142,255,35,63,528
Mississippi,Moorhead,1975,325,303,412,58,18,1116
Mississippi,Morgan City,264,16,60,35,9,6,126
Mississippi,Morgantown,1502,183,352,259,62,55,911
Mississippi,Morton,3456,576,789,467,127,68,2027
Mississippi,Moss Point,13685,1397,3887,2977,954,491,9706
Mississippi,Mound Bayou,1863,164,236,296,117,110,923
Mississippi,Mount Olive,981,84,163,140,74,103,564
Mississippi,Myrtle,493,59,106,75,48,10,298
Mississippi,Natchez,15474,1649,3183,3236,1447,1023,10538
Mississippi,Nellieburg,1317,139,455,282,44,103,1023
Mississippi,Nettleton,1665,301,503,326,80,51,1261
Mississippi,New Albany,8466,1078,1703,1821,624,426,5652
Mississippi,New Augusta,835,66,200,172,34,11,483
Mississippi,New Hamilton,457,32,141,83,33,27,316
Mississippi,Baldwyn,3139,488,730,679,190,74,2161
Mississippi,Ashland,524,108,109,133,33,11,394
Mississippi,Artesia,380,86,88,64,11,1,250
Mississippi,Arnold Line,2609,69,457,261,527,499,1813
Mississippi,Arcola,274,53,51,54,14,4,176
Mississippi,Bay St. Louis,10861,848,2241,2464,1428,608,7589
Mississippi,Batesville,7413,666,1137,1252,970,325,4350
Mississippi,Amory,7151,1216,1341,1389,655,260,4861
Mississippi,Algoma,677,96,150,131,46,16,439
Mississippi,Alcorn State University,774,15,99,9,27,63,213
Mississippi,Ackerman,1861,233,367,392,156,75,1223
Mississippi,Aberdeen,5466,965,1221,919,440,223,3768
Mississippi,Abbeville,447,61,117,69,35,23,305
Mississippi,New Hebron,526,17,117,132,53,11,330
Mississippi,Alligator,328,43,82,32,7,0,164
Mississippi,Bay Springs,1738,278,397,388,104,63,1230
Mississippi,Union,1826,345,319,376,135,47,1222
Mississippi,Beauregard,328,49,75,67,10,9,210
Mississippi,Waynesboro,4974,840,1013,825,331,88,3097
Mississippi,Waveland,6449,794,1584,1321,338,122,4159
Mississippi,Water Valley,3344,496,920,550,78,140,2184
Mississippi,Walthall,133,16,17,20,10,6,69
Mississippi,Walnut Grove,913,112,174,108,18,6,418
Mississippi,Walnut,827,133,256,128,29,28,574
Mississippi,Walls,1247,85,232,275,50,22,664
Mississippi,Wade,887,167,196,172,44,19,598
Mississippi,Vicksburg,23439,2343,4635,4499,2015,1274,14766
Mississippi,Verona,3062,553,667,608,29,69,1926
Mississippi,Vardaman,1316,264,199,216,60,14,753
Mississippi,Vancleave,5783,433,1214,1311,334,87,3379
Mississippi,Vaiden,802,133,293,87,33,40,586
Mississippi,Utica,830,107,93,241,47,16,504
Mississippi,University,4619,64,9,5,0,0,78
Mississippi,Webb,250,52,47,66,15,5,185
Mississippi,Beaumont,1110,173,275,185,27,18,678
Mississippi,Weir,507,61,103,85,46,13,308
Mississippi,West,177,39,14,27,24,8,112
Mississippi,Tylertown,1641,252,323,274,164,80,1093
Mississippi,Beechwood,4528,296,787,980,251,363,2677
Mississippi,Belmont,2119,193,525,375,80,24,1197
Mississippi,Belzoni,2325,505,436,306,84,98,1429
Mississippi,Benoit,462,125,75,60,35,17,312
Mississippi,Bentonia,521,77,84,110,57,6,334
Mississippi,Beulah,359,46,57,88,15,6,212
Mississippi,Big Creek,265,66,45,24,0,0,135
Mississippi,Big Point,841,102,127,206,76,16,527
Mississippi,Winstonville,223,45,47,60,17,4,173
Mississippi,Winona,4704,963,756,569,310,201,2799
Mississippi,Wiggins,4487,654,1048,854,212,121,2889
Mississippi,White Oak,660,156,135,40,9,0,340
Mississippi,West Point,11122,1660,2298,2089,947,375,7369
Mississippi,West Hattiesburg,6674,293,738,1495,776,387,3689
Mississippi,Wesson,2134,166,331,342,131,89,1059
Mississippi,Tutwiler,3516,836,722,577,153,198,2486
Mississippi,Isola,1003,226,146,145,38,36,591
Mississippi,Tunica Resorts,1514,62,251,374,215,88,990
Mississippi,Columbus,23360,2994,4361,4700,2064,1329,15448
Mississippi,Columbia,6367,990,1225,1213,401,206,4035
Mississippi,Collinsville,1663,80,338,449,148,178,1193
Mississippi,Collins,2557,383,496,468,304,81,1732
Mississippi,Coldwater,1251,231,254,286,75,54,900
Mississippi,Coffeeville,1044,178,218,168,80,30,674
Mississippi,Coahoma,390,81,59,88,13,9,250
Mississippi,Cloverdale,772,127,220,177,16,24,564
Mississippi,Clinton,25475,1270,2912,5518,3614,3024,16338
Mississippi,Cleveland,12339,1290,1808,2155,1541,805,7599
Mississippi,Cleary,1090,76,292,371,134,36,909
Mississippi,Clarksdale,17314,2134,3116,3084,1435,524,10293
Mississippi,Clara,589,99,76,27,122,51,375
Mississippi,Chunky,406,46,86,110,22,6,270
Mississippi,Charleston,1164,237,242,238,46,52,815
Mississippi,Centreville,1765,258,482,216,86,99,1141
Mississippi,Cary,348,75,84,57,12,2,230
Mississippi,Carthage,4966,763,951,706,216,115,2751
Mississippi,Carrollton,146,7,40,14,16,29,106
Mississippi,Canton,13413,2405,1948,2074,1375,714,8516
Mississippi,Calhoun City,1850,277,463,279,84,105,1208
Mississippi,Caledonia,1332,148,212,338,100,43,841
Mississippi,Byram,11592,460,1925,2753,1265,840,7243
Mississippi,Columbus AFB,1443,24,73,162,259,202,720
Mississippi,Como,1374,328,320,173,92,28,941
Mississippi,Conehatta,1124,194,151,206,0,0,551
Mississippi,Corinth,14839,1973,3227,2625,1260,935,10020
Mississippi,Durant,2978,433,534,458,150,31,1606
Mississippi,Duncan,435,146,42,76,17,10,291
Mississippi,Dumas,470,67,133,83,21,25,329
Mississippi,Duck Hill,1000,201,191,179,48,15,634
Mississippi,Drew,1941,336,291,359,88,19,1093
Mississippi,Doddsville,339,19,25,88,1,2,135
Mississippi,D'Lo,432,51,144,98,22,22,337
Mississippi,D'Iberville,10532,861,2115,2434,702,552,6664
Mississippi,Diamondhead,8246,169,1239,2129,1469,1080,6086
Mississippi,Derma,1056,246,269,115,13,15,658
Mississippi,DeLisle,1121,245,124,160,127,109,765
Mississippi,Byhalia,1358,167,344,230,74,18,833
Mississippi,De Kalb,1082,150,245,199,82,46,722
Mississippi,Darling,284,42,113,10,3,0,168
Mississippi,Crystal Springs,4970,819,945,930,430,150,3274
Mississippi,Cruger,336,51,89,44,26,9,219
Mississippi,Crowder,701,193,154,107,17,0,471
Mississippi,Crosby,413,110,100,30,1,3,244
Mississippi,Crenshaw,975,234,239,99,48,23,643
Mississippi,Crawford,569,92,142,65,23,16,338
Mississippi,Yazoo City,11421,1651,2449,1637,412,428,6577
Mississippi,Woodville,1245,208,291,162,166,26,853
Mississippi,Woodland,170,29,31,21,0,1,82
Mississippi,Courtland,725,78,139,102,27,19,365
Mississippi,Decatur,2100,117,166,402,172,168,1025
Mississippi,Burnsville,1089,173,249,186,25,15,648
Mississippi,Bude,905,110,194,116,49,67,536
Mississippi,Buckatunna,464,123,88,116,0,16,343
Mississippi,Southaven,51090,3767,9059,12417,5301,1904,32448
Mississippi,Standing Pine,363,68,62,0,10,12,152
Mississippi,Starkville,24754,1718,1959,3229,2911,3266,13083
Mississippi,State Line,677,126,192,130,19,3,470
Mississippi,Stonewall,1315,205,275,265,57,29,831
Mississippi,Mississippi Valley State University,1296,8,0,137,41,69,255
Mississippi,Sturgis,438,18,61,51,87,5,222
Mississippi,Summit,2307,303,448,331,109,102,1293
Mississippi,Sumner,252,35,17,62,43,18,175
Mississippi,Sumrall,1714,62,436,312,174,125,1109
Mississippi,Sunflower,1047,145,164,177,49,32,567
Mississippi,Soso,472,98,62,117,38,22,337
Mississippi,Sylvarena,101,8,28,32,3,3,74
Mississippi,Taylorsville,1348,119,243,331,109,75,877
Mississippi,Tchula,1885,334,423,180,50,41,1028
Mississippi,Terry,1477,74,299,330,185,118,1006
Mississippi,Thaxton,996,110,247,221,34,24,636
Mississippi,Tillatoba,264,40,44,0,0,0,84
Mississippi,Tishomingo,489,69,163,80,13,9,334
Mississippi,Toccopola,219,60,75,19,1,6,161
Mississippi,Toomsuba,1180,89,180,244,15,0,528
Mississippi,Tremont,477,99,108,81,16,19,323
Mississippi,Tucker,497,55,70,113,0,0,238
Mississippi,Tunica,1233,203,243,179,183,66,874
Mississippi,Taylor,304,14,53,85,46,23,221
Mississippi,Tupelo,35561,2935,6219,7234,4187,2307,22882
Mississippi,Snow Lake Shores,354,39,98,90,52,34,313
Mississippi,Sledge,476,89,67,137,18,3,314
Mississippi,Bruce,1660,213,364,358,122,68,1125
Mississippi,Brooksville,914,182,138,149,70,14,553
Mississippi,Brookhaven,12465,1141,2334,2466,967,601,7509
Mississippi,Bridgetown,1937,73,514,594,216,120,1517
Mississippi,Braxton,207,44,52,45,2,2,145
Mississippi,Brandon,22897,1034,2971,5109,4195,2079,15388
Mississippi,Boyle,1053,123,150,198,51,30,552
Mississippi,Booneville,8780,1018,1626,1368,468,311,4791
Mississippi,Bolton,423,41,112,121,33,14,321
Mississippi,Bogue Chitto CDP (Lincoln County),631,124,143,55,0,0,322
Mississippi,Bogue Chitto CDP (Kemper and Neshoba Counties),673,273,191,80,0,0,544
Mississippi,Smithville,695,105,203,124,31,6,469
Mississippi,Blue Springs,282,36,59,56,13,6,170
Mississippi,Biloxi,44825,4240,7664,9869,4294,2451,28518
Mississippi,Sharon,1306,64,470,283,35,72,924
Mississippi,Shaw,1672,392,230,366,150,24,1162
Mississippi,Shelby,2381,544,262,417,45,72,1340
Mississippi,Sherman,784,53,174,139,17,18,401
Mississippi,Shubuta,342,81,103,37,11,9,241
Mississippi,Shuqualak,453,92,80,87,10,31,300
Mississippi,Sidon,489,83,166,32,3,27,311
Mississippi,Silver City,343,80,56,35,24,6,201
Mississippi,Silver Creek,206,21,90,25,0,0,136
Mississippi,Slate Springs,101,20,35,18,11,2,86
Mississippi,Blue Mountain,937,136,92,154,31,31,444
Mississippi,Mississippi State,3797,0,0,50,32,113,195
Mississippi,Montrose,108,19,18,20,11,7,75
Mississippi,Merigold,468,88,81,71,43,24,307
Mississippi,Gulfport,70642,7133,13448,15776,5966,3552,45875
Mississippi,Gunnison,305,52,72,46,10,5,185
Mississippi,Guntown,2412,211,392,505,248,107,1463
Mississippi,Hamilton,396,16,105,70,85,7,283
Mississippi,Hatley,494,36,133,76,27,27,299
Mississippi,Hattiesburg,46762,4165,6568,7655,4763,3870,27021
Mississippi,Hazlehurst,3942,421,914,910,338,51,2634
Mississippi,Heidelberg,702,83,197,168,27,46,521
Mississippi,Helena,1049,285,451,188,11,0,935
Mississippi,Henderson Point,112,0,9,43,22,31,105
Mississippi,Hernando,14984,1081,2546,3557,1934,760,9878
Mississippi,Hickory,604,60,102,121,26,14,323
Mississippi,Hickory Flat,729,75,130,139,23,12,379
Mississippi,Hide-A-Way Lake,1555,0,393,437,301,234,1365
Mississippi,Hillsboro,1022,155,162,217,57,0,591
Mississippi,Metcalfe,1120,160,202,172,52,9,595
Mississippi,Hollandale,2621,495,372,409,191,97,1564
Mississippi,Holly Springs,7572,1147,1735,1086,354,200,4522
Mississippi,Horn Lake,26662,2533,5888,6121,1465,499,16506
Mississippi,Houston,3566,642,682,418,259,69,2070
Mississippi,Hurley,1166,122,210,361,84,159,936
Mississippi,Indianola,10281,1525,1654,1874,730,508,6291
Mississippi,Inverness,934,141,113,179,140,49,622
Mississippi,Shannon,1780,292,282,378,51,35,1038
Mississippi,Senatobia,8017,1089,872,1478,753,545,4737
Mississippi,Seminary,447,88,73,57,33,22,273
Mississippi,Sebastopol,314,37,54,70,29,18,208
Mississippi,Scooba,1052,86,117,81,35,37,356
Mississippi,Schlater,374,87,61,66,17,7,238
Mississippi,Gulf Park Estates,6113,184,771,1573,759,395,3682
Mississippi,Gulf Hills,8493,505,1609,2524,668,661,5967
Mississippi,Grenada,12908,2292,2483,2295,824,552,8446
Mississippi,Greenwood,15734,2147,3523,2327,1264,630,9891
Mississippi,Edwards,1177,92,209,299,72,33,705
Mississippi,Elliott,1430,226,287,185,58,0,756
Mississippi,Ellisville,4566,828,556,796,168,241,2589
Mississippi,Enterprise,716,75,106,161,26,45,413
Mississippi,Escatawpa,3825,508,968,1201,142,77,2896
Mississippi,Ethel,505,113,123,64,17,0,317
Mississippi,Eupora,2191,427,466,316,164,74,1447
Mississippi,Falcon,192,50,40,16,2,3,111
Mississippi,Falkner,551,77,121,117,44,20,379
Mississippi,Farmington,2333,212,412,648,104,51,1427
Mississippi,Farrell,440,39,79,129,13,0,260
Mississippi,Fayette,1563,245,306,265,34,167,1017
Mississippi,Flora,1954,154,390,350,143,38,1075
Mississippi,Florence,4279,235,877,1021,261,137,2531
Mississippi,Saucier,1060,63,266,223,31,32,615
Mississippi,Flowood,8385,360,1150,1849,1417,1086,5862
Mississippi,Foxworth,389,60,154,62,0,0,276
Mississippi,French Camp,216,1,6,56,22,17,102
Mississippi,Friars Point,870,181,136,170,62,20,569
Mississippi,Fulton,4014,313,637,710,297,211,2168
Mississippi,Gattman,113,38,59,4,0,0,101
Mississippi,Gautier,18563,1361,3584,4318,1469,965,11697
Mississippi,Georgetown,294,73,92,41,7,3,216
Mississippi,Glen,461,40,89,129,20,7,285
Mississippi,Glendale,1833,176,603,230,34,77,1120
Mississippi,Glendora,78,13,10,6,0,0,29
Mississippi,Gloster,972,174,256,217,40,3,690
Mississippi,Golden,188,52,36,26,6,8,128
Mississippi,Goodman,1288,176,188,91,35,25,515
Mississippi,Greenville,33119,4495,6219,6112,2732,1567,21125
Mississippi,Forest,5713,1270,987,1052,345,190,3844
Mississippi,Eden,104,25,19,33,0,0,77
Mississippi,Satartia,11,3,4,0,0,2,9
Mississippi,Sandersville,685,74,238,111,52,36,511
Mississippi,Polkville,820,143,215,156,25,7,546
Mississippi,Plantersville,1010,145,270,264,64,28,771
Mississippi,Pittsboro,188,14,58,53,6,5,136
Mississippi,Pickens,818,102,199,144,64,7,516
Mississippi,Picayune,10784,1068,1769,2599,814,351,6601
Mississippi,Philadelphia,7433,1116,1412,1277,550,302,4657
Mississippi,Petal,10723,799,1879,2156,1358,749,6941
Mississippi,Pelahatchie,1340,239,302,209,69,8,827
Mississippi,Pearl River,4040,667,653,694,93,12,2119
Mississippi,Pearlington,1397,167,380,316,57,7,927
Mississippi,Pearl,26222,1871,5208,6387,1992,971,16429
Mississippi,Pass Christian,5130,372,637,1377,637,381,3404
Mississippi,Pascagoula,22230,2371,4514,5290,1805,801,14781
Mississippi,Paden,93,12,26,23,7,0,68
Mississippi,Pachuta,286,53,66,58,29,14,220
Mississippi,Pace,174,50,38,50,5,2,145
Mississippi,Oxford,20769,726,1735,3033,2760,2743,10997
Mississippi,Osyka,425,28,109,70,27,6,240
Mississippi,Olive Branch,35018,2023,6735,7574,4031,2067,22430
Mississippi,Okolona,2658,656,513,489,76,46,1780
Mississippi,Ocean Springs,17528,1069,2566,3845,2391,2059,11930
Mississippi,Oakland,702,87,185,130,14,11,427
Mississippi,Noxapater,374,52,137,62,22,10,283
Mississippi,North Tunica,1060,95,290,233,0,0,618
Mississippi,North Carrollton,498,47,130,80,51,0,308
Mississippi,Nicholson,2636,486,594,596,5,41,1722
Mississippi,Newton,3347,428,738,837,288,78,2369
Mississippi,New Houlka,813,147,122,118,35,13,435
Mississippi,New Hope,3083,123,580,854,424,65,2046
Mississippi,Pontotoc,5808,760,1024,959,499,257,3499
Mississippi,Pope,231,14,46,53,30,2,145
Mississippi,Poplarville,2919,158,255,580,226,111,1330
Mississippi,Port Gibson,1607,213,246,251,115,132,957
Mississippi,Saltillo,4958,441,930,1579,625,146,3721
Mississippi,Sallis,147,16,41,30,33,0,120
Mississippi,St. Martin,7728,689,1708,1870,435,278,4980
Mississippi,Ruleville,2877,572,369,430,222,106,1699
Mississippi,Roxie,551,57,147,109,30,5,348
Mississippi,Rosedale,1743,365,300,306,87,22,1080
Mississippi,Rolling Fork,2491,404,566,437,189,89,1685
Mississippi,Robinhood,1443,256,435,214,63,15,983
Mississippi,Ripley,5350,830,1058,1058,329,343,3618
Mississippi,Rienzi,343,79,62,109,16,7,273
Mississippi,Ridgeland,24276,1084,2420,4469,4496,3645,16114
Mississippi,Richton,928,84,207,236,107,44,678
Mississippi,Richland,7055,587,1592,1650,432,246,4507
Mississippi,Renova,820,131,102,141,135,26,535
Mississippi,Sardis,1953,386,380,371,150,53,1340
Mississippi,Redwater,603,84,88,180,33,12,397
Mississippi,Kilmichael,869,152,251,120,33,18,574
Mississippi,Kearney Park,1402,271,145,320,63,90,889
Mississippi,Jumpertown,653,67,133,134,64,14,412
Mississippi,Jonestown,1436,267,139,312,32,0,750
Mississippi,Jackson,173212,16847,26894,34082,16141,11727,105691
Mississippi,Iuka,3005,666,651,509,212,97,2135
Mississippi,Itta Bena,2103,347,426,348,136,86,1343
Mississippi,Rawls Springs,1214,140,383,106,48,52,729
Mississippi,Raleigh,1454,228,376,238,68,51,961
Mississippi,Quitman,2147,252,444,545,235,106,1582
Mississippi,Purvis,2160,224,385,509,206,120,1444
Mississippi,Puckett,350,26,81,88,17,8,220
Mississippi,Prentiss,1193,212,280,294,54,34,874
Mississippi,Potts Camp,525,79,111,88,28,11,317
Mississippi,Raymond,1995,68,104,183,139,133,627
Mississippi,Ecru,1379,107,311,260,58,36,772
Mississippi,Holcomb,462,12,184,60,17,39,312
Mississippi,Maben,677,138,137,118,26,4,423
Mississippi,Lucedale,2993,454,833,462,181,86,2016
Mississippi,Louisville,6407,1012,936,1108,654,147,3857
Mississippi,Louise,150,37,23,54,22,0,136
Mississippi,Meridian Station,636,0,3,132,17,0,152
Mississippi,Long Beach,15369,1249,2273,3910,1569,1017,10018
Mississippi,Liberty,771,127,199,115,42,28,511
Mississippi,Lexington,2106,273,514,329,138,83,1337
Mississippi,Lena,200,22,33,55,36,17,163
Mississippi,Leland,4318,667,774,743,392,205,2781
Mississippi,Learned,44,0,10,14,13,4,41
Mississippi,Leakesville,802,104,198,148,69,54,573
Mississippi,Laurel,18770,3138,2825,3386,1204,993,11546
Mississippi,Lauderdale,686,70,296,17,0,0,383
Mississippi,Latimer,7009,725,1470,1607,458,256,4516
Mississippi,Lambert,1302,342,190,228,48,16,824
Mississippi,Lake,435,57,118,66,19,5,265
Mississippi,Kossuth,263,33,64,71,19,6,193
Mississippi,Lula,292,78,22,69,11,3,183
Mississippi,Lumberton,2080,256,479,382,77,46,1240
Mississippi,Lyman,2136,95,419,725,245,34,1518
Mississippi,Lynchburg,2307,188,456,577,225,140,1586
Mississippi,Meridian,40507,3780,7421,9712,3341,1897,26151
Mississippi,Mendenhall,2511,298,617,526,193,124,1758
Mississippi,Meadville,454,42,86,124,45,55,352
Mississippi,Mayersville,634,184,195,63,17,10,469
Mississippi,Mathiston,760,121,142,141,74,48,526
Mississippi,Marks,1630,281,340,314,172,61,1168
Mississippi,Marion,1547,133,240,497,65,54,989
Mississippi,Marietta,333,19,83,74,26,14,216
Mississippi,Kosciusko,7242,1127,1319,1239,481,323,4489
Mississippi,Mantee,331,7,100,47,37,32,223
Mississippi,Magnolia,2021,322,486,354,195,15,1372
Mississippi,Magee,4399,420,843,764,232,102,2361
Mississippi,Madison,25167,312,1537,4376,6080,4297,16602
Mississippi,Macon,2659,455,599,343,48,73,1518
Mississippi,McLain,428,73,99,66,14,10,262
Mississippi,McCool,148,10,53,25,10,3,101
Mississippi,McComb,12723,1886,2770,2310,818,521,8305
Mississippi,Lyon,320,17,52,92,62,40,263
Mississippi,Mantachie,1403,219,302,240,77,37,875
Mississippi,Kiln,2169,353,330,584,221,142,1630
Mississippi,Louin,237,24,53,56,35,6,174
Missouri,Bogard,181,16,79,36,0,6,137
Missouri,Fillmore,197,24,54,19,11,4,112
Missouri,Fidelity,240,31,82,36,17,5,171
Missouri,Festus,11839,1083,2619,2885,887,555,8029
Missouri,Ferrelview,403,47,128,75,40,8,298
Missouri,Ferguson,21120,1679,3774,5039,1854,914,13260
Missouri,Fenton,4033,138,583,1002,830,336,2889
Missouri,Fayette,2708,159,547,299,312,193,1510
Missouri,Farmington,17570,2153,3893,4225,1375,962,12608
Missouri,Farley,229,10,62,50,38,6,166
Missouri,Farber,315,68,122,41,9,2,242
Missouri,Fairview,336,80,85,66,11,0,242
Missouri,Fair Play,480,57,116,95,14,0,282
Missouri,Fisk,464,64,146,89,24,4,327
Missouri,Fair Grove,1612,108,311,361,128,22,930
Missouri,Fairdealing,1151,171,240,201,124,60,796
Missouri,Exeter,786,133,241,154,13,11,552
Missouri,Excelsior Springs,11512,1226,2700,2193,702,395,7216
Missouri,Excelsior Estates,175,41,47,26,0,0,114
Missouri,Excello,102,5,5,40,0,0,50
Missouri,Ewing,358,46,101,84,10,2,243
Missouri,Everton,338,48,115,43,24,5,235
Missouri,Evergreen,35,6,4,9,3,5,27
Missouri,Eureka,10450,336,1500,1989,1796,950,6571
Missouri,Ethel,51,6,26,5,3,3,43
Missouri,Essex,546,72,168,92,10,7,349
Missouri,Eolia,511,55,121,101,37,20,334
Missouri,Fairfax,664,48,230,113,63,16,470
Missouri,Fleming,130,16,47,28,0,1,92
Missouri,Flemington,116,16,30,24,0,0,70
Missouri,Flint Hill,548,19,116,86,114,29,364
Missouri,Pleasant Valley,3032,241,728,947,290,58,2264
Missouri,Pleasant Hope,652,33,131,156,45,20,385
Missouri,Fort Leonard Wood,17576,243,1140,2023,1069,429,4904
Missouri,Pleasant Hill,8216,426,2157,1351,923,389,5246
Missouri,Plattsburg,2383,220,563,449,192,83,1507
Missouri,Platte Woods,468,7,55,98,112,69,341
Missouri,Platte City,4793,178,1009,1027,599,305,3118
Missouri,Plato,134,6,18,38,6,9,77
Missouri,Pinhook,9,3,6,0,0,0,9
Missouri,Pineville,883,86,263,166,46,24,585
Missouri,Pine Lawn,3363,423,671,739,104,0,1937
Missouri,Pilot Knob,699,149,161,148,39,8,505
Missouri,Pilot Grove,713,66,275,106,50,12,509
Missouri,Pierpont,87,0,15,10,19,14,58
Missouri,Pierce City,1261,160,356,273,40,22,851
Missouri,Piedmont,2246,449,612,375,81,30,1547
Missouri,Pickering,174,13,59,31,9,8,120
Missouri,Phillipsburg,160,25,40,52,7,0,124
Missouri,Fortescue,5,2,0,1,2,0,5
Missouri,Forsyth,2068,223,630,537,168,138,1696
Missouri,Foristell,473,26,101,138,56,28,349
Missouri,Forest City,273,32,107,44,12,0,195
Missouri,Fordland,897,40,243,121,80,13,497
Missouri,Foley,127,32,41,16,2,2,93
Missouri,Florissant,52356,2926,10518,13533,5555,2682,35214
Missouri,Florida,0,0,0,0,0,0,0
Missouri,Flordell Hills,843,111,179,151,40,4,485
Missouri,Emma,247,34,61,51,32,4,182
Missouri,Bolckow,220,22,62,59,10,1,154
Missouri,Eminence,604,78,167,128,45,15,433
Missouri,Blanchard,42,0,4,12,0,0,16
Missouri,Bosworth,235,37,81,30,7,3,158
Missouri,Boonville,8350,823,2244,1644,764,286,5761
Missouri,Bonne Terre,7064,1434,1919,1299,255,93,5000
Missouri,Bolivar,10507,624,1922,1911,786,646,5889
Missouri,Edmundson,898,99,184,237,61,20,601
Missouri,Edinburg,132,10,43,11,0,11,75
Missouri,Edina,1187,89,325,253,109,39,815
Missouri,Edgerton,607,34,190,108,61,10,403
Missouri,Edgar Springs,216,12,62,28,7,2,111
Missouri,East Prairie,3178,648,643,363,95,41,1790
Missouri,Easton,254,37,68,51,27,2,185
Missouri,Aullville,99,9,35,20,0,2,66
Missouri,Bourbon,1458,260,404,257,58,25,1004
Missouri,Eagleville,264,27,74,47,16,14,178
Missouri,Dutchtown,34,8,10,6,2,1,27
Missouri,Duquesne,1747,152,406,339,149,80,1126
Missouri,Duenweg,1218,135,271,256,112,28,802
Missouri,Dudley,158,29,50,37,5,2,123
Missouri,Drexel,911,73,309,181,56,29,648
Missouri,Downing,278,27,104,58,12,4,205
Missouri,Blodgett,233,26,39,26,27,0,118
Missouri,Bloomfield,1952,360,531,385,104,21,1401
Missouri,Bloomsdale,631,73,136,120,44,20,393
Missouri,Blue Eye,220,38,55,51,9,8,161
Missouri,Blue Springs,53364,2123,9287,11898,7238,3815,34361
Missouri,Blythedale,164,12,53,38,7,0,110
Missouri,Eagle Rock,124,0,69,0,0,0,69
Missouri,Bowling Green,5465,1100,1669,919,242,63,3993
Missouri,Bragg City,127,31,24,15,7,0,77
Missouri,Brandsville,109,20,27,25,5,2,79
Missouri,Bland,478,70,134,44,29,11,288
Missouri,Emerald Beach,279,19,82,86,18,21,226
Missouri,Elsberry,1930,214,534,316,174,41,1279
Missouri,Elmo,180,18,51,28,11,1,109
Missouri,Elmira,60,2,16,16,6,0,40
Missouri,Phelps City,0,0,0,0,0,0,0
Missouri,Pevely,5596,386,1200,1418,441,105,3550
Missouri,Perryville,8333,735,2250,1552,666,307,5510
Missouri,Perry,656,99,205,127,43,22,496
Missouri,Penermon,91,15,12,18,2,0,47
Missouri,Pendleton,23,7,9,1,0,0,17
Missouri,Elmer,89,4,39,8,3,0,54
Missouri,Ellsinore,502,75,99,82,23,13,292
Missouri,Ellisville,9181,256,1507,1543,1997,926,6229
Missouri,Ellington,1119,140,404,146,27,12,729
Missouri,El Dorado Springs,3553,578,936,394,340,90,2338
Missouri,Eldon,4617,477,1477,687,256,128,3025
Missouri,Peculiar,4808,332,1084,1143,329,276,3164
Missouri,Peaceful Village,8,8,0,0,0,0,8
Missouri,Paynesville,58,15,19,5,4,7,50
Missouri,Pattonsburg,379,54,132,75,3,9,273
Missouri,Passaic,38,4,19,13,0,0,36
Missouri,Pascola,111,15,44,3,0,0,62
Missouri,Braymer,684,73,221,128,27,21,470
Missouri,Brashear,226,18,84,46,16,4,168
Missouri,Branson West,434,41,112,78,29,13,273
Missouri,Branson,11084,770,2426,2700,1336,637,7869
Missouri,Blairstown,125,23,55,8,0,1,87
Missouri,Blackwater,141,8,33,34,7,1,83
Missouri,Verona,591,107,123,80,2,9,321
Missouri,Blackburn,299,18,94,55,22,9,198
Missouri,Warsaw,2362,231,709,524,141,59,1664
Missouri,Warson Woods,1758,8,55,225,558,413,1259
Missouri,Washburn,533,102,128,90,7,8,335
Missouri,Washington,13993,1149,2854,3072,1841,778,9694
Missouri,Wasola,36,26,0,10,0,0,36
Missouri,Clearmont,194,11,87,33,12,2,145
Missouri,Clayton,15900,308,569,1047,3113,4449,9486
Missouri,Claycomo,1457,209,517,311,81,13,1131
Missouri,Clarkton,1228,299,295,110,26,11,741
Missouri,Clarksville,444,51,137,99,75,7,369
Missouri,Clarkson Valley,2634,26,154,275,768,657,1880
Missouri,Clarksdale,271,23,87,52,16,4,182
Missouri,Watson,47,5,19,6,2,0,32
Missouri,Waverly,823,79,238,119,29,31,496
Missouri,Wayland,537,100,153,81,15,0,349
Missouri,Waynesville,5250,45,987,1231,692,691,3646
Missouri,Weatherby,101,11,30,12,1,0,54
Missouri,Weatherby Lake,1834,46,198,463,387,348,1442
Missouri,Weaubleau,443,71,122,73,11,11,288
Missouri,Webb City,11035,679,2779,2023,977,368,6826
Missouri,Webster Groves,23120,379,1450,3513,5032,5150,15524
Missouri,Weingarten,68,0,50,10,8,0,68
Missouri,Cleveland,609,45,168,153,76,18,460
Missouri,Clever,2381,111,475,474,266,110,1436
Missouri,Cliff Village,30,0,9,8,1,0,18
Missouri,Bel-Nor,1486,64,155,302,343,310,1174
Missouri,Bel-Ridge,2726,347,414,621,127,58,1567
Missouri,Warrenton,8025,913,1676,1549,458,228,4824
Missouri,Belton,23209,1563,4680,5280,1969,1059,14551
Missouri,Warrensburg,19739,684,2017,2817,1929,1855,9302
Missouri,Wardell,349,47,111,67,14,2,241
Missouri,Velda Village Hills,905,102,253,203,44,22,624
Missouri,Velda City,1315,179,352,267,74,28,900
Missouri,Vanduser,128,34,42,18,3,0,97
Missouri,Vandiver,97,7,25,19,4,6,61
Missouri,Vandalia,4126,720,1498,674,129,65,3086
Missouri,Van Buren,1044,99,174,266,50,44,633
Missouri,Valley Park,6970,640,1063,1401,1146,703,4953
Missouri,Utica,272,18,128,35,11,2,194
Missouri,Urich,453,26,163,82,37,6,314
Missouri,Urbana,376,37,122,75,10,11,255
Missouri,Uplands Park,384,43,110,82,25,25,285
Missouri,University City,35172,1731,3563,6137,6033,7682,25146
Missouri,Unity Village,114,0,7,28,26,7,68
Missouri,Unionville,1989,201,598,463,89,81,1432
Missouri,Union Star,344,30,108,72,15,9,234
Missouri,Union,10644,910,2147,2811,847,408,7123
Missouri,Umber View Heights,71,0,28,28,8,2,66
Missouri,Viburnum,721,96,166,131,66,23,482
Missouri,Vienna,721,85,180,110,46,49,470
Missouri,Village of Four Seasons,2218,53,295,584,348,250,1530
Missouri,Villa Ridge,2800,215,763,649,194,180,2001
Missouri,Vinita Park,1940,272,422,314,210,68,1286
Missouri,Vinita Terrace,220,11,44,54,35,25,169
Missouri,Vista,48,1,22,5,3,0,31
Missouri,Waco,52,2,16,14,3,0,35
Missouri,Walker,275,38,61,45,19,1,164
Missouri,Walnut Grove,689,83,189,117,34,20,443
Missouri,Wardsville,1890,43,328,311,296,108,1086
Missouri,Black Jack,6938,339,1135,1851,911,450,4686
Missouri,Bennett Springs,114,13,77,24,0,0,114
Missouri,Benton City,176,32,42,40,0,2,116
Missouri,Baker,0,0,0,0,0,0,0
Missouri,Bakersfield,289,39,86,46,13,3,187
Missouri,Baldwin Park,66,8,38,7,0,0,53
Missouri,Ballwin,30484,872,3308,5442,7178,4196,20996
Missouri,Baring,153,17,63,17,6,0,103
Missouri,Barnard,268,12,98,46,2,6,164
Missouri,Barnett,163,55,51,38,2,1,147
Missouri,Barnhart,5858,259,1283,1531,681,194,3948
Missouri,Bates City,235,26,69,56,6,10,167
Missouri,Battlefield,5844,218,747,1465,940,525,3895
Missouri,Bella Villa,756,85,153,160,97,42,537
Missouri,Bell City,491,76,103,84,10,7,280
Missouri,Belle,1738,305,424,310,97,13,1149
Missouri,Bellefontaine Neighbors,10814,927,2203,2822,637,449,7038
Missouri,Bellerive,183,9,5,36,31,73,154
Missouri,Bellflower,337,60,105,54,5,0,224
Missouri,Westphalia,381,71,149,40,30,17,307
Missouri,Weston,1673,63,343,372,246,107,1131
Missouri,West Line,89,5,27,22,2,0,56
Missouri,Westboro,181,10,62,17,10,3,102
Missouri,West Alton,545,97,189,78,38,3,405
Missouri,Wentzville,32827,1319,5910,7302,4315,1545,20391
Missouri,Wentworth,103,25,31,17,3,4,80
Missouri,Wellsville,1138,162,358,198,42,41,801
Missouri,Wellston,1949,199,472,307,54,14,1046
Missouri,Versailles,2826,562,815,388,119,97,1981
Missouri,Plevna,15,0,6,0,9,0,15
Missouri,Bagnell,52,5,29,6,0,0,40
Missouri,Benton,937,95,246,166,61,49,617
Missouri,Avondale,392,42,101,95,24,11,273
Missouri,Ava,2961,385,817,643,88,81,2014
Missouri,Weldon Spring,5517,69,783,1190,1223,893,4158
Missouri,Weldon Spring Heights,92,1,36,15,13,14,79
Missouri,Wellington,850,52,274,128,53,12,519
Missouri,Twin Oaks,332,9,49,71,84,40,253
Missouri,Tuscumbia,252,44,88,45,5,12,194
Missouri,Turney,111,10,52,15,12,4,93
Missouri,Truxton,90,18,16,10,1,0,45
Missouri,Truesdale,869,127,170,161,14,8,480
Missouri,Troy,11175,749,3020,1878,904,418,6969
Missouri,Berger,168,21,38,41,9,3,112
Missouri,Berkeley,9083,731,1924,2203,563,181,5602
Missouri,Bernie,1992,339,542,326,58,37,1302
Missouri,Bertrand,807,154,322,145,18,5,644
Missouri,Bethany,3080,481,993,500,279,21,2274
Missouri,Marshfield,6860,495,1649,1392,419,314,4269
Missouri,Beverly Hills,450,38,136,103,27,29,333
Missouri,Bevier,642,33,249,126,19,11,438
Missouri,Biehle,0,0,0,0,0,0,0
Missouri,Bigelow,8,0,8,0,0,0,8
Missouri,Big Lake,102,5,57,15,13,3,93
Missouri,Big Spring,29,0,29,0,0,0,29
Missouri,Billings,921,77,274,199,95,39,684
Missouri,Birch Tree,559,133,157,90,27,7,414
Missouri,Birmingham,212,14,72,57,11,0,154
Missouri,Bismarck,1336,246,332,289,46,23,936
Missouri,Aurora,7473,1172,1686,1341,572,99,4870
Missouri,Auxvasse,1298,87,430,168,124,3,812
Missouri,Avilla,100,6,35,18,0,0,59
Missouri,Pocahontas,124,6,35,18,1,5,65
Missouri,Harwood,106,7,19,19,0,2,47
Missouri,Polo,606,51,151,119,20,13,354
Missouri,Dadeville,259,19,80,56,11,12,178
Missouri,Dalton,15,6,4,0,0,0,10
Missouri,Danville,71,32,12,0,0,0,44
Missouri,Dardenne Prairie,12383,155,1627,2330,2388,1434,7934
Missouri,Darlington,75,11,23,13,0,3,50
Missouri,Dawn,111,3,43,5,15,0,66
Missouri,Dearborn,412,16,118,99,22,24,279
Missouri,Deepwater,427,49,136,92,18,5,300
Missouri,Deerfield,70,5,19,10,8,3,45
Missouri,Defiance,161,15,66,30,20,0,131
Missouri,De Kalb,202,20,94,22,12,3,151
Missouri,Dellwood,5011,253,1045,1334,379,176,3187
Missouri,Delta,422,70,136,59,19,3,287
Missouri,Dennis Acres,45,1,9,13,0,0,23
Missouri,Denver,47,0,26,7,0,4,37
Missouri,Des Arc,170,39,52,21,4,1,117
Missouri,Desloge,4966,648,1272,1256,155,160,3491
Missouri,De Soto,6469,995,1377,1305,378,225,4280
Missouri,Des Peres,8480,107,564,1061,2270,1853,5855
Missouri,De Witt,101,22,43,8,0,0,73
Missouri,Dexter,7920,1146,2025,1683,454,268,5576
Missouri,Diamond,921,118,273,190,67,9,657
Missouri,Diehlstadt,184,35,63,21,7,0,126
Missouri,Curryville,240,48,50,39,7,0,144
Missouri,Diggins,280,32,88,58,20,15,213
Missouri,Cuba,3377,577,523,674,174,86,2034
Missouri,Crystal Lake Park,494,1,22,45,140,141,349
Missouri,Conception Junction,210,11,70,26,14,9,130
Missouri,Concord,16953,755,2884,3923,3223,1591,12376
Missouri,Concordia,2373,149,679,339,241,178,1586
Missouri,Coney Island,68,5,33,16,13,0,67
Missouri,Conway,918,153,212,106,7,19,497
Missouri,Cool Valley,1167,130,302,241,77,33,783
Missouri,Cooter,428,78,92,73,23,5,271
Missouri,Corder,337,31,83,79,18,8,219
Missouri,Corning,4,2,2,0,0,0,4
Missouri,Cosby,151,23,33,28,9,6,99
Missouri,Cottleville,3836,57,472,823,901,375,2628
Missouri,Country Club,2833,101,542,634,343,310,1930
Missouri,Country Club Hills,1398,189,209,230,45,22,695
Missouri,Country Life Acres,138,0,8,30,37,24,99
Missouri,Cowgill,139,22,42,23,8,2,97
Missouri,Craig,208,37,59,30,3,1,130
Missouri,Crane,2022,269,480,342,63,42,1196
Missouri,Creighton,320,33,104,62,8,8,215
Missouri,Crestwood,11961,443,1529,2598,2469,1565,8604
Missouri,Creve Coeur,17944,375,976,2635,4580,4519,13085
Missouri,Crocker,997,67,234,218,34,24,577
Missouri,Cross Timbers,239,34,40,64,8,4,150
Missouri,Crystal City,4829,347,1150,1244,386,158,3285
Missouri,Crystal Lakes,322,29,133,68,10,5,245
Missouri,Conception,262,6,29,36,16,32,119
Missouri,Dixon,1443,200,293,248,70,21,832
Missouri,Doniphan,2337,283,539,503,154,43,1522
Missouri,Sedalia,21457,2736,4359,4712,1567,796,14170
Missouri,Sedgewickville,255,19,85,31,6,2,143
Missouri,Seligman,1021,200,322,134,29,7,692
Missouri,Senath,1813,405,393,220,90,41,1149
Missouri,Seneca,2285,225,543,507,189,65,1529
Missouri,Seymour,1789,280,559,348,75,15,1277
Missouri,Shelbina,1583,105,560,333,75,40,1113
Missouri,Shelbyville,546,26,198,108,47,14,393
Missouri,Sheldon,672,86,156,141,18,0,401
Missouri,Shell Knob,1475,126,467,242,197,101,1133
Missouri,Zalma,146,30,48,6,12,0,96
Missouri,Wyatt,443,88,96,66,26,0,276
Missouri,Wyaconda,199,20,90,30,4,4,148
Missouri,Wright City,3355,300,671,763,316,81,2131
Missouri,Worthington,96,4,15,10,11,0,40
Missouri,Wortham,226,0,66,61,0,10,137
Missouri,Worth,53,8,14,6,3,0,31
Missouri,Wooldridge,35,0,17,10,1,1,29
Missouri,Woodson Terrace,4072,377,1157,923,321,87,2865
Missouri,Wood Heights,748,27,244,188,38,21,518
Missouri,Winston,226,26,80,39,5,1,151
Missouri,Winona,1202,199,287,210,23,17,736
Missouri,Winigan,61,0,20,14,7,5,46
Missouri,Scott City,4527,514,1354,637,189,188,2882
Missouri,Doe Run,1096,150,245,315,12,0,722
Missouri,Scotsdale,228,9,42,56,31,10,148
Missouri,Savannah,5092,289,1573,723,393,303,3281
Missouri,Doolittle,658,70,157,140,20,11,398
Missouri,Dover,115,22,31,26,5,0,84
Missouri,St. Charles,67479,3518,11522,13663,9831,5706,44240
Missouri,St. Clair,4706,741,1148,1105,216,67,3277
Missouri,St. Clement,108,28,0,20,13,12,73
Missouri,St. Cloud,64,6,12,11,7,0,36
Missouri,Ste. Genevieve,4437,330,1416,893,272,91,3002
Missouri,St. Elizabeth,319,10,93,53,31,39,226
Missouri,St. Francisville,102,15,27,15,4,4,65
Missouri,St. James,4172,519,1074,752,291,146,2782
Missouri,St. John,6491,620,1520,1506,432,253,4331
Missouri,St. Joseph,77037,6907,18455,15608,6423,3333,50726
Missouri,St. Louis,317850,34651,51466,62389,39893,29709,218108
Missouri,St. Martins,1223,63,297,245,164,46,815
Missouri,St. Mary,407,45,103,66,15,28,257
Missouri,St. Paul,1863,53,457,391,313,132,1346
Missouri,St. Peters,55135,2179,9826,12929,9038,4590,38562
Missouri,St. Robert,5151,419,792,1065,605,288,3169
Missouri,St. Thomas,225,14,69,24,30,7,144
Missouri,Salem,4976,1088,1270,886,121,165,3530
Missouri,Salisbury,1667,137,506,252,125,77,1097
Missouri,Sappington,7113,271,1350,1872,1197,588,5278
Missouri,Sarcoxie,1181,76,382,247,27,55,787
Missouri,Schell City,241,27,79,43,6,2,157
Missouri,Commerce,44,9,12,2,0,0,23
Missouri,Columbia,115391,3870,9513,14456,18679,15989,62507
Missouri,Collins,132,38,33,27,7,1,106
Missouri,Mine La Motte,225,0,132,72,0,0,204
Missouri,Miner,963,171,381,141,56,17,766
Missouri,Mineral Point,389,80,102,33,0,2,217
Missouri,Miramiguoa Park,112,9,14,43,4,2,72
Missouri,Missouri City,311,32,113,52,7,12,216
Missouri,Moberly,13879,1416,3386,3103,874,465,9244
Missouri,Mokane,156,15,54,12,4,6,91
Missouri,Moline Acres,2377,222,498,557,119,86,1482
Missouri,Monett,8957,1419,2042,1316,699,321,5797
Missouri,Monroe City,2439,197,906,322,156,94,1675
Missouri,Montgomery City,2795,261,724,481,152,128,1746
Missouri,Monticello,139,40,53,18,7,3,121
Missouri,Montier,51,0,0,31,20,0,51
Missouri,Montreal,55,0,27,0,0,0,27
Missouri,Montrose,355,46,129,66,37,7,285
Missouri,Mooresville,122,9,40,11,10,0,70
Missouri,Morehouse,826,147,271,129,17,4,568
Missouri,Morley,728,98,209,80,23,4,414
Missouri,Morrison,91,7,33,16,6,4,66
Missouri,Morrisville,378,32,97,75,19,7,230
Missouri,Mosby,206,40,70,32,3,0,145
Missouri,Moscow Mills,2550,243,578,395,52,53,1321
Missouri,Mound City,1265,106,318,277,127,86,914
Missouri,Mindenmines,270,27,88,77,9,5,206
Missouri,Moundville,132,20,47,27,2,2,98
Missouri,Milo,108,13,18,18,15,0,64
Missouri,Miller,732,49,205,190,39,14,497
Missouri,Marston,417,40,166,64,0,0,270
Missouri,Marthasville,1273,47,261,353,103,39,803
Missouri,Martinsburg,325,33,89,71,21,8,222
Missouri,Maryland Heights,27401,1358,3956,5835,4953,3129,19231
Missouri,Maryville,11997,367,1888,1391,798,667,5111
Missouri,Matthews,736,178,257,97,8,10,550
Missouri,Maysville,1115,123,430,163,57,41,814
Missouri,Mayview,335,23,125,34,7,2,191
Missouri,Meadville,415,12,132,73,20,22,259
Missouri,Mehlville,29953,2304,6910,6989,3781,1390,21374
Missouri,Memphis,1938,169,501,353,169,66,1258
Missouri,Mendon,156,21,53,21,14,0,109
Missouri,Mercer,413,34,143,71,22,30,300
Missouri,Merriam Woods,1668,245,372,356,73,29,1075
Missouri,Merwin,37,10,14,5,1,0,30
Missouri,Meta,244,17,88,46,12,1,164
Missouri,Metz,36,10,12,4,0,0,26
Missouri,Mexico,11588,964,3585,1944,627,410,7530
Missouri,Miami,142,20,43,35,2,4,104
Missouri,Middletown,232,53,51,30,0,2,136
Missouri,Milan,2110,336,586,295,66,52,1335
Missouri,Milford,31,1,19,9,0,0,29
Missouri,Millard,66,13,21,11,3,0,48
Missouri,Mill Spring,160,39,61,8,0,0,108
Missouri,Mountain Grove,4712,654,1512,745,209,153,3273
Missouri,Mountain View,2701,307,686,568,96,49,1706
Missouri,Mount Leonard,83,21,24,10,4,2,61
Missouri,Rock Hill,4638,94,430,1031,1037,764,3356
Missouri,Rock Port,1359,99,387,258,174,62,980
Missouri,Rockville,140,21,44,21,2,0,88
Missouri,Rogersville,3453,160,555,770,427,134,2046
Missouri,Rolla,19910,1310,3154,2624,1864,1636,10588
Missouri,Roscoe,111,14,42,35,0,0,91
Missouri,Rosebud,436,72,116,68,23,10,289
Missouri,Rosendale,129,16,34,15,4,0,69
Missouri,Rothville,131,4,30,7,11,1,53
Missouri,Rush Hill,137,24,55,15,0,2,96
Missouri,Rushville,258,22,83,40,9,5,159
Missouri,Russellville,837,39,223,127,70,44,503
Missouri,Rutledge,72,16,18,8,0,2,44
Missouri,Saddlebrooke,284,16,51,79,37,36,219
Missouri,Saginaw,338,17,85,103,29,17,251
Missouri,St. Ann,12973,1229,2872,3537,1053,317,9008
Missouri,Clifton Hill,105,8,36,14,4,5,67
Missouri,Climax Springs,166,17,55,27,3,2,104
Missouri,Clinton,9012,915,2428,1931,574,391,6239
Missouri,Clyde,90,5,21,13,4,5,48
Missouri,Cobalt,256,43,63,44,1,0,151
Missouri,Coffey,135,21,54,22,1,0,98
Missouri,Cole Camp,1443,81,395,319,83,105,983
Missouri,Rockaway Beach,832,87,213,222,61,27,610
Missouri,Rocheport,243,13,35,65,37,36,186
Missouri,Rives,56,8,28,10,0,0,46
Missouri,Riverview Estates,120,3,21,29,14,14,81
Missouri,Mount Moriah,124,17,40,16,5,0,78
Missouri,Mount Vernon,4531,434,1345,974,352,81,3186
Missouri,Murphy,8745,803,2126,2031,579,347,5886
Missouri,Napoleon,243,16,96,44,6,4,166
Missouri,Naylor,756,126,181,133,29,6,475
Missouri,Neck City,139,22,55,10,5,8,100
Missouri,Neelyville,529,64,138,88,20,2,312
Missouri,Nelson,158,30,41,22,2,2,97
Missouri,Neosho,12102,1443,2379,2415,772,423,7432
Missouri,Nevada,8454,785,2121,1751,514,277,5448
Missouri,Newark,68,10,18,17,6,3,54
Missouri,Winfield,1698,163,396,280,106,44,989
Missouri,New Bloomfield,806,52,217,147,45,23,484
Missouri,Rich Hill,1446,225,410,221,49,25,930
Missouri,Richland,1678,149,495,301,72,24,1041
Missouri,Richmond,5654,514,1799,985,340,247,3885
Missouri,Richmond Heights,8510,165,633,1344,2104,2187,6433
Missouri,Ridgely,106,2,27,19,16,2,66
Missouri,Ridgeway,479,59,182,47,18,13,319
Missouri,Risco,362,27,126,49,14,4,220
Missouri,Ritchey,78,8,17,24,2,5,56
Missouri,River Bend,6,0,6,0,0,0,6
Missouri,Riverside,3056,254,737,689,284,179,2143
Missouri,Riverview,2849,263,537,702,144,32,1678
Missouri,Richards,115,2,25,25,16,0,68
Missouri,Windsor Place,383,8,88,91,38,23,248
Missouri,Windsor,2753,235,702,745,253,52,1987
Missouri,Winchester,1612,104,384,379,195,65,1127
Missouri,Clark,261,28,75,39,5,0,147
Missouri,Clarksburg,256,40,64,39,14,4,161
Missouri,Adrian,1953,201,574,354,105,54,1288
Missouri,Advance,1449,205,390,253,106,28,982
Missouri,Affton,21345,1278,4047,5081,3034,1976,15416
Missouri,Agency,907,75,237,191,60,28,591
Missouri,Airport Drive,877,28,165,168,132,63,556
Missouri,Alba,503,34,177,101,23,0,335
Missouri,Albany,2178,198,620,371,207,111,1507
Missouri,Aldrich,76,13,14,20,4,2,53
Missouri,Alexandria,142,15,61,24,4,0,104
Missouri,Allendale,44,1,13,16,10,1,41
Missouri,Allenville,68,11,27,3,10,0,51
Missouri,Alma,387,40,118,60,47,19,284
Missouri,Altamont,175,28,45,27,4,3,107
Missouri,Altenburg,477,34,146,74,37,17,308
Missouri,Alton,1087,197,320,153,27,34,731
Missouri,Amazonia,253,43,106,24,2,2,177
Missouri,Amity,18,8,5,1,1,0,15
Missouri,Amoret,140,26,58,23,0,0,107
Missouri,Amsterdam,231,31,76,50,4,0,161
Missouri,Anderson,2435,415,588,351,57,107,1518
Missouri,Annada,42,1,20,0,3,0,24
Missouri,Clarence,918,95,303,148,35,20,601
Missouri,Annapolis,466,76,117,71,18,8,290
Missouri,Chula,245,9,78,60,6,0,153
Missouri,Chilhowee,272,53,96,37,20,8,214
Missouri,Carytown,282,28,76,32,35,7,178
Missouri,Cassville,3286,257,940,597,158,249,2201
Missouri,Castle Point,3368,396,611,869,93,73,2042
Missouri,Catron,82,23,13,13,0,6,55
Missouri,Cave,1,1,0,0,0,0,1
Missouri,Cedar Hill,1694,133,451,414,93,8,1099
Missouri,Cedar Hill Lakes,205,25,70,56,8,12,171
Missouri,Center,382,56,155,52,12,2,277
Missouri,Centertown,288,16,87,57,22,9,191
Missouri,Centerview,253,21,69,36,2,2,130
Missouri,Centerville,244,46,64,51,20,3,184
Missouri,Centralia,4159,333,1022,935,402,165,2857
Missouri,Chaffee,2943,391,894,608,116,30,2039
Missouri,Chain of Rocks,133,6,35,31,7,0,79
Missouri,Chain-O-Lakes,122,5,28,28,11,4,76
Missouri,Chamois,396,45,101,69,27,16,258
Missouri,Champ,10,2,4,4,0,0,10
Missouri,Charlack,1483,72,394,366,145,43,1020
Missouri,Charleston,5877,1123,1818,1028,328,140,4437
Missouri,Charmwood,24,2,10,4,0,0,16
Missouri,Cherokee Pass,242,59,78,85,0,0,222
Missouri,Chesapeake,116,0,45,25,0,23,93
Missouri,Chesterfield,47706,715,3876,7165,12008,10301,34065
Missouri,Chillicothe,9025,1001,2578,1478,861,503,6421
Missouri,Anniston,215,52,82,34,0,0,168
Missouri,Appleton City,1322,109,503,182,52,47,893
Missouri,Arbela,19,3,11,1,0,0,15
Missouri,Raymore,19813,462,3910,4542,2678,1641,13233
Missouri,Raymondville,406,55,125,54,13,6,253
Missouri,Ravenwood,436,22,148,91,23,16,300
Missouri,Ravanna,44,3,41,0,0,0,44
Missouri,Randolph,28,4,7,4,0,2,17
Missouri,Qulin,446,91,114,59,21,2,287
Missouri,Quitman,45,10,11,8,0,0,29
Missouri,Queen City,686,96,211,161,15,11,494
Missouri,Puxico,782,90,257,127,56,37,567
Missouri,Purdy,1416,270,342,188,43,28,871
Missouri,Purdin,194,42,76,20,0,0,138
Missouri,Purcell,399,28,94,78,11,3,214
Missouri,Princeton,1080,75,407,192,66,20,760
Missouri,Preston,273,27,108,29,3,1,168
Missouri,Prathersville,111,11,26,47,6,0,90
Missouri,Prairie Home,328,25,51,88,21,15,200
Missouri,Powersville,79,15,18,29,0,4,66
Missouri,Potosi,2666,566,418,525,148,78,1735
Missouri,Portageville,3168,557,874,477,115,114,2137
Missouri,Portage Des Sioux,403,41,111,89,19,6,266
Missouri,Poplar Bluff,17195,2260,3796,3797,992,761,11606
Missouri,Pontiac,278,39,53,76,12,12,192
Missouri,Pomona,306,126,103,56,0,0,285
Missouri,Raytown,29486,1607,6665,6768,3078,1500,19618
Missouri,Rayville,201,34,77,11,6,0,128
Missouri,Rea,53,5,26,9,3,0,43
Missouri,Redings Mill,197,16,39,46,45,8,154
Missouri,Arbyrd,531,59,140,42,25,7,273
Missouri,Arcadia,831,110,137,209,55,87,598
Missouri,Archie,1359,47,344,305,70,32,798
Missouri,Arcola,61,9,18,12,1,7,47
Missouri,Argyle,163,12,54,27,14,5,112
Missouri,Arkoe,75,5,15,18,0,2,40
Missouri,Armstrong,364,41,118,52,19,4,234
Missouri,Arnold,21123,2020,4862,4921,2013,944,14760
Missouri,Arrow Point,125,12,26,35,19,2,94
Missouri,Arrow Rock,37,0,9,9,17,2,37
Missouri,Asbury,171,30,51,47,6,5,139
Missouri,Caruthersville,6026,1212,1350,923,402,101,3988
Missouri,Ashburn,40,29,11,0,0,0,40
Missouri,Ashland,3828,231,608,914,604,210,2567
Missouri,Ashley,75,16,40,19,0,0,75
Missouri,Atlanta,512,46,131,93,23,14,307
Missouri,Augusta,284,12,64,66,48,19,209
Missouri,Rhineland,156,7,55,40,9,5,116
Missouri,Revere,83,9,40,13,0,0,62
Missouri,Republic,15594,669,2900,4137,1491,664,9861
Missouri,Rensselaer,243,23,79,58,17,6,183
Missouri,Renick,193,4,60,56,12,2,134
Missouri,Reeds Spring,905,69,247,207,35,25,583
Missouri,Reeds,71,7,25,17,2,0,51
Missouri,Ash Grove,1567,195,406,324,98,52,1075
Missouri,Pollock,40,12,17,8,0,1,38
Missouri,Carthage,14278,2557,2880,1938,1004,492,8871
Missouri,Carrollton,3734,336,1249,546,187,159,2477
Missouri,Humphreys,108,31,26,11,4,0,72
Missouri,Hume,373,43,103,50,15,3,214
Missouri,Humansville,1140,192,367,143,41,3,746
Missouri,Hughesville,160,18,40,47,4,4,113
Missouri,Howardville,286,64,86,26,5,0,181
Missouri,Houston Lake,347,21,62,84,74,8,249
Missouri,Houstonia,207,34,39,40,12,5,130
Missouri,Houston,2354,266,492,461,133,64,1416
Missouri,Hornersville,803,108,166,157,19,14,464
Missouri,Horine,1332,49,359,336,32,0,776
Missouri,Hopkins,485,45,156,84,38,13,336
Missouri,Homestown,169,30,32,21,6,0,89
Missouri,Homestead,175,25,59,41,2,4,131
Missouri,Holts Summit,3447,332,832,528,376,200,2268
Missouri,Holt,474,59,124,94,15,5,297
Missouri,Hollister,4441,406,936,931,352,37,2662
Missouri,Holliday,102,11,34,13,10,4,72
Missouri,Holland,199,73,38,27,5,1,144
Missouri,Holden,2284,265,658,451,125,83,1582
Missouri,Holcomb,749,119,188,112,17,2,438
Missouri,Hoberg,47,9,11,9,0,0,29
Missouri,Hillsdale,1327,171,304,260,48,20,803
Missouri,Hillsboro,2980,248,451,706,139,166,1710
Missouri,Hunnewell,136,19,62,30,6,0,117
Missouri,High Ridge,3553,262,827,899,365,87,2440
Missouri,Hunter,106,42,37,17,0,0,96
Missouri,Huntsdale,25,4,6,10,0,2,22
Missouri,Wilson City,55,24,10,8,0,0,42
Missouri,Willow Springs,2294,241,477,463,139,120,1440
Missouri,Williamsville,390,86,98,89,9,0,282
Missouri,Willard,5429,318,1067,1260,620,154,3419
Missouri,Wildwood,35776,433,2266,5639,9576,5568,23482
Missouri,Wilbur Park,505,33,92,135,69,44,373
Missouri,Whitewater,99,15,37,17,0,3,72
Missouri,Whiteside,56,16,15,9,0,0,40
Missouri,Whiteman AFB,3893,20,212,644,176,74,1126
Missouri,Wheeling,280,25,96,65,14,0,200
Missouri,Wheaton,689,52,153,128,50,7,390
Missouri,Wheatland,289,75,104,47,2,5,233
Missouri,Westwood,298,1,6,34,90,87,218
Missouri,West Sullivan,59,10,18,11,3,0,42
Missouri,West Plains,12230,1095,2998,2671,641,630,8035
Missouri,Indian Point,541,41,134,133,66,27,401
Missouri,Independence,117192,10044,30956,25580,9904,4667,81151
Missouri,Imperial,4807,339,1418,964,374,191,3286
Missouri,Iberia,693,92,197,118,56,34,497
Missouri,Iatan,41,7,14,5,0,2,28
Missouri,Hurley,220,35,65,31,3,0,134
Missouri,Hurdland,118,10,54,13,9,0,86
Missouri,Huntsville,1570,141,505,331,73,33,1083
Missouri,Huntleigh,372,8,18,41,122,75,264
Missouri,Highlandville,1040,85,268,194,85,30,662
Missouri,High Hill,196,28,68,35,19,1,151
Missouri,Higginsville,4706,525,1073,751,538,195,3082
Missouri,Burgess,59,6,13,14,7,3,43
Missouri,Burlington Junction,468,56,183,64,15,2,320
Missouri,Butler,4153,496,1077,916,142,185,2816
Missouri,Butterfield,483,138,112,54,10,2,316
Missouri,Byrnes Mill,2822,214,761,680,269,130,2054
Missouri,Cabool,2309,285,461,377,254,78,1455
Missouri,Cainsville,240,20,92,45,9,5,171
Missouri,Cairo,314,19,76,78,9,5,187
Missouri,Caledonia,173,10,60,35,0,1,106
Missouri,Calhoun,414,41,127,72,17,2,259
Missouri,California,4351,432,1173,567,459,145,2776
Missouri,Callao,436,53,126,60,13,0,252
Missouri,Calverton Park,1289,130,272,331,99,31,863
Missouri,Camden,242,33,72,37,7,1,150
Missouri,Camden Point,502,22,95,117,53,30,317
Missouri,Camdenton,3822,474,860,785,232,81,2432
Missouri,Cameron,10167,1211,3064,2166,589,257,7287
Missouri,Campbell,1997,417,477,337,87,26,1344
Missouri,Canalou,278,45,81,42,0,0,168
Missouri,Canton,2522,176,554,346,119,121,1316
Missouri,Cape Girardeau,38959,2703,6073,6845,4981,3247,23849
Missouri,Cardwell,698,161,170,76,26,13,446
Missouri,Carl Junction,7577,259,1436,1342,1175,577,4789
Missouri,Gunn City,79,13,11,10,4,0,38
Missouri,Hale,459,45,146,88,16,21,316
Missouri,Halfway,126,23,39,30,5,1,98
Missouri,Hallsville,1593,109,406,308,137,80,1040
Missouri,Higbee,589,85,159,152,9,11,416
Missouri,Hermitage,801,107,233,138,52,8,538
Missouri,Hermann,2461,189,762,488,273,101,1813
Missouri,Herculaneum,3762,337,772,1030,252,48,2439
Missouri,Henrietta,303,33,120,36,11,4,204
Missouri,Hazelwood,25686,1529,5178,6186,2742,1298,16933
Missouri,Haywood City,151,22,47,19,10,0,98
Missouri,Hayward,130,8,42,20,0,0,70
Missouri,Hayti Heights,557,92,109,62,2,0,265
Missouri,Hayti,2840,506,741,427,73,60,1807
Missouri,Hawk Point,796,61,241,105,21,5,433
Missouri,Carterville,1795,172,496,381,115,28,1192
Missouri,Breckenridge,277,23,82,59,13,3,180
Missouri,Hartwell,0,0,0,0,0,0,0
Missouri,Hartville,588,125,133,98,28,21,405
Missouri,Hartsburg,100,5,19,38,15,4,81
Missouri,Harrisonville,10003,602,2861,1870,853,348,6534
Missouri,Harrisburg,347,13,60,82,27,11,193
Missouri,Harris,46,7,16,18,0,0,41
Missouri,Hardin,555,45,188,103,18,23,377
Missouri,Hannibal,17717,1930,4339,3204,1450,736,11659
Missouri,Hanley Hills,2194,219,558,458,97,66,1398
Missouri,Hamilton,1663,204,547,296,77,41,1165
Missouri,Halltown,109,23,34,14,7,0,78
Missouri,Harviell,163,0,81,0,0,0,81
Missouri,Breckenridge Hills,4728,450,1181,884,127,89,2731
Missouri,East Lynne,248,11,79,57,10,2,159
Missouri,Brewer,419,62,109,122,0,0,293
Missouri,Granby,2170,259,392,629,38,17,1335
Missouri,Grain Valley,13134,566,2821,2524,1376,827,8114
Missouri,Graham,214,13,68,35,6,1,123
Missouri,Gower,1588,67,400,351,151,47,1016
Missouri,Goss,0,0,0,0,0,0,0
Missouri,Gordonville,416,24,121,91,41,36,313
Missouri,Goodnight,12,0,3,2,2,0,7
Missouri,Goodman,1141,170,324,225,26,20,765
Missouri,Golden City,578,65,166,112,25,5,373
Missouri,Golden,491,27,202,97,74,3,403
Missouri,Glenwood,175,16,40,56,5,2,119
Missouri,Glen Echo Park,126,8,20,28,11,23,90
Missouri,Glendale,5928,0,274,550,1738,1413,3975
Missouri,Glen Allen,100,11,21,18,0,0,50
Missouri,Glenaire,440,38,129,106,53,21,347
Missouri,Brentwood,8052,159,649,1106,2022,2012,5948
Missouri,Marshall,13048,1100,2969,2178,1022,659,7928
Missouri,Grand Falls Plaza,111,4,14,29,25,19,91
Missouri,Marquand,318,25,95,42,7,7,176
Missouri,Grandin,175,33,40,30,6,0,109
Missouri,Grandview,24997,2028,4736,5905,2103,1056,15828
Missouri,Guilford,54,3,20,10,8,1,42
Missouri,Greenwood,5400,132,937,1200,781,275,3325
Missouri,Greenville,530,92,103,143,13,6,357
Missouri,Greentop,446,48,137,89,25,10,309
Missouri,Green Ridge,467,25,109,106,29,11,280
Missouri,Green Park,2630,264,522,680,326,172,1964
Missouri,Greenfield,1325,192,387,254,50,49,932
Missouri,Greendale,636,17,115,158,126,67,483
Missouri,Green City,695,78,242,106,33,22,481
Missouri,Greencastle,330,77,103,38,7,6,231
Missouri,Gray Summit,2943,202,652,648,261,22,1785
Missouri,Grayridge,68,11,17,25,0,0,53
Missouri,Grayhawk,536,9,186,215,0,9,419
Missouri,Gravois Mills,154,26,63,9,0,0,98
Missouri,Grantwood Village,962,17,89,129,291,162,688
Missouri,Grant City,835,66,306,162,71,15,620
Missouri,Granger,28,4,6,8,3,0,21
Missouri,Grand Pass,73,5,19,19,2,3,48
Missouri,Innsbrook,786,21,142,148,211,108,630
Missouri,Marlborough,2006,104,284,651,454,113,1606
Missouri,Triplett,18,1,10,1,0,4,16
Missouri,Sunset Hills,8533,119,1510,1430,1816,1086,5961
Missouri,Sunrise Beach,421,50,108,134,40,4,336
Missouri,Sundown,27,8,7,3,9,0,27
Missouri,Sumner,106,3,29,25,4,1,62
Missouri,Summersville,636,44,108,124,35,21,332
Missouri,Sullivan,6998,907,1722,1281,301,169,4380
Missouri,Sugar Creek,3339,274,1018,752,167,109,2320
Missouri,Sturgeon,778,70,204,167,84,33,558
Missouri,Strasburg,143,21,31,33,15,3,103
Missouri,Strafford,2137,153,519,502,188,48,1410
Missouri,Stover,1204,167,352,140,33,31,723
Missouri,Stoutsville,53,5,19,12,0,0,36
Missouri,Stoutland,171,11,75,40,16,5,147
Missouri,Stotts City,152,18,30,45,12,0,105
Missouri,Stotesbury,14,2,12,0,0,0,14
Missouri,Stockton,1849,178,439,336,118,84,1155
Missouri,Stewartsville,767,66,282,136,61,6,551
Missouri,Sweet Springs,1521,223,454,323,76,46,1122
Missouri,Marionville,2153,245,533,480,82,43,1383
Missouri,Sycamore Hills,623,22,147,168,103,34,474
Missouri,Tallapoosa,205,26,85,16,2,0,129
Missouri,Trimble,680,47,171,160,28,12,418
Missouri,Trenton,6042,550,1533,1223,421,324,4051
Missouri,Tracy,214,17,65,50,18,9,159
Missouri,Town and Country,10960,173,604,1194,2720,3310,8001
Missouri,Tipton,3303,544,1222,643,155,76,2640
Missouri,Tindall,78,8,7,16,8,2,41
Missouri,Tina,93,18,42,7,7,2,76
Missouri,Tightwad,62,3,21,21,5,0,50
Missouri,Three Creeks,4,0,2,2,0,0,4
Missouri,Thomasville,38,12,26,0,0,0,38
Missouri,Theodosia,231,30,104,28,13,6,181
Missouri,Thayer,2236,274,503,439,125,61,1402
Missouri,Terre du Lac,2401,148,463,703,225,153,1692
Missouri,Tarrants,0,0,0,0,0,0,0
Missouri,Tarkio,1420,154,436,295,154,63,1102
Missouri,Taos,1233,83,258,243,191,54,829
Missouri,Taneyville,327,60,89,60,3,15,227
Missouri,Syracuse,178,31,72,22,5,2,132
Missouri,Stella,124,27,31,18,5,0,81
Missouri,Ionia,119,24,46,23,0,2,95
Missouri,Irondale,451,69,123,69,5,3,269
Missouri,Lamar,4457,419,1119,1014,362,207,3121
Missouri,Lake Winnebago,1287,13,117,239,331,249,949
Missouri,Lake Waukomis,885,7,135,234,174,153,703
Missouri,Lake Viking,360,24,159,87,44,30,344
Missouri,Lake Tekakwitha,235,22,71,56,17,13,179
Missouri,Lake Tapawingo,689,28,136,173,126,97,560
Missouri,Lakeside,0,0,0,0,0,0,0
Missouri,Lakeshire,1579,88,289,417,224,158,1176
Missouri,Lake St. Louis,14933,207,2226,3487,2659,1577,10156
Missouri,Lake Ozark,1626,82,342,407,168,101,1100
Missouri,Lake Mykee Town,491,13,81,116,84,31,325
Missouri,Lake Lotawana,2100,95,310,526,406,238,1575
Missouri,Lake Lafayette,332,55,123,60,11,0,249
Missouri,Lake Annette,136,11,39,43,12,1,106
Missouri,La Grange,950,82,357,160,25,34,658
Missouri,Ladue,8559,58,341,635,2216,2592,5842
Missouri,La Due,55,23,15,8,0,0,46
Missouri,Lamar Heights,200,25,53,31,18,18,145
Missouri,Laddonia,556,57,172,95,19,11,354
Missouri,Lambert,0,0,0,0,0,0,0
Missouri,Northwoods,4208,282,1428,821,308,253,3092
Missouri,New Florence,794,122,325,128,32,0,607
Missouri,New Franklin,1242,179,374,237,82,20,892
Missouri,New Hampton,270,19,87,54,7,3,170
Missouri,New Haven,2194,187,480,543,117,18,1345
Missouri,New London,959,120,293,128,42,23,606
Missouri,New Madrid,3042,312,782,646,153,149,2042
Missouri,New Melle,448,22,108,104,66,49,349
Missouri,Newtonia,258,39,62,58,10,5,174
Missouri,Newtown,218,14,99,27,13,4,157
Missouri,Niangua,396,49,140,85,19,1,294
Missouri,Nixa,20177,906,3992,4905,1861,966,12630
Missouri,Noel,1877,454,318,230,28,19,1049
Missouri,Norborne,739,43,249,150,35,36,513
Missouri,Normandy,4985,433,1052,958,325,385,3153
Missouri,North Kansas City,4298,513,981,1147,447,300,3388
Missouri,North Lilbourn,37,3,34,0,0,0,37
Missouri,Northmoor,380,35,115,85,30,5,270
Missouri,La Monte,1406,371,222,139,39,14,785
Missouri,Irena,23,0,8,4,0,4,16
Missouri,Laclede,326,30,155,44,6,2,237
Missouri,LaBarque Creek,1857,0,435,395,252,253,1335
Missouri,Junction City,474,131,82,43,6,14,276
Missouri,Josephville,399,20,116,68,59,17,280
Missouri,Joplin,51042,3953,11138,10406,5292,2778,33567
Missouri,Jonesburg,754,120,290,103,28,8,549
Missouri,Jerico Springs,180,24,69,36,2,3,134
Missouri,Jennings,14755,1884,3050,3232,727,304,9197
Missouri,Jefferson City,43186,2554,8598,8608,6677,3561,29998
Missouri,Jasper,987,127,315,93,70,23,628
Missouri,Jane,460,69,133,56,33,1,292
Missouri,Jamestown,351,38,123,39,27,3,230
Missouri,Jamesport,543,75,152,58,29,0,314
Missouri,Jameson,82,7,36,18,4,2,67
Missouri,Jacksonville,159,19,43,26,4,0,92
Missouri,Jackson,14439,694,3227,2913,1486,897,9217
Missouri,Irwin,35,27,8,0,0,0,35
Missouri,Ironton,1571,189,343,280,111,53,976
Missouri,Iron Mountain Lake,826,147,189,151,24,14,525
Missouri,Kahoka,1969,154,511,486,117,49,1317
Missouri,La Belle,647,101,239,102,21,0,463
Missouri,Kansas City,467990,36295,81767,94102,63172,37895,313231
Missouri,Kelso,588,39,156,87,71,35,388
Missouri,Koshkonong,248,36,81,37,9,13,176
Missouri,Knox City,261,27,101,42,3,0,173
Missouri,Knob Noster,2779,152,466,687,183,72,1560
Missouri,Kissee Mills,998,122,383,185,85,33,808
Missouri,Kirkwood,27612,656,2449,4438,7224,5280,20047
Missouri,Kirksville,17574,927,2465,1944,1290,1375,8001
Missouri,Kirbyville,244,39,70,30,18,4,161
Missouri,Kinloch,267,46,89,36,2,2,175
Missouri,Kingsville,233,23,71,36,12,10,152
Missouri,Kingston,332,40,143,68,11,5,267
Missouri,Kingdom City,135,24,40,14,9,5,92
Missouri,King City,1006,45,331,143,90,52,661
Missouri,Kimmswick,143,4,37,41,2,0,84
Missouri,Kimberling City,2687,141,653,828,343,178,2143
Missouri,Kidder,215,24,78,34,21,4,161
Missouri,Keytesville,515,40,199,70,47,27,383
Missouri,Kennett,10678,1945,2452,1615,590,460,7062
Missouri,Kearney,9039,216,1659,1880,1140,613,5508
Missouri,Steelville,2225,383,625,321,69,65,1463
Missouri,Steele,2237,276,433,439,89,124,1361
Missouri,Stark City,138,42,30,37,4,0,113
Missouri,Paris,1215,83,375,214,79,70,821
Missouri,Parkdale,197,17,70,41,12,2,142
Missouri,Park Hills,8695,1043,2076,1857,449,210,5635
Missouri,Parkville,5946,163,565,915,1271,1003,3917
Missouri,Parkway,355,61,84,83,19,7,254
Missouri,Parma,649,197,151,71,12,0,431
Missouri,Parnell,137,9,36,17,6,5,73
Missouri,Pasadena Hills,935,16,100,251,175,232,774
Missouri,Pasadena Park,555,0,58,129,127,106,420
Missouri,McCord Bend,280,65,81,49,0,12,207
Missouri,McBaine,6,2,0,2,2,0,6
Missouri,Luray,61,7,29,8,0,0,44
Missouri,Lupus,30,0,6,4,14,3,27
Missouri,Ludlow,119,35,28,16,0,1,80
Missouri,Lucerne,93,5,37,7,1,1,51
Missouri,Lowry City,522,80,185,94,21,10,390
Missouri,Louisiana,3322,447,1021,384,135,57,2044
Missouri,Palmyra,3622,375,1055,499,263,148,2340
Missouri,Louisburg,146,13,33,37,1,3,87
Missouri,Pagedale,3309,431,795,766,66,74,2132
Missouri,Ozora,159,58,45,15,1,0,119
Missouri,Old Monroe,243,28,81,63,8,4,184
Missouri,Olean,99,8,26,16,22,0,72
Missouri,Olivette,7843,340,630,1334,1544,1762,5610
Missouri,Olympian Village,651,87,142,146,26,5,406
Missouri,Oran,1313,164,417,236,89,35,941
Missouri,Oregon,933,40,343,191,76,42,692
Missouri,Oronogo,2568,157,416,471,349,93,1486
Missouri,Orrick,785,38,277,141,34,18,508
Missouri,Osage Beach,4477,358,1216,975,601,288,3438
Missouri,Osborn,514,51,164,124,16,12,367
Missouri,Osceola,904,172,290,180,51,22,715
Missouri,Osgood,19,0,4,2,4,0,10
Missouri,Otterville,498,35,153,113,15,9,325
Missouri,Overland,16011,1613,4012,3197,1348,502,10672
Missouri,Owensville,2648,366,750,424,137,49,1726
Missouri,Oxly,113,7,35,36,5,0,83
Missouri,Ozark,18608,1253,3170,4186,2006,1016,11631
Missouri,Pacific,6305,589,1613,1569,336,129,4236
Missouri,Old Jamestown,19239,836,3213,4536,3023,2047,13655
Missouri,Longtown,128,18,39,18,4,0,79
Missouri,Loma Linda,804,15,154,220,111,135,635
Missouri,Leisure Lake,205,7,63,40,11,0,121
Missouri,Leeton,678,43,122,209,39,19,432
Missouri,Lee's Summit,93618,2205,12344,20538,17104,9208,61399
Missouri,Lebanon,14637,1834,3863,2878,832,406,9813
Missouri,Leawood,652,37,101,122,93,69,422
Missouri,Leasburg,466,72,117,50,22,3,264
Missouri,Leadwood,1543,219,302,315,26,21,883
Missouri,Leadington,360,49,96,87,27,2,261
Missouri,Lawson,2319,213,675,405,134,85,1512
Missouri,Laurie,960,117,378,221,89,19,824
Missouri,La Tour,62,17,45,0,0,0,62
Missouri,Lathrop,2215,129,672,448,88,72,1409
Missouri,La Russell,235,14,53,52,2,0,121
Missouri,Laredo,209,15,62,51,13,0,141
Missouri,La Plata,1323,131,460,299,41,40,971
Missouri,Lancaster,726,53,208,139,45,27,472
Missouri,Lanagan,428,106,90,56,15,4,271
Missouri,Lemay,16603,2181,4543,2972,1401,502,11599
Missouri,Lone Jack,1076,55,199,257,148,29,688
Missouri,Leonard,59,2,22,10,3,3,40
Missouri,Levasy,75,1,28,7,5,7,48
Missouri,Lohman,192,9,60,23,39,6,137
Missouri,Lockwood,1054,102,299,235,81,43,760
Missouri,Lock Springs,64,12,11,9,2,0,34
Missouri,Loch Lloyd,656,9,43,128,236,126,542
Missouri,Livonia,82,14,27,10,0,0,51
Missouri,Lithium,38,5,22,7,0,0,34
Missouri,Linneus,350,66,128,40,12,6,252
Missouri,Linn Creek,218,23,62,36,28,7,156
Missouri,Linn,1567,102,314,339,115,56,926
Missouri,Lincoln,1141,177,296,248,37,24,782
Missouri,Lilbourn,1202,271,241,143,41,40,736
Missouri,Licking,3066,632,926,495,108,51,2212
Missouri,Liberty,30035,1303,5162,5722,4654,2407,19248
Missouri,Liberal,739,72,216,139,33,10,470
Missouri,Lexington,4633,591,1118,1075,413,240,3437
Missouri,Lewistown,533,66,223,66,17,2,374
Missouri,Lewis and Clark Village,122,11,23,35,3,3,75
Missouri,Leslie,138,7,26,23,16,0,72
Missouri,Old Appleton,19,1,8,3,3,2,17
Missouri,O'Fallon,83053,3142,13237,17093,12740,7011,53223
Missouri,Odessa,5222,165,1518,1061,401,97,3242
Missouri,Shoal Creek Drive,303,23,73,75,30,18,219
Missouri,Sheridan,234,18,71,56,11,9,165
Missouri,Glasgow Village,5178,475,985,991,129,52,2632
Missouri,Glasgow,1135,89,303,168,136,54,750
Missouri,Gladstone,26309,1755,5806,6177,3391,1677,18806
Missouri,Ginger Blue,35,2,10,9,2,1,24
Missouri,Gilman City,394,51,106,69,26,4,256
Missouri,Gilliam,188,24,70,30,15,1,140
Missouri,Gideon,1150,248,300,137,22,9,716
Missouri,Gibbs,126,4,49,13,3,0,69
Missouri,Gerster,22,9,6,4,0,0,19
Missouri,Gerald,1374,114,325,241,96,40,816
Missouri,Gentry,54,3,20,12,0,0,35
Missouri,Gasconade,222,29,84,40,7,5,165
Missouri,Garden City,1534,173,500,271,77,25,1046
Missouri,Galt,206,35,81,49,0,6,171
Missouri,Gallatin,1784,142,521,314,162,72,1211
Missouri,Shoal Creek Estates,126,1,12,38,30,10,91
Missouri,Galena,556,94,164,55,13,9,335
Missouri,Shrewsbury,6208,230,728,1211,1616,846,4631
Missouri,Sikeston,16436,1770,4130,3069,1192,693,10854
Missouri,Stanberry,1359,111,339,255,109,27,841
Missouri,Springfield,163763,11999,29205,33647,17707,10266,102824
Missouri,Spokane,181,28,31,59,18,11,147
Missouri,Spickard,334,54,57,77,7,3,198
Missouri,Sparta,1943,186,513,386,154,20,1259
Missouri,Spanish Lake,19218,1124,3795,4317,1382,560,11178
Missouri,Southwest City,1020,241,137,88,46,4,516
Missouri,South Lineville,25,3,2,13,0,0,18
Missouri,South Greenfield,149,33,51,26,0,2,112
Missouri,South Gorin,108,34,13,15,5,0,67
Missouri,South Gifford,49,9,19,6,0,0,34
Missouri,South Fork,190,0,55,68,6,21,150
Missouri,Smithville,8911,333,1874,2129,1102,606,6044
Missouri,Smithton,483,51,93,137,15,8,304
Missouri,Slater,2065,202,549,466,72,63,1352
Missouri,Skidmore,269,20,75,51,22,5,173
Missouri,Silex,71,23,11,30,0,2,66
Missouri,Sibley,302,33,104,60,13,7,217
Missouri,Gainesville,799,57,188,179,45,28,497
Missouri,Fulton,12812,1740,2934,2042,895,533,8144
Missouri,Frontenac,3523,1,137,286,1065,1027,2516
Missouri,Macks Creek,516,65,134,75,2,23,299
Missouri,McKittrick,68,6,28,10,1,0,45
Missouri,Mackenzie,123,3,11,38,38,18,108
Missouri,McFall,106,5,20,18,4,3,50
Missouri,Norwood,675,69,170,129,6,8,382
Missouri,Norwood Court,868,71,190,264,37,20,582
Missouri,Novelty,164,9,59,40,1,5,114
Missouri,Novinger,456,81,183,49,16,7,336
Missouri,Oak Grove,7839,402,1754,1901,506,167,4730
Missouri,Oak Grove Village,406,102,97,102,5,2,308
Missouri,Oakland,1506,75,172,286,341,261,1135
Missouri,Oak Ridge,235,21,81,38,5,11,156
Missouri,Oaks,128,8,12,23,32,10,85
Missouri,Oakview,512,24,117,127,61,12,341
Missouri,Oakville,36663,1051,6338,8657,6736,3295,26077
Missouri,Oakwood,153,6,26,24,32,23,111
Missouri,Oakwood Park,185,9,43,45,29,20,146
Missouri,Macon,5468,544,1407,977,549,213,3690
Missouri,Madison,635,60,179,135,9,9,392
Missouri,Maitland,294,19,97,55,8,0,179
Missouri,Malden,4407,830,1080,623,153,164,2850
Missouri,Frohna,243,28,73,43,9,9,162
Missouri,Fremont Hills,894,28,89,190,240,153,700
Missouri,Fremont,64,0,34,23,0,0,57
Missouri,Freistatt,131,25,40,23,5,6,99
Missouri,Freeman,511,28,129,143,22,12,334
Missouri,Freeburg,447,35,135,113,18,15,316
Missouri,Fredericktown,4054,807,962,695,249,160,2873
Missouri,Franklin,70,25,23,11,0,0,59
Missouri,New Cambria,164,4,59,52,15,3,133
Missouri,Frankford,441,41,142,59,40,10,292
Missouri,Fountain N' Lakes,332,50,81,36,6,5,178
Missouri,Foster,188,20,78,18,33,4,153
Missouri,Marceline,2154,147,670,354,113,63,1347
Missouri,Marble Hill,1613,246,380,285,42,37,990
Missouri,Maplewood,7960,513,1220,1854,1570,847,6004
Missouri,Mansfield,1191,192,301,209,56,15,773
Missouri,Manchester,18187,385,2140,3414,3980,2324,12243
Missouri,Malta Bend,330,41,76,55,12,2,186
Missouri,Frankclay,120,31,73,16,0,0,120
Missouri,Newburg,657,116,168,97,12,19,412
Missouri,Bethel,103,6,29,29,10,0,74
Missouri,Brumley,65,10,23,9,7,1,50
Missouri,Brooklyn Heights,123,22,39,18,10,0,89
Missouri,Browning,241,18,99,19,11,0,147
Missouri,Brownington,88,16,24,27,0,0,67
Missouri,Brimson,63,7,37,5,0,0,49
Missouri,Brunswick,858,106,254,131,53,34,578
Missouri,Bucklin,511,58,196,103,49,8,414
Missouri,Buckner,3077,276,921,622,114,69,2002
Missouri,Buffalo,3066,426,720,591,170,147,2054
Missouri,Bull Creek,522,54,76,122,0,3,255
Missouri,Bunceton,339,37,94,86,8,10,235
Missouri,Bunker,412,89,113,48,2,2,254
Missouri,Bridgeton,11699,743,2599,2597,1602,792,8333
Missouri,Brookfield,4391,486,1525,771,188,108,3078
Missouri,Bronaugh,219,34,47,35,4,8,128
Montana,Old Agency,117,12,15,32,1,2,62
Montana,Noxon,257,28,79,39,12,2,160
Montana,North Browning,2444,162,526,545,48,13,1294
Montana,Niarada,11,0,8,0,3,0,11
Montana,Neihart,36,6,11,11,8,0,36
Montana,Nashua,305,23,111,76,20,9,239
Montana,Musselshell,65,10,39,9,0,0,58
Montana,Alder,87,3,31,19,11,0,64
Montana,Moore,177,9,52,59,15,4,139
Montana,Montana City,2793,41,443,579,634,255,1952
Montana,Missoula,69190,1681,8402,13405,12216,8016,43720
Montana,Muddy,616,44,114,100,15,6,279
Montana,Olney,201,14,83,43,3,0,143
Montana,Opheim,76,1,21,12,8,9,51
Montana,Orchard Homes,5576,147,924,1215,988,436,3710
Montana,Outlook,79,6,17,22,5,1,51
Montana,Ovando,81,10,25,31,8,0,74
Montana,Pablo,2725,139,573,639,86,24,1461
Montana,Paradise,204,27,67,47,21,2,164
Montana,Park City,1014,57,275,206,50,28,616
Montana,Parker School,606,53,79,137,42,7,318
Montana,Philipsburg,666,94,175,137,74,65,545
Montana,Piltzville,408,7,95,92,42,25,261
Montana,Sun River,101,38,32,9,4,0,83
Montana,Miles City,8627,465,1787,2457,759,281,5749
Montana,Midvale,330,0,15,40,36,36,127
Montana,Manhattan,1191,29,288,306,213,86,922
Montana,Medicine Lake,314,8,67,70,49,16,210
Montana,Lewistown,5883,242,1764,1095,1051,287,4439
Montana,Lewistown Heights,736,37,93,159,19,31,339
Montana,Libby,2671,276,696,521,251,140,1884
Montana,Lima,185,3,70,73,12,2,160
Montana,Lincoln,829,37,230,274,61,18,620
Montana,Lindisfarne,283,36,33,127,48,0,244
Montana,Little Bitterroot Lake,207,10,47,56,35,7,155
Montana,Little Browning,277,14,46,64,23,0,147
Montana,Livingston,7136,284,1874,1444,1242,530,5374
Montana,Lockwood,7437,473,1998,1744,610,232,5057
Montana,Lodge Grass,325,31,51,76,21,8,187
Montana,Melstone,82,16,23,22,8,0,69
Montana,Lodge Pole,274,43,42,55,9,5,154
Montana,Lolo,4125,83,845,970,556,302,2756
Montana,Loma,36,4,32,0,0,0,36
Montana,Lonepine,164,6,35,46,13,8,108
Montana,Malmstrom AFB,3651,0,172,730,333,191,1426
Montana,Malta,1867,161,513,474,230,65,1443
Montana,Superior,804,59,212,224,38,14,547
Montana,Marion,852,87,286,206,64,14,657
Montana,Martin City,380,32,207,60,41,0,340
Montana,Martinsdale,81,0,16,43,14,0,73
Montana,Marysville,95,0,29,12,37,17,95
Montana,Maxville,109,28,34,26,4,11,103
Montana,Logan,41,15,6,10,10,0,41
Montana,Swan Lake,114,32,17,27,21,5,102
Montana,Townsend,1970,130,497,377,138,104,1246
Montana,Sylvanite,116,0,32,35,19,6,92
Montana,Whitehall,926,50,193,265,168,33,709
Montana,White Haven,602,48,152,120,51,0,371
Montana,White Sulphur Springs,979,67,328,169,80,18,662
Montana,Whitewater,43,2,12,8,6,0,28
Montana,Wibaux,522,73,166,95,42,11,387
Montana,Willow Creek,180,16,44,34,26,9,129
Montana,Wilsall,198,10,26,47,34,20,137
Montana,Wineglass,386,0,37,57,67,23,184
Montana,Winifred,179,11,48,38,25,1,123
Montana,Winnett,177,2,100,21,9,8,140
Montana,Winston,0,0,0,0,0,0,0
Montana,Wisdom,87,6,38,18,11,5,78
Montana,Wolf Point,2755,192,720,467,168,83,1630
Montana,Woods Bay,626,7,132,224,82,37,482
Montana,Worden,749,0,233,121,85,23,462
Montana,Wye,482,23,159,94,41,18,335
Montana,Wyola,142,20,29,37,9,3,98
Montana,Yaak,260,23,101,63,32,8,227
Montana,Zortman,23,0,9,6,8,0,23
Montana,Crow Agency,1890,151,391,327,95,45,1009
Montana,Culbertson,826,55,153,190,75,25,498
Montana,Custer,146,9,47,29,12,14,111
Montana,Cut Bank,2985,295,543,538,322,154,1852
Montana,Whitefish,6692,165,812,1392,1744,832,4945
Montana,Wheatland,447,18,125,115,92,8,358
Montana,West Yellowstone,1279,58,331,291,172,45,897
Montana,West Kootenai,89,0,73,16,0,0,89
Montana,Terry,838,38,289,151,65,37,580
Montana,The Silos,640,48,191,76,118,45,478
Montana,Thompson Falls,941,113,331,178,86,51,759
Montana,Three Forks,1888,123,512,458,211,55,1359
Montana,Toston,237,0,141,5,4,0,150
Montana,Lavina,194,9,57,53,17,5,141
Montana,Trego,644,57,129,142,68,15,411
Montana,Trout Creek,189,31,40,50,17,26,164
Montana,Troy,710,82,182,228,50,28,570
Montana,Turah,431,10,108,100,29,39,286
Montana,Turner,85,2,26,18,8,5,59
Montana,Sweet Grass,85,3,23,35,11,0,72
Montana,Turtle Lake,304,58,63,64,0,0,185
Montana,Ulm,559,21,187,163,38,40,449
Montana,Valier,577,24,139,147,52,13,375
Montana,Vaughn,863,85,234,175,64,19,577
Montana,Victor,829,36,250,85,122,0,493
Montana,Virginia City,239,15,49,69,38,13,184
Montana,Walkerville,878,28,234,179,64,17,522
Montana,Weeksville,79,17,34,12,0,0,63
Montana,Westby,170,13,39,46,9,21,128
Montana,West Glacier,311,7,41,60,47,54,209
Montana,West Glendive,2067,87,649,578,211,39,1564
Montana,West Havre,167,0,30,34,34,0,98
Montana,Twin Bridges,260,8,81,49,37,20,195
Montana,Laurel,6933,379,2057,1596,631,187,4850
Montana,Lame Deer,2106,270,370,394,84,37,1155
Montana,Lakeside,2918,67,466,692,691,295,2211
Montana,Boneau,364,21,46,78,0,0,145
Montana,Bonner-West Riverside,1600,103,440,367,169,55,1134
Montana,Evergreen,6955,348,1834,1713,464,140,4499
Montana,Evaro,339,11,90,61,35,26,223
Montana,Eureka,1254,105,278,350,122,51,906
Montana,Ennis,864,49,317,255,95,26,742
Montana,Emigrant,358,6,105,49,83,28,271
Montana,Elmo,195,22,14,34,44,0,114
Montana,Elliston,286,13,72,80,42,11,218
Montana,Elkhorn,18,0,0,9,9,0,18
Montana,Ekalaka,297,12,86,99,31,14,242
Montana,Edgar,134,19,67,16,7,0,109
Montana,East Missoula,2359,106,249,720,332,92,1499
Montana,East Helena,2306,77,484,498,279,134,1472
Montana,East Glacier Park Village,486,16,104,127,77,35,359
Montana,Dutton,326,15,78,77,42,14,226
Montana,Dupuyer,87,19,26,29,11,0,85
Montana,Drummond,377,45,92,94,29,7,267
Montana,Kremlin,76,13,10,24,12,4,63
Montana,Lake Mary Ronan,86,3,15,13,19,6,56
Montana,Sun Prairie,1258,176,340,250,125,34,925
Montana,Sunburst,254,9,61,77,26,5,178
Montana,Sula,70,16,0,40,14,0,70
Montana,Stryker,35,2,25,6,2,0,35
Montana,Stockett,204,11,41,51,0,0,103
Montana,Stevensville,2048,87,628,450,134,68,1367
Montana,Starr School,90,11,16,17,0,0,44
Montana,Black Eagle,1151,110,276,269,105,15,775
Montana,Birney,92,4,16,10,5,9,44
Montana,Billings,108134,5279,21259,24082,15597,6787,73004
Montana,Big Timber,1517,76,444,308,195,70,1093
Montana,Alberton,479,17,85,178,18,23,321
Montana,Absarokee,1068,50,299,366,113,11,839
Montana,Amsterdam,155,12,24,27,7,3,73
Montana,Anaconda-Deer Lodge,9211,613,2603,2373,699,431,6719
Montana,Antelope,57,5,19,5,5,0,34
Montana,Arlee,651,38,131,138,50,52,409
Montana,Ashland,981,79,166,140,71,62,518
Montana,Augusta,267,20,80,64,40,13,217
Montana,Avon,128,6,23,32,11,1,73
Montana,Azure,180,20,26,40,5,0,91
Montana,Babb,149,0,24,80,23,0,127
Montana,Bainville,276,10,61,60,20,8,159
Montana,Baker,1838,95,510,511,113,38,1267
Montana,Stanford,375,14,109,101,64,24,312
Montana,Ballantine,195,95,90,0,10,0,195
Montana,Batavia,367,29,105,56,24,8,222
Montana,Bearcreek,138,2,55,34,10,3,104
Montana,Bear Dance,261,0,115,43,75,22,255
Montana,Beaver Creek,378,16,136,82,26,0,260
Montana,Belfry,197,7,34,86,13,4,144
Montana,Belgrade,7738,155,1549,1604,1019,438,4765
Montana,Belknap,189,0,110,79,0,0,189
Montana,Belt,683,29,240,133,39,16,457
Montana,Biddle,20,0,10,5,5,0,20
Montana,Big Arm,230,28,67,26,51,0,172
Montana,Bigfork,4621,143,717,1349,590,346,3145
Montana,Big Sandy,677,26,201,139,74,29,469
Montana,Big Sky,2767,114,302,427,848,177,1868
Montana,Basin,227,15,36,60,31,8,150
Montana,Darby,673,71,201,108,32,20,432
Montana,Springhill,58,0,0,12,16,20,48
Montana,Spokane Creek,306,0,40,91,104,35,270
Montana,Ronan,1858,133,348,467,164,66,1178
Montana,Rollins,284,43,37,57,72,11,220
Montana,Rocky Point,91,13,0,43,35,0,91
Montana,Rocky Boy West,975,93,125,218,40,9,485
Montana,Rocky Boy's Agency,474,24,80,100,23,7,234
Montana,Roberts,301,11,74,80,50,0,215
Montana,Riverbend,420,56,155,70,18,20,319
Montana,Richey,165,3,42,48,10,11,114
Montana,Rexford,89,12,34,33,0,1,80
Montana,Reserve,32,0,8,9,4,0,21
Montana,Reed Point,232,2,76,50,17,29,174
Montana,Red Lodge,2236,131,378,579,472,215,1775
Montana,Ravalli,61,15,8,38,0,0,61
Montana,Radersburg,208,19,144,12,0,0,175
Montana,Rader Creek,195,0,77,62,20,26,185
Montana,Pryor,630,39,100,156,28,12,335
Montana,Pray,599,7,209,86,106,62,470
Montana,Power,172,6,47,59,11,5,128
Montana,Poplar,830,59,166,156,38,16,435
Montana,Pony,154,0,66,35,20,12,133
Montana,Ponderosa Pines,464,30,134,83,80,8,335
Montana,Polson,4643,210,1153,851,375,274,2863
Montana,Plevna,142,9,18,35,29,2,93
Montana,Plentywood,1891,142,471,539,229,33,1414
Montana,Plains,758,83,264,151,62,27,587
Montana,Pioneer Junction,794,112,170,268,55,18,623
Montana,Pinesdale,985,77,166,89,20,8,360
Montana,Roscoe,53,0,7,15,31,0,53
Montana,Rosebud,119,0,53,17,9,3,82
Montana,Roundup,1900,155,536,413,159,83,1346
Montana,Roy,140,6,68,27,15,1,117
Montana,South Hills,504,5,36,50,114,86,291
Montana,South Glastonbury,284,0,67,53,71,21,212
Montana,South Browning,1852,114,484,240,32,12,882
Montana,Somers,1000,0,96,334,241,7,678
Montana,Simms,427,28,151,90,29,5,303
Montana,Silver Gate,20,0,2,4,2,6,14
Montana,Silesia,111,15,12,23,28,8,86
Montana,Sidney,6216,304,1577,1618,403,206,4108
Montana,Sheridan,706,52,154,171,114,39,530
Montana,Shepherd,564,20,162,177,34,9,402
Montana,Shelby,3272,411,928,723,218,78,2358
Montana,Shawmut,47,3,25,10,0,2,40
Montana,Seeley Lake,1081,92,230,246,187,83,838
Montana,Springdale,43,0,18,9,0,0,27
Montana,Sedan,121,0,34,47,10,10,101
Montana,Savage,339,15,102,50,19,12,198
Montana,Santa Rita,89,0,0,9,13,0,22
Montana,Sangrey,444,75,25,93,11,0,204
Montana,Sand Coulee,245,11,71,59,34,7,182
Montana,St. Xavier,4,0,4,0,0,0,4
Montana,St. Regis,261,23,48,24,44,0,139
Montana,St. Pierre,498,24,72,119,17,5,237
Montana,St. Marie,619,50,215,119,18,10,412
Montana,St. Ignatius,850,79,136,204,92,28,539
Montana,Saddle Butte,175,0,28,47,0,11,86
Montana,Saco,202,27,46,46,16,9,144
Montana,Ryegate,196,21,90,27,19,10,167
Montana,Rudyard,201,0,46,70,26,5,147
Montana,Scobey,1129,35,285,333,149,40,842
Montana,Dayton,89,9,29,10,14,14,76
Montana,Alzada,21,6,7,7,0,0,20
Montana,Deer Lodge,3056,237,749,761,292,150,2189
Montana,Gardiner,1099,36,207,182,199,115,739
Montana,Garrison,57,1,22,18,3,6,50
Montana,Geraldine,259,19,56,63,20,14,172
Montana,Boulder,1287,91,289,393,69,41,883
Montana,Box Elder,83,4,5,19,9,1,38
Montana,Boyd,20,0,5,6,0,0,11
Montana,Bozeman,40319,439,2823,6580,8134,4625,22601
Montana,Gallatin River Ranch,74,0,19,5,28,18,70
Montana,Brady,174,9,39,48,31,28,155
Montana,Bridger,11,0,0,0,11,0,11
Montana,Broadus,477,35,115,121,27,39,337
Montana,Broadview,163,5,51,41,10,8,115
Montana,Brockton,173,8,49,29,9,5,100
Montana,Browning,1108,103,306,223,62,29,723
Montana,Busby,690,64,107,74,20,12,277
Montana,Butte-Silver Bow (balance),33671,2087,7911,7148,3853,1815,22814
Montana,Bridger,894,53,266,209,59,51,638
Montana,Gallatin Gateway,933,55,148,213,155,45,616
Montana,Fromberg,388,18,107,117,29,9,280
Montana,Froid,148,10,31,22,48,3,114
Montana,Herron,35,4,9,22,0,0,35
Montana,Heron,222,25,88,6,50,14,183
Montana,Helena West Side,1365,67,209,239,336,255,1106
Montana,Helena Valley West Central,8564,259,1438,2075,1371,493,5636
Montana,Helena Valley Southeast,7383,321,1565,1877,757,310,4830
Montana,Cooke City,35,1,5,19,8,2,35
Montana,Conrad,2604,214,623,568,286,94,1785
Montana,Conner,90,28,8,16,10,4,66
Montana,Condon,431,16,116,139,34,42,347
Montana,Columbus,2181,121,629,564,142,63,1519
Montana,Fortine,465,49,105,152,35,12,353
Montana,Fort Peck,197,3,58,48,40,16,165
Montana,Fort Shaw,161,27,42,41,8,6,124
Montana,Fort Smith,37,9,8,13,0,0,30
Montana,Fox Lake,100,0,25,24,7,4,60
Montana,Frazer,244,18,55,42,3,6,124
Montana,Frenchtown,1657,71,447,395,212,19,1144
Montana,Bynum,39,8,21,6,4,0,39
Montana,Camas,37,2,0,14,0,0,16
Montana,Camp Three,101,0,14,53,2,6,75
Montana,Cardwell,40,0,13,6,5,1,25
Montana,Hamilton,4501,301,1062,1125,492,373,3353
Montana,Choteau,1685,93,462,342,233,82,1212
Montana,Churchill,997,48,171,169,207,67,662
Montana,Circle,607,32,217,122,65,0,436
Montana,Clancy,1563,97,258,403,342,148,1248
Montana,Clinton,1127,161,286,172,84,40,743
Montana,Clyde Park,230,6,63,57,27,11,164
Montana,Colstrip,2289,31,409,611,326,104,1481
Montana,Columbia Falls,4856,280,1105,1300,499,156,3340
Montana,Geyser,96,3,43,16,14,0,76
Montana,Gibson Flats,162,0,86,18,0,0,104
Montana,Gildford,76,7,7,32,15,3,64
Montana,Glasgow,3376,201,810,919,327,156,2413
Montana,Glendive,5284,295,1208,1350,423,218,3494
Montana,Grass Range,115,8,45,26,10,1,90
Montana,Great Falls,59563,3618,12687,13943,6891,3284,40423
Montana,Greycliff,68,11,14,26,3,0,54
Montana,Happys Inn,70,0,49,21,0,0,70
Montana,Highwood,224,3,26,43,37,7,116
Montana,Hardin,3754,233,809,813,177,198,2230
Montana,Harlowton,899,105,300,166,70,27,668
Montana,Carlton,647,36,248,104,122,15,525
Montana,Carter,77,3,22,19,2,6,52
Montana,Cascade,648,57,196,112,47,44,456
Montana,Charlo,386,16,90,93,17,8,224
Montana,Charlos Heights,148,0,88,31,0,0,119
Montana,Chester,884,73,182,250,147,29,681
Montana,Chinook,1058,79,387,219,118,23,826
Montana,Helena Valley Northwest,3990,80,535,1024,682,256,2577
Montana,Helena Valley Northeast,3238,123,604,763,617,167,2274
Montana,Helena Flats,916,35,230,202,127,50,644
Montana,Helena,29600,1170,4181,6020,5595,3862,20828
Montana,Hebgen Lake Estates,148,25,15,32,23,7,102
Montana,Heart Butte,567,38,70,136,24,5,273
Montana,Hays,1088,48,122,299,75,19,563
Montana,Havre North,714,36,133,192,16,10,387
Montana,Havre,9790,523,1767,2356,1105,563,6314
Montana,Harrison,237,31,121,38,16,0,206
Montana,Harlem,865,17,86,206,123,40,472
Montana,Hingham,108,6,19,34,17,3,79
Montana,Four Corners,3406,101,463,514,771,354,2203
Montana,Hobson,264,9,84,35,48,7,183
Montana,Fort Belknap Agency,1300,127,80,373,66,9,655
Montana,Jette,211,13,50,83,32,33,211
Montana,Joliet,532,43,136,142,58,17,396
Montana,Fairfield,749,62,151,183,53,39,488
Montana,Fairview,792,82,243,161,46,29,561
Montana,Fallon,149,26,29,50,8,8,121
Montana,Finley Point,688,21,110,160,144,253,688
Montana,Flaxville,95,8,26,22,8,1,65
Montana,Florence,644,45,123,142,68,90,468
Montana,Forest Hill Village,210,0,122,31,15,0,168
Montana,Forsyth,1874,152,449,456,175,35,1267
Montana,Crane,197,26,25,48,25,6,130
Montana,Hinsdale,167,13,55,40,19,11,138
Montana,Jordan,332,35,144,75,4,1,259
Montana,Judith Gap,86,8,18,28,19,2,75
Montana,De Borgia,0,0,0,0,0,0,0
Montana,Kalispell,21142,827,4056,5704,2643,1185,14415
Montana,Kerr,164,10,47,36,26,19,138
Montana,Klein,248,34,74,65,19,0,192
Montana,Kings Point,122,0,29,65,18,10,122
Montana,King Arthur Park,1009,73,83,245,244,0,645
Montana,Kila,387,22,83,94,79,31,309
Montana,Kicking Horse,167,21,15,55,34,6,131
Montana,Kevin,110,5,29,45,0,0,79
Montana,Joplin,220,17,61,74,28,0,180
Montana,Dillon,4193,175,770,582,490,313,2330
Montana,Fort Benton,1349,85,445,344,161,68,1103
Montana,Corwin Springs,106,13,10,22,30,11,86
Montana,Craig,31,2,8,8,7,0,25
Montana,Denton,246,9,39,72,38,2,160
Montana,Jefferson City,715,0,128,161,67,44,400
Montana,Ismay,18,0,3,2,2,3,10
Montana,Inverness,104,8,15,28,22,0,73
Montana,Indian Springs,124,0,0,69,39,16,124
Montana,Hysham,363,17,108,67,21,2,215
Montana,Huson,11,0,11,0,0,0,11
Montana,Jardine,22,5,0,9,8,0,22
Montana,Hungry Horse,757,119,214,93,52,38,516
Montana,Hot Springs,544,47,157,136,52,33,425
Montana,Corvallis,1047,108,201,336,53,0,698
Montana,Dodson,166,13,24,19,18,3,77
Montana,Dixon,224,14,42,46,28,4,134
Montana,Coram,585,41,172,133,127,0,473
Montana,Huntley,504,0,169,103,96,21,389
Moore County metropolitan government; Tennessee,Lynchbur,6351,591,1857,1357,562,249,4616
Nebraska,Stella,190,18,51,26,34,18,147
Nebraska,Steinauer,75,2,26,19,3,0,50
Nebraska,Steele City,74,3,23,17,5,2,50
Nebraska,Stapleton,298,14,68,90,30,14,216
Nebraska,Stamford,195,15,74,39,7,3,138
Nebraska,Stanton,1650,97,393,427,106,54,1077
Nebraska,Inavale,66,7,43,14,0,2,66
Nebraska,Imperial,1917,199,455,476,224,67,1421
Nebraska,Hyannis,200,5,71,68,22,15,181
Nebraska,Sterling,470,18,107,115,38,17,295
Nebraska,Aten,49,0,26,8,0,0,34
Nebraska,Staplehurst,254,19,74,60,11,6,170
Nebraska,Indianola,591,46,170,166,37,2,421
Nebraska,Tekamah,1830,134,474,458,158,49,1273
Nebraska,Inland,89,0,19,26,8,0,53
Nebraska,Tarnov,67,2,16,18,0,0,36
Nebraska,Tamora,78,0,44,6,8,0,58
Nebraska,Talmage,218,41,67,35,4,7,154
Nebraska,Table Rock,282,18,84,77,28,9,216
Nebraska,Syracuse,1933,111,493,487,183,60,1334
Nebraska,Swanton,93,2,33,26,4,0,65
Nebraska,Sutton,1706,176,340,341,190,47,1094
Nebraska,Sutherland,1446,63,379,383,121,53,999
Nebraska,Ashton,179,10,80,36,3,2,131
Nebraska,Surprise,50,6,11,15,3,0,35
Nebraska,Inglewood,372,28,113,105,13,2,261
Nebraska,Superior,1957,134,608,495,143,106,1486
Nebraska,Sumner,246,12,53,64,27,7,163
Nebraska,Stuart,605,19,107,201,60,17,404
Nebraska,Stromsburg,1129,81,228,260,123,57,749
Nebraska,Stratton,404,23,112,84,30,18,267
Nebraska,Strang,20,1,5,6,4,0,16
Nebraska,Stockville,10,2,5,3,0,0,10
Nebraska,Stockham,46,12,15,12,1,0,40
Nebraska,Taylor,158,11,56,38,11,3,119
Nebraska,Tecumseh,1518,197,354,340,125,49,1065
Nebraska,Inman,119,10,31,37,2,6,86
Nebraska,Sunol,88,9,27,32,4,0,72
Nebraska,Ashland,2419,118,681,568,199,140,1706
Nebraska,Long Pine,270,15,87,64,16,4,186
Nebraska,Arnold,520,20,163,150,61,20,414
Nebraska,Battle Creek,1131,30,141,403,148,54,776
Nebraska,Bayard,1064,130,196,289,71,35,721
Nebraska,Bazile Mills,20,1,6,2,3,2,14
Nebraska,Beatrice,12355,1100,2996,2951,1191,498,8736
Nebraska,Beaver City,644,61,176,145,55,14,451
Nebraska,Beaver Crossing,393,12,119,105,26,9,271
Nebraska,Bee,215,16,51,81,9,9,166
Nebraska,Beemer,629,70,220,124,42,34,490
Nebraska,Belden,87,3,22,31,12,2,70
Nebraska,Huntley,43,0,12,6,4,0,22
Nebraska,Big Springs,575,54,184,123,25,9,395
Nebraska,Berwyn,89,7,35,27,0,3,72
Nebraska,Bertrand,749,41,202,188,80,26,537
Nebraska,Berea,22,0,0,22,0,0,22
Nebraska,Bennington,1608,45,310,312,275,98,1040
Nebraska,Bennet,875,14,158,256,104,31,563
Nebraska,Benkelman,936,52,187,306,68,39,652
Nebraska,Benedict,239,11,62,76,11,9,169
Nebraska,Belvidere,31,4,17,7,0,0,28
Nebraska,Belmar,146,7,38,67,13,10,135
Nebraska,Bellwood,345,26,107,74,18,5,230
Nebraska,Bellevue,54067,2476,9437,12771,6550,3101,34335
Nebraska,Belgrade,137,8,60,30,8,0,106
Nebraska,Bladen,196,12,48,38,14,5,117
Nebraska,Blair,7995,236,1869,1776,1232,282,5395
Nebraska,Bloomfield,977,102,270,228,90,47,737
Nebraska,Bassett,594,32,228,126,46,18,450
Nebraska,Arlington,1205,35,276,258,122,65,756
Nebraska,Archer,44,9,30,5,0,0,44
Nebraska,Louisville,1039,58,260,233,117,18,686
Nebraska,Lorton,45,2,18,10,1,0,31
Nebraska,Loretto,68,14,7,23,0,0,44
Nebraska,Lorenzo,99,0,0,48,0,0,48
Nebraska,Loomis,411,11,103,126,23,7,270
Nebraska,Atkinson,1347,76,325,292,162,60,915
Nebraska,Atlanta,104,2,32,32,8,0,74
Nebraska,Auburn,3387,105,712,814,479,159,2269
Nebraska,Daykin,200,11,45,43,14,4,117
Nebraska,Arthur,129,7,15,34,15,3,74
Nebraska,Decatur,440,52,145,128,15,11,351
Nebraska,Deshler,621,28,159,143,37,28,395
Nebraska,Deweese,67,0,41,12,0,0,53
Nebraska,Aurora,4455,185,948,1097,569,258,3057
Nebraska,Avoca,227,9,94,48,5,3,159
Nebraska,Axtell,651,17,195,178,88,30,508
Nebraska,Ayr,68,5,16,23,1,0,45
Nebraska,Bancroft,547,16,150,128,60,9,363
Nebraska,Barada,11,1,10,0,0,0,11
Nebraska,Barneston,101,18,26,40,2,0,86
Nebraska,Bartlett,135,7,40,25,21,10,103
Nebraska,Bartley,272,24,70,61,20,2,177
Nebraska,Denton,240,2,58,77,5,14,156
Nebraska,Humphrey,744,25,185,209,55,20,494
Nebraska,Harrison,247,2,71,47,49,18,187
Nebraska,Hubbell,65,4,15,24,0,0,43
Nebraska,Greeley Center,339,15,132,103,15,9,274
Nebraska,Terrytown,972,154,187,214,64,8,627
Nebraska,Thayer,58,5,11,15,6,1,38
Nebraska,Thedford,144,5,35,37,25,11,113
Nebraska,Thurston,121,6,42,26,4,4,82
Nebraska,Tilden,1172,90,230,318,112,33,783
Nebraska,Tobias,96,2,44,19,3,3,71
Nebraska,Greenwood,578,34,140,148,67,4,393
Nebraska,Trenton,517,20,161,120,23,14,338
Nebraska,Litchfield,262,40,61,65,26,7,199
Nebraska,Lisco,36,5,15,16,0,0,36
Nebraska,Linwood,103,2,46,16,8,1,73
Nebraska,Lindy,17,1,8,2,0,3,14
Nebraska,Lindsay,237,35,68,45,16,5,169
Nebraska,Lincoln,269726,11439,36946,56286,39499,21144,165314
Nebraska,Yutan,1121,41,246,346,108,16,757
Nebraska,Lodgepole,278,9,55,114,24,7,209
Nebraska,Gresham,283,27,72,59,10,4,172
Nebraska,Gretna,5026,92,748,1200,737,441,3218
Nebraska,Gross,3,0,0,3,0,0,3
Nebraska,Curtis,884,22,163,177,63,67,492
Nebraska,Cushing,53,0,22,16,0,0,38
Nebraska,Dakota City,2271,306,558,331,105,42,1342
Nebraska,Dalton,298,8,76,75,20,16,195
Nebraska,Danbury,105,5,24,36,9,2,76
Nebraska,Dannebrog,319,23,115,70,18,11,237
Nebraska,Davenport,270,20,68,61,26,14,189
Nebraska,Davey,128,2,41,31,16,7,97
Nebraska,David City,2862,260,744,632,209,91,1936
Nebraska,Dawson,137,15,37,40,11,7,110
Nebraska,Hamlet,64,6,26,15,2,0,49
Nebraska,Halsey,70,2,23,16,5,14,60
Nebraska,Hallam,233,12,61,55,26,5,159
Nebraska,Haigler,170,25,50,42,6,1,124
Nebraska,Hadar,302,2,78,89,31,10,210
Nebraska,Gurley,200,9,40,79,19,2,149
Nebraska,Guide Rock,220,18,59,60,12,1,150
Nebraska,York,7908,321,1574,1790,1084,454,5223
Nebraska,Yankee Hill,318,0,30,89,54,8,181
Nebraska,Wynot,179,2,69,35,14,3,123
Nebraska,Wymore,1483,143,441,355,74,35,1048
Nebraska,Weeping Water,1180,34,281,323,72,48,758
Nebraska,Liberty,42,4,13,13,2,1,33
Nebraska,Lexington,10152,2571,1513,1117,432,153,5786
Nebraska,Lewiston,93,1,23,7,14,4,49
Nebraska,Lewellen,188,9,57,81,8,3,158
Nebraska,Leshara,101,16,43,21,4,0,84
Nebraska,Lemoyne,54,0,31,17,6,0,54
Nebraska,Leigh,483,27,129,142,50,19,367
Nebraska,Lebanon,39,5,8,18,2,2,35
Nebraska,Lawrence,334,25,76,88,37,4,230
Nebraska,La Vista,16895,621,2745,4145,2571,1089,11171
Nebraska,Laurel,1177,70,280,259,103,68,780
Nebraska,La Platte,116,8,43,26,10,0,87
Nebraska,Lamar,31,0,20,10,1,0,31
Nebraska,Lakeview,309,0,56,80,63,26,225
Nebraska,King Lake,110,15,25,64,0,6,110
Nebraska,Kimball,2577,265,570,683,176,94,1788
Nebraska,Wellfleet,69,14,11,23,5,0,53
Nebraska,Culbertson,631,26,190,208,28,27,479
Nebraska,Western,311,17,94,58,21,3,193
Nebraska,Weston,334,13,104,57,9,6,189
Nebraska,Wood River,1393,154,264,309,102,58,887
Nebraska,Woodland Park,1884,130,316,441,221,51,1159
Nebraska,Woodland Hills,145,0,30,18,61,13,122
Nebraska,Wood Lake,44,4,3,20,7,4,38
Nebraska,Wolbach,286,25,95,66,24,4,214
Nebraska,Wisner,1313,128,336,318,135,26,943
Nebraska,Winslow,51,0,28,17,0,0,45
Nebraska,Winside,419,11,76,120,49,13,269
Nebraska,Winnetoon,60,0,17,20,2,0,39
Nebraska,Winnebago,895,69,133,171,18,14,405
Nebraska,Wilsonville,94,10,23,43,0,6,82
Nebraska,Willow Island,11,0,6,5,0,0,11
Nebraska,Wilcox,473,31,150,87,40,23,331
Nebraska,Wilber,1716,142,379,460,109,38,1128
Nebraska,Whitney,54,6,20,9,3,6,44
Nebraska,White Clay,0,0,0,0,0,0,0
Nebraska,West Point,3346,368,724,612,301,92,2097
Nebraska,Westerville,17,0,3,6,3,0,12
Nebraska,Crookston,35,2,5,13,0,2,22
Nebraska,Crofton,708,29,190,180,72,19,490
Nebraska,Crete,7080,1000,1191,1271,194,284,3940
Nebraska,Hazard,60,1,28,5,12,0,46
Nebraska,Hay Springs,521,40,171,147,57,22,437
Nebraska,Hayes Center,361,56,56,108,34,15,269
Nebraska,Hastings,24973,1688,5040,5528,2268,1367,15891
Nebraska,Harvard,785,115,196,169,64,22,566
Nebraska,Hartington,1715,94,427,392,140,77,1130
Nebraska,Loup City,1031,90,288,238,99,33,748
Nebraska,Harrisburg,60,4,23,12,4,0,43
Nebraska,Hardy,153,14,40,51,10,6,121
Nebraska,Harbine,53,0,20,12,4,1,37
Nebraska,Hampton,433,9,103,107,37,19,275
Nebraska,Burton,18,0,7,8,1,0,16
Nebraska,Burwell,1219,62,340,326,98,27,853
Nebraska,Bushnell,147,23,54,37,7,11,132
Nebraska,Butte,333,23,98,109,37,1,268
Nebraska,Byron,102,7,31,36,5,3,82
Nebraska,Cairo,888,51,185,169,117,37,559
Nebraska,Heartwell,62,7,25,8,0,6,46
Nebraska,Callaway,644,17,153,181,69,31,451
Nebraska,Hebron,1627,109,454,444,188,46,1241
Nebraska,Henderson,947,59,227,294,101,37,718
Nebraska,Hubbard,208,5,45,68,20,12,150
Nebraska,Howells,602,28,141,156,68,13,406
Nebraska,Howard City,168,13,59,35,15,1,123
Nebraska,Hoskins,197,19,56,60,12,4,151
Nebraska,Hordville,145,14,25,45,15,0,99
Nebraska,Hooper,792,48,239,203,75,32,597
Nebraska,Homer,595,20,146,159,50,10,385
Nebraska,Holstein,265,24,71,82,10,1,188
Nebraska,Holmesville,49,7,27,10,0,5,49
Nebraska,Holdrege,5528,267,1289,1347,660,261,3824
Nebraska,Holbrook,241,24,65,71,1,1,162
Nebraska,Hildreth,487,14,118,142,36,26,336
Nebraska,Hickman,1888,33,285,445,250,108,1121
Nebraska,Hershey,598,36,148,158,61,11,414
Nebraska,Herman,223,24,63,66,9,5,167
Nebraska,Henry,78,17,22,18,2,1,60
Nebraska,Hendley,21,3,3,9,1,0,16
Nebraska,Hemingford,869,50,220,216,87,13,586
Nebraska,Humboldt,857,58,281,213,61,27,640
Nebraska,Cambridge,1093,108,242,273,156,26,805
Nebraska,Carleton,95,4,25,46,3,4,82
Nebraska,Coleridge,538,31,131,174,42,9,387
Nebraska,Colon,167,12,43,31,36,2,124
Nebraska,Columbus,22584,1922,4374,5249,2086,998,14629
Nebraska,Comstock,108,11,25,29,0,4,69
Nebraska,Concord,144,9,38,26,17,13,103
Nebraska,Cook,317,22,94,63,50,13,242
Nebraska,Cordova,109,14,36,26,2,1,79
Nebraska,Cornlea,61,5,21,8,3,0,37
Nebraska,Cortland,527,9,119,154,49,20,351
Nebraska,Cotesfield,27,3,15,7,0,0,25
Nebraska,Cowles,12,2,6,0,2,0,10
Nebraska,Cozad,3905,373,1153,749,221,237,2733
Nebraska,Crab Orchard,57,13,16,15,1,0,45
Nebraska,Craig,201,21,69,40,8,4,142
Nebraska,Crawford,1113,89,316,278,90,44,817
Nebraska,Creighton,1151,81,315,282,135,53,866
Nebraska,Creston,163,9,49,42,10,4,114
Nebraska,Cody,116,3,26,39,12,7,87
Nebraska,Campbell,303,36,102,89,12,2,241
Nebraska,Clinton,39,0,13,22,0,3,38
Nebraska,Clay Center,802,25,206,222,65,25,543
Nebraska,Carroll,190,16,49,34,17,5,121
Nebraska,Cedar Bluffs,526,31,180,141,27,21,400
Nebraska,Cedar Creek,394,21,131,106,29,29,316
Nebraska,Cedar Rapids,401,33,133,94,18,2,280
Nebraska,Center,101,0,24,31,9,5,69
Nebraska,Central City,2902,144,705,809,268,120,2046
Nebraska,Ceresco,945,25,196,284,74,51,630
Nebraska,Chadron,5828,143,778,938,687,566,3112
Nebraska,Chalco,11258,245,1787,2759,1583,624,6998
Nebraska,Chambers,277,15,75,64,33,16,203
Nebraska,Champion,64,5,13,10,0,0,28
Nebraska,Chapman,257,28,62,72,16,2,180
Nebraska,Chappell,894,67,205,216,87,58,633
Nebraska,Chester,231,11,76,78,20,6,191
Nebraska,Clarks,387,28,102,114,14,6,264
Nebraska,Clarkson,806,36,238,234,42,30,580
Nebraska,Clatonia,323,20,56,105,9,6,196
Nebraska,Clearwater,330,23,66,115,19,3,226
Nebraska,Lushton,34,1,7,20,3,0,31
Nebraska,Walthill,781,76,146,157,24,14,417
Nebraska,Lynch,234,18,63,72,10,6,169
Nebraska,Norman,67,4,16,13,3,0,36
Nebraska,Norfolk,24393,1661,4537,5997,2125,1108,15428
Nebraska,Nora,18,0,2,3,0,12,17
Nebraska,Niobrara,344,17,94,77,32,31,251
Nebraska,Nickerson,386,45,122,45,14,6,232
Nebraska,Newport,125,4,45,34,12,0,95
Nebraska,Newman Grove,631,40,182,177,72,31,502
Nebraska,North Bend,1292,61,384,272,70,67,854
Nebraska,Newcastle,252,15,85,62,21,9,192
Nebraska,Nemaha,170,28,69,37,4,0,138
Nebraska,Nelson,499,27,161,164,35,12,399
Nebraska,Neligh,1484,92,344,380,152,70,1038
Nebraska,Nehawka,314,11,77,68,30,5,191
Nebraska,Nebraska City,7301,561,1945,1429,646,310,4891
Nebraska,Naponee,80,1,22,18,4,5,50
Nebraska,Naper,72,10,25,14,7,1,57
Nebraska,Nenzel,33,3,2,15,0,7,27
Nebraska,Murray,417,24,107,119,28,17,295
Nebraska,North Loup,331,30,101,91,13,4,239
Nebraska,Oak,47,0,27,8,3,0,38
Nebraska,Orleans,381,43,126,85,20,8,282
Nebraska,Ord,2257,115,735,440,226,88,1604
Nebraska,Orchard,461,35,122,86,26,15,284
Nebraska,Ong,75,6,23,18,9,0,56
Nebraska,O'Neill,3673,275,884,998,407,178,2742
Nebraska,Omaha,440034,34160,65315,88149,63157,34082,284863
Nebraska,Ohiowa,176,21,40,41,2,0,104
Nebraska,North Platte,24420,1589,5109,6507,2223,912,16340
Nebraska,Ogallala,4605,289,1202,1177,403,215,3286
Nebraska,Odessa,72,2,35,18,3,0,58
Nebraska,Odell,313,3,86,79,18,10,196
Nebraska,Octavia,128,20,36,32,5,0,93
Nebraska,Oconto,129,10,30,38,17,0,95
Nebraska,Obert,22,4,11,2,0,0,17
Nebraska,Oakland,1325,77,302,344,156,38,917
Nebraska,Oakdale,300,39,86,72,11,3,211
Nebraska,Offutt AFB,4919,11,280,1264,426,187,2168
Nebraska,Osceola,824,38,182,265,73,38,596
Nebraska,Murdock,254,10,71,79,32,14,206
Nebraska,Morse Bluff,144,17,23,51,5,4,100
Nebraska,Friend,1232,61,253,356,110,52,832
Nebraska,Fremont,26483,2422,6112,5572,2477,897,17480
Nebraska,Franklin,1050,73,268,284,77,35,737
Nebraska,Foster,56,10,8,14,3,4,39
Nebraska,Fort Calhoun,691,31,167,155,95,66,514
Nebraska,Fordyce,135,10,68,21,4,0,103
Nebraska,Fontanelle,69,49,20,0,0,0,69
Nebraska,Fullerton,1416,124,363,313,116,68,984
Nebraska,Lyman,452,51,100,75,22,6,254
Nebraska,Farwell,130,8,49,37,4,0,98
Nebraska,Farnam,237,9,68,76,16,6,175
Nebraska,Falls City,4246,216,1237,853,474,194,2974
Nebraska,Fairmont,583,64,242,111,44,8,469
Nebraska,Fairfield,396,14,86,115,34,11,260
Nebraska,Fairbury,3863,418,1231,914,132,115,2810
Nebraska,Exeter,624,25,111,192,75,12,415
Nebraska,Filley,101,8,45,27,6,0,86
Nebraska,Mullen,391,25,105,117,49,33,329
Nebraska,Funk,209,6,58,55,19,2,140
Nebraska,Garland,243,12,67,64,17,6,166
Nebraska,Morrill,885,67,152,271,62,35,587
Nebraska,Grant,1250,94,262,349,97,76,878
Nebraska,Grand Island,50582,6107,10426,10096,3791,1804,32224
Nebraska,Grafton,127,12,37,40,6,0,95
Nebraska,Gothenburg,3542,249,805,758,335,183,2330
Nebraska,Gordon,1665,149,288,423,148,87,1095
Nebraska,Goehner,89,6,32,23,6,4,71
Nebraska,Gandy,26,0,4,7,0,0,11
Nebraska,Glenwood,767,48,97,106,174,24,449
Nebraska,Giltner,388,16,91,101,43,7,258
Nebraska,Gilead,43,7,7,5,5,0,24
Nebraska,Gibbon,1904,336,359,330,177,33,1235
Nebraska,Gering,8429,402,1895,2231,786,427,5741
Nebraska,Genoa,1006,89,284,226,72,68,739
Nebraska,Geneva,2271,106,622,527,189,98,1542
Nebraska,Garrison,68,7,13,14,1,0,35
Nebraska,Glenvil,281,13,72,83,15,6,189
Nebraska,Ewing,410,14,100,112,12,15,253
Nebraska,Oshkosh,792,43,204,246,87,43,623
Nebraska,Otoe,150,1,63,29,5,0,98
Nebraska,Ames,74,0,26,26,0,0,52
Nebraska,Alvo,125,5,23,32,10,3,73
Nebraska,Alma,1195,76,352,373,116,43,960
Nebraska,Alliance,8500,556,1786,2299,560,281,5482
Nebraska,Allen,356,11,76,94,36,4,221
Nebraska,Alexandria,151,6,53,35,12,2,108
Nebraska,Alda,607,98,149,131,28,6,412
Nebraska,Amherst,230,6,48,61,30,11,156
Nebraska,Albion,1667,80,461,424,121,72,1158
Nebraska,Adams,596,37,143,112,62,21,375
Nebraska,Abie,107,3,45,21,3,4,76
Nebraska,Moorefield,28,0,18,7,3,0,28
Nebraska,Monroe,353,19,79,106,9,9,222
Nebraska,Monowi,0,0,0,0,0,0,0
Nebraska,Mitchell,1821,248,352,391,114,82,1187
Nebraska,Minden,3112,210,674,715,364,133,2096
Nebraska,Ainsworth,1695,164,489,399,131,53,1236
Nebraska,Minatare,791,103,146,213,29,1,492
Nebraska,Anoka,16,0,9,7,0,0,16
Nebraska,Ansley,406,24,99,130,39,15,307
Nebraska,Ithaca,133,15,19,43,3,9,89
Nebraska,Jackson,194,10,56,47,22,5,140
Nebraska,Jansen,142,10,52,28,6,1,97
Nebraska,Johnson,318,14,68,82,51,16,231
Nebraska,Johnstown,76,4,30,28,3,0,65
Nebraska,Julian,73,10,13,11,17,7,58
Nebraska,Juniata,878,28,218,250,65,41,602
Nebraska,Anselmo,202,16,44,72,5,5,142
Nebraska,Kearney,32217,942,4412,6568,4609,2050,18581
Nebraska,Kennard,342,15,75,67,21,13,191
Nebraska,Keystone,123,0,32,0,47,0,79
Nebraska,Kilgore,59,5,7,23,4,1,40
Nebraska,Plattsmouth,6475,377,1646,1604,443,160,4230
Nebraska,Platte Center,338,14,92,98,13,5,222
Nebraska,Arcadia,307,10,90,67,38,8,213
Nebraska,Arapahoe,924,69,289,241,63,22,684
Nebraska,Kenesaw,1014,55,206,299,90,29,679
Nebraska,Osmond,759,55,180,167,66,33,501
Nebraska,Milligan,343,15,98,100,39,4,256
Nebraska,Milford,2373,136,351,493,208,96,1284
Nebraska,Phillips,301,9,86,93,7,0,195
Nebraska,Petersburg,321,15,123,82,17,7,244
Nebraska,Peru,850,12,109,103,55,35,314
Nebraska,Pender,1117,66,317,232,98,66,779
Nebraska,Paxton,551,27,92,154,63,33,369
Nebraska,Pawnee City,893,45,273,207,50,46,621
Nebraska,Parks,27,0,7,10,10,0,27
Nebraska,Pickrell,186,7,59,59,14,4,143
Nebraska,Papillion,19463,389,3018,4496,3218,1892,13013
Nebraska,Palmyra,664,30,168,190,24,18,430
Nebraska,Palmer,584,42,167,156,47,0,412
Nebraska,Palisade,407,38,95,118,23,10,284
Nebraska,Page,212,17,55,54,10,4,140
Nebraska,Oxford,780,90,184,175,86,35,570
Nebraska,Overton,677,27,196,121,39,10,393
Nebraska,Overland,199,16,50,33,34,17,150
Nebraska,Panama,284,4,72,92,22,12,202
Nebraska,Miller,168,15,24,48,8,0,95
Nebraska,Pierce,1959,116,394,478,232,51,1271
Nebraska,Plainview,990,59,268,303,119,34,783
Nebraska,Merriman,91,7,38,11,11,0,67
Nebraska,Merna,388,20,116,93,20,18,267
Nebraska,Memphis,93,6,23,33,4,0,66
Nebraska,Melbeta,129,17,35,27,11,0,90
Nebraska,Meadow Grove,329,27,85,87,32,6,237
Nebraska,Mead,584,32,131,150,38,18,369
Nebraska,Maywood,297,13,75,76,16,4,184
Nebraska,Pilger,276,18,100,74,12,8,212
Nebraska,Maxwell,283,23,58,108,11,7,207
Nebraska,Mason City,176,13,42,35,40,7,137
Nebraska,Maskell,76,9,17,21,2,0,49
Nebraska,Martinsburg,67,6,23,10,5,4,48
Nebraska,Martin,136,0,112,24,0,0,136
Nebraska,Marquette,231,16,61,50,10,2,139
Nebraska,Manley,146,5,55,34,8,8,110
Nebraska,Malmo,226,3,51,43,10,6,113
Nebraska,Max,44,0,9,13,0,0,22
Nebraska,Eustis,394,33,116,104,40,10,303
Nebraska,Firth,550,33,124,123,49,11,340
Nebraska,Endicott,121,7,43,24,2,2,78
Nebraska,Brady,343,14,97,70,38,14,233
Nebraska,Brainard,291,10,98,86,15,11,220
Nebraska,Brewster,5,0,4,1,0,0,5
Nebraska,Bridgeport,1807,118,399,385,222,54,1178
Nebraska,Bristow,51,3,25,16,2,2,48
Nebraska,Broadwater,154,21,44,40,5,5,115
Nebraska,Brock,147,17,49,43,7,0,116
Nebraska,Bradshaw,280,10,88,68,15,13,194
Nebraska,Broken Bow,3518,260,639,914,287,141,2241
Nebraska,Brownville,117,8,46,28,12,8,102
Nebraska,Brule,376,26,123,98,29,14,290
Nebraska,Bruning,219,4,81,62,14,3,164
Nebraska,Bruno,145,7,34,30,0,6,77
Nebraska,Brunswick,169,19,43,44,14,6,126
Nebraska,Burchard,53,2,22,13,6,1,44
Nebraska,Burr,27,0,13,9,1,0,23
Nebraska,Brownlee,8,1,4,3,0,0,8
Nebraska,Malcolm,363,13,94,113,25,14,259
Nebraska,Boys Town,913,0,14,110,15,4,143
Nebraska,Blue Springs,331,38,129,77,8,0,252
Nebraska,Shickley,340,8,49,103,48,22,230
Nebraska,Sholes,16,2,9,1,0,0,12
Nebraska,Shubert,154,22,56,35,9,4,126
Nebraska,Sidney,6830,310,1358,1945,947,317,4877
Nebraska,Silver Creek,397,27,102,113,18,7,267
Nebraska,Smithfield,30,5,12,6,0,0,23
Nebraska,Snyder,348,22,81,111,7,3,224
Nebraska,Bow Valley,102,25,28,25,0,0,78
Nebraska,South Bend,94,7,39,19,15,1,81
Nebraska,Spalding,546,33,152,130,43,18,376
Nebraska,Spencer,482,13,146,72,74,28,333
Nebraska,Sprague,142,4,60,27,10,3,104
Nebraska,Springfield,1423,62,329,318,214,53,976
Nebraska,Springview,210,5,47,60,27,8,147
Nebraska,Bloomington,131,15,29,29,4,2,79
Nebraska,Blue Hill,908,58,229,190,105,60,642
Nebraska,Ericson,148,22,28,43,14,4,111
Nebraska,Shelton,1154,118,263,253,111,19,764
Nebraska,Magnet,46,6,26,3,0,0,35
Nebraska,Madison,2545,572,460,486,125,24,1667
Nebraska,Verdel,25,9,5,8,0,1,23
Nebraska,Venice,55,0,41,0,7,7,55
Nebraska,Venango,141,9,38,50,14,4,115
Nebraska,Valparaiso,708,39,155,165,69,33,461
Nebraska,Valley,2018,137,463,514,207,111,1432
Nebraska,Valentine,2782,194,699,740,315,118,2066
Nebraska,Utica,779,63,188,185,90,48,574
Nebraska,Verdigre,575,65,153,152,51,27,448
Nebraska,Upland,158,11,43,22,24,0,100
Nebraska,Unadilla,276,19,100,61,13,8,201
Nebraska,Ulysses,249,23,75,56,22,6,182
Nebraska,Uehling,258,18,79,48,26,7,178
Nebraska,Tryon,81,0,29,40,6,0,75
Nebraska,Trumbull,229,11,51,55,5,3,125
Nebraska,McCook,7649,347,1805,2015,631,209,5007
Nebraska,Lyons,925,67,316,219,64,20,686
Nebraska,Union,204,19,70,50,8,1,148
Nebraska,Madrid,302,47,63,46,22,8,186
Nebraska,Verdon,164,23,56,46,1,2,128
Nebraska,Waco,294,22,68,76,42,13,221
Nebraska,Macy,877,96,101,152,7,2,358
Nebraska,McLean,28,5,11,9,1,2,28
Nebraska,McGrew,74,9,16,9,8,3,45
Nebraska,McCool Junction,473,11,85,104,62,29,291
Nebraska,Wayne,5553,218,279,817,825,467,2606
Nebraska,Waverly,3614,52,485,819,517,257,2130
Nebraska,Wausa,718,45,157,197,83,45,527
Nebraska,Virginia,44,3,12,16,0,0,31
Nebraska,Wauneta,699,76,167,189,50,17,499
Nebraska,Waterbury,59,10,19,7,6,0,42
Nebraska,Washington,116,2,24,25,11,6,68
Nebraska,Wann,164,0,9,17,8,36,70
Nebraska,Walton,332,0,58,58,82,78,276
Nebraska,Wallace,299,37,39,80,50,7,213
Nebraska,Wakefield,1539,206,372,230,115,91,1014
Nebraska,Wahoo,4505,247,911,887,625,231,2901
Nebraska,Waterloo,1086,55,241,238,86,22,642
Nebraska,Shelby,766,55,178,175,40,16,464
Nebraska,South Sioux City,13315,2521,2461,1968,490,262,7702
Nebraska,Seneca,50,8,21,10,2,0,41
Nebraska,Dix,283,30,73,69,6,5,183
Nebraska,Diller,186,5,64,61,19,0,149
Nebraska,De Witt,487,23,139,134,35,16,347
Nebraska,Pleasant Dale,237,9,63,77,23,6,178
Nebraska,Pleasanton,304,21,60,67,43,13,204
Nebraska,Plymouth,423,32,103,118,25,4,282
Nebraska,Polk,332,10,114,80,24,11,239
Nebraska,Ponca,1037,75,247,251,83,49,705
Nebraska,Poole,53,0,15,10,10,5,40
Nebraska,Potter,315,18,53,79,24,15,189
Nebraska,Prague,356,25,105,95,15,3,243
Nebraska,Preston,26,6,8,5,0,2,21
Nebraska,Primrose,78,2,27,26,0,0,55
Nebraska,Prosser,109,1,35,24,12,8,80
Nebraska,Raeville,0,0,0,0,0,0,0
Nebraska,Ragan,60,11,24,4,9,0,48
Nebraska,Ralston,5997,552,1273,1355,979,310,4469
Nebraska,Randolph,786,61,238,183,68,21,571
Nebraska,Ravenna,1466,95,369,292,148,36,940
Nebraska,Raymond,139,10,37,31,14,9,101
Nebraska,Red Cloud,1075,100,272,263,65,47,747
Nebraska,Dixon,84,6,24,21,5,3,59
Nebraska,Republican City,147,11,62,36,9,1,119
Nebraska,Dodge,651,58,211,150,26,13,458
Nebraska,Dorchester,525,29,132,154,35,14,364
Nebraska,Enders,36,0,8,9,6,7,30
Nebraska,Emmet,38,4,10,10,3,3,30
Nebraska,Emerson,842,81,239,172,55,15,562
Nebraska,Elyria,43,1,18,7,4,0,30
Nebraska,Elwood,756,31,207,185,68,23,514
Nebraska,Elsie,115,7,17,21,8,20,73
Nebraska,Elmwood,607,14,138,151,75,29,407
Nebraska,Elm Creek,909,25,245,216,91,14,591
Nebraska,Elk Creek,102,15,32,18,15,0,80
Nebraska,Elgin,609,59,172,155,65,27,478
Nebraska,Elba,271,36,62,63,25,3,189
Nebraska,Edison,164,20,38,36,5,2,101
Nebraska,Edgar,472,36,121,148,33,22,360
Nebraska,Eddyville,127,22,48,15,0,2,87
Nebraska,Eagle,1043,68,220,242,89,23,642
Nebraska,Dwight,169,11,58,53,7,5,134
Nebraska,Dunning,103,0,27,28,11,0,66
Nebraska,Duncan,451,30,167,94,9,8,308
Nebraska,Dunbar,188,30,66,35,16,1,148
Nebraska,Du Bois,172,17,70,33,6,3,129
Nebraska,Douglas,199,12,55,63,10,8,148
Nebraska,Doniphan,1020,42,197,279,72,26,616
Nebraska,Reynolds,70,2,24,17,0,0,43
Nebraska,Richfield,175,0,0,62,0,20,82
Nebraska,Richland,70,7,19,16,0,6,48
Nebraska,Rushville,852,76,200,170,78,52,576
Nebraska,Ruskin,116,6,40,31,5,2,84
Nebraska,St. Edward,778,48,254,168,35,25,530
Nebraska,Seward,7109,278,1095,1517,795,468,4153
Nebraska,St. Helena,85,7,38,4,4,3,56
Nebraska,St. Libory,341,27,93,92,11,6,229
Nebraska,St. Paul,2313,126,663,429,247,123,1588
Nebraska,Salem,90,15,19,24,0,2,60
Nebraska,Santee,381,36,50,62,0,4,152
Nebraska,Sarben,16,0,15,0,0,0,15
Nebraska,Sargent,598,63,185,150,58,15,471
Nebraska,Saronville,83,2,16,5,16,2,41
Nebraska,Schuyler,6196,1580,1032,592,188,79,3471
Nebraska,Scotia,365,28,99,90,18,12,247
Nebraska,Scottsbluff,14955,1757,2768,2959,1323,714,9521
Nebraska,Scribner,942,55,264,214,97,30,660
Nebraska,Rulo,189,28,55,54,4,2,143
Nebraska,Royal,84,16,31,17,3,2,69
Nebraska,Roseland,254,19,59,60,13,11,162
Nebraska,Roscoe,14,0,0,14,0,0,14
Nebraska,Rosalie,221,11,48,39,10,4,112
Nebraska,Rogers,56,6,20,10,3,2,41
Nebraska,Rockville,86,4,28,25,11,0,68
Nebraska,Roca,220,7,32,74,22,7,142
Nebraska,Riverton,109,19,42,16,7,1,85
Nebraska,Riverdale,166,8,25,53,27,14,127
Nebraska,Rising City,292,20,93,69,21,11,214
Nevada,Zephyr Cove,463,29,37,138,98,107,409
Nevada,Yerington,3021,585,690,700,120,66,2161
Nevada,Walker Lake,355,14,56,188,46,13,317
Nevada,Winchester,28365,4671,6772,4836,2390,1225,19894
Nevada,Sunrise Manor,191464,32411,38234,32796,8897,3532,115870
Nevada,Sun Valley,19663,3422,4528,3680,767,222,12619
Nevada,Sutcliffe,194,13,74,47,11,0,145
Nevada,Tonopah,2360,212,664,643,161,109,1789
Nevada,Topaz Lake,264,9,25,124,9,7,174
Nevada,Topaz Ranch Estates,1704,147,481,599,103,38,1368
Nevada,Unionville,13,0,0,0,0,13,13
Nevada,Winnemucca,7810,715,1814,1388,553,330,4800
Nevada,Ursine,94,13,54,16,0,0,83
Nevada,Verdi,1525,102,191,445,192,267,1197
Nevada,Virginia City,717,4,219,285,120,72,700
Nevada,Wadsworth,900,65,233,186,22,12,518
Nevada,Washoe Valley,3348,66,526,1229,576,162,2559
Nevada,Wells,1288,153,183,416,65,11,828
Nevada,West Wendover,4422,988,740,454,96,125,2403
Nevada,Whitney,40165,5144,8322,8897,3363,1334,27060
Nevada,Valmy,8,0,8,0,0,0,8
Nevada,Panaca,1257,35,222,286,234,33,810
Nevada,Fish Springs,909,18,127,282,136,47,610
Nevada,Oasis,0,0,0,0,0,0,0
Nevada,McGill,1321,153,257,315,84,141,950
Nevada,Mesquite,16533,1647,3801,4719,1452,765,12384
Nevada,Mina,24,4,11,9,0,0,24
Nevada,Minden,3180,180,508,1100,598,170,2556
Nevada,Moapa Town,1149,124,226,228,83,0,661
Nevada,Moapa Valley,7099,319,1175,2154,337,402,4387
Nevada,Mogul,1353,28,135,404,257,87,911
Nevada,Montello,89,19,8,54,8,0,89
Nevada,Mount Charleston,373,0,46,119,102,30,297
Nevada,Mount Wilson,27,0,27,0,0,0,27
Nevada,Nellis AFB,3554,16,129,800,216,159,1320
Nevada,Nelson,36,0,27,9,0,0,36
Nevada,Nixon,308,41,94,58,17,0,210
Nevada,North Las Vegas,226860,29573,41612,43791,13835,6863,135674
Nevada,Orovada,144,70,66,8,0,0,144
Nevada,Osino,983,50,249,264,0,0,563
Nevada,Owyhee,1367,150,237,348,91,30,856
Nevada,Summerlin South,25338,917,2925,5724,5077,4283,18926
Nevada,Stateline,1160,186,150,308,127,22,793
Nevada,Stagecoach,1668,271,410,426,88,34,1229
Nevada,Spring Creek,13564,622,2374,3692,1373,677,8738
Nevada,Sparks,93437,9091,17176,22183,9722,4631,62803
Nevada,Spanish Springs,15789,804,3170,4298,1465,857,10594
Nevada,McDermitt,155,21,21,44,0,0,86
Nevada,Lund,217,0,70,22,0,0,92
Nevada,Lovelock,2306,237,635,464,83,39,1458
Nevada,Logan Creek,39,0,0,14,12,13,39
Nevada,Golden Valley,2127,177,332,536,339,68,1452
Nevada,Goldfield,443,25,136,89,31,4,285
Nevada,Goodsprings,101,101,0,0,0,0,101
Nevada,Grass Valley,834,108,185,252,20,60,625
Nevada,Hawthorne,3095,300,773,1017,152,138,2380
Nevada,Henderson,271725,14024,50259,68190,36906,22462,191841
Nevada,Hiko,131,0,13,57,24,0,94
Nevada,Humboldt River Ranch,31,0,0,0,0,31,31
Nevada,Imlay,65,0,36,29,0,0,65
Nevada,Golconda,211,48,68,43,12,0,171
Nevada,Glenbrook,123,0,11,38,34,40,123
Nevada,Smith Valley,1182,58,160,399,140,130,887
Nevada,Gerlach,194,23,49,50,11,50,183
Nevada,Indian Hills,6193,489,1008,1908,686,462,4553
Nevada,Indian Springs,1050,71,289,316,45,6,727
Nevada,Jackpot,1579,471,208,241,0,23,943
Nevada,Johnson Lane,6441,241,1160,2079,831,556,4867
Nevada,Kingsbury,1970,41,234,815,485,164,1739
Nevada,Kingston,172,0,97,75,0,0,172
Nevada,Lakeridge,318,0,90,81,73,45,289
Nevada,Lamoille,340,0,43,143,0,93,279
Nevada,Las Vegas,605097,67471,114640,131909,58686,31266,403972
Nevada,Laughlin,7622,756,2213,2114,660,381,6124
Nevada,Lemmon Valley,5073,425,1275,1336,288,180,3504
Nevada,Incline Village,8734,373,736,1858,2322,1431,6720
Nevada,Skyland,230,0,39,35,92,47,213
Nevada,Spring Valley,186632,16438,38523,45080,22795,8215,131051
Nevada,Silver Peak,61,0,46,5,10,0,61
Nevada,Caliente,1029,86,177,258,56,66,643
Nevada,Silver Springs,5351,721,1419,1426,257,43,3866
Nevada,Boulder City,15266,789,3193,4761,1842,1141,11726
Nevada,Blue Diamond,344,8,47,54,54,90,253
Nevada,Bennett Springs,146,0,50,70,0,0,120
Nevada,Beaverdam,28,0,5,5,0,0,10
Nevada,Beatty,1051,145,244,333,71,31,824
Nevada,Battle Mountain,3276,388,680,864,127,88,2147
Nevada,Baker,30,9,7,0,6,0,22
Nevada,Austin,93,56,6,18,0,0,80
Nevada,Alamo,1095,51,208,223,128,56,666
Nevada,Cal-Nev-Ari,137,39,50,41,0,7,137
Nevada,Silver City,222,33,27,46,18,36,160
Nevada,Schurz,824,92,172,201,33,3,501
Nevada,Sandy Valley,1385,198,493,391,13,120,1215
Nevada,Ruth,391,13,148,70,0,0,231
Nevada,Ruhenstroth,1101,68,83,558,177,64,950
Nevada,Round Hill Village,849,29,111,225,224,136,725
Nevada,Reno,234161,22123,34953,50942,29408,17490,154916
Nevada,Rachel,87,0,0,28,59,0,87
Nevada,Preston,20,0,0,20,0,0,20
Nevada,Pioche,911,150,215,259,31,0,655
Nevada,Paradise Valley,158,0,36,94,0,13,143
Nevada,Paradise,226957,25151,48528,50598,22777,9905,156959
Nevada,Searchlight,416,76,127,38,49,10,300
Nevada,Carlin,2299,156,612,658,38,54,1518
Nevada,Bunkerville,1374,109,494,158,60,0,821
Nevada,Fallon Station,799,5,82,172,56,3,318
Nevada,Genoa,1087,5,87,219,249,153,713
Nevada,Gardnerville Ranchos,11023,415,2259,3648,903,292,7517
Nevada,Gardnerville,5636,350,1465,1559,386,345,4105
Nevada,Gabbs,126,8,79,39,0,0,126
Nevada,Fort McDermitt,613,70,158,66,8,2,304
Nevada,Pahrump,34902,3958,9361,9799,2535,1038,26691
Nevada,Fernley,19185,1528,3786,5059,1596,787,12756
Nevada,Carson,54482,5091,11037,14451,4923,3067,38569
Nevada,Fallon,8442,526,2027,2060,514,269,5396
Nevada,Eureka,487,31,116,132,94,56,429
Nevada,Empire,20,0,10,10,0,0,20
Nevada,Enterprise,125498,7165,20480,30950,19019,7622,85236
Nevada,Elko,19709,1862,2891,4548,1728,760,11789
Nevada,Carter Springs,555,59,118,190,33,11,411
Nevada,Cold Springs,8868,636,1586,2782,602,183,5789
Nevada,Crescent Valley,346,31,146,55,0,7,239
Nevada,Crystal Bay,239,0,27,84,27,65,203
Nevada,Ely,4206,449,1036,936,327,116,2864
Nevada,Denio,42,0,0,42,0,0,42
Nevada,Dayton,9163,878,1723,2602,746,381,6330
Nevada,Dry Valley,45,0,29,16,0,0,45
Nevada,Dyer,264,31,90,60,36,11,228
Nevada,East Valley,1266,105,179,401,214,139,1038
Nevada,Double Spring,176,2,69,71,13,5,160
New Hampshire,Londonderry,10729,396,1834,2214,1934,1078,7456
New Hampshire,Littleton,4663,438,1014,1083,438,236,3209
New Hampshire,Manchester,110139,9584,24258,21404,14163,6674,76083
New Hampshire,Loudon,533,0,173,146,105,0,424
New Hampshire,Marlborough,1008,72,315,187,117,67,758
New Hampshire,Milton,791,108,234,168,55,5,570
New Hampshire,Meredith,1749,82,173,456,226,105,1042
New Hampshire,Milford,9107,381,2306,1935,1478,479,6579
New Hampshire,Lisbon,973,75,218,195,105,21,614
New Hampshire,Milton Mills,411,27,28,82,87,7,231
New Hampshire,Melvin Village,161,0,40,78,14,16,148
New Hampshire,Lincoln,761,77,262,183,58,29,609
New Hampshire,New London,1486,45,100,66,79,119,409
New Hampshire,Lancaster,1417,114,319,266,142,199,1040
New Hampshire,West Stewartstown,293,56,113,79,3,0,251
New Hampshire,Warner,417,15,77,64,111,35,302
New Hampshire,Walpole,311,0,24,93,115,62,294
New Hampshire,Troy,1379,112,373,284,169,66,1004
New Hampshire,Tilton Northfield,3725,364,1039,752,414,106,2675
New Hampshire,Suncook,5247,338,1175,1195,553,226,3487
New Hampshire,Suissevale,133,43,8,19,42,21,133
New Hampshire,South Hooksett,5825,232,981,1044,802,393,3452
New Hampshire,New Hampton,327,17,63,44,45,65,234
New Hampshire,Mountain Lakes,416,23,166,78,75,14,356
New Hampshire,Lebanon,13535,671,2514,2165,2187,2501,10038
New Hampshire,Nashua,87110,6125,15319,17597,13636,8018,60695
New Hampshire,Union,161,9,66,39,18,0,132
New Hampshire,Hinsdale,1508,102,425,348,117,90,1082
New Hampshire,Henniker,1623,23,132,221,113,112,601
New Hampshire,Goffstown,3124,165,602,822,536,214,2339
New Hampshire,Franklin,8460,728,2313,1780,764,301,5886
New Hampshire,Farmington,4203,360,1089,868,344,87,2748
New Hampshire,Exeter,9223,369,1525,1925,1537,1326,6682
New Hampshire,Epping,1597,234,460,300,173,50,1217
New Hampshire,Hanover,8360,81,161,300,1292,1605,3439
New Hampshire,Enfield,1129,24,403,223,206,111,967
New Hampshire,Dover,30534,1702,4132,6518,5074,3630,21056
New Hampshire,Derry,22363,880,5891,5070,2703,1116,15660
New Hampshire,Conway,3325,227,837,795,429,91,2379
New Hampshire,Contoocook,1801,35,163,162,361,324,1045
New Hampshire,Concord,42537,2251,7680,9469,6517,4359,30276
New Hampshire,Colebrook,1286,113,274,294,155,94,930
New Hampshire,East Merrimack,3774,149,1119,856,761,234,3119
New Hampshire,Claremont,13076,1121,3847,2306,1137,368,8779
New Hampshire,Hancock,199,0,25,30,48,50,153
New Hampshire,Hampton,9338,234,1467,1685,1925,1596,6907
New Hampshire,Gorham,1518,91,372,470,127,82,1142
New Hampshire,Newfields,324,11,56,55,74,23,219
New Hampshire,Somersworth,11778,664,2956,2169,1603,479,7871
New Hampshire,Seabrook Beach,629,31,137,214,151,58,591
New Hampshire,Sanbornville,867,104,273,245,107,17,746
New Hampshire,Rochester,29954,2508,7803,6737,3250,1229,21527
New Hampshire,Hampton Beach,2068,74,417,486,355,307,1639
New Hampshire,Laconia,16075,1307,3977,3458,1949,1027,11718
New Hampshire,Hillsborough,1697,375,382,296,123,96,1272
New Hampshire,Jaffrey,2478,298,764,413,230,44,1749
New Hampshire,Hudson,7388,599,1574,1708,804,334,5019
New Hampshire,Hooksett,3820,146,680,1115,733,283,2957
New Hampshire,Greenville,1178,50,317,245,60,32,704
New Hampshire,Groveton,1132,154,361,238,74,0,827
New Hampshire,Keene,23403,954,3860,3717,3330,2440,14301
New Hampshire,Charlestown,1020,39,257,275,92,31,694
New Hampshire,Durham,10640,7,173,205,554,1058,1997
New Hampshire,Center Ossipee,358,79,116,56,18,10,279
New Hampshire,Pinardville,4903,525,1151,1173,531,223,3603
New Hampshire,Peterborough,3113,59,444,679,641,667,2490
New Hampshire,North Woodstock,299,4,97,72,50,9,232
New Hampshire,North Walpole,1023,32,272,234,102,26,666
New Hampshire,North Haverhill,711,126,242,176,70,9,623
New Hampshire,Center Sandwich,172,3,16,11,37,15,82
New Hampshire,Pittsfield,1629,182,405,304,86,62,1039
New Hampshire,Newport,4798,418,1352,987,473,270,3500
New Hampshire,Woodsville,1364,137,366,266,52,20,841
New Hampshire,Wolfeboro,2600,97,502,605,567,321,2092
New Hampshire,Winchester,1544,174,590,240,125,83,1212
New Hampshire,Wilton,939,70,338,177,107,73,765
New Hampshire,Whitefield,1087,137,292,256,106,14,805
New Hampshire,West Swanzey,1402,90,416,123,97,85,811
New Hampshire,Newmarket,5319,282,879,845,964,508,3478
New Hampshire,Plainfield,232,7,40,28,26,26,127
New Hampshire,North Conway,2314,45,394,697,192,225,1553
New Hampshire,Portsmouth,21426,691,2604,3632,6023,3416,16366
New Hampshire,Plymouth,3913,27,184,227,298,295,1031
New Hampshire,Bristol,1928,158,504,453,164,50,1329
New Hampshire,Bradford,411,20,71,111,40,19,261
New Hampshire,Blodgett Landing,150,6,49,22,20,20,117
New Hampshire,Berlin,9580,1162,3190,2030,698,154,7234
New Hampshire,Bennington,335,5,101,66,21,22,215
New Hampshire,Bethlehem,916,82,127,184,150,53,596
New Hampshire,Bartlett,239,0,44,81,35,53,213
New Hampshire,Ashland,1412,47,325,305,165,86,928
New Hampshire,Antrim,1302,84,330,379,92,37,922
New Hampshire,Amherst,558,10,8,43,145,156,362
New Hampshire,Alton,154,14,16,84,40,0,154
New Hampshire,Raymond,3052,173,790,498,479,150,2090
New Hampshire,Belmont,1738,293,427,328,128,11,1187
New Hampshire,Canaan,501,6,155,135,72,9,377
New Jersey,Belle Mead,189,0,0,72,34,7,113
New Jersey,Berlin borough,7618,579,1839,1393,1150,332,5293
New Jersey,Belleplain,584,71,191,111,42,5,420
New Jersey,Bellmawr borough,11507,920,3965,2214,820,457,8376
New Jersey,Belmar borough,5745,375,1195,844,1412,678,4504
New Jersey,Belvidere,2634,157,641,478,319,180,1775
New Jersey,Bergenfield borough,27339,1989,5462,4254,5043,1904,18652
New Jersey,Smithville,7090,300,1670,1872,844,573,5259
New Jersey,Beverly,2569,184,674,611,196,80,1745
New Jersey,Somers Point,10776,847,2468,2364,1284,446,7409
New Jersey,Somerset,24409,1056,3741,4199,5322,3579,17897
New Jersey,Somerdale borough,5298,323,1419,1414,586,192,3934
New Jersey,Society Hill,3651,142,265,267,884,728,2286
New Jersey,Skillman,115,0,38,4,13,38,93
New Jersey,Belford,1513,72,354,291,223,72,1012
New Jersey,Bernardsville borough,7786,52,850,688,1782,1875,5247
New Jersey,Beckett,4809,184,974,764,1031,244,3197
New Jersey,Hampton borough,1213,61,247,333,207,85,933
New Jersey,Beachwood borough,11128,523,2831,2339,1132,483,7308
New Jersey,Wallington borough,11584,806,3653,1963,1605,702,8729
New Jersey,Waldwick borough,9902,254,1387,1748,2197,1204,6790
New Jersey,Voorhees,1058,80,160,120,130,170,660
New Jersey,Vista Center,2158,80,433,551,449,380,1893
New Jersey,Villas,9029,1199,3134,1607,576,156,6672
New Jersey,Vienna,796,0,201,211,104,72,588
New Jersey,Wanamassa,4542,174,992,550,773,526,3015
New Jersey,Victory Lakes,1751,150,594,317,91,104,1256
New Jersey,Vernon Valley,1427,39,482,316,147,29,1013
New Jersey,Vernon Center,1892,91,316,446,292,80,1225
New Jersey,Ventnor City,10593,919,2503,1950,1329,952,7653
New Jersey,Upper Stewartsville,171,18,49,45,22,0,134
New Jersey,Upper Saddle River borough,8335,107,602,781,2265,1461,5216
New Jersey,Upper Pohatcong,1470,105,448,319,121,24,1017
New Jersey,Victory Gardens borough,1593,174,459,236,93,22,984
New Jersey,Beattystown,4403,226,1180,884,676,247,3213
New Jersey,New Village,443,16,116,140,25,13,310
New Jersey,North Beach Haven,2130,68,478,435,471,467,1919
New Jersey,Beach Haven West,4076,343,1022,794,843,401,3403
New Jersey,Beach Haven borough,991,17,171,213,288,165,854
New Jersey,Bayonne,65378,5809,15938,9918,9880,4055,45600
New Jersey,Bay Head borough,992,6,131,187,274,182,780
New Jersey,Haworth borough,3451,50,237,434,890,682,2293
New Jersey,Hawthorne borough,18989,1016,4677,3238,2822,1332,13085
New Jersey,North Arlington borough,15734,1133,3640,2957,2320,1284,11334
New Jersey,Egg Harbor City,4246,542,1093,752,199,126,2712
New Jersey,Ellisburg,4301,334,808,690,924,392,3148
New Jersey,Elmer borough,1460,66,396,293,159,67,981
New Jersey,Elmwood Park borough,19959,1715,5099,3185,2997,913,13909
New Jersey,Elwood,1635,295,527,90,32,8,952
New Jersey,Emerson borough,7616,433,1191,1319,1517,838,5298
New Jersey,Englewood,27992,2257,4532,3773,5721,3936,20219
New Jersey,Elizabeth,127759,21857,32396,16877,6238,3134,80502
New Jersey,Vineland,60987,9552,14807,9072,5088,1931,40450
New Jersey,Saddle River borough,3229,71,593,396,646,738,2444
New Jersey,Singac,5108,388,1546,481,806,297,3518
New Jersey,Rockaway borough,6490,362,1490,1316,1068,463,4699
New Jersey,Robertsville,11334,268,1255,1557,2943,1445,7468
New Jersey,Robbinsville,3326,133,425,442,986,360,2346
New Jersey,Riverton borough,2766,78,466,518,598,330,1990
New Jersey,River Edge borough,11566,551,1721,1332,2495,1839,7938
New Jersey,Riverdale borough,4154,192,840,602,1045,572,3251
New Jersey,Rio Grande,2499,288,494,625,274,80,1761
New Jersey,Ringwood borough,12387,631,2020,2081,2186,1267,8185
New Jersey,Edgewater borough,11935,475,1076,1117,3901,2516,9085
New Jersey,Eatontown borough,12298,778,2728,2432,2119,1026,9083
New Jersey,East Rutherford borough,9076,467,1689,1262,2193,985,6596
New Jersey,East Rocky Hill,208,0,17,34,76,41,168
New Jersey,East Orange,64578,6317,15702,13778,5008,2405,43210
New Jersey,East Newark borough,2577,353,645,455,141,83,1677
New Jersey,East Millstone,481,0,20,153,54,169,396
New Jersey,East Freehold,5633,138,875,1086,1053,634,3786
New Jersey,East Franklin,7493,689,2459,977,521,225,4871
New Jersey,Dunellen borough,7368,580,1748,1229,929,479,4965
New Jersey,Dumont borough,17820,930,3309,2848,3394,1927,12408
New Jersey,Dover Beaches South,1185,98,281,178,319,177,1053
New Jersey,Dover Beaches North,1157,37,426,203,233,182,1081
New Jersey,Dover,18324,3533,4106,2722,1425,476,12262
New Jersey,Diamond Beach,145,0,30,46,50,19,145
New Jersey,Demarest borough,5004,78,485,560,1240,1009,3372
New Jersey,Delaware Park,728,60,178,138,83,54,513
New Jersey,Delaware,78,0,9,45,0,0,54
New Jersey,Deal borough,757,85,164,157,130,57,593
New Jersey,Rockleigh borough,576,77,175,71,90,51,464
New Jersey,Rocky Hill borough,615,19,52,81,123,165,440
New Jersey,Roebling,3550,180,1074,763,526,84,2627
New Jersey,Roosevelt borough,800,13,148,128,163,95,547
New Jersey,Silver Ridge,1299,173,605,293,141,63,1275
New Jersey,Silver Lake CDP (Warren County),328,4,68,89,40,7,208
New Jersey,Silver Lake CDP (Essex County),3908,487,1030,740,373,49,2679
New Jersey,Shrewsbury borough,3923,66,469,432,1073,543,2583
New Jersey,Short Hills,12831,82,346,373,2828,4340,7969
New Jersey,Ship Bottom borough,914,26,199,236,209,142,812
New Jersey,Shiloh borough,492,47,171,79,47,20,364
New Jersey,Shark River Hills,3721,120,863,844,757,318,2902
New Jersey,Sewaren,2530,129,731,506,488,138,1992
New Jersey,Secaucus,18170,1745,3534,2603,3341,2323,13546
New Jersey,Seaside Park borough,1543,31,328,393,417,180,1349
New Jersey,Seaside Heights borough,2885,399,777,518,237,0,1931
New Jersey,Sea Isle City,1788,57,484,428,335,315,1619
New Jersey,Six Mile Run,3002,108,286,354,651,523,1922
New Jersey,Sea Girt borough,1683,10,205,238,483,382,1318
New Jersey,Sea Bright borough,1387,14,232,333,348,185,1112
New Jersey,Sayreville borough,44051,2823,8979,9009,6735,3254,30800
New Jersey,Salem,4997,727,1388,606,230,117,3068
New Jersey,Upper Montclair,11753,138,250,781,2881,3569,7619
New Jersey,Rutherford borough,18434,695,2756,2676,4342,2424,12893
New Jersey,Runnemede borough,8414,646,2321,1679,808,225,5679
New Jersey,Rumson borough,6993,62,461,751,1805,1138,4217
New Jersey,Rossmoor,2823,469,885,755,478,236,2823
New Jersey,Ross Corner,0,0,0,0,0,0,0
New Jersey,Rosenhayn,1226,190,450,220,35,20,915
New Jersey,Roselle Park borough,13555,777,3119,2485,1969,866,9216
New Jersey,Roselle borough,21466,1916,4945,5326,1816,703,14706
New Jersey,Roseland borough,5853,177,858,754,1354,1169,4312
New Jersey,Seabrook Farms,993,209,149,110,74,12,554
New Jersey,Union City,68656,15077,14536,8706,5508,2357,46184
New Jersey,Spring Lake borough,2989,29,393,340,917,594,2273
New Jersey,Twin Rivers,7303,655,1293,973,1398,688,5007
New Jersey,Wildwood,5234,764,1502,888,422,195,3771
New Jersey,Wildwood Crest borough,3227,127,888,584,666,294,2559
New Jersey,Williamstown,15539,1201,3766,3169,1691,713,10540
New Jersey,Woodbine borough,2710,690,611,374,70,40,1785
New Jersey,Woodbridge,19822,1461,3787,3212,3302,2150,13912
New Jersey,Woodbury,10087,866,1996,1834,1303,664,6663
New Jersey,Woodbury Heights borough,3022,181,833,694,339,134,2181
New Jersey,Woodcliff Lake borough,5818,144,346,608,1712,1233,4043
New Jersey,Woodland Park borough,12267,1007,3531,1610,1635,1096,8879
New Jersey,Woodlynne borough,2970,449,678,507,116,26,1776
New Jersey,Wood-Ridge borough,7938,396,1642,1488,1324,855,5705
New Jersey,Woodstown borough,3562,144,610,603,744,250,2351
New Jersey,Wrightstown borough,821,120,164,136,62,11,493
New Jersey,Yardville,6868,284,1822,1429,1101,425,5061
New Jersey,Whittingham,2570,45,700,657,591,436,2429
New Jersey,Yorketown,6547,145,1152,1100,1348,580,4325
New Jersey,Leisure Knoll,2378,253,1206,484,247,146,2336
New Jersey,Lebanon borough,1836,36,279,306,398,255,1274
New Jersey,Lawrenceville,3825,44,365,692,1188,823,3112
New Jersey,Lawnside borough,2926,197,763,548,428,174,2110
New Jersey,Lavallette borough,2108,114,554,419,410,275,1772
New Jersey,Laurence Harbor,7232,303,2059,1634,919,412,5327
New Jersey,Laurel Springs borough,1923,61,473,350,264,165,1313
New Jersey,Laurel Lake,3193,539,884,500,94,45,2062
New Jersey,Lambertville,3851,223,531,599,1060,723,3136
New Jersey,Lakewood,53591,4151,5725,5207,3318,2204,20605
New Jersey,Lake Telemark,1340,18,259,220,208,127,832
New Jersey,Lake Mohawk,9635,170,1115,1658,2656,950,6549
New Jersey,Lakehurst borough,2669,184,777,421,166,73,1621
New Jersey,Lake Como borough,1489,107,302,240,320,175,1144
New Jersey,Zarephath,0,0,0,0,0,0,0
New Jersey,Whitesboro,2500,311,599,190,135,54,1289
New Jersey,White Meadow Lake,8943,138,1200,1321,2175,1052,5886
New Jersey,White House Station,1936,193,454,295,411,244,1597
New Jersey,Ashland,8548,271,1475,1325,1788,1038,5897
New Jersey,Atlantic City,39547,7727,8054,5671,3043,882,25377
New Jersey,Atlantic Highlands borough,4346,103,667,815,1005,560,3150
New Jersey,Audubon borough,8772,400,1990,1944,1461,525,6320
New Jersey,Audubon Park borough,1010,135,409,220,82,10,856
New Jersey,Avalon borough,1596,33,273,295,511,342,1454
New Jersey,Avenel,18793,1107,7298,2628,2181,1273,14487
New Jersey,Avon-by-the-Sea borough,1809,21,191,354,559,321,1446
New Jersey,Barclay,4376,55,487,664,1044,792,3042
New Jersey,Barnegat,3180,281,814,558,388,153,2194
New Jersey,Barnegat Light borough,589,4,128,147,113,124,516
New Jersey,Barrington borough,6877,434,1621,1589,1024,461,5129
New Jersey,Little Silver borough,5937,0,599,771,1437,1101,3908
New Jersey,Little Ferry borough,10856,764,2476,2146,1891,591,7868
New Jersey,Linwood,7036,275,1175,1360,1362,806,4978
New Jersey,Lindenwold borough,17492,2058,4292,3609,1232,549,11740
New Jersey,Linden,41322,4496,10494,8475,3559,1849,28873
New Jersey,White Horse,8447,480,2479,2061,967,465,6452
New Jersey,Wharton borough,6607,801,1765,1080,601,319,4566
New Jersey,Westwood borough,11140,417,2192,1587,2360,1259,7815
New Jersey,West Wildwood borough,448,53,175,93,32,28,381
New Jersey,Westville borough,4247,238,1538,769,309,106,2960
New Jersey,Weston,2008,68,481,475,427,386,1837
New Jersey,Kinnelon borough,10372,200,1161,1406,2443,1925,7135
New Jersey,Leisuretowne,3454,530,1523,774,323,124,3274
New Jersey,Leisure Village East,3721,293,1514,1013,588,297,3705
New Jersey,Leisure Village West,3072,378,1197,775,485,228,3063
New Jersey,Leonardo,2495,92,485,685,331,167,1760
New Jersey,Leonia borough,9129,429,1068,1089,2268,1473,6327
New Jersey,Lincoln Park borough,10478,492,2602,1905,1793,969,7761
New Jersey,Lincroft,6431,181,789,873,1332,1118,4293
New Jersey,Leisure Village,4340,624,1702,989,244,175,3734
New Jersey,Union Beach borough,5885,531,1553,1122,536,167,3909
New Jersey,Kingston Estates,6573,236,1069,1012,1353,806,4476
New Jersey,Keyport borough,7195,757,1828,1187,913,547,5232
New Jersey,South Bound Brook borough,4612,172,1383,1036,623,166,3380
New Jersey,South Plainfield borough,23871,2170,4990,3688,4063,2239,17150
New Jersey,South River borough,16274,2146,3816,2408,1604,865,10839
New Jersey,South Toms River borough,3706,430,1035,520,148,59,2192
New Jersey,Spotswood borough,8413,380,2468,1860,1018,474,6200
New Jersey,Springdale,14145,420,1299,1454,3342,3542,10057
New Jersey,Dayton,7388,157,760,552,1893,1122,4484
New Jersey,Spring Lake Heights borough,4683,108,559,876,1396,603,3542
New Jersey,Stanhope borough,3509,141,756,701,618,205,2421
New Jersey,Stewartsville,276,8,79,56,22,0,165
New Jersey,Stockton borough,624,11,109,96,105,108,429
New Jersey,Stone Harbor borough,875,18,144,153,253,179,747
New Jersey,Stratford borough,7007,528,1744,1400,937,313,4922
New Jersey,Strathmere,191,0,76,0,28,52,156
New Jersey,South Amboy,8787,748,2431,1602,1112,645,6538
New Jersey,Strathmore,7010,220,983,1371,1380,916,4870
New Jersey,Summit,21869,841,1573,1895,4974,5347,14630
New Jersey,Surf City borough,1130,50,247,226,248,211,982
New Jersey,Sussex borough,1972,228,606,345,151,63,1393
New Jersey,Swedesboro borough,2612,230,521,488,302,157,1698
New Jersey,Tavistock borough,8,0,1,2,3,0,6
New Jersey,Tenafly borough,14788,275,853,1055,3143,3951,9277
New Jersey,Ten Mile Run,1504,20,98,160,434,494,1206
New Jersey,Teterboro borough,85,12,39,12,7,0,70
New Jersey,Tinton Falls borough,17872,641,3129,3812,3528,2479,13589
New Jersey,Toms River,88687,5096,22265,16221,12872,6368,62822
New Jersey,Totowa borough,10931,1170,2446,1602,1911,793,7922
New Jersey,Trenton,84632,15870,20941,11944,3820,2181,54756
New Jersey,Tuckerton borough,3364,332,803,712,473,91,2411
New Jersey,Turnersville,3521,53,675,620,645,374,2367
New Jersey,Succasunna,8859,302,1355,1473,1954,1116,6200
New Jersey,Somerville borough,12212,749,2667,2055,2437,912,8820
New Jersey,Heathcote,5802,142,348,680,1610,1311,4091
New Jersey,Helmetta borough,2350,119,426,527,378,223,1673
New Jersey,Kenvil,2854,206,667,456,440,196,1965
New Jersey,Kenilworth borough,8104,748,1733,1548,1101,344,5474
New Jersey,Kendall Park,10323,545,1360,1702,2185,1178,6970
New Jersey,Kearny,41866,4730,10602,6677,4492,1905,28406
New Jersey,Keansburg borough,9967,1112,3080,2031,863,332,7418
New Jersey,Juliustown,301,33,105,56,29,9,232
New Jersey,Johnsonburg,95,17,20,0,3,19,59
New Jersey,Jersey City,259651,26460,43419,34061,47535,30628,182103
New Jersey,Jamesburg borough,5978,487,1428,1136,674,196,3921
New Jersey,Island Heights borough,1640,33,299,273,357,254,1216
New Jersey,Iselin,19146,1479,3452,2574,4237,2264,14006
New Jersey,Interlaken borough,795,16,100,99,206,217,638
New Jersey,Hutchinson,126,0,51,21,7,13,92
New Jersey,Hopewell borough,1845,27,157,255,448,448,1335
New Jersey,Hope,193,20,33,48,35,14,150
New Jersey,Hopatcong borough,14802,639,3356,3548,2346,869,10758
New Jersey,Holiday Heights,2120,446,972,403,188,111,2120
New Jersey,High Bridge borough,3581,132,641,694,637,461,2565
New Jersey,Highland Lakes,4862,331,1203,1044,704,293,3575
New Jersey,Highland Park borough,14263,419,1503,1358,2411,3848,9539
New Jersey,Highlands borough,4947,255,1317,983,757,692,4004
New Jersey,Hightstown borough,5529,649,734,1006,928,633,3950
New Jersey,Hillsdale borough,10452,407,1331,1595,2211,1533,7077
New Jersey,Kingston,1274,54,133,91,154,454,886
New Jersey,Hi-Nella borough,831,50,195,200,63,29,537
New Jersey,Ho-Ho-Kus borough,4132,87,177,387,1406,703,2760
New Jersey,Holiday City-Berkeley,12132,2103,6123,2423,927,383,11959
New Jersey,Newton,8036,850,2194,1301,881,391,5617
New Jersey,New Providence borough,12355,355,1108,1332,3058,2384,8237
New Jersey,Englewood Cliffs borough,5369,310,602,495,1412,1081,3900
New Jersey,Holiday City South,4087,539,1737,955,364,73,3668
New Jersey,Hoboken,52452,2400,3076,3579,20216,10959,40230
New Jersey,Crestwood Village,7958,1078,4097,1757,629,332,7893
New Jersey,Echelon,11276,802,2277,1926,2200,1077,8282
New Jersey,Crandon Lakes,1371,44,297,299,175,60,875
New Jersey,Guttenberg,11595,1708,2141,1926,1442,1028,8245
New Jersey,Groveville,2879,97,712,518,338,219,1884
New Jersey,Griggstown,911,49,152,144,118,191,654
New Jersey,Greenwich,2586,22,167,357,555,339,1440
New Jersey,Greentree,11283,196,1048,1476,2688,2318,7726
New Jersey,Green Knoll,6403,277,782,948,1340,1134,4481
New Jersey,Hackensack,44035,4348,9988,6994,7401,3614,32345
New Jersey,Great Meadows,316,16,44,104,15,2,181
New Jersey,Gloucester City,11386,1138,3471,1606,1095,353,7663
New Jersey,Glen Rock borough,11859,178,941,1367,3016,2164,7666
New Jersey,Glen Ridge borough,7607,97,666,529,1498,1902,4692
New Jersey,Glen Gardner borough,1560,71,302,268,361,136,1138
New Jersey,Glendora,4442,462,1207,964,261,250,3144
New Jersey,Glassboro borough,18958,808,3157,3137,1924,1268,10294
New Jersey,Golden Triangle,3888,321,798,703,599,366,2787
New Jersey,Hackettstown,9579,845,2044,1716,1135,527,6267
New Jersey,Haddonfield borough,11474,100,698,1240,2980,2787,7805
New Jersey,Haddon Heights borough,7497,271,1136,1133,1772,1041,5353
New Jersey,West Long Branch borough,7974,313,1318,1178,1086,747,4642
New Jersey,West Freehold,14000,344,2297,2728,2869,1736,9974
New Jersey,Westfield,30552,640,2690,3131,7227,6426,20114
New Jersey,West Cape May borough,966,58,221,174,195,109,757
New Jersey,West Belmar,2424,116,554,367,432,358,1827
New Jersey,Wenonah borough,2199,36,287,444,464,289,1520
New Jersey,Watchung borough,5900,236,675,643,1031,1313,3898
New Jersey,Washington borough,6466,398,1550,1242,762,407,4359
New Jersey,Waretown,1773,87,586,363,282,43,1361
New Jersey,Wanaque borough,11617,853,3061,2215,1806,893,8828
New Jersey,Hammonton,14735,1600,3937,2650,1577,688,10452
New Jersey,Hamilton Square,13456,524,2609,2364,2656,1247,9400
New Jersey,Hamburg borough,3209,182,662,759,517,239,2359
New Jersey,Haledon borough,8412,930,1826,1490,922,463,5631
New Jersey,Hainesburg,70,0,33,11,13,0,57
New Jersey,Gibbstown,3775,298,1303,777,390,118,2886
New Jersey,West New York,51860,9919,10252,7653,5654,3266,36744
New Jersey,Gibbsboro borough,2236,102,511,448,302,208,1571
New Jersey,Garfield,31265,3416,8860,4675,3047,951,20949
New Jersey,Fanwood borough,7479,59,939,929,1881,1102,4910
New Jersey,Fairview,3843,100,585,724,770,439,2618
New Jersey,Fairview borough,14233,2627,3586,2150,1938,468,10769
New Jersey,Fairton,1117,128,453,158,35,23,797
New Jersey,Fair Lawn borough,33164,1888,4574,5029,7116,5090,23697
New Jersey,Fair Haven borough,6075,60,415,540,1660,1204,3879
New Jersey,Far Hills borough,1052,36,108,142,255,182,723
New Jersey,Estell Manor,1728,99,484,346,208,86,1223
New Jersey,Erma,2238,168,566,427,310,115,1586
New Jersey,Englishtown borough,2186,118,533,451,297,101,1500
New Jersey,Burleigh,404,15,181,54,62,21,333
New Jersey,Buena borough,4566,701,957,1010,382,111,3161
New Jersey,Budd Lake,8403,251,1774,1351,1504,944,5824
New Jersey,Brownville,2727,87,500,590,439,175,1791
New Jersey,Essex Fells borough,2153,6,165,163,583,532,1449
New Jersey,Farmingdale borough,1434,41,381,248,235,76,981
New Jersey,Fieldsboro borough,624,46,105,144,97,45,437
New Jersey,Finderne,6333,204,1081,1296,1253,485,4319
New Jersey,Frenchtown borough,1444,54,323,266,313,167,1123
New Jersey,Cresskill borough,8729,368,967,1150,2332,1217,6034
New Jersey,Franklin Park,15238,666,1543,1981,3909,2697,10796
New Jersey,Franklin Lakes borough,10799,250,1061,1229,3204,1809,7553
New Jersey,Franklin Center,4275,130,819,628,932,1057,3566
New Jersey,Franklin borough,4944,296,1466,1101,516,156,3535
New Jersey,Fort Lee borough,36251,2066,5554,4759,9905,6157,28441
New Jersey,Fort Dix,8305,836,2286,2300,586,340,6348
New Jersey,Forked River,5194,307,1168,1341,673,312,3801
New Jersey,Fords,15085,1126,3440,2691,2459,1098,10814
New Jersey,Folsom borough,1891,168,502,406,160,68,1304
New Jersey,Florham Park borough,11802,307,1246,1192,2448,2436,7629
New Jersey,Florence,4409,348,1380,886,443,135,3192
New Jersey,Flemington borough,4676,851,887,628,636,361,3363
New Jersey,Finesville,210,0,52,55,17,8,132
New Jersey,Garwood borough,4306,218,886,724,776,430,3034
New Jersey,Browns Mills,10831,1090,3047,2080,709,230,7156
New Jersey,Burlington,9868,687,2698,2064,818,458,6725
New Jersey,Buttzville,165,0,50,67,0,0,117
New Jersey,New Milford borough,16640,1000,3414,2628,2912,1549,11503
New Jersey,Asbury,304,62,99,40,44,13,258
New Jersey,Asbury Park,15945,1904,3942,2520,1237,977,10580
New Jersey,Camden,76904,13956,15728,9940,2545,918,43087
New Jersey,Califon borough,1283,16,164,184,306,159,829
New Jersey,North Caldwell borough,6415,153,615,504,1714,1325,4311
New Jersey,Annandale,1413,34,189,171,371,200,965
New Jersey,North Cape May,2751,206,926,563,245,189,2129
New Jersey,North Haledon borough,8507,388,1788,1449,2038,675,6338
New Jersey,North Middletown,3212,158,870,530,332,182,2072
New Jersey,North Plainfield borough,22156,2308,5008,3802,2269,1401,14788
New Jersey,Northvale borough,4763,341,864,565,1195,395,3360
New Jersey,North Wildwood,3957,392,1070,853,612,258,3185
New Jersey,Norwood borough,5823,279,911,899,1421,737,4247
New Jersey,Northfield,8597,517,1795,1664,1282,561,5819
New Jersey,Andover borough,662,44,170,150,109,32,505
New Jersey,Anderson,294,0,134,49,65,15,263
New Jersey,Hasbrouck Heights borough,12100,473,2584,1954,2392,1073,8476
New Jersey,Absecon,8394,771,1827,1789,1067,709,6163
New Jersey,Allamuchy,116,0,5,5,30,31,71
New Jersey,Allendale borough,6717,122,440,919,1701,1185,4367
New Jersey,Allenhurst borough,486,9,67,89,111,107,383
New Jersey,Allentown borough,1888,91,327,305,334,206,1263
New Jersey,Allenwood,973,15,142,143,230,106,636
New Jersey,Alloway,1686,30,365,337,296,34,1062
New Jersey,Alpha borough,2272,155,784,387,203,89,1618
New Jersey,Alpine borough,1559,51,160,158,435,403,1207
New Jersey,Hancocks Bridge,210,15,49,34,11,0,109
New Jersey,Harlingen,188,0,20,20,59,39,138
New Jersey,Harmony,382,21,162,52,22,5,262
New Jersey,Harrington Park borough,4764,110,493,575,1085,861,3124
New Jersey,Harrison,14629,2273,3037,1677,1648,1641,10276
New Jersey,Harvey Cedars borough,416,8,49,66,141,106,370
New Jersey,Oakhurst,3727,170,513,703,710,424,2520
New Jersey,Butler borough,7659,415,1682,1348,1365,623,5433
New Jersey,Oakland borough,13003,488,1797,2154,2548,1829,8816
New Jersey,Oak Valley,3325,202,1450,558,151,45,2406
New Jersey,Peapack and Gladstone borough,2588,123,279,263,630,454,1749
New Jersey,Pedricktown,516,22,121,115,31,35,324
New Jersey,Pemberton borough,1485,116,326,374,169,123,1108
New Jersey,Pemberton Heights,2595,161,559,707,314,62,1803
New Jersey,Pennington borough,2599,75,251,223,575,694,1818
New Jersey,Penns Grove borough,5032,930,1006,761,76,30,2803
New Jersey,Paulsboro borough,6025,441,1871,1137,315,60,3824
New Jersey,Pennsville,11623,800,3534,2570,900,374,8178
New Jersey,Phillipsburg,14608,2194,4009,2183,1237,430,10053
New Jersey,Pine Beach borough,2175,53,410,474,336,207,1480
New Jersey,Pine Hill borough,10419,812,2627,2259,1020,325,7043
New Jersey,Pine Lake Park,9064,571,2672,1674,916,279,6112
New Jersey,Caldwell borough,7902,423,1143,1297,1711,1106,5680
New Jersey,Byram Center,39,10,0,13,5,0,28
New Jersey,Perth Amboy,52179,10466,10945,6496,3624,1115,32646
New Jersey,Paterson,146987,25737,36559,18588,6472,2736,90092
New Jersey,Passaic,70618,13682,14136,6349,3689,2029,39885
New Jersey,Park Ridge borough,8820,354,1304,1124,2093,1232,6107
New Jersey,Ocean Acres,16000,478,4323,3079,1929,798,10607
New Jersey,Ocean City,11470,485,2156,2261,2572,1617,9091
New Jersey,Ocean Gate borough,2105,109,550,447,274,87,1467
New Jersey,Ocean Grove,3015,84,617,655,707,575,2638
New Jersey,Oceanport borough,5800,227,991,962,1220,664,4064
New Jersey,Ogdensburg borough,2432,86,604,587,243,106,1626
New Jersey,Old Bridge,23550,1337,4743,4875,3639,2106,16700
New Jersey,Old Tappan borough,5922,243,668,757,1467,910,4045
New Jersey,Olivet,1444,10,264,293,385,110,1062
New Jersey,Oradell borough,8146,241,786,929,2157,1376,5489
New Jersey,Oxford,1069,135,433,169,69,38,844
New Jersey,Palisades Park borough,20364,2152,4314,2568,5436,1055,15525
New Jersey,Palmyra borough,7356,473,1934,1555,1058,391,5411
New Jersey,Panther Valley,3518,35,519,586,947,540,2627
New Jersey,Paramus borough,26760,1342,4763,4047,6109,3233,19494
New Jersey,Oaklyn borough,4004,189,998,842,725,262,3016
New Jersey,Brooklawn borough,1944,189,557,399,183,25,1353
New Jersey,Freehold borough,11978,1842,2444,1792,977,662,7717
New Jersey,Brookdale,9813,306,1376,1615,2323,1332,6952
New Jersey,Ridgefield borough,11256,759,2789,1267,2009,950,7774
New Jersey,Ridgefield Park,12969,790,2524,2190,2317,999,8820
New Jersey,Ridgewood,25370,388,1491,2201,6663,5651,16394
New Jersey,Cape May,3553,205,572,548,613,411,2349
New Jersey,Cape May Court House,5472,440,1348,779,779,595,3941
New Jersey,Carlstadt borough,6225,499,1401,1084,959,481,4424
New Jersey,Richwood,3130,40,320,625,632,457,2074
New Jersey,Carneys Point,7162,884,1923,1558,549,253,5167
New Jersey,Cedar Glen Lakes,1459,184,680,434,113,48,1459
New Jersey,Cedar Glen West,1001,158,514,217,42,39,970
New Jersey,Cedarville,681,59,242,150,20,24,495
New Jersey,Brookfield,638,63,279,243,39,14,638
New Jersey,Cherry Hill Mall,13829,855,1667,2487,2684,2104,9797
New Jersey,Chesilhurst borough,1662,236,504,385,75,36,1236
New Jersey,Carteret borough,23965,2494,5595,4179,2549,1112,15929
New Jersey,Chester borough,1612,60,199,221,349,268,1097
New Jersey,Red Bank borough,12238,1866,1789,1693,1916,1543,8807
New Jersey,Ramtown,6050,95,1178,1137,866,562,3838
New Jersey,Lopatcong Overlook,545,21,45,139,209,23,437
New Jersey,Long Valley,1835,144,171,399,345,126,1185
New Jersey,Longport borough,999,35,247,193,233,171,879
New Jersey,Long Branch,30721,3250,6900,4522,3682,2144,20498
New Jersey,Lodi borough,24590,2827,5351,4623,3023,1019,16843
New Jersey,Loch Arbour,189,2,15,30,37,46,130
New Jersey,Raritan borough,7328,239,1744,1200,1254,577,5014
New Jersey,Pr,28936,585,1354,1689,4211,9267,17106
New Jersey,Princeton Meadows,13839,482,1054,1322,3354,3282,9494
New Jersey,Prospect Park borough,5924,506,1460,993,467,115,3541
New Jersey,Quinton,596,42,156,130,67,20,415
New Jersey,Rahway,28644,1985,6918,5282,3831,1929,19945
New Jersey,Ramblewood,5823,233,1039,1008,1327,577,4184
New Jersey,Ramsey borough,14889,210,1514,2013,3804,2717,10258
New Jersey,Princeton Junction,2423,119,90,153,652,716,1730
New Jersey,McGuire AFB,5113,58,390,1126,389,230,2193
New Jersey,Pine Ridge at Crestwood,2247,364,1121,473,181,69,2208
New Jersey,Pitman borough,8932,392,2033,1729,1306,746,6206
New Jersey,Cliffside Park borough,24493,2297,5491,3476,5009,2659,18932
New Jersey,Cliffwood Beach,3151,171,870,692,328,172,2233
New Jersey,Clifton,85552,7318,19090,14711,11667,5879,58665
New Jersey,Clinton,2681,150,350,405,601,294,1800
New Jersey,Closter borough,8582,251,1249,787,2167,1286,5740
New Jersey,Clyde,253,37,30,12,15,11,105
New Jersey,Clementon borough,4968,356,1222,1280,490,133,3481
New Jersey,Collings Lakes,1242,161,395,248,68,60,932
New Jersey,Colonia,17517,864,4018,3034,2663,1519,12098
New Jersey,Columbia,331,6,87,59,42,11,205
New Jersey,Concordia,3227,325,823,834,674,470,3126
New Jersey,Corbin City,482,24,158,78,50,39,349
New Jersey,Country Lake Estates,3658,304,857,892,263,33,2349
New Jersey,Cranbury,2283,80,227,228,485,515,1535
New Jersey,Collingswood borough,13925,682,2381,2677,2795,1716,10251
New Jersey,Pine Valley borough,3,0,0,0,2,1,3
New Jersey,Clearbrook Park,2713,176,1101,591,536,262,2666
New Jersey,Presidential Lakes Estates,2235,115,654,532,156,61,1518
New Jersey,Plainfield,50678,9156,9950,7612,3801,2271,32790
New Jersey,Plainsboro Center,2785,28,125,339,687,883,2062
New Jersey,Pleasant Plains,694,9,66,161,98,161,495
New Jersey,Pleasantville,20518,3963,4583,3186,1250,256,13238
New Jersey,Point Pleasant borough,18426,659,3630,3271,3426,1785,12771
New Jersey,Point Pleasant Beach borough,4604,187,817,877,842,608,3331
New Jersey,Clayton borough,8292,699,2305,1289,796,252,5341
New Jersey,Pomona,7495,984,1176,1257,1147,454,5018
New Jersey,Port Colden,126,13,47,36,14,0,110
New Jersey,Port Monmouth,3568,218,929,798,339,124,2408
New Jersey,Port Murray,96,0,81,0,15,0,96
New Jersey,Port Norris,1282,212,332,248,45,0,837
New Jersey,Port Reading,3634,252,989,454,516,212,2423
New Jersey,Port Republic,996,81,200,224,159,90,754
New Jersey,Pompton Lakes borough,11179,432,3117,1791,1604,1038,7982
New Jersey,Madison borough,16091,451,1587,1445,3417,3180,10080
New Jersey,Chatham borough,9011,164,728,670,2206,1835,5603
New Jersey,Madison Park,6690,505,1504,1241,1043,469,4762
New Jersey,Newfield borough,1616,83,483,360,146,89,1161
New Jersey,New Egypt,2016,128,681,411,147,73,1440
New Jersey,New Brunswick,56338,10205,7096,3850,3229,2183,26563
New Jersey,Newark,279793,48987,62390,41739,16419,7130,176665
New Jersey,Netcong borough,3258,240,1051,545,295,156,2287
New Jersey,Neptune City borough,4834,226,1291,1128,477,356,3478
New Jersey,Navesink,1738,21,252,327,368,126,1094
New Jersey,National Park borough,3005,212,1067,600,192,58,2129
New Jersey,Mystic Island,7864,615,2482,1705,622,394,5818
New Jersey,Mullica Hill,4377,291,853,1032,511,457,3144
New Jersey,Mount Hermon,108,3,23,33,13,3,75
New Jersey,Mount Ephraim borough,4646,334,1252,894,450,220,3150
New Jersey,Mount Arlington borough,5187,149,1257,1111,870,695,4082
New Jersey,Mountainside borough,6832,219,811,1168,1417,1116,4731
New Jersey,Mountain Lakes borough,4262,50,98,183,948,1325,2604
New Jersey,Blackwells Mills,503,0,10,89,124,105,328
New Jersey,Mountain Lake,579,29,124,167,61,82,463
New Jersey,Blackwood,4662,301,1393,974,378,96,3142
New Jersey,Blawenburg,343,0,0,50,93,63,206
New Jersey,Broadway,194,0,60,33,15,21,129
New Jersey,Brigantine,9347,677,1941,2137,1716,811,7282
New Jersey,Brielle borough,4769,109,346,843,1334,731,3363
New Jersey,Bridgeville,173,0,43,31,12,0,86
New Jersey,Bridgeton,25201,5826,5464,3014,596,250,15150
New Jersey,Branchville borough,889,70,249,166,77,28,590
New Jersey,Brainards,189,8,64,45,27,0,144
New Jersey,Bradley Gardens,13994,484,1626,1425,2910,2838,9283
New Jersey,Bradley Beach borough,4297,395,551,1092,666,598,3302
New Jersey,Bound Brook borough,10515,1128,3056,1696,995,559,7434
New Jersey,Bordentown,3903,121,742,830,708,451,2852
New Jersey,Boonton,8422,498,1324,1263,1990,900,5975
New Jersey,Bogota borough,8329,637,1807,1375,1215,597,5631
New Jersey,Bloomsbury borough,720,42,136,134,128,55,495
New Jersey,Bloomingdale borough,7933,450,2198,1486,1177,602,5913
New Jersey,Blairstown,540,70,156,153,0,0,379
New Jersey,Morristown,18563,2076,3193,2085,3649,2901,13904
New Jersey,Brass Castle,1575,60,389,247,258,144,1098
New Jersey,Morganville,4999,133,657,825,894,713,3222
New Jersey,Medford Lakes borough,4124,58,433,818,931,656,2896
New Jersey,Maywood borough,9694,472,2086,1871,1624,923,6976
New Jersey,Mays Landing,1932,114,499,346,325,127,1411
New Jersey,Matawan borough,8887,377,1716,1900,1684,776,6453
New Jersey,Martinsville,11950,304,1461,1510,2582,2559,8416
New Jersey,Marlton,10271,516,2136,2048,1927,942,7569
New Jersey,Mendham borough,5016,41,449,587,1242,961,3280
New Jersey,Marksboro,96,11,16,16,11,2,56
New Jersey,Manville borough,10454,851,3839,1834,785,233,7542
New Jersey,Mantoloking borough,340,8,18,39,145,97,307
New Jersey,Manasquan borough,5830,97,977,880,1427,925,4306
New Jersey,Manahawkin,2474,234,443,324,485,106,1592
New Jersey,Morris Plains borough,5598,144,736,816,1295,948,3939
New Jersey,Magnolia borough,4314,216,1271,985,437,123,3032
New Jersey,Margate City,6304,261,1302,1287,1501,950,5301
New Jersey,Mercerville,13371,859,2787,3122,1783,839,9390
New Jersey,Cape May Point borough,240,1,49,37,80,69,236
New Jersey,Milltown borough,6989,176,1310,1401,1569,672,5128
New Jersey,Monmouth Beach borough,3258,22,425,531,983,457,2418
New Jersey,Millville,28515,2495,7737,5054,2451,1001,18738
New Jersey,Merchantville borough,3793,312,840,705,512,274,2643
New Jersey,Monmouth Junction,3267,134,293,380,618,575,2000
New Jersey,Millstone borough,487,19,78,63,74,59,293
New Jersey,Milford borough,1123,40,276,231,199,90,836
New Jersey,Moonachie borough,2753,365,794,389,332,85,1965
New Jersey,Middlesex borough,13831,866,3233,2579,1890,845,9413
New Jersey,Middlebush,2478,56,530,346,441,406,1779
New Jersey,Metuchen borough,13765,491,1474,1864,3056,2888,9773
New Jersey,Moorestown-Lenola,14217,362,1826,2111,3124,2277,9700
New Jersey,Midland Park borough,7269,214,1325,956,1816,837,5148
New Jersey,Montvale borough,8199,242,1049,1139,1706,1358,5494
New Mexico,Lower Frisco,0,0,0,0,0,0,0
New Mexico,Lovington,11499,2231,1907,1698,239,208,6283
New Mexico,Loving,1451,291,377,247,33,5,953
New Mexico,Los Ranchos de Albuquerque,6067,264,785,1363,1250,972,4634
New Mexico,Los Ojos,114,10,80,0,0,24,114
New Mexico,Luis Lopez,246,0,169,8,0,14,191
New Mexico,Williamsburg,512,29,111,163,45,1,349
New Mexico,Los Luceros,523,0,102,148,142,0,392
New Mexico,Lumberton,114,15,81,0,8,6,110
New Mexico,Los Chaves,5067,513,1098,1118,427,345,3501
New Mexico,Los Cerrillos,421,56,71,108,65,30,330
New Mexico,Los Alamos,11815,238,981,1682,2104,3619,8624
New Mexico,Lordsburg,2740,495,647,449,68,60,1719
New Mexico,Logan,1012,80,432,222,46,44,824
New Mexico,Los Lunas,15281,1187,2790,3720,1291,641,9629
New Mexico,Luna,130,0,3,78,27,22,130
New Mexico,Malaga,66,30,30,6,0,0,66
New Mexico,McCartys Village,88,22,21,27,0,0,70
New Mexico,Middle Frisco,165,9,121,8,0,0,138
New Mexico,Mesquite,563,111,125,78,0,0,314
New Mexico,Mesita,627,24,104,188,35,11,362
New Mexico,Mesilla,2403,154,388,351,372,427,1692
New Mexico,Mescalero,1520,183,417,232,23,32,887
New Mexico,Melrose,634,38,154,177,48,18,435
New Mexico,Meadow Lake,4813,858,998,622,93,16,2587
New Mexico,Lyden,386,0,20,156,0,43,219
New Mexico,Mayhill,234,0,77,39,42,3,161
New Mexico,Manzano Springs,149,3,0,35,46,38,122
New Mexico,Manzano,13,0,0,0,0,13,13
New Mexico,Loco Hills,34,34,0,0,0,0,34
New Mexico,Magdalena,603,66,201,175,8,14,464
New Mexico,Madrone,577,149,136,36,0,12,333
New Mexico,Madrid,178,0,0,92,39,17,148
New Mexico,McIntosh,809,86,244,302,68,23,723
New Mexico,Maxwell,137,27,29,24,26,5,111
New Mexico,Llano del Medio,49,24,0,0,0,25,49
New Mexico,Las Palomas,444,31,77,57,89,31,285
New Mexico,Lemitar,331,55,16,90,45,10,216
New Mexico,La Jara,197,18,98,44,0,23,183
New Mexico,La Huerta,1116,12,130,355,86,101,684
New Mexico,La Hacienda,671,122,91,82,20,0,315
New Mexico,Laguna,1510,111,406,330,81,18,946
New Mexico,La Cueva,113,0,0,69,11,33,113
New Mexico,La Cienega,2884,272,675,637,245,184,2013
New Mexico,Kirtland,6068,401,992,1743,330,227,3693
New Mexico,Kingston,9,9,0,0,0,0,9
New Mexico,Yah-ta-hey,383,30,92,57,0,0,179
New Mexico,Young Place,108,0,55,53,0,0,108
New Mexico,Youngsville,87,42,38,3,4,0,87
New Mexico,Zia Pueblo,879,81,206,201,22,11,521
New Mexico,Zuni Pueblo,9494,1662,2386,1662,251,53,6014
New Mexico,Winston,20,9,11,0,0,0,20
New Mexico,Windmill,63,0,9,30,8,0,47
New Mexico,La Joya,0,0,0,0,0,0,0
New Mexico,Livingston Wheeler,645,137,99,65,77,63,441
New Mexico,Lake Arthur,436,95,91,46,18,9,259
New Mexico,Lake Roberts Heights,25,0,0,0,13,12,25
New Mexico,Lee Acres,6480,1051,1100,1217,225,207,3800
New Mexico,La Villita,1153,138,272,251,0,0,661
New Mexico,La Union,1561,248,376,81,72,16,793
New Mexico,Las Vegas,13713,2167,2392,2860,949,814,9182
New Mexico,Las Nutrias,335,10,105,57,20,0,192
New Mexico,Las Maravillas,1994,76,400,533,81,110,1200
New Mexico,Las Cruces,101164,8806,12053,19631,11922,8219,60631
New Mexico,La Puebla,1000,174,303,98,65,59,699
New Mexico,La Plata,751,12,170,155,45,30,412
New Mexico,Lamy,174,2,34,22,19,41,118
New Mexico,La Mesilla,2134,128,366,517,302,221,1534
New Mexico,La Mesa,887,92,179,175,50,0,496
New Mexico,La Luz,1837,232,434,335,120,135,1256
New Mexico,Lake Valley,55,15,10,6,0,0,31
New Mexico,Lake Sumner,166,12,36,32,14,0,94
New Mexico,Lake Roberts,0,0,0,0,0,0,0
New Mexico,La Madera,123,0,41,0,37,45,123
New Mexico,Jarales,2000,288,475,489,105,62,1419
New Mexico,Abiquiu,61,0,32,12,0,0,44
New Mexico,Pueblitos,708,117,180,182,62,39,580
New Mexico,Pueblo,16,0,16,0,0,0,16
New Mexico,Pueblo of Sandia Village,362,10,57,121,20,11,219
New Mexico,Pueblo Pintado,407,31,46,111,8,4,200
New Mexico,Des Moines,123,10,59,7,7,1,84
New Mexico,Dexter,1390,298,178,196,57,48,777
New Mexico,Dixon,1009,276,144,215,60,59,754
New Mexico,Do?a Ana,1313,159,215,259,56,0,689
New Mexico,Dora,65,5,9,12,4,8,38
New Mexico,Pueblito,112,15,50,14,2,13,94
New Mexico,Dulce,2499,179,580,479,99,35,1372
New Mexico,Abeytas,28,0,0,0,20,8,28
New Mexico,Puerto de Luna,174,22,6,55,38,0,121
New Mexico,Pulpotio Bareas,151,0,53,73,0,0,126
New Mexico,Quemado,72,0,12,21,0,0,33
New Mexico,Questa,1748,215,418,516,36,52,1237
New Mexico,Radium Springs,1400,234,197,216,277,123,1047
New Mexico,Ramah,278,36,21,45,54,9,165
New Mexico,Rancho Grande,157,0,95,38,12,12,157
New Mexico,Ranchos de Taos,2435,451,581,392,271,83,1778
New Mexico,Duran,15,0,0,6,4,0,10
New Mexico,Raton,6493,717,1940,1421,383,176,4637
New Mexico,Portales,12416,1100,1657,2077,898,718,6450
New Mexico,Ponderosa,498,52,55,131,43,9,290
New Mexico,Paradise Hills,4733,177,742,1280,493,436,3128
New Mexico,Paraje,817,74,337,153,48,30,642
New Mexico,Pastura,8,0,8,0,0,0,8
New Mexico,Peak Place,347,81,66,34,12,0,193
New Mexico,Pecan Park,33,0,4,29,0,0,33
New Mexico,Pecos,1409,186,311,363,36,79,975
New Mexico,Pe?a Blanca,584,96,121,116,19,39,391
New Mexico,Pe?asco,527,72,115,130,32,36,385
New Mexico,Peralta,3625,471,759,772,549,118,2669
New Mexico,Ponderosa Pine,1225,26,188,272,180,336,1002
New Mexico,Picuris Pueblo,49,14,25,5,2,0,46
New Mexico,Pinehill,81,17,15,38,0,0,70
New Mexico,Pinon,26,26,0,0,0,0,26
New Mexico,Pinos Altos,226,0,26,33,0,44,103
New Mexico,Placitas CDP (Do?a Ana County),678,255,0,46,0,0,301
New Mexico,Placitas CDP (Sandoval County),4917,78,685,1494,948,1079,4284
New Mexico,Playas,157,0,0,43,24,0,67
New Mexico,Pleasanton,119,9,9,31,23,0,72
New Mexico,Pojoaque,2202,220,415,494,181,124,1434
New Mexico,Polvadera,783,39,86,125,65,0,315
New Mexico,Pie Town,123,0,39,34,50,0,123
New Mexico,Pajarito Mesa,329,38,117,40,0,0,195
New Mexico,Red River,328,2,48,110,76,6,242
New Mexico,Reserve,613,83,142,168,13,28,434
New Mexico,Sandia Knolls,1486,8,280,363,358,178,1187
New Mexico,Sandia Park,105,0,23,41,17,24,105
New Mexico,San Felipe Pueblo,3167,493,691,541,59,28,1812
New Mexico,San Fidel,133,44,1,1,2,0,48
New Mexico,San Ildefonso Pueblo,699,66,227,132,55,32,512
New Mexico,San Jon,153,31,33,24,10,4,102
New Mexico,San Jose CDP (Rio Arriba County),677,124,110,183,38,18,473
New Mexico,San Jose CDP (San Miguel County),161,45,19,24,24,32,144
New Mexico,San Lorenzo,51,0,21,20,10,0,51
New Mexico,Sandia Heights,3377,20,190,644,832,1206,2892
New Mexico,San Luis,29,21,0,0,8,0,29
New Mexico,San Miguel,1213,249,236,134,92,24,735
New Mexico,Sanostee,387,65,93,36,0,7,201
New Mexico,San Pablo,1042,145,155,136,87,86,609
New Mexico,San Pedro,187,0,18,51,102,16,187
New Mexico,San Rafael,1055,154,408,195,19,39,815
New Mexico,Santa Ana Pueblo,645,26,152,192,27,12,409
New Mexico,Santa Clara,1560,318,310,399,118,23,1168
New Mexico,Santa Clara Pueblo,1086,81,252,278,85,46,742
New Mexico,Santa Cruz,351,70,76,64,13,3,226
New Mexico,San Mateo,316,0,107,25,44,47,223
New Mexico,Regina,4,0,0,0,4,0,4
New Mexico,San Cristobal,288,78,86,71,53,0,288
New Mexico,San Antonito CDP (Bernalillo County),952,9,115,151,284,137,696
New Mexico,Ribera,763,87,222,224,0,0,533
New Mexico,Rincon,54,15,0,0,0,0,15
New Mexico,Rio Communities,5189,278,1302,1343,351,225,3499
New Mexico,Corona,132,7,44,39,25,9,124
New Mexico,Rio Lucio,392,38,108,75,36,6,263
New Mexico,Rio Rancho,91807,4201,14941,23705,10422,6453,59722
New Mexico,Rivers,0,0,0,0,0,0,0
New Mexico,Rock Springs,314,12,40,46,3,0,101
New Mexico,Rodeo,95,10,47,17,0,4,78
New Mexico,San Antonito CDP (Socorro County),123,0,95,0,9,19,123
New Mexico,Rodey,198,92,33,0,0,0,125
New Mexico,Roswell,48553,5903,8166,10328,3723,1809,29929
New Mexico,Rowe,361,13,177,140,0,17,347
New Mexico,Roy,222,35,90,46,16,8,195
New Mexico,Ruidoso,7884,454,1569,1980,1289,707,5999
New Mexico,Ruidoso Downs,2674,561,354,643,161,41,1760
New Mexico,Sacramento,92,30,0,48,0,0,78
New Mexico,Salem,975,355,49,0,24,0,428
New Mexico,San Acacia,87,9,29,0,10,0,48
New Mexico,San Antonio,32,0,0,0,32,0,32
New Mexico,Rosedale,267,14,103,88,0,62,267
New Mexico,Paguate,328,16,77,100,30,49,272
New Mexico,Orogrande,109,44,0,44,0,0,88
New Mexico,Organ,189,23,29,96,0,0,148
New Mexico,Cedro,302,0,44,79,33,67,223
New Mexico,Cedar Hill,693,52,177,212,92,60,593
New Mexico,Cedar Grove,669,14,66,250,109,82,521
New Mexico,Cedar Crest,919,66,139,253,90,118,666
New Mexico,Causey,56,6,8,15,8,7,44
New Mexico,Casa Colorada,112,22,38,19,0,6,85
New Mexico,Carrizozo,934,115,274,252,35,37,713
New Mexico,Carnuel,1687,319,427,376,134,143,1399
New Mexico,Carlsbad,27592,2558,6317,5499,1710,1683,17767
New Mexico,Chama,868,85,174,216,62,37,574
New Mexico,Capulin,100,11,44,9,3,0,67
New Mexico,Canova,0,0,0,0,0,0,0
New Mexico,Ca?ones,65,39,19,0,2,0,60
New Mexico,Ca?on,219,0,61,22,11,39,133
New Mexico,Cannon AFB,2575,11,94,590,254,32,981
New Mexico,Canjilon,340,58,163,98,10,0,329
New Mexico,Ca?ada de los Alamos,229,0,43,20,74,63,200
New Mexico,Caballo,46,0,33,13,0,0,46
New Mexico,Buckhorn,182,18,24,46,39,17,144
New Mexico,Brimhall Nizhoni,371,65,99,91,3,4,262
New Mexico,Capitan,1306,101,498,305,63,37,1004
New Mexico,Brazos,51,0,25,26,0,0,51
New Mexico,Chamberino,923,202,138,180,37,34,591
New Mexico,Chamita,987,267,242,162,12,18,701
New Mexico,Cordova,417,121,65,133,39,0,358
New Mexico,Conchas Dam,82,0,9,22,10,0,41
New Mexico,Columbus,1265,513,161,63,37,69,843
New Mexico,Cochiti Lake,590,21,71,186,115,98,491
New Mexico,Cochiti,453,13,109,144,22,4,292
New Mexico,Cobre,18,0,0,0,0,18,18
New Mexico,Clovis,39466,4352,5974,8645,2868,2120,23959
New Mexico,Cloudcroft,530,32,121,145,71,84,453
New Mexico,Cliff,334,0,140,116,6,0,262
New Mexico,Chamisal,285,51,86,71,15,17,240
New Mexico,Clayton,2816,521,729,601,140,77,2068
New Mexico,Cimarron,1035,117,241,196,106,32,692
New Mexico,Church Rock,1051,138,182,214,52,15,601
New Mexico,Chupadero,270,14,22,35,98,75,244
New Mexico,Chimayo,2369,208,524,671,29,94,1526
New Mexico,Chilili,46,23,23,0,0,0,46
New Mexico,Chili,648,33,227,137,31,0,428
New Mexico,Chical,134,20,29,45,17,0,111
New Mexico,Chaparral,13629,3199,2101,1703,496,147,7646
New Mexico,Chamizal,44,22,0,11,11,0,44
New Mexico,City of the Sun,38,0,0,38,0,0,38
New Mexico,Costilla,61,11,0,0,9,0,20
New Mexico,Cotton City,284,98,34,38,23,3,196
New Mexico,Coyote,150,7,80,47,0,0,134
New Mexico,Nakaibito,473,68,104,78,28,0,278
New Mexico,Nambe,1906,156,372,407,233,149,1317
New Mexico,Napi Headquarters,688,116,150,110,0,0,376
New Mexico,Nara Visa,52,0,21,31,0,0,52
New Mexico,Naschitti,229,22,52,62,7,18,161
New Mexico,Navajo,1918,225,354,227,32,24,862
New Mexico,Navajo Dam,91,9,28,35,0,0,72
New Mexico,Nenahnezad,812,66,199,162,19,16,462
New Mexico,Newcomb,265,25,61,42,26,20,174
New Mexico,Nageezi,284,61,65,25,0,0,151
New Mexico,Newkirk,0,0,0,0,0,0,0
New Mexico,North Acomita Village,250,39,58,49,0,20,166
New Mexico,North Hobbs,6034,649,1281,1193,420,323,3866
New Mexico,North Hurley,290,8,97,52,0,7,164
New Mexico,North Light Plant,426,49,59,27,29,0,164
New Mexico,North San Ysidro,121,30,0,37,32,0,99
New Mexico,North Valley,11221,1082,2299,2283,981,1400,8045
New Mexico,Oasis,113,36,49,23,5,0,113
New Mexico,Ohkay Owingeh,1531,115,393,389,53,18,968
New Mexico,Ojo Amarillo,659,47,161,104,9,3,324
New Mexico,Nogal,112,0,33,17,22,9,81
New Mexico,Nadine,381,43,134,87,14,0,278
New Mexico,Mountain View,88,39,0,49,0,0,88
New Mexico,Mountainair,1137,144,299,173,63,19,698
New Mexico,Crownpoint,2565,265,423,690,82,52,1512
New Mexico,Cruzville,167,5,28,0,0,15,48
New Mexico,Crystal,364,29,75,108,6,25,243
New Mexico,Cuartelez,404,15,0,154,51,0,220
New Mexico,Cuba,725,80,217,80,33,20,430
New Mexico,Cubero,256,39,62,39,0,44,184
New Mexico,Cundiyo,11,8,3,0,0,0,11
New Mexico,Cuyamungue,548,52,118,134,49,22,375
New Mexico,Cuyamungue Grant,127,23,35,15,11,13,97
New Mexico,Datil,109,0,44,54,11,0,109
New Mexico,Deming,14667,3126,2963,2145,607,427,9268
New Mexico,Midway,1065,203,176,200,0,0,579
New Mexico,Milan,3257,734,598,706,73,27,2138
New Mexico,Mimbres,737,8,62,340,22,172,604
New Mexico,Monterey Park,1697,541,103,118,12,38,812
New Mexico,Monument,159,37,30,47,4,7,125
New Mexico,Moquino,0,0,0,0,0,0,0
New Mexico,Mora,751,18,224,63,0,0,305
New Mexico,Moriarty,2227,261,538,460,168,24,1451
New Mexico,Morningside,970,173,68,38,0,0,279
New Mexico,Mosquero,52,6,16,10,4,0,36
New Mexico,Santa Fe,83008,8532,12447,14582,12065,11995,59621
New Mexico,Santa Rosa,3040,566,951,511,133,118,2279
New Mexico,Rio en Medio,196,42,46,36,27,0,151
New Mexico,Santo Domingo Pueblo,2665,455,506,538,62,26,1587
New Mexico,South Acomita Village,116,10,45,47,0,0,102
New Mexico,South Valley,41660,8023,9609,6530,2089,1205,27456
New Mexico,Spencerville,1587,234,293,440,93,0,1060
New Mexico,Springer,1051,49,293,203,143,35,723
New Mexico,Sunland Park,15142,3742,2012,1567,693,192,8206
New Mexico,Sunshine,307,0,98,77,6,16,197
New Mexico,Tajique,58,58,0,0,0,0,58
New Mexico,Talpa,1014,31,136,211,78,116,572
New Mexico,Taos,5711,498,968,1429,897,556,4348
New Mexico,Taos Pueblo,1098,62,224,434,80,34,834
New Mexico,Taos Ski Valley,115,1,19,9,18,36,83
New Mexico,Tatum,751,156,167,110,5,19,457
New Mexico,Tecolote,96,66,11,9,0,0,86
New Mexico,Sombrillo,398,12,21,156,160,6,355
New Mexico,Tecolotito,123,49,0,9,0,0,58
New Mexico,Tesuque Pueblo,243,36,62,40,7,8,153
New Mexico,Texico,1355,248,209,271,39,71,838
New Mexico,Thoreau,1570,249,328,205,160,38,980
New Mexico,Tierra Amarilla,598,63,89,184,29,0,365
New Mexico,Tijeras,530,47,145,142,34,65,433
New Mexico,Timberon,357,29,49,163,38,0,279
New Mexico,Tohatchi,1004,121,209,188,70,38,626
New Mexico,Tome,1855,128,655,391,153,139,1466
New Mexico,Torreon CDP (Sandoval County),368,63,70,45,17,6,201
New Mexico,Torreon CDP (Torrance County),184,0,78,85,0,0,163
New Mexico,Trout Valley,0,0,0,0,0,0,0
New Mexico,Truchas,388,20,140,66,93,38,357
New Mexico,Truth or Consequences,6266,867,1781,1462,451,304,4865
New Mexico,Tesuque,961,48,88,171,164,384,855
New Mexico,Soham,191,74,61,0,27,0,162
New Mexico,Socorro,8843,1445,1745,1017,533,433,5173
New Mexico,Skyline-Ganipa,1232,83,286,289,41,7,706
New Mexico,Hagerman,1112,164,187,227,35,8,621
New Mexico,Hanover,190,0,26,23,0,11,60
New Mexico,Happy Valley,850,204,235,173,0,0,612
New Mexico,Hatch,1757,470,278,106,34,32,920
New Mexico,Hernandez,937,277,207,102,28,4,618
New Mexico,Highland Meadows,688,87,154,153,14,13,421
New Mexico,High Rolls,558,14,36,250,96,33,429
New Mexico,Hillsboro,110,29,38,43,0,0,110
New Mexico,Hobbs,36191,5916,6348,6137,2059,1185,21645
New Mexico,Holloman AFB,4112,11,171,813,257,191,1443
New Mexico,Homestead,52,0,0,17,17,18,52
New Mexico,Hope,98,33,26,7,7,5,78
New Mexico,Hot Springs Landing,150,49,48,53,0,0,150
New Mexico,House,38,6,8,11,6,7,38
New Mexico,Hurley,1275,112,335,274,115,71,907
New Mexico,Indian Hills,1374,108,411,332,22,16,889
New Mexico,Isleta Village Proper,509,97,114,110,63,9,393
New Mexico,Jacona,449,33,88,88,55,44,308
New Mexico,Jaconita,476,29,42,139,91,34,335
New Mexico,Jal,2161,388,473,429,90,37,1417
New Mexico,Jemez Pueblo,1969,128,461,530,76,40,1235
New Mexico,Jemez Springs,272,3,49,50,59,44,205
New Mexico,Keeler Farm,1823,287,449,356,18,11,1121
New Mexico,Seboyeta,108,0,42,12,18,0,72
New Mexico,Sedillo,851,8,94,227,182,192,703
New Mexico,Sena,157,38,29,41,0,0,108
New Mexico,Sheep Springs,215,22,47,49,8,3,129
New Mexico,Shiprock,8496,731,1666,1868,363,233,4861
New Mexico,Silver City,10184,1185,1429,2025,809,1094,6542
New Mexico,Tse Bonito,207,4,13,79,0,0,96
New Mexico,Hachita,57,13,19,12,13,0,57
New Mexico,Tucumcari,5157,650,1323,1028,281,197,3479
New Mexico,Twin Forks,101,0,22,19,8,52,101
New Mexico,Berino,1775,549,95,93,36,0,773
New Mexico,Bent,123,23,38,62,0,0,123
New Mexico,Belen,7209,1036,1452,1336,377,231,4432
New Mexico,Beclabito,267,37,49,75,17,8,186
New Mexico,Bayard,2490,392,641,413,93,53,1592
New Mexico,Aztec,6501,718,1313,1624,227,302,4184
New Mexico,Atoka,727,221,250,72,67,25,635
New Mexico,Artesia,11641,1370,2528,2436,916,269,7519
New Mexico,Arroyo Seco,888,87,174,155,298,101,815
New Mexico,Arroyo Hondo,334,8,91,85,22,24,230
New Mexico,Arrey,312,132,33,0,65,0,230
New Mexico,Arenas Valley,1524,99,229,375,181,130,1014
New Mexico,Aragon,9,0,0,9,0,0,9
New Mexico,Bernalillo,8522,1226,2009,1833,604,483,6155
New Mexico,Apache Creek,21,0,10,11,0,0,21
New Mexico,Anton Chico,39,7,32,0,0,0,39
New Mexico,Anthony,9429,2057,1493,1212,166,43,4971
New Mexico,Animas,167,13,64,41,9,19,146
New Mexico,Angel Fire,960,32,99,294,179,187,791
New Mexico,Algodones,932,97,259,153,82,53,644
New Mexico,Alcalde,210,12,51,69,10,3,145
New Mexico,Albuquerque,556092,40927,86028,119694,68651,55684,370984
New Mexico,Alamogordo,31198,2348,6479,8455,2030,1656,20968
New Mexico,Alamo,607,219,202,50,24,5,500
New Mexico,Alamillo,106,0,14,15,43,34,106
New Mexico,Agua Fria,2857,392,643,445,144,87,1711
New Mexico,Adelino,841,138,247,257,69,0,711
New Mexico,Acomita Lake,375,39,128,71,5,0,243
New Mexico,Anzac Village,129,0,29,39,21,10,99
New Mexico,Bibo,173,20,66,0,40,0,126
New Mexico,Black Rock,1613,110,245,242,56,58,711
New Mexico,Blanco,200,15,87,30,0,13,145
New Mexico,Twin Lakes,908,126,275,145,27,3,576
New Mexico,Tyrone,545,40,58,160,78,63,399
New Mexico,University Park,3276,0,39,281,111,104,535
New Mexico,Upper Fruitland,1660,232,399,314,87,15,1047
New Mexico,Ute Park,100,0,0,18,82,0,100
New Mexico,Vadito,300,41,51,88,21,10,211
New Mexico,Vado,2681,719,590,118,40,10,1477
New Mexico,Valencia,2295,337,569,559,193,66,1724
New Mexico,Vaughn,437,43,98,79,12,0,232
New Mexico,Veguita,108,0,17,31,0,0,48
New Mexico,Velarde,409,0,14,104,146,53,317
New Mexico,Ventura,183,48,47,79,0,0,174
New Mexico,Villanueva,133,36,60,16,10,0,122
New Mexico,Virden,172,9,25,49,17,5,105
New Mexico,Wagon Mound,649,190,260,68,45,40,603
New Mexico,Waterflow,1784,145,299,414,179,43,1080
New Mexico,Watrous,0,0,0,0,0,0,0
New Mexico,Weed,46,15,0,0,14,17,46
New Mexico,West Hammond,2867,263,667,823,55,108,1916
New Mexico,White Rock,5927,73,381,1090,1056,1371,3971
New Mexico,White Sands,1567,2,88,277,135,40,542
New Mexico,Whites City,164,0,51,35,0,0,86
New Mexico,White Signal,235,4,40,70,20,65,199
New Mexico,Willard,230,38,82,37,3,0,160
New Mexico,Bosque Farms,3864,281,814,982,358,290,2725
New Mexico,Boles Acres,2053,172,494,872,64,74,1676
New Mexico,Bluewater Village,350,0,112,64,39,0,215
New Mexico,Bluewater Acres,347,57,181,46,0,0,284
New Mexico,Bloomfield,7735,931,1502,1354,424,316,4527
New Mexico,Tularosa,2914,370,637,557,245,217,2026
New Mexico,Santa Teresa,4710,515,433,865,434,429,2676
New Mexico,Corrales,8455,369,1236,1333,1696,1821,6455
New Mexico,Grenville,28,0,3,8,7,2,20
New Mexico,Grady,84,19,14,19,5,3,60
New Mexico,Golden,38,0,7,0,0,24,31
New Mexico,Glorieta,549,105,90,128,60,39,422
New Mexico,Glenwood,0,0,0,0,0,0,0
New Mexico,Ensenada,161,0,46,74,0,0,120
New Mexico,Escondida,23,0,23,0,0,0,23
New Mexico,Escudilla Bonita,31,0,0,31,0,0,31
New Mexico,Glen Acres,276,58,43,55,21,0,177
New Mexico,Espa?ola,10168,1466,2014,2088,650,336,6554
New Mexico,Estancia,1804,501,456,245,9,60,1271
New Mexico,Grants,9243,1227,2043,1830,706,192,5998
New Mexico,Gila,318,34,114,70,10,0,228
New Mexico,Gallup,22467,2482,3336,3907,1354,1243,12322
New Mexico,Gallina,268,89,81,20,18,0,208
New Mexico,Galisteo,194,0,3,70,37,29,139
New Mexico,Eunice,3060,573,581,572,129,43,1898
New Mexico,Fairacres,1030,131,153,222,51,114,671
New Mexico,Farmington,44865,3805,8198,10454,3460,2246,28163
New Mexico,Faywood,113,78,0,26,9,0,113
New Mexico,Fence Lake,0,0,0,0,0,0,0
New Mexico,Flora Vista,2040,333,494,576,103,24,1530
New Mexico,Floyd,121,19,8,28,6,2,63
New Mexico,Garfield,50,0,12,30,0,8,50
New Mexico,Folsom,41,0,22,13,0,0,35
New Mexico,Fort Sumner,1251,150,458,303,5,14,930
New Mexico,Eldorado at Santa Fe,6486,87,487,1093,2135,1742,5544
New Mexico,Edgewood,3773,75,673,1058,557,310,2673
New Mexico,Edith Endave,328,22,85,59,20,20,206
New Mexico,El Cerro,2965,326,644,904,173,140,2187
New Mexico,El Cerro Mission,4547,1037,785,663,127,28,2640
New Mexico,El Duende,972,153,143,145,1,1,443
New Mexico,Elephant Butte,1393,140,468,350,53,88,1099
New Mexico,Elida,190,41,26,41,11,8,127
New Mexico,East Pecos,569,0,222,64,0,63,349
New Mexico,El Rancho,1219,92,282,231,127,99,831
New Mexico,El Valle de Arroyo Seco,1291,152,405,182,30,39,808
New Mexico,Encinal,111,7,79,18,7,0,111
New Mexico,Encino,36,3,27,6,0,0,36
New Mexico,Seama,366,7,146,101,0,0,254
New Mexico,Sausal,1322,129,222,249,55,61,716
New Mexico,San Ysidro,177,24,33,50,19,10,136
New Mexico,San Ysidro,2432,632,148,363,307,111,1561
New Mexico,El Rito,1051,59,537,110,139,0,845
New Mexico,Eagle Nest,264,0,49,58,45,15,167
New York,Lake Placid,2539,163,531,547,380,217,1838
New York,Lake Katrine,2322,258,722,490,191,186,1847
New York,Lake Mohegan,5663,216,805,1106,1061,655,3843
New York,Lake Luzerne,1252,91,344,256,100,59,850
New York,Lakeland,2747,122,823,639,314,190,2088
New York,Lake Erie Beach,4228,99,1295,992,336,286,3008
New York,Lake Grove,11262,503,2140,2157,1674,1176,7650
New York,Lake George,851,81,182,234,123,69,689
New York,Brentwood,61374,11290,14413,8013,3454,1535,38705
New York,Kennedy,504,58,184,131,18,10,401
New York,Lake Carmel,8294,389,2077,1785,938,722,5911
New York,La Fargeville,560,11,161,107,37,79,395
New York,Lacona,682,51,177,146,31,36,441
New York,Lackawanna,18019,2084,4668,3769,1232,643,12396
New York,Windsor,1030,39,281,241,82,82,725
New York,Kysorville,156,35,25,27,8,3,98
New York,Kiryas Joel,21749,2137,2491,838,378,88,5932
New York,Kingston,23625,2568,5280,5083,2152,1518,16601
New York,Kings Point,5071,329,517,535,871,641,2893
New York,Kings Park,17823,826,3081,3600,2932,2195,12634
New York,Kinderhook,1389,25,274,240,192,382,1113
New York,Keuka Park,875,0,24,29,19,6,78
New York,Kerhonkson,2247,233,475,350,226,73,1357
New York,Lake Ronkonkoma,19943,1108,4304,4215,2118,1813,13558
New York,Winthrop,371,34,198,41,0,48,321
New York,Keeseville,1776,216,487,323,78,80,1184
New York,Kenmore,15271,814,2293,4382,1920,1862,11271
New York,Kensington,1113,26,54,92,218,377,767
New York,Lake Success,3027,209,378,237,677,717,2218
New York,Lakeview,6569,688,1017,1258,504,436,3903
New York,Lakeville,1055,117,269,132,14,10,542
New York,Brighton,36929,1488,3082,5599,7121,9408,26698
New York,Brightwaters,3102,30,381,512,669,571,2163
New York,Brinckerhoff,2602,108,628,660,317,288,2001
New York,Broadalbin,1550,83,313,382,158,47,983
New York,Brockport,8428,243,941,926,666,663,3439
New York,Brocton,1518,158,463,348,82,67,1118
New York,Bridgewater,612,44,116,133,21,9,323
New York,Bronxville,6409,49,236,433,1287,1833,3838
New York,Brookville,3546,32,144,179,536,598,1489
New York,Brownville,958,63,223,200,64,59,609
New York,Brushton,578,52,151,117,46,26,392
New York,Buchanan,2218,117,490,428,305,223,1563
New York,Buffalo,259517,28718,45491,50824,22224,18506,165763
New York,Wheatley Heights,5220,244,811,914,785,535,3289
New York,Brookhaven,3138,262,487,622,441,444,2256
New York,Bridgeport,1668,201,507,437,66,2,1213
New York,Bridgehampton,1274,62,368,169,224,169,992
New York,Briarcliff Manor,7739,229,517,753,1584,1977,5060
New York,Breesport,738,16,156,172,111,33,488
New York,Brasher Falls,452,16,157,62,63,45,343
New York,Boonville,2067,172,676,348,121,109,1426
New York,Bolton Landing,416,0,52,84,159,21,316
New York,Bolivar,1123,106,340,223,101,63,833
New York,Bohemia,9977,531,2304,1912,918,933,6598
New York,Blue Point,4725,83,893,916,669,723,3284
New York,Bloomville,186,16,68,40,14,8,146
New York,Brewster,2212,550,419,292,169,81,1511
New York,Bloomfield,1550,40,246,367,241,109,1003
New York,Blodgett Mills,321,36,96,62,0,6,200
New York,Bliss,613,29,130,158,31,22,370
New York,Blauvelt,5394,218,634,692,933,826,3303
New York,Blasdell,2579,138,808,577,139,59,1721
New York,Brewster Hill,1378,81,260,379,173,126,1019
New York,Whitehall,2769,270,916,431,191,48,1856
New York,White Plains,57790,5816,7456,7674,9918,10180,41044
New York,Whitesboro,3731,120,1020,1016,445,110,2711
New York,Whitney Point,1004,36,268,200,68,58,630
New York,Liberty,4241,597,951,1079,236,106,2969
New York,Lewiston,2598,59,349,556,530,334,1828
New York,Levittown,51593,2715,11164,10692,6784,4405,35760
New York,Le Roy,4333,317,1059,800,443,243,2862
New York,Leicester,444,38,116,109,27,22,312
New York,Leeds,480,61,187,42,19,7,316
New York,Lawrence,6529,100,157,708,1386,1850,4201
New York,Laurens,233,12,58,57,24,7,158
New York,Laurel Hollow,1835,31,123,149,379,481,1163
New York,Laurel,1250,47,205,276,180,263,971
New York,Lattingtown,1542,99,108,183,367,358,1115
New York,Larchmont,6005,68,194,343,1493,1665,3763
New York,Lansing,3629,36,283,447,606,1222,2594
New York,Lancaster,10300,410,2295,2799,1071,639,7214
New York,Lakewood,2951,130,481,844,335,347,2137
New York,Lido Beach,2600,69,266,315,574,706,1930
New York,Brewerton,4414,221,829,1169,352,244,2815
New York,Lima,2433,130,362,580,268,211,1551
New York,Limestone,330,21,86,76,21,2,206
New York,Williamson,2324,126,697,600,168,136,1727
New York,Williamsville,5269,121,571,1082,1202,1164,4140
New York,Williston Park,7322,373,1031,1092,1376,1147,5019
New York,Willsboro,891,64,327,220,33,64,708
New York,Wilmington,1055,63,216,222,161,75,737
New York,Wilson,1163,37,319,315,114,106,891
New York,Windham,312,21,96,96,34,52,299
New York,Liverpool,2230,71,465,589,405,265,1795
New York,Little Valley,1276,139,349,215,59,8,770
New York,Little Falls,4878,376,1120,994,583,347,3420
New York,Lisle,257,13,88,62,13,11,187
New York,Linwood,64,0,26,0,6,9,41
New York,Lindenhurst,27310,2032,7055,5387,3183,1579,19236
New York,Lincoln Park,2082,234,546,542,145,112,1579
New York,Lincolndale,1537,19,284,178,265,206,952
New York,Lime Lake,661,68,264,109,40,20,501
New York,Bloomingburg,471,33,153,63,23,2,274
New York,Chatham,1381,114,360,299,144,108,1025
New York,Woodbury,10873,379,1412,2183,1516,1498,6988
New York,Canandaigua,10499,452,1851,2437,1311,1244,7295
New York,Canaseraga,600,48,176,111,20,23,378
New York,Canastota,4707,178,933,1084,615,291,3101
New York,Candor,677,43,171,148,55,43,460
New York,Canisteo,2298,120,614,364,155,119,1372
New York,Canton,6665,249,565,604,422,821,2661
New York,Cape Vincent,645,19,120,145,81,64,429
New York,Carle Place,5152,471,847,844,872,543,3577
New York,Carmel Hamlet,6542,621,1203,1044,824,782,4474
New York,Caroga Lake,496,11,140,142,55,91,439
New York,Carthage,3682,302,639,939,67,102,2049
New York,Cassadaga,709,39,161,188,54,41,483
New York,Castile,922,60,293,192,80,45,670
New York,Castleton-on-Hudson,1322,81,245,297,181,142,946
New York,Castorland,376,25,81,58,34,18,216
New York,Cato,655,23,179,138,13,23,376
New York,Catskill,3952,102,1186,624,417,336,2665
New York,Cattaraugus,1035,72,334,208,75,44,733
New York,Cayuga,545,26,148,130,82,21,407
New York,Cayuga Heights,3789,57,81,154,606,1395,2293
New York,Cazenovia,2815,98,327,429,375,355,1584
New York,Cedarhurst,6655,181,876,1011,851,941,3860
New York,Celoron,1183,157,325,264,66,41,853
New York,Centereach,32649,1521,6945,6847,3603,2689,21605
New York,Center Moriches,8418,486,1973,1679,611,726,5475
New York,Centerport,5447,90,508,857,1208,1018,3681
New York,Central Bridge,282,40,143,31,10,14,238
New York,Canajoharie,2195,221,560,452,153,111,1497
New York,Campbell,630,39,148,269,17,23,496
New York,Camillus,1242,27,285,326,159,84,881
New York,Camden,2491,194,674,474,156,137,1635
New York,Jamestown West,2267,261,471,533,372,166,1803
New York,Jefferson Heights,1116,186,187,277,112,49,811
New York,Jefferson Valley-Yorktown,14923,483,2344,2630,2444,2193,10094
New York,Jeffersonville,387,39,75,66,61,41,282
New York,Jericho,13746,418,1081,1546,2993,3268,9306
New York,Johnson City,14903,1057,3389,3079,1419,983,9927
New York,Johnstown,8500,681,2436,2030,603,458,6208
New York,Jordan,1495,60,324,350,192,95,1021
New York,Kaser,4998,319,823,177,13,21,1353
New York,Katonah,2196,71,160,137,515,445,1328
New York,Clarkson,4325,211,1062,578,728,219,2798
New York,Clark Mills,2139,113,489,573,318,133,1626
New York,Clarence Center,2151,17,161,250,451,491,1370
New York,Central Islip,34960,6345,7186,5010,1952,1385,21878
New York,Clarence,3164,128,425,702,461,507,2223
New York,Chittenango,4992,279,1064,921,716,390,3370
New York,Chestnut Ridge,8090,431,1223,1502,1290,1033,5479
New York,Wolcott,1723,178,535,275,71,60,1119
New York,Burdett,364,22,107,70,46,26,271
New York,Burke,169,13,52,37,9,7,118
New York,Busti,477,32,107,59,58,7,263
New York,Byersville,131,9,38,21,0,3,71
New York,Cairo,1325,310,307,290,69,44,1020
New York,Calcium,4102,228,530,737,405,151,2051
New York,Caledonia,2137,91,506,534,211,105,1447
New York,Callicoon,172,2,56,47,30,0,135
New York,Calverton,6380,527,2044,1311,759,553,5194
New York,Cambridge,1715,164,381,331,168,151,1195
New York,Churchville,1981,53,336,492,277,230,1388
New York,Central Square,1945,150,517,427,184,87,1365
New York,Centre Island,454,7,47,61,98,114,327
New York,Chadwicks,1757,133,434,329,116,41,1053
New York,Belfast,907,74,279,196,33,28,610
New York,Bellerose,1132,27,95,128,226,268,744
New York,Bellerose Terrace,2004,86,315,484,317,199,1401
New York,Belle Terre,783,4,66,94,127,236,527
New York,Belleville,474,35,117,52,9,0,213
New York,Bellmore,15871,577,2453,2621,3211,2326,11188
New York,Bellport,2059,43,321,371,321,590,1646
New York,Belmont,1010,49,292,226,85,67,719
New York,Bemus Point,192,10,33,56,29,28,156
New York,Bergen,1312,27,232,320,128,85,792
New York,Bethpage,16315,832,3582,2955,2807,1599,11775
New York,Big Flats,5303,124,776,1376,753,718,3747
New York,Billington Heights,1653,57,239,278,368,289,1231
New York,Bedford Hills,3271,574,388,446,327,402,2137
New York,Binghamton,46495,4665,9834,8344,3801,3173,29817
New York,Black River,1381,43,224,384,140,91,882
New York,Yonkers,199435,23213,36630,34397,24581,17998,136819
New York,Yaphank,5958,401,1381,1222,693,564,4261
New York,Wyoming,381,15,90,101,38,11,255
New York,Wynantskill,3036,202,488,913,369,291,2263
New York,Wyandanch,11558,1565,2588,1718,703,290,6864
New York,Wurtsboro,1131,106,264,284,77,63,794
New York,Worcester,973,121,262,185,79,97,744
New York,Woodsville,62,10,25,12,0,0,47
New York,Woodstock,1766,46,271,423,428,474,1642
New York,Woodsburgh,740,6,69,62,152,228,517
New York,Woodridge,732,114,127,163,60,44,508
New York,Woodmere,17217,483,1349,2043,2986,3820,10681
New York,Binghamton University,6084,0,2,57,0,18,77
New York,Woodbury,8473,332,1246,773,2003,2092,6446
New York,Bedford,2044,46,136,231,540,413,1366
New York,Beacon,14375,1108,2995,3096,1783,1333,10315
New York,Champlain,1139,93,275,197,81,66,712
New York,Chappaqua,1287,36,40,78,351,415,920
New York,Chateaugay,626,63,171,175,32,46,487
New York,Chaumont,796,46,197,166,63,48,520
New York,Chautauqua,594,11,22,11,65,202,311
New York,Chazy,448,19,134,134,16,17,320
New York,Cheektowaga,74905,5273,19855,17336,7675,4299,54438
New York,Chenango Bridge,2795,105,621,511,438,296,1971
New York,Cherry Creek,447,41,128,83,30,15,297
New York,Cherry Valley,562,39,166,119,39,54,417
New York,Chester,3928,217,833,968,494,237,2749
New York,Chestertown,764,34,207,132,64,45,482
New York,Zena,1385,14,161,241,293,267,976
New York,Beaver Dam Lake,1780,0,422,415,209,132,1178
New York,Youngstown,1967,84,385,505,221,216,1411
New York,Yorktown Heights,1964,36,254,255,454,262,1261
New York,Yorkshire,1093,233,377,217,51,34,912
New York,York Hamlet,459,0,148,166,42,28,384
New York,Barneveld,221,4,55,50,41,23,173
New York,Barnum Island,2226,343,485,439,317,210,1794
New York,Batavia,15188,1074,3452,3411,1397,1058,10392
New York,Bath,5720,442,1787,1291,372,306,4198
New York,Baxter Estates,816,33,71,75,214,219,612
New York,Bay Park,1856,41,374,523,267,165,1370
New York,Bayport,8305,291,1125,1881,1413,1094,5804
New York,Bay Shore,29670,3310,5893,5036,3313,2030,19582
New York,Bayville,6724,218,1239,1199,1178,995,4829
New York,Baywood,7249,646,1799,1482,730,188,4845
New York,Yorkville,2642,193,570,713,309,147,1932
New York,Witherbee,333,0,189,27,0,0,216
New York,South Glens Falls,3586,241,1079,964,213,171,2668
New York,West Valley,468,11,95,151,35,29,321
New York,Millerton,866,105,204,191,122,29,651
New York,Miller Place,11312,186,1691,1994,1846,1571,7288
New York,Millbrook,1542,72,236,320,213,272,1113
New York,Milford,396,32,127,57,36,42,294
New York,Middleville,533,36,145,138,41,20,380
New York,Middletown,27828,3007,5486,5766,2148,1264,17671
New York,Mill Neck,994,15,114,129,258,214,730
New York,Middleport,1788,120,436,437,114,69,1176
New York,Middleburgh,1448,115,347,342,101,79,984
New York,Rodman,215,10,85,23,5,10,133
New York,Rome,32916,2853,8499,7512,2633,1880,23377
New York,Romulus,524,54,169,82,8,15,328
New York,Ronkonkoma,18634,1011,4262,4074,2118,1585,13050
New York,Roosevelt,16645,2546,3889,2835,910,440,10620
New York,Middle Island,9949,462,2477,2367,1227,927,7460
New York,Roscoe,564,59,138,100,98,39,434
New York,Millport,355,37,117,66,5,11,236
New York,Milton CDP (Ulster County),1521,66,394,405,182,102,1149
New York,Mooers,293,44,58,78,36,35,251
New York,Montrose,2659,64,412,720,472,246,1914
New York,Montour Falls,1821,222,574,408,104,42,1350
New York,Monticello,6685,920,1554,1408,442,265,4589
New York,Montgomery,4311,298,875,940,498,372,2983
New York,Montebello,4616,153,515,541,953,1036,3198
New York,Milton CDP (Saratoga County),3536,18,477,780,594,369,2238
New York,Montauk,3495,142,832,809,766,387,2936
New York,Monroe,8532,397,997,1591,1415,881,5281
New York,Mohawk,2571,81,798,530,233,157,1799
New York,Minoa,3514,42,557,936,435,492,2462
New York,Mineville,1273,185,435,179,119,75,993
New York,Minetto,933,43,214,192,154,98,701
New York,Mineola,18980,1714,3176,3238,2866,2682,13676
New York,Monsey,21001,1666,3500,1291,758,535,7750
New York,Moravia,1521,164,389,358,107,104,1122
New York,Rosendale Hamlet,1453,81,253,386,228,98,1046
New York,Roslyn Estates,1159,10,61,80,240,375,766
New York,St. Regis Falls,383,39,128,116,5,4,292
New York,Salamanca,5686,562,1531,954,316,138,3501
New York,Salem,698,45,181,141,71,77,515
New York,Salisbury,12467,820,1861,2539,2103,1489,8812
New York,Salisbury Mills,308,7,44,87,25,30,193
New York,Saltaire,46,0,4,3,10,16,33
New York,St. Johnsville,1789,185,541,357,76,66,1225
New York,Salt Point,195,16,7,25,45,48,141
New York,Sand Ridge,663,157,275,85,0,23,540
New York,Sands Point,2715,88,99,264,645,786,1882
New York,Sandy Creek,875,37,237,202,73,14,563
New York,Saranac Lake,5727,317,1007,1510,661,496,3991
New York,Saratoga Springs,27244,1018,3735,4567,5068,4361,18749
New York,Saugerties,3940,389,835,850,378,283,2735
New York,Sanborn,1361,96,377,268,109,53,903
New York,Roslyn,2779,74,357,261,857,605,2154
New York,St. James,13536,554,2381,2432,2033,1930,9330
New York,Sag Harbor,2075,134,439,276,395,412,1656
New York,Roslyn Harbor,952,13,74,84,237,262,670
New York,Roslyn Heights,6969,294,564,909,1559,1296,4622
New York,Rotterdam,20949,1014,5234,5295,2126,1165,14834
New York,Round Lake,693,8,85,129,209,121,552
New York,Rouses Point,2126,146,558,486,250,130,1570
New York,Rushford,327,26,93,52,10,20,201
New York,St. Bonaventure,2052,59,143,137,103,99,541
New York,Rushville,679,47,171,204,22,13,457
New York,Rye,15944,307,970,1379,3709,3842,10207
New York,Rye Brook,9510,539,821,792,2288,2120,6560
New York,Sackets Harbor,1495,31,221,292,306,211,1061
New York,Saddle Rock,904,32,150,59,137,192,570
New York,Saddle Rock Estates,343,0,0,22,99,139,260
New York,Sagaponack,208,0,28,23,61,48,160
New York,Russell Gardens,878,25,54,56,208,290,633
New York,Saugerties South,2119,115,457,635,90,183,1480
New York,Moriches,2703,206,430,709,240,404,1989
New York,Morrisonville,1444,56,405,301,150,112,1024
New York,Rhinebeck,2629,130,316,533,453,519,1951
New York,Rhinecliff,290,26,66,40,35,61,228
New York,Richburg,615,45,191,91,14,21,362
New York,Richfield Springs,1229,154,337,226,99,71,887
New York,Richmondville,918,132,269,148,26,43,618
New York,Richville,363,24,89,74,13,18,218
New York,Retsof,214,0,57,44,35,7,143
New York,Ridge,12835,752,3696,2897,967,1238,9550
New York,Ripley,966,104,229,226,46,34,639
New York,Riverhead,14258,1568,3538,2961,1268,779,10114
New York,Riverside,589,46,147,120,39,18,370
New York,Riverside,4912,1156,1710,910,178,17,3971
New York,Rochester,210745,25632,37252,37105,18421,12778,131188
New York,Rock Hill,1497,52,263,250,312,242,1119
New York,Rifton,609,0,61,140,68,120,389
New York,Rockville Centre,24155,649,3129,2901,4852,4941,16472
New York,Rensselaer Falls,403,27,72,84,30,36,249
New York,Remsenburg-Speonk,1867,15,353,392,338,235,1333
New York,Pultneyville,458,7,99,92,50,83,331
New York,Putnam Lake,3877,312,950,759,420,228,2669
New York,Quiogue,640,23,122,101,104,96,446
New York,Quogue,854,14,142,139,222,189,706
New York,Randolph,1179,74,285,281,50,40,730
New York,Ransomville,1668,90,418,460,80,38,1086
New York,Rensselaer,9502,696,2193,2254,919,634,6696
New York,Rapids,1653,89,364,312,225,81,1071
New York,Red Creek,646,53,131,127,14,26,351
New York,Redford,528,14,101,41,0,67,223
New York,Red Hook,1715,117,272,296,211,284,1180
New York,Red Oaks Mill,3671,69,684,847,481,418,2499
New York,Redwood,584,98,105,95,22,0,320
New York,Remsen,506,39,171,105,30,4,349
New York,Ravena,3289,195,896,682,241,96,2110
New York,Morris,396,14,83,117,63,23,300
New York,Rocky Point,13593,469,2588,2674,1556,1556,8843
New York,New Hartford,1813,66,223,449,326,275,1339
New York,Nanuet,18678,1589,3349,3230,3422,2147,13737
New York,Myers Corner,6867,273,1201,1356,1127,895,4852
New York,Muttontown,3626,134,304,327,766,1006,2537
New York,Munsons Corners,2387,140,544,396,223,236,1539
New York,Munsey Park,2715,33,153,125,701,673,1685
New York,Munnsville,498,25,127,95,22,18,287
New York,Napanoch,1096,42,326,283,83,54,788
New York,Mount Vernon,68221,7090,13516,12712,7683,5120,46121
New York,Mount Morris,2505,275,700,598,85,119,1777
New York,Mount Kisco,11060,1351,1520,1712,1646,1374,7603
New York,Mount Ivy,7090,570,1064,1479,896,608,4617
New York,Mountain Lodge Park,1639,159,485,316,136,47,1143
New York,Morrisville,1938,54,145,185,51,78,513
New York,Morristown,431,30,126,92,46,19,313
New York,Mount Sinai,12451,546,1819,2450,1972,1530,8317
New York,New Hempstead,5265,305,626,827,754,473,2985
New York,Napeague,211,33,23,42,53,40,191
New York,Narrowsburg,382,34,117,76,40,30,297
New York,Newfield Hamlet,699,146,152,110,98,93,599
New York,Newfane,3769,259,1156,858,347,133,2753
New York,New City,33722,1483,3499,5058,7136,6536,23712
New York,New Cassel,13903,2578,2583,1923,942,554,8580
New York,Newburgh,28495,4454,5215,3482,1038,698,14887
New York,New Berlin,1170,191,353,254,55,47,900
New York,Naples,990,44,244,248,88,102,726
New York,Newark Valley,1188,31,255,270,102,64,722
New York,Nesconset,13876,602,2230,2513,2306,1763,9414
New York,Nelsonville,805,30,145,93,132,105,505
New York,Nelliston,535,78,178,122,28,12,418
New York,Nedrow,2176,165,503,614,123,154,1559
New York,Natural Bridge,776,102,166,122,0,0,390
New York,Nassau,1077,32,233,317,107,82,771
New York,Newark,8965,955,2398,1886,553,399,6191
New York,Savannah,405,64,116,93,31,3,307
New York,Savona,809,50,230,189,31,13,513
New York,Sayville,16621,623,3008,2831,2519,2700,11681
New York,Elmira Heights,3945,262,1018,904,217,151,2552
New York,Elmira,28817,3094,7214,5183,1432,1080,18003
New York,Elma Center,2639,73,640,617,318,306,1954
New York,Sharon Springs,614,67,159,137,65,19,447
New York,Shelter Island,1313,19,261,194,223,232,929
New York,Shelter Island Heights,1493,0,151,246,330,337,1064
New York,Elmont,37388,3480,6636,7905,4721,2545,25287
New York,Shenorock,1874,77,273,430,270,184,1234
New York,Sherman,681,65,145,154,51,42,457
New York,Sherrill,3073,211,571,808,401,243,2234
New York,Shinnecock Hills,2152,30,477,213,358,367,1445
New York,Shirley,25691,2158,7888,4630,1529,1320,17525
New York,Shokan,1111,146,241,231,128,136,882
New York,Shoreham,432,3,54,55,65,182,359
New York,Sherburne,1359,122,315,336,130,73,976
New York,Shortsville,1385,103,340,397,92,37,969
New York,Elmsford,4765,570,719,920,616,588,3413
New York,Endicott,13143,1007,3358,2842,1053,686,8946
New York,Hyde Park,2192,83,238,517,329,260,1427
New York,Ilion,8066,554,1597,1841,742,632,5366
New York,Interlaken,703,53,146,129,91,63,482
New York,Inwood,10052,1541,1989,1695,573,456,6254
New York,Irondequoit,51337,3049,10237,11204,8126,4927,37543
New York,Irvington,6540,192,462,623,1342,1823,4442
New York,Elwood,10941,576,1592,1792,2059,1377,7396
New York,Islandia,3370,288,748,691,362,222,2311
New York,Islip,18433,955,3931,3555,2446,1648,12535
New York,West Winfield,820,47,192,198,92,73,602
New York,Ithaca,30565,622,1403,1968,2683,4100,10776
New York,Jamesport,1355,0,232,213,85,337,867
New York,Jamestown,30546,2861,6982,6678,2181,1524,20226
New York,Endwell,11445,467,1921,2736,1669,1191,7984
New York,Island Park,4694,311,1212,1131,463,363,3480
New York,Hurley,3452,115,578,692,620,498,2503
New York,Shrub Oak,1997,172,309,520,401,261,1663
New York,Silver Creek,2598,137,638,519,253,163,1710
New York,South Fallsburg,3571,650,518,351,78,167,1764
New York,South Farmingdale,15130,589,3393,2871,2160,1351,10364
New York,South Floral Park,2058,106,380,524,258,144,1412
New York,Ellisburg,256,14,60,67,16,13,170
New York,South Hempstead,3152,94,522,446,556,491,2109
New York,South Hill,6501,34,369,313,337,626,1679
New York,South Dayton,756,39,214,145,27,22,447
New York,South Huntington,9724,375,1737,1987,1645,1292,7036
New York,South Lockport,7788,533,2021,1849,608,422,5433
New York,South Nyack,3549,71,375,466,628,738,2278
New York,Southold,6295,150,1433,1641,834,902,4960
New York,Southport,7001,608,2288,1688,416,163,5163
New York,South Valley Stream,6588,322,852,1029,1172,1059,4434
New York,Spackenkill,4122,103,424,779,711,932,2949
New York,South Lima,252,20,75,86,18,11,210
New York,Sidney,4146,259,1213,819,323,260,2874
New York,South Corning,1060,56,265,255,121,83,780
New York,Southampton,3193,208,597,511,691,633,2640
New York,Silver Springs,951,103,315,144,40,7,609
New York,Sinclairville,644,44,187,143,38,2,414
New York,Skaneateles,2553,29,217,381,671,608,1906
New York,Sleepy Hollow,10074,1636,1671,859,1390,1195,6751
New York,Sloan,3624,384,1000,1086,244,26,2740
New York,Sloatsburg,3106,149,385,676,472,294,1976
New York,South Blooming Grove,3214,128,647,873,305,226,2179
New York,Smallwood,269,15,38,97,58,40,248
New York,Smithville Flats,480,47,115,94,25,6,287
New York,Smyrna,236,17,72,42,12,9,152
New York,Sodus,2374,208,628,383,136,65,1420
New York,Sodus Point,981,28,263,257,116,65,729
New York,Solvay,6490,637,1760,1245,671,378,4691
New York,Sound Beach,8071,306,1513,1570,1246,669,5304
New York,Smithtown,25974,977,3776,4926,4479,3619,17777
New York,Huntington Station,34088,4923,5545,4740,3953,2835,21996
New York,Huntington Bay,1509,8,100,176,478,369,1131
New York,Huntington,17917,446,1891,2474,4226,3989,13026
New York,Seneca Knolls,2393,90,637,745,123,151,1746
New York,Setauket-East Setauket,14346,293,1502,2241,2384,3506,9926
New York,Hartwick,577,38,85,141,82,38,384
New York,Hastings-on-Hudson,7951,162,592,658,1609,2474,5495
New York,Hauppauge,20616,559,3654,3827,3625,2694,14359
New York,Haverstraw,12094,2026,2167,1788,1088,720,7789
New York,Seneca Falls,6493,402,1689,1252,899,462,4704
New York,Haviland,3470,121,756,820,436,414,2547
New York,Head of the Harbor,1330,24,108,199,274,318,923
New York,Hemlock,401,16,42,183,60,0,301
New York,Hempstead,55105,10276,10967,8378,3700,2361,35682
New York,Henderson,170,7,66,36,12,2,123
New York,Heritage Hills,4024,169,796,876,1113,765,3719
New York,Herkimer,7731,563,1731,1846,628,510,5278
New York,Hawthorne,4583,314,835,746,790,550,3235
New York,Hermon,404,51,67,97,41,7,263
New York,Selden,20123,1433,4685,4129,1836,1410,13493
New York,Seaford,15656,553,2915,3246,2511,1601,10826
New York,Scarsdale,17621,129,560,751,3384,6258,11082
New York,Schaghticoke,564,23,174,131,29,12,369
New York,Schenectady,65735,6770,14730,12476,5507,3555,43038
New York,Schenevus,537,39,155,119,35,3,351
New York,Schoharie,859,101,271,222,58,42,694
New York,Schroon Lake,474,11,100,175,38,50,374
New York,Searingtown,4765,216,474,619,946,1101,3356
New York,Schuylerville,1621,115,388,294,157,106,1060
New York,Scotchtown,9061,497,1632,2189,1004,547,5869
New York,Scotia,7744,233,1411,2003,783,807,5237
New York,Scottsburg,116,3,41,34,10,11,99
New York,Scotts Corners,563,18,115,106,46,174,459
New York,Scottsville,2616,126,445,471,341,259,1642
New York,Sea Cliff,5025,103,502,573,1106,1235,3519
New York,Scio,508,18,149,133,36,53,389
New York,Herricks,4370,172,622,534,973,614,2915
New York,Herrings,78,9,22,20,0,8,59
New York,Heuvelton,798,50,207,191,55,53,556
New York,Homer,3224,152,569,717,422,250,2110
New York,Honeoye,655,12,167,188,57,19,443
New York,Honeoye Falls,2720,69,334,605,436,459,1903
New York,Hoosick Falls,3453,181,853,823,358,144,2359
New York,Hopewell Junction,362,33,76,97,33,42,281
New York,Hornell,8471,611,2229,1693,509,415,5457
New York,Holtsville,20081,1037,3850,4747,2699,1548,13881
New York,Horseheads,6594,290,1467,1566,805,548,4676
New York,Hortonville,235,9,74,56,26,0,165
New York,Houghton,1747,16,107,50,136,230,539
New York,Hudson,6572,864,1375,1213,554,470,4476
New York,Hudson Falls,7239,687,1851,1658,385,222,4803
New York,Hunt,44,8,20,10,0,0,38
New York,Hunter,320,12,53,91,105,26,287
New York,Horseheads North,2755,16,567,697,461,273,2014
New York,Holley,2032,154,578,446,102,51,1331
New York,Holland Patent,373,11,87,93,32,30,253
New York,Holland,1236,89,372,299,109,48,917
New York,Hewlett,6032,149,1096,724,1147,1227,4343
New York,Hewlett Bay Park,354,8,21,34,89,116,268
New York,Hewlett Harbor,1229,7,66,133,291,328,825
New York,Hewlett Neck,352,2,21,26,68,116,233
New York,Hicksville,42333,2805,8702,8016,7058,3943,30524
New York,High Falls,905,36,214,284,102,69,705
New York,Highland,5189,474,954,1147,741,362,3678
New York,Highland Falls,3856,190,692,956,630,431,2899
New York,Hillburn,872,60,192,199,91,55,597
New York,Hillcrest,7317,820,1256,1739,917,473,5205
New York,Hillside,855,65,89,146,130,196,626
New York,Hillside Lake,1070,92,234,181,106,110,723
New York,Hilton,5936,195,1369,1398,389,477,3828
New York,Hobart,481,26,112,104,65,30,337
New York,Holbrook,27533,1307,5818,5820,3398,2740,19083
New York,Pulaski,2214,106,533,514,155,119,1427
New York,Sparkill,1523,87,196,217,333,186,1019
New York,Prospect,214,11,49,69,15,10,154
New York,Prattsville,263,47,84,18,11,3,163
New York,Groton,2536,154,545,641,222,168,1730
New York,Greigsville,296,9,96,93,0,24,222
New York,Greenwood Lake,3118,112,647,967,257,282,2265
New York,Greenwich,1885,80,397,401,191,179,1248
New York,Greenville CDP (Westchester County),7543,175,283,452,1283,2583,4776
New York,Greenville CDP (Greene County),505,82,152,114,18,26,392
New York,Groveland Station,283,18,90,42,21,5,176
New York,Greenvale,1003,49,123,148,192,209,721
New York,Greenport,2234,325,437,351,345,251,1709
New York,Greenlawn,14481,716,2393,2692,2010,1590,9401
New York,Green Island,2629,118,631,689,207,86,1731
New York,Greene,1592,92,377,347,168,101,1085
New York,Greece,14568,897,3356,3782,1668,1178,10881
New York,Great River,1561,24,213,267,187,376,1067
New York,Greenport West,2002,76,508,440,311,299,1634
New York,Great Neck Plaza,6879,417,967,918,1707,1709,5718
New York,Guilford,339,36,91,137,18,18,300
New York,Hagaman,1414,67,277,455,173,84,1056
New York,Harbor Hills,545,50,32,41,105,183,411
New York,Hannibal,604,51,203,132,39,20,445
New York,Hannawa Falls,925,23,142,215,161,129,670
New York,Hancock,946,71,345,185,38,32,671
New York,Hampton Manor,2104,37,457,727,88,202,1511
New York,Hampton Bays,12866,981,2906,2568,1941,1164,9560
New York,Hadley,846,94,305,184,58,33,674
New York,Hammondsport,592,20,85,150,126,83,464
New York,Hamlin,5587,199,1317,1246,502,178,3442
New York,Hamilton,4064,84,178,229,257,538,1286
New York,Hamburg,9521,283,1554,2205,1591,1102,6735
New York,Hall,152,9,52,44,17,13,135
New York,Halesite,2810,12,639,346,505,653,2155
New York,Hailesboro,686,30,227,163,38,20,478
New York,Hammond,342,13,84,79,16,20,212
New York,Harbor Isle,1529,36,216,337,256,203,1048
New York,Great Neck Gardens,1166,101,16,86,244,278,725
New York,Great Neck,10095,625,1087,1201,1872,1682,6467
New York,Glasco,2464,342,513,542,172,144,1713
New York,Gilgo,208,0,0,41,62,43,146
New York,Gilbertsville,361,33,93,81,36,28,271
New York,Ghent,438,17,43,77,39,25,201
New York,Old Field,858,6,52,79,116,375,628
New York,Old Brookville,2307,67,137,227,516,548,1495
New York,Glen Aubrey,308,29,127,50,23,0,229
New York,Old Bethpage,5252,141,611,748,1126,1086,3712
New York,Ogdensburg,10996,1265,2864,2513,669,591,7902
New York,Odessa,661,37,158,158,43,45,441
New York,Oceanside,30371,1234,5634,5265,5298,4309,21740
New York,Ocean Beach,32,1,5,11,6,9,32
New York,Oakfield,1767,162,484,409,114,40,1209
New York,Oakdale,7336,283,1263,1894,792,946,5178
New York,Olcott,1096,56,263,293,142,39,793
New York,Great Neck Estates,2809,31,156,270,479,841,1777
New York,Glen Cove,27245,3797,5110,3413,3968,2955,19243
New York,Glen Park,577,44,136,120,49,23,372
New York,Great Bend,854,46,297,222,36,29,630
New York,Granville,2321,250,639,502,169,135,1695
New York,Grandyle Village,4812,201,936,1012,718,415,3282
New York,Grand View-on-Hudson,295,1,21,25,102,77,226
New York,Gowanda,2656,328,689,619,168,151,1955
New York,Gouverneur,3882,338,1011,886,153,160,2548
New York,Glen Head,4620,182,694,731,891,814,3312
New York,Goshen,5394,263,689,1119,1005,599,3675
New York,Gordon Heights,3866,402,710,728,240,156,2236
New York,Golden's Bridge,1694,8,37,152,403,465,1065
New York,Gloversville,15293,1950,3825,2918,668,768,10129
New York,Glenwood Landing,3767,49,438,471,924,837,2719
New York,Glens Falls North,8494,290,1814,1861,1016,1016,5997
New York,Glens Falls,14496,1114,3580,3066,1548,1138,10446
New York,Gorham,601,0,107,178,103,27,415
New York,Oak Beach-Captree,134,38,15,39,0,42,134
New York,Harriman,2704,267,510,503,354,242,1876
New York,Harrison,27998,1525,3745,3025,4801,3473,16569
New York,Philadelphia,1113,75,246,241,61,34,657
New York,Phelps,1983,81,518,496,151,119,1365
New York,Peru,1300,38,107,406,319,138,1008
New York,Perrysburg,325,2,109,75,14,8,208
New York,Perry,3462,310,823,778,288,131,2330
New York,Penn Yan,4815,481,1491,717,448,321,3458
New York,Philmont,1373,156,270,271,67,86,850
New York,Pelham Manor,5567,86,483,431,1273,1342,3615
New York,Peekskill,23928,3212,5416,3642,2717,1783,16770
New York,Peconic,526,70,89,90,74,143,466
New York,Pearl River,16383,875,1972,3085,2759,2067,10758
New York,Peach Lake,1428,27,130,265,426,199,1047
New York,Pawling,2243,169,422,363,244,185,1383
New York,Pavilion,549,11,171,87,77,19,365
New York,Pelham,6993,340,818,911,1178,1395,4642
New York,Paul Smiths,667,0,0,0,0,3,3
New York,Phoenicia,215,0,91,44,9,61,205
New York,Piermont,2557,105,254,308,681,709,2057
New York,Plattekill,1240,179,208,246,141,79,853
New York,Plandome Manor,813,22,62,69,200,193,546
New York,Plandome Heights,988,12,46,76,215,282,631
New York,Plandome,1278,5,39,110,291,354,799
New York,Plainview,26199,794,3008,3337,5512,5656,18307
New York,Plainedge,9343,437,1920,1777,1529,810,6473
New York,Phoenix,2496,168,617,616,175,63,1639
New York,Pittsford,1516,33,98,160,435,404,1130
New York,Pine Plains,1575,128,325,438,88,111,1090
New York,Pine Hill,172,10,34,33,9,25,111
New York,Pine Bush,1514,129,339,404,213,176,1261
New York,Pike,233,15,89,44,3,4,155
New York,Piffard,260,18,70,94,21,0,203
New York,Pierrepont Manor,143,5,57,0,37,0,99
New York,Pine Valley,774,89,293,126,75,0,583
New York,Harris Hill,5499,81,839,1182,840,868,3810
New York,Patchogue,12173,1211,2839,2311,1309,898,8568
New York,Parish,489,23,142,95,36,38,334
New York,Oriskany,1280,48,426,308,145,54,981
New York,Orient,706,18,184,155,162,97,616
New York,Orchard Park,3229,34,415,472,611,726,2258
New York,Orange Lake,6718,497,1667,1363,862,562,4951
New York,Orangeburg,4442,309,686,510,833,652,2990
New York,Ontario,2190,191,660,479,190,113,1633
New York,Oriskany Falls,857,56,249,159,62,21,547
New York,Oneonta,13862,382,1422,1345,1328,1257,5734
New York,Oneida,11252,983,2476,2670,904,684,7717
New York,Olean,14099,833,3840,2674,1417,1081,9845
New York,Old Westbury,4418,54,236,281,628,851,2050
New York,Old Forge,441,45,121,140,55,31,392
New York,Hartsdale,5146,236,695,637,1188,1371,4127
New York,Harrisville,590,39,161,130,51,20,401
New York,Oneida Castle,689,23,181,167,78,36,485
New York,Parishville,832,36,166,193,65,34,494
New York,Ossining,25311,4939,3939,3319,2888,2631,17716
New York,Otego,1152,53,266,211,106,115,751
New York,Parc,206,5,0,0,0,5,10
New York,Panama,503,38,117,117,37,28,337
New York,Pamelia Center,404,0,49,111,54,102,316
New York,Palmyra,3446,234,1065,715,268,127,2409
New York,Palenville,760,13,90,280,75,61,519
New York,Palatine Bridge,814,89,250,175,46,53,613
New York,Oswego,17988,1421,3508,3348,1581,1366,11224
New York,Painted Post,1689,104,305,357,237,203,1206
New York,Oyster Bay,6562,409,1159,855,1521,851,4795
New York,Oxford,1370,93,326,336,118,104,977
New York,Oxbow,96,9,39,21,2,4,75
New York,Owego,3807,200,856,733,492,385,2666
New York,Ovid,602,73,150,125,40,33,421
New York,Otisville,1110,82,233,271,84,88,758
New York,Oyster Bay Cove,2190,37,167,226,563,565,1558
New York,Nyack,6769,630,574,1335,1307,1277,5123
New York,Nunda,1422,100,435,293,86,80,994
New York,Noyack,3970,266,566,576,973,563,2944
New York,Fleischmanns,386,52,103,38,32,22,247
New York,Flanders,4906,1190,839,425,369,297,3120
New York,Fishkill,2001,118,350,300,344,299,1411
New York,Fishers Landing,70,7,20,37,6,0,70
New York,Fishers Island,339,13,81,48,44,95,281
New York,Firthcliffe,4681,130,809,965,622,652,3178
New York,Floral Park,16093,484,2602,2849,3206,2378,11519
New York,Fire Island,298,20,30,63,49,31,193
New York,Felts Mills,257,0,92,63,29,0,184
New York,Fayetteville,4203,85,283,927,738,928,2961
New York,Farnham,405,36,116,110,17,9,288
New York,Farmingville,15690,859,3924,3485,1633,919,10820
New York,Farmingdale,8399,556,1716,1700,1448,992,6412
New York,Falconer,2573,123,726,542,155,110,1656
New York,Fillmore,596,13,140,156,32,77,418
New York,Fairview CDP (Westchester County),2874,313,676,471,272,86,1818
New York,Florida,2865,113,599,635,445,212,2004
New York,Fonda,737,49,194,164,53,20,480
New York,Franklin Square,31544,2523,7387,5650,4043,2146,21749
New York,Franklin,375,16,43,101,24,36,220
New York,Frankfort,2560,213,489,663,203,138,1706
New York,Fowlerville,258,28,51,11,17,10,117
New York,Fort Salonga,9821,132,1410,1796,1697,1543,6578
New York,Fort Plain,1949,228,574,390,104,70,1366
New York,Flower Hill,4772,185,301,307,1286,937,3016
New York,Fort Montgomery,1421,97,271,264,289,180,1101
New York,Fort Edward,3318,256,1132,626,295,50,2359
New York,Fort Drum,13985,227,1152,2580,789,430,5178
New York,Fort Covington Hamlet,1481,111,395,334,75,63,978
New York,Fort Ann,545,24,172,131,21,27,375
New York,Forestville,581,36,166,121,52,15,390
New York,Forest Home,555,4,30,13,103,234,384
New York,Fort Johnson,582,33,161,114,67,42,417
New York,Franklinville,1850,120,470,392,121,63,1166
New York,Fairview CDP (Dutchess County),5700,441,859,1203,396,336,3235
New York,Fairmount,10106,413,1865,2691,1232,1087,7288
New York,Port Ewen,3413,264,922,829,302,300,2617
New York,Port Gibson,495,140,105,116,7,28,396
New York,Port Henry,920,94,276,191,53,43,657
New York,Port Jefferson,7802,99,1007,1179,1123,2498,5906
New York,Port Jefferson Station,8582,399,1690,1407,1089,965,5550
New York,Port Jervis,8681,962,2090,1657,717,291,5717
New York,Port Dickinson,1648,39,367,398,195,118,1117
New York,Port Leyden,756,52,221,122,42,4,441
New York,Port Washington,16233,783,1437,1776,3902,3246,11144
New York,Port Washington North,3190,74,243,449,805,752,2323
New York,Potsdam,9656,261,656,660,790,1106,3473
New York,Pottersville,489,56,190,26,7,0,279
New York,Poughkeepsie,30635,4138,5640,5737,2779,1959,20253
New York,Prattsburgh,753,103,219,118,40,25,505
New York,Portville,1146,59,246,237,97,97,736
New York,Fairport,5362,216,681,1225,1088,1126,4336
New York,Port Chester,29406,6391,5561,4030,2723,1455,20160
New York,Poquott,856,21,88,121,137,254,621
New York,Fair Haven,700,34,208,140,96,60,538
New York,Fabius,310,10,60,64,32,31,197
New York,Evans Mills,481,27,106,117,51,33,334
New York,Esperance,357,8,105,80,25,6,224
New York,Erin,357,31,167,83,17,3,301
New York,Plattsburgh,19845,1252,2848,3511,1905,1600,11116
New York,Port Byron,1310,83,290,305,58,38,774
New York,Plattsburgh West,1458,250,475,202,76,32,1035
New York,Pleasantville,7125,238,812,981,1497,1271,4799
New York,Plessis,115,0,32,26,7,10,75
New York,Poestenkill,1010,112,277,208,89,102,788
New York,Point Lookout,1267,22,168,220,316,221,947
New York,Poland,381,15,82,92,49,29,267
New York,Pomona,3286,179,407,451,571,559,2167
New York,Pleasant Valley,1452,86,258,382,129,202,1057
New York,Fredonia,10881,213,1467,1575,1046,1258,5559
New York,Freedom Plains,472,16,122,83,106,27,354
New York,Freeport,43251,5398,8984,6769,4249,3342,28742
New York,North Lindenhurst,11679,1139,2944,1992,1089,566,7730
New York,North Hornell,867,24,208,218,115,151,716
New York,North Hills,5190,57,573,870,1390,1481,4371
New York,North Haven,846,14,100,119,231,217,681
New York,North Great River,4091,136,1075,918,550,197,2876
New York,North Gates,9756,1095,2602,2183,914,340,7134
New York,North Lynbrook,496,58,81,129,44,76,388
New York,Northeast Ithaca,3103,40,136,218,494,1040,1928
New York,North Collins,1352,96,315,288,115,53,867
New York,North Boston,2749,15,874,749,305,222,2165
New York,North Bellport,11623,1384,1911,1947,743,726,6711
New York,North Bellmore,20153,684,3859,3230,3457,2829,14059
New York,North Bay Shore,20127,3302,3771,3454,956,404,11887
New York,North Ballston Spa,1569,115,335,259,223,33,965
New York,North Creek,446,76,134,102,25,50,387
New York,North Babylon,17228,804,4685,3465,1977,1285,12216
New York,North Massapequa,18749,715,4078,3919,2414,1871,12997
New York,North New Hyde Park,15177,895,2797,2172,2760,2166,10790
New York,Norwood,1644,121,308,389,166,126,1110
New York,Norwich,7032,588,1534,1359,595,526,4602
New York,Northwest Ithaca,1193,81,286,179,124,320,990
New York,Northwest Harbor,4004,62,629,675,1007,756,3129
New York,North Wantagh,11713,547,2443,2185,1785,1456,8416
New York,Northville,1685,15,318,404,303,179,1219
New York,North Merrick,12077,381,1735,2468,2063,1529,8176
New York,Northville,934,46,263,254,83,47,693
New York,North Tonawanda,31077,1769,7529,7572,3624,2029,22523
New York,North Syracuse,6641,373,1726,1750,737,443,5029
New York,North Sea,4441,195,1016,868,940,557,3576
New York,North Rose,544,67,131,165,16,31,410
New York,Northport,7412,156,586,1096,1867,1701,5406
New York,North Patchogue,6680,240,1862,1351,549,447,4449
New York,North Valley Stream,17845,1168,3379,3397,2618,1981,12543
New York,Northampton,578,134,243,109,0,22,508
New York,North Amityville,19895,2956,3891,3272,1422,844,12385
New York,Norfolk,1387,29,421,245,44,58,797
New York,Gardnertown,5033,300,1186,1024,512,261,3283
New York,Gardiner,643,43,132,137,102,112,526
New York,Garden City South,4265,341,692,767,632,547,2979
New York,Garden City Park,8221,561,1489,1442,1476,844,5812
New York,Garden City,22575,366,1813,2345,5133,4687,14344
New York,Gang Mills,4401,226,420,793,619,880,2938
New York,Gasport,1103,61,285,312,57,15,730
New York,Galway,320,25,58,56,39,36,214
New York,Gainesville,204,14,73,52,14,4,157
New York,Fultonville,667,63,143,130,44,20,400
New York,Fulton,11713,1259,3168,2190,667,467,7751
New York,Friendship,1255,127,332,174,41,31,705
New York,Frewsburg,2207,185,531,653,156,171,1696
New York,Freeville,524,3,74,113,98,86,374
New York,Galeville,4821,622,1248,1184,282,232,3568
New York,Gates,5034,546,1275,927,592,205,3545
New York,Geneseo,8096,272,466,481,478,646,2343
New York,Geneva,13157,902,2062,2180,876,981,7001
New York,Niverville,1629,81,283,545,320,120,1349
New York,Nissequogue,1692,39,173,250,221,455,1138
New York,Niskayuna,4911,32,346,740,1047,1151,3316
New York,Nichols,594,22,157,174,32,29,414
New York,Niagara Falls,49435,4852,13249,9809,3350,2522,33782
New York,New York Mills,3243,105,829,956,234,75,2199
New York,New York,8426743,1140129,1400057,1192942,1219071,849125,5801324
New York,New Windsor,8691,826,1938,2034,899,529,6226
New York,New Suffolk,310,43,33,65,64,72,277
New York,New Square,7540,574,1156,144,58,22,1954
New York,New Rochelle,79027,9201,10980,10867,11088,11589,53725
New York,Newport,544,35,95,139,29,32,330
New York,New Paltz,7055,123,198,398,676,802,2197
New York,New Hyde Park,9788,741,1832,1809,1544,994,6920
New York,Germantown,860,22,214,257,106,48,647
New York,Preston-Potter Hollow,420,53,160,36,31,23,303
New York,Speculator,362,49,88,84,34,42,297
New York,Islip Terrace,5327,207,1355,1043,603,342,3550
New York,Spencerport,3598,140,591,989,441,398,2559
New York,Turin,163,8,65,33,8,7,121
New York,Tuscarora,0,0,0,0,0,0,0
New York,Tuxedo Park,590,6,57,68,161,138,430
New York,Unadilla,831,103,224,138,80,33,578
New York,Uniondale,25092,3460,5144,4183,2287,1105,16179
New York,Union Springs,1268,49,291,329,100,52,821
New York,Unionville,596,42,166,88,55,34,385
New York,University at Buffalo,6174,0,11,97,199,156,463
New York,University Gardens,4122,157,387,349,1064,1002,2959
New York,Upper Brookville,1528,39,195,194,310,418,1156
New York,Upper Nyack,2050,34,164,284,395,514,1391
New York,Utica,61628,8062,12281,11920,4139,2187,38589
New York,Vails Gate,3509,323,753,898,305,141,2420
New York,Valatie,1735,142,363,351,230,124,1210
New York,Valhalla,3352,287,340,513,588,583,2311
New York,Tupper Lake,3566,301,1019,795,172,116,2403
New York,Tully,1082,69,195,286,88,105,743
New York,Tuckahoe,6586,308,756,1198,1168,1309,4739
New York,Tuckahoe,1169,151,187,257,178,164,937
New York,Theresa,903,64,227,187,36,51,565
New York,Thiells,5173,160,982,1046,903,493,3584
New York,Thomaston,2624,71,253,240,454,703,1721
New York,Thornwood,4054,214,670,610,690,521,2705
New York,Thousand Island Park,71,0,0,31,40,0,71
New York,Three Mile Bay,198,4,79,10,4,19,116
New York,Ticonderoga,3123,235,669,798,238,182,2122
New York,Valley Cottage,10191,574,1771,1630,2016,1405,7396
New York,Spencer,993,59,238,230,79,48,654
New York,Tivoli,1184,78,144,148,151,125,646
New York,Tonawanda,15000,982,3797,3879,1552,1035,11245
New York,Tonawanda,58149,2941,12099,13380,7817,5996,42233
New York,Town Line,2270,64,597,521,277,108,1567
New York,Tribes Hill,808,68,179,284,67,17,615
New York,Troy,49933,4616,8684,9306,4562,3037,30205
New York,Trumansburg,1637,38,317,370,259,248,1232
New York,Titusville,561,28,101,105,110,96,440
New York,Valley Falls,531,5,131,98,63,65,362
New York,Valley Stream,37838,2616,6925,7348,6005,2687,25581
New York,Van Etten,602,42,122,149,57,11,381
New York,Mayville,1413,128,341,347,117,77,1010
New York,Mayfield,760,48,184,209,54,52,547
New York,Maybrook,3093,193,660,690,331,180,2054
New York,Mattydale,6434,374,2089,1257,317,160,4197
New York,Mattituck,4435,161,939,774,618,644,3136
New York,Matinecock,813,12,50,73,258,167,560
New York,Mastic Beach,14883,1303,4301,2410,783,513,9310
New York,Mechanicstown,7130,710,1776,1683,587,390,5146
New York,Mastic,16084,1384,4260,3051,927,464,10086
New York,Massapequa Park,17175,378,3413,3377,2678,1902,11748
New York,Massapequa,22128,638,4252,4100,3911,2475,15376
New York,Marlboro,3518,167,785,658,408,263,2281
New York,Marion,1403,122,361,229,142,89,943
New York,Mariaville Lake,609,15,124,99,106,52,396
New York,Margaretville,566,93,167,155,40,40,495
New York,Marcellus,1655,25,271,369,333,230,1228
New York,Massena,11086,792,2490,2518,702,924,7426
New York,Thendara,183,0,46,92,15,0,153
New York,Mechanicville,5205,337,1274,1285,443,157,3496
New York,Medina,5936,385,1582,1284,495,419,4165
New York,Vernon,1198,60,312,316,116,85,889
New York,Verona,735,134,217,156,33,0,540
New York,Verplanck,1662,240,323,446,30,81,1120
New York,Victor,2768,70,284,549,448,369,1720
New York,Victory,471,46,116,85,35,35,317
New York,Village Green,3527,173,925,866,611,241,2816
New York,Village of the Branch,1986,25,183,263,350,451,1272
New York,Medford,24793,1764,5755,4995,2422,1528,16464
New York,Viola,6282,226,959,713,694,656,3248
New York,Voorheesville,2820,39,281,570,523,463,1876
New York,Merritt Park,1720,18,153,185,447,351,1154
New York,Merrick,20572,462,2520,3016,4153,4082,14233
New York,Meridian,293,18,75,78,27,5,203
New York,Menands,4004,129,497,641,839,621,2727
New York,Melville,18682,539,2840,2704,3652,3714,13449
New York,Melrose Park,2199,44,327,576,469,195,1611
New York,Virgil,344,15,91,42,32,25,205
New York,Terryville,12296,817,2468,2134,1626,1040,8085
New York,Tarrytown,11452,651,1193,1767,1997,2540,8148
New York,Tappan,6873,414,914,871,1416,1166,4781
New York,Crompond,2466,145,407,410,448,385,1795
New York,Croghan,696,61,217,136,40,32,486
New York,Cranberry Lake,187,9,56,35,35,21,156
New York,Cragsmoor,608,32,137,113,82,126,490
New York,Coxsackie,2753,319,710,486,231,146,1892
New York,Cove Neck,298,4,14,40,65,79,202
New York,Country Knolls,2102,13,153,322,591,361,1440
New York,Croton-on-Hudson,8202,376,550,1213,1560,1778,5477
New York,Cortland West,1289,135,150,317,237,137,976
New York,Cornwall-on-Hudson,2984,108,401,497,423,628,2057
New York,Corning,11059,524,2082,2476,1388,1253,7723
New York,Corinth,2545,215,676,511,160,82,1644
New York,Corfu,807,25,229,220,49,51,574
New York,Coram,40685,2066,8026,8257,5825,4221,28395
New York,Copiague,22772,3259,6316,3615,1818,1128,16136
New York,Copenhagen,716,77,153,184,36,12,462
New York,Cortland,19134,1141,3182,3401,1376,985,10085
New York,Copake Lake,518,27,90,130,28,93,368
New York,Crown Heights,2830,167,594,666,312,234,1973
New York,Crystal Beach,727,115,175,181,51,60,582
New York,Depauville,961,12,267,172,0,33,484
New York,Delhi,3078,128,292,308,166,171,1065
New York,Delevan,1076,82,322,206,56,14,680
New York,Delanson,390,4,88,100,40,22,254
New York,DeKalb Junction,576,53,130,85,70,9,347
New York,Deferiet,276,15,65,63,17,4,164
New York,Deer Park,27346,1739,6442,5432,3094,1968,18675
New York,Crugers,1720,384,412,249,323,121,1489
New York,Davenport Center,417,45,200,51,22,0,318
New York,Dannemora,3894,975,1681,512,92,55,3315
New York,Dalton,306,10,111,86,9,6,222
New York,Cuylerville,344,41,93,42,52,9,237
New York,Cutchogue,3192,123,529,623,624,434,2333
New York,Cumminsville,146,29,73,38,0,0,140
New York,Cumberland Head,1564,121,303,341,177,283,1225
New York,Cuba,1654,58,448,356,170,123,1155
New York,Dansville,4537,604,1202,707,284,399,3196
New York,Marathon,939,41,264,246,49,37,637
New York,Copake Hamlet,352,29,85,59,29,28,230
New York,Cooperstown,2185,86,311,385,351,561,1694
New York,Clayville,328,32,95,67,11,19,224
New York,Clayton,1917,103,511,363,211,120,1308
New York,Claverack-Red Mills,735,67,53,162,161,138,581
New York,Mexico,1702,67,357,401,112,130,1067
New York,Stony Brook University,9101,124,163,153,335,216,991
New York,Stony Point,12882,721,2634,2620,1762,1157,8894
New York,Stottville,1355,213,379,249,92,70,1003
New York,Cleveland,776,62,256,152,22,15,507
New York,Strykersville,719,21,183,125,65,20,414
New York,Sunset Bay,781,112,227,173,51,17,580
New York,SUNY Oswego,3559,10,0,0,7,0,17
New York,Sylvan Beach,856,101,322,200,77,26,726
New York,Syosset,19157,610,1770,2314,4372,3870,12936
New York,Syracuse,144564,16841,22880,22721,12099,10319,84860
New York,Taconic Shores,639,35,249,74,67,82,507
New York,Tannersville,714,51,151,107,51,45,405
New York,Suffern,10914,599,1824,1882,1807,1692,7804
New York,Copake Falls,184,0,90,37,0,7,134
New York,Clifton Springs,2180,172,584,496,154,127,1533
New York,Clintondale,1391,125,357,353,256,75,1166
New York,Coopers Plains,407,0,162,97,58,0,317
New York,Constantia,837,88,246,233,100,76,743
New York,Constableville,239,15,64,75,8,19,181
New York,Congers,8698,584,990,1661,1432,1332,5999
New York,Conesus Lake,2584,69,540,703,487,329,2128
New York,Conesus Hamlet,512,0,33,214,44,5,296
New York,Commack,35914,1081,5557,6109,6365,5782,24894
New York,Clinton,1850,34,230,344,333,403,1344
New York,Colton,428,24,55,158,28,52,317
New York,Cold Spring Harbor,5076,70,536,404,1203,1275,3488
New York,Cold Spring,1790,40,235,430,362,297,1364
New York,Cold Brook,336,25,93,55,16,11,200
New York,Cohoes,16281,1472,4636,3332,1211,929,11580
New York,Cohocton,1016,94,236,253,37,17,637
New York,Cobleskill,4602,298,736,661,317,320,2332
New York,Clyde,2012,165,415,408,75,63,1126
New York,Colonie,7898,337,1532,2027,1147,812,5855
New York,Depew,15227,745,4565,3372,1470,678,10830
New York,Manorville,14501,363,2570,2859,1892,1468,9152
New York,Mannsville,375,31,94,85,18,21,249
New York,Walton Park,2281,61,258,487,407,186,1399
New York,Wampsville,577,38,183,156,29,19,425
New York,Wanakah,2836,141,548,830,457,217,2193
New York,Wantagh,18939,503,2801,3512,3433,2415,12664
New York,Wappingers Falls,5424,644,1301,976,500,166,3587
New York,Warrensburg,3170,373,748,588,260,235,2204
New York,Warsaw,3519,544,954,837,195,103,2633
New York,Warwick,6797,322,1316,1455,1116,682,4891
New York,Washington Heights,2149,230,366,406,198,175,1375
New York,Washington Mills,1360,27,165,287,186,196,861
New York,Washingtonville,5814,210,1071,1458,621,534,3894
New York,Watchtower,2603,9,1323,451,168,47,1998
New York,Waterford,2233,168,521,520,236,134,1579
New York,Waterloo,5048,307,1091,1293,464,187,3342
New York,Water Mill,2273,83,398,345,475,603,1904
New York,Walton,3026,510,851,529,151,107,2148
New York,Wallkill,2227,137,443,392,344,193,1509
New York,Walker Valley,829,18,121,224,52,39,454
New York,Walden,6886,466,1313,1447,564,377,4167
New York,Avoca,1033,39,320,235,68,37,699
New York,Avon,3343,123,620,788,474,334,2339
New York,Babylon,12186,373,2306,2372,1984,1764,8799
New York,Bainbridge,1237,91,287,234,99,86,797
New York,Baiting Hollow,1542,67,396,416,158,139,1176
New York,Baldwin,24481,1701,3664,4620,3781,2359,16125
New York,Baldwin Harbor,7724,252,1379,1336,1219,1138,5324
New York,Watertown,27250,1933,5347,6222,2134,1448,17084
New York,Baldwinsville,7692,439,1530,1888,951,703,5511
New York,Balmville,2741,93,510,674,339,309,1925
New York,Bardonia,3551,113,484,490,803,670,2560
New York,Barker,738,36,212,133,22,15,418
New York,Waddington,953,74,269,146,172,40,701
New York,Wading River,7762,278,1254,1922,1014,1127,5595
New York,Wadsworth,350,53,63,40,26,7,189
New York,Wainscott,753,70,134,131,107,145,587
New York,Ballston Spa,5256,141,968,1240,793,539,3681
New York,Waterville,1574,107,538,299,143,94,1181
New York,Watervliet,10241,622,2442,2591,825,369,6849
New York,Watkins Glen,1912,166,426,397,183,130,1302
New York,West Hampton Dunes,53,0,0,6,17,26,49
New York,West Haverstraw,10347,1295,1679,2276,670,569,6489
New York,West Hempstead,19012,1252,3461,3105,2726,2176,12720
New York,West Hills,5098,144,585,901,1064,1089,3783
New York,West Hurley,2034,126,493,376,254,415,1664
New York,West Islip,27224,1082,5319,5342,3618,3115,18476
New York,Westmere,6758,206,1052,1548,967,1336,5109
New York,Westhampton Beach,1918,61,367,307,389,362,1486
New York,Westmoreland,584,21,169,140,16,0,346
New York,Weston Mills,1527,120,535,275,86,116,1132
New York,West Point,6830,19,116,387,492,647,1661
New York,Westport,427,14,118,92,44,58,326
New York,West Sand Lake,2845,123,355,644,515,322,1959
New York,West Sayville,4712,238,875,1006,676,515,3310
New York,West Seneca,45089,2361,10583,11029,5453,3614,33040
New York,Westvale,5210,109,703,1133,920,810,3675
New York,West Nyack,3939,87,563,640,714,647,2651
New York,Averill Park,1413,21,198,465,170,86,940
New York,Westhampton,2935,95,570,516,494,430,2105
New York,Westfield,3466,280,834,648,370,312,2444
New York,Waverly,4328,366,1227,890,278,277,3038
New York,Wayland,1750,146,535,400,92,94,1267
New York,Webster,5524,324,1034,1057,690,453,3558
New York,Websters Crossing,22,0,22,0,0,0,22
New York,Weedsport,1847,128,356,494,178,140,1296
New York,Wells,970,38,212,344,56,62,712
New York,Wellsburg,573,32,185,108,44,20,389
New York,West Glens Falls,7670,463,1914,1800,441,439,5057
New York,Wellsville,4589,343,973,1107,382,307,3112
New York,West Babylon,42664,3484,11570,8184,4629,2282,30149
New York,West Bay Shore,4684,119,877,958,702,722,3378
New York,Westbury,15273,1595,2922,2593,2080,1628,10818
New York,West Carthage,2019,135,417,409,255,103,1319
New York,West Chazy,986,131,164,193,52,10,550
New York,West Elmira,5160,35,657,1130,1008,960,3790
New York,West End,1482,135,300,354,146,300,1235
New York,Wesley Hills,5820,174,439,677,749,1097,3136
New York,Au Sable Forks,472,66,146,112,12,27,363
New York,Aurora,740,21,44,86,49,92,292
New York,Auburn,27264,2972,5985,6563,2183,1338,19041
New York,Lynbrook,19556,965,3544,3829,3203,2296,13837
New York,Lowville,3506,193,929,743,365,277,2507
New York,Lorraine,108,10,42,28,4,2,86
New York,Lorenz Park,2265,185,579,558,92,147,1561
New York,Long Lake,302,59,21,95,28,23,226
New York,Long Beach,33470,1589,5733,6710,6410,5495,25937
New York,Lodi,404,28,119,84,19,53,303
New York,Lyncourt,4098,384,1077,973,408,89,2931
New York,Locust Valley,3270,294,562,596,503,316,2271
New York,Loch Sheldrake,1187,91,198,238,0,83,610
New York,Lloyd Harbor,3684,37,145,336,718,921,2157
New York,Livonia Center,236,11,35,47,48,29,170
New York,Livonia,1196,27,262,279,151,111,830
New York,Livingston Manor,1104,180,326,129,93,50,778
New York,Accord,762,27,68,246,33,13,387
New York,Adams,1717,91,351,341,153,127,1063
New York,Lockport,20857,1632,4956,4911,1680,1372,14551
New York,Adams Center,1865,156,633,348,100,140,1377
New York,Lyndonville,789,42,211,194,70,33,550
New York,Lyons,3241,341,859,769,118,130,2217
New York,Manlius,4670,108,490,706,1122,810,3236
New York,Manhasset Hills,3755,275,271,479,794,908,2727
New York,Manhasset,8248,449,1045,960,1512,1693,5659
New York,Manchester,1712,96,441,511,141,60,1249
New York,Mamaroneck,19219,1613,2722,2318,3168,3293,13114
New York,Malverne Park Oaks,557,0,18,131,130,165,444
New York,Malverne,8552,281,1283,1625,1620,1546,6355
New York,Lyon Mountain,279,34,125,76,0,13,248
New York,Malone,5830,777,1358,1258,428,304,4125
New York,Mahopac,8083,346,1367,1488,1123,1149,5473
New York,Madrid,659,133,180,104,42,40,499
New York,Madison,327,42,94,57,16,14,223
New York,Machias,500,19,143,124,0,26,312
New York,McGraw,936,103,279,188,60,51,681
New York,Macedon,1591,52,235,387,257,157,1088
New York,Lyons Falls,741,60,260,128,32,45,525
New York,Malden-on-Hudson,202,39,75,17,15,17,163
New York,Manorhaven,6684,324,937,1015,1284,867,4427
New York,Addison,1788,84,452,414,60,121,1131
New York,Airmont,8808,629,1243,1285,1191,1387,5735
New York,Angelica,831,40,251,195,70,53,609
New York,Angola,1858,127,450,451,154,102,1284
New York,Angola on the Lake,1720,130,564,451,108,81,1334
New York,Antwerp,511,46,144,137,14,13,354
New York,Apalachin,1508,79,551,329,101,22,1082
New York,Aquebogue,1958,47,443,386,195,317,1388
New York,Arcade,2214,163,440,477,172,91,1343
New York,Andover,829,34,232,213,84,34,597
New York,Ardsley,4542,188,350,461,995,1149,3143
New York,Arkport,760,38,215,207,50,31,541
New York,Arlington,3888,215,432,639,623,169,2078
New York,Armonk,4541,68,270,349,1057,1003,2747
New York,Asharoken,532,0,48,129,137,112,426
New York,Athens,1420,173,428,298,108,120,1127
New York,Atlantic Beach,1511,32,218,283,349,303,1185
New York,Attica,2643,145,565,549,187,115,1561
New York,Argyle,379,19,108,51,35,37,250
New York,Afton,1086,113,347,205,38,67,770
New York,Andes,230,15,74,17,32,25,163
New York,Amityville,9515,535,1922,1792,1582,1029,6860
New York,Akron,2860,129,659,706,309,241,2044
New York,Albany,98468,6249,16260,15591,11761,10046,59907
New York,Albertson,5146,256,886,742,833,973,3690
New York,Albion,5631,918,1647,794,228,109,3696
New York,Alden,2590,71,683,713,264,155,1886
New York,Alexander,516,17,93,149,29,21,309
New York,Alexandria Bay,965,97,249,224,51,104,725
New York,Amsterdam,18157,2393,3964,3908,1203,530,11998
New York,Alfred,4314,3,27,58,155,230,473
New York,Almond,480,13,80,125,38,51,307
New York,Altamont,1610,30,279,368,217,287,1181
New York,Altmar,412,58,105,63,4,7,237
New York,Altona,789,193,306,115,16,9,639
New York,Amagansett,1211,32,285,162,298,170,947
New York,Amenia,1060,68,222,271,169,45,775
New York,Ames,165,28,40,30,18,10,126
New York,Allegany,1839,20,260,305,223,229,1037
New York,Deposit,1832,141,605,368,86,63,1263
New York,Tillson,1597,165,262,296,249,149,1121
New York,East Ithaca,2322,37,154,166,586,641,1584
New York,Eden,3271,111,723,844,418,200,2296
New York,Eatons Neck,1469,7,134,261,325,340,1067
New York,East Williston,2585,17,255,281,488,633,1674
New York,East Syracuse,3043,253,707,611,286,94,1951
New York,East Shoreham,6455,196,896,1244,774,1130,4240
New York,East Rockaway,9871,262,1941,1658,1709,1381,6951
New York,East Rochester,6678,383,1379,1528,629,587,4506
New York,Edmeston,794,50,187,181,33,43,494
New York,East Randolph,588,62,127,155,11,20,375
New York,Eastport,1869,84,428,377,401,168,1458
New York,East Patchogue,22452,2202,5563,4613,2197,1726,16301
New York,East Norwich,2751,65,349,338,515,535,1802
New York,East Northport,19682,679,3328,3695,3503,2636,13841
New York,East Nassau,624,12,133,128,83,44,400
New York,East Moriches,5428,164,1298,1016,612,644,3734
New York,East Meadow,37836,2410,7874,6962,5808,4171,27225
New York,East Quogue,4589,113,1050,840,584,741,3328
New York,East Marion,915,54,240,211,130,143,778
New York,Edwards,380,31,111,74,16,9,241
New York,Elba,713,33,148,154,85,56,476
New York,Springs,6065,300,873,1260,1202,1103,4738
New York,Spring Valley,32221,5582,4804,4666,2092,1009,18153
New York,Springville,4328,240,1321,910,389,289,3149
New York,Springwater Hamlet,484,79,140,82,13,11,325
New York,Staatsburg,183,0,8,39,41,76,164
New York,Stamford,1455,142,335,279,157,103,1016
New York,Stannards,841,99,223,183,76,95,676
New York,Eggertsville,15675,580,1785,2723,2535,2953,10576
New York,Star Lake,719,98,204,135,25,44,506
New York,Stillwater,1812,45,402,446,180,68,1141
New York,Stone Ridge,1256,50,173,155,125,176,679
New York,Stony Brook,13889,227,1080,2028,2503,3591,9429
New York,Ellicottville,273,10,46,106,48,32,242
New York,Ellenville,4131,475,744,715,184,231,2349
New York,Elizabethtown,763,48,145,215,102,97,607
New York,Elbridge,1080,24,214,379,125,43,785
New York,Stewart Manor,2113,43,315,325,453,343,1479
New York,East Kingston,391,13,143,71,8,0,235
New York,East Massapequa,19843,1110,4638,3731,3207,1859,14545
New York,East Islip,13802,544,2865,2259,1830,1853,9351
New York,Dering Harbor,6,0,0,0,1,2,3
New York,DeRuyter,545,29,120,149,34,42,374
New York,Dexter,1359,148,248,325,81,65,867
New York,Dix Hills,27374,902,2902,3899,5541,5352,18596
New York,Dobbs Ferry,11055,380,1541,1262,1937,2268,7388
New York,Dolgeville,2349,203,536,572,101,174,1586
New York,Dover Plains,919,209,288,138,51,41,727
New York,Downsville,648,89,143,134,40,16,422
New York,Dresden,452,107,75,65,33,20,300
New York,Duane Lake,361,0,57,57,66,82,262
New York,Duanesburg,359,0,16,174,39,16,245
New York,Dundee,1448,137,389,324,72,57,979
New York,Dunkirk,12308,1177,3311,2502,624,653,8267
New York,Dryden,2014,112,265,448,340,225,1390
New York,Earlville,1102,56,219,195,79,52,601
New York,East Hills,7066,71,383,564,1552,1889,4459
New York,Durhamville,806,60,212,190,0,0,462
New York,East Hampton,1148,34,159,167,322,302,984
New York,East Greenbush,4752,100,668,945,795,855,3363
New York,East Glenville,6621,168,1164,1561,921,791,4605
New York,East Garden City,6470,179,522,577,740,770,2788
New York,East Farmingdale,6414,476,1227,968,889,390,3950
New York,East Hampton North,3979,412,663,824,611,482,2992
New York,East Avon,619,65,150,97,48,38,398
New York,East Aurora,6251,272,870,1090,1027,1120,4379
New York,East Atlantic Beach,2126,34,265,474,396,490,1659
New York,Eastchester,19885,885,2453,2969,4127,3709,14143
North Carolina,Hertford,2197,294,585,415,126,67,1487
North Carolina,Henderson,15311,2958,3342,2145,864,394,9703
North Carolina,Hendersonville,13457,1354,2163,3068,1870,1055,9510
North Carolina,Henrietta,456,87,191,70,10,0,358
North Carolina,Hobgood,384,97,117,48,35,4,301
North Carolina,Hillsborough,6316,504,875,1161,723,839,4102
North Carolina,Hildebran,2173,269,608,377,163,61,1478
North Carolina,High Shoals,580,113,142,117,32,5,409
North Carolina,High Point,108031,10544,16860,21602,14508,6195,69709
North Carolina,Highlands,1059,31,174,232,254,207,898
North Carolina,Hemby Bridge,1307,162,371,269,110,13,925
North Carolina,Hickory,40172,4201,6628,7382,5393,3130,26734
North Carolina,Hiddenite,605,19,299,62,17,78,475
North Carolina,Hightsville,828,151,370,158,117,16,812
North Carolina,Hays,1896,274,395,394,124,0,1187
North Carolina,Dillsboro,295,9,48,120,52,25,254
North Carolina,Haw River,2585,261,602,559,148,40,1610
North Carolina,Elroy,3635,459,789,935,136,100,2419
North Carolina,Emerald Isle,3708,118,687,777,793,605,2980
North Carolina,Enfield,2426,599,648,292,100,24,1663
North Carolina,Engelhard,805,161,140,129,49,0,479
North Carolina,Enochville,2788,437,809,547,176,82,2051
North Carolina,Erwin,4601,595,1102,968,395,141,3201
North Carolina,Etowah,6797,364,1508,1880,758,689,5199
North Carolina,Eureka,144,15,36,38,20,1,110
North Carolina,Everetts,157,26,46,46,5,0,123
North Carolina,Evergreen,400,69,60,157,21,0,307
North Carolina,Fair Bluff,859,147,264,192,17,42,662
North Carolina,Fairfield,306,63,107,79,0,0,249
North Carolina,Fairfield Harbour,2749,22,573,836,578,412,2421
North Carolina,Fairmont,2684,414,654,424,170,96,1758
North Carolina,Fairplains,2181,473,558,344,101,14,1490
North Carolina,Fairview,2815,90,630,611,362,228,1921
North Carolina,Fairview,3530,217,959,795,352,103,2426
North Carolina,Lake Santeetlah,36,0,5,7,16,6,34
North Carolina,Lake Royale,3162,90,781,620,477,317,2285
North Carolina,Lake Park,3636,97,455,927,691,328,2498
North Carolina,Lake Norman of Catawba,7274,557,1306,1715,1334,632,5544
North Carolina,Lake Lure,1409,50,204,447,311,172,1184
North Carolina,Lake Junaluska,2682,128,497,663,468,393,2149
North Carolina,Elrod,502,49,158,34,22,19,282
North Carolina,La Grange,2842,405,896,646,123,103,2173
North Carolina,Kure Beach,2286,60,397,616,542,270,1885
North Carolina,Fallston,667,53,146,161,25,35,420
North Carolina,Falkland,59,10,8,12,4,2,36
North Carolina,Falcon,226,16,25,67,12,20,140
North Carolina,Faith,875,59,219,175,80,49,582
North Carolina,Faison,1107,228,156,229,80,27,720
North Carolina,Knightdale,13243,772,1780,2484,2574,975,8585
North Carolina,Elon,9698,252,636,1659,966,837,4350
North Carolina,Elm City,1630,273,424,283,90,12,1082
North Carolina,Ellerbe,1137,140,292,242,63,0,737
North Carolina,Dunn,9654,1373,2027,2057,820,410,6687
North Carolina,Dundarrach,60,0,26,34,0,0,60
North Carolina,Duck,534,26,71,119,135,111,462
North Carolina,Dublin,411,56,50,76,23,20,225
North Carolina,Drexel,1869,207,282,467,130,128,1214
North Carolina,Dover,284,50,75,85,12,1,223
North Carolina,Durham,246084,20889,25764,38476,40484,36307,161920
North Carolina,Dortches,1000,93,217,200,133,60,703
North Carolina,Dobbins Heights,858,113,231,212,33,9,598
North Carolina,Hobucken,64,0,32,11,0,0,43
North Carolina,Harrisburg,13883,464,1506,2720,2180,1376,8246
North Carolina,Hassell,38,0,11,16,2,0,29
North Carolina,Hatteras,466,11,177,56,137,0,381
North Carolina,Havelock,20729,457,2743,4361,1034,415,9010
North Carolina,Dobson,1569,256,295,269,91,80,991
North Carolina,Hayesville,404,41,86,83,47,32,289
North Carolina,Earl,303,29,85,57,9,4,184
North Carolina,East Bend,473,54,150,101,35,16,356
North Carolina,Ellenboro,1250,185,230,198,31,33,677
North Carolina,Elk Park,411,61,97,135,5,6,304
North Carolina,Elkin,4217,546,855,846,332,215,2794
North Carolina,Elizabethtown,3610,529,696,927,286,105,2543
North Carolina,Elizabeth City,18111,2184,2832,3776,1471,946,11209
North Carolina,Efland,837,6,227,231,43,154,661
North Carolina,East Arcadia,440,87,104,59,18,2,270
North Carolina,Edneyville,2069,333,395,423,258,0,1409
North Carolina,Eden,15483,2151,3724,3078,878,497,10328
North Carolina,East Spencer,1453,197,335,230,79,6,847
North Carolina,East Rockingham,3921,684,904,626,347,20,2581
North Carolina,Eastover,3681,433,888,857,326,129,2633
North Carolina,East Laurinburg,367,63,115,67,1,0,246
North Carolina,East Flat Rock,3500,783,1026,736,333,149,3027
North Carolina,Edenton,4942,687,1035,945,349,268,3284
North Carolina,Hoffman,572,112,137,99,10,6,364
North Carolina,Canton,4156,552,763,976,284,175,2750
North Carolina,Denton,1766,254,474,345,77,38,1188
North Carolina,Mount Gilead,1282,143,307,293,119,11,873
North Carolina,Mount Airy,10391,1782,1671,2048,1244,579,7324
North Carolina,Mountain View,3276,348,653,784,540,188,2513
North Carolina,Mountain Home,3603,228,935,735,464,195,2557
North Carolina,Morven,510,137,89,49,32,8,315
North Carolina,Morrisville,21726,735,1440,2934,5836,3827,14772
North Carolina,Morganton,16748,2603,2713,3412,1811,1187,11726
North Carolina,Morehead City,9162,798,1664,2373,1277,626,6738
North Carolina,Moravian Falls,1564,155,429,451,69,36,1140
North Carolina,Mooresville,34930,1657,4748,7908,5559,1964,21836
North Carolina,Mooresboro,486,77,151,72,22,15,337
North Carolina,Montreat,677,28,4,39,97,172,340
North Carolina,Monroe,33951,5252,6173,6106,2655,913,21099
North Carolina,Moncure,506,55,115,141,44,33,388
North Carolina,Momeyer,250,46,74,44,26,7,197
North Carolina,Mocksville,5090,752,970,996,440,189,3347
North Carolina,Misenheimer,711,25,38,54,35,31,183
North Carolina,Mint Hill,24545,1385,3945,5881,4343,1730,17284
North Carolina,Minnesott Beach,385,10,76,128,87,55,356
North Carolina,Mineral Springs,2797,238,609,756,169,145,1917
North Carolina,Milton,176,18,53,35,16,13,135
North Carolina,Mount Holly,13924,1371,2549,3433,1601,736,9690
North Carolina,Mount Olive,4756,761,1077,719,237,179,2973
North Carolina,Mount Pleasant,1825,84,370,492,168,85,1199
North Carolina,Moyock,3456,109,398,1333,205,136,2181
North Carolina,North Wilkesboro,4250,994,686,591,299,154,2724
North Carolina,Northwest,959,104,250,206,40,44,644
North Carolina,North Topsail Beach,1047,13,98,335,202,179,827
North Carolina,Northlakes,1681,64,199,413,500,82,1258
North Carolina,Northchase,3386,220,465,963,537,124,2309
North Carolina,Norman,151,28,28,22,4,2,84
North Carolina,Norlina,1131,147,371,207,72,51,848
North Carolina,Newton Grove,526,86,147,120,57,20,430
North Carolina,Newton,12980,1956,2981,2566,873,382,8758
North Carolina,Newport,4598,386,1041,1401,324,243,3395
North Carolina,Mills River,6964,342,1234,1730,864,653,4823
North Carolina,New London,596,36,155,166,69,18,444
North Carolina,New Bern,30218,3234,5132,6319,3288,1994,19967
North Carolina,Neuse Forest,2244,87,503,527,245,128,1490
North Carolina,Navassa,1887,266,451,381,93,32,1223
North Carolina,Nashville,5459,542,1270,1374,472,245,3903
North Carolina,Nags Head,2825,85,389,835,592,265,2166
North Carolina,Myrtle Grove,8972,422,1433,1989,1666,992,6502
North Carolina,Murraysville,14844,632,2525,3796,2225,909,10087
North Carolina,Murphy,2095,304,535,459,166,62,1526
North Carolina,Murfreesboro,2920,177,328,549,267,199,1520
North Carolina,Mulberry,2122,364,346,644,113,61,1528
North Carolina,Newland,844,127,136,173,65,39,540
North Carolina,Denver,1994,100,410,502,317,55,1384
North Carolina,Millingport,368,53,66,105,59,23,306
North Carolina,Midway,4716,551,918,1133,531,275,3408
North Carolina,Hudson,3732,308,810,887,266,300,2571
North Carolina,Hot Springs,573,166,113,89,45,6,419
North Carolina,Horse Shoe,2509,95,620,695,328,190,1928
North Carolina,Hope Mills,16123,844,2743,4037,1368,508,9500
North Carolina,Hoopers Creek,1399,68,340,488,158,30,1084
North Carolina,Hookerton,318,62,94,86,18,2,262
North Carolina,Holly Springs,28640,692,2263,4906,6813,3164,17838
North Carolina,Holly Ridge,1785,159,315,467,266,79,1286
North Carolina,Hollister,854,144,179,98,14,15,450
North Carolina,Holden Beach,955,25,92,229,306,143,795
North Carolina,Lake Waccamaw,1465,174,297,303,199,106,1079
North Carolina,Dallas,4540,540,972,1066,436,105,3119
North Carolina,Dana,2486,367,527,709,192,145,1940
North Carolina,Danbury,175,19,46,27,42,6,140
North Carolina,Davidson,11765,176,713,1384,2360,2243,6876
North Carolina,Davis,352,10,90,96,64,9,269
North Carolina,Deercroft,289,0,32,119,76,36,263
North Carolina,Delco,249,113,47,44,10,0,214
North Carolina,Dellview,5,0,0,5,0,0,5
North Carolina,Norwood,2881,339,730,648,181,116,2014
North Carolina,Delway,53,11,30,12,0,0,53
North Carolina,Huntersville,50433,1527,4896,8634,12864,5428,33349
North Carolina,Icard,2971,615,649,636,154,48,2102
North Carolina,Indian Beach,179,0,43,40,41,26,150
North Carolina,Indian Trail,35602,1592,5229,7071,5264,2092,21248
North Carolina,Midland,3243,277,1090,707,291,96,2461
North Carolina,Middlesex,1058,155,230,207,49,7,648
North Carolina,Middleburg,154,24,9,35,7,5,80
North Carolina,Micro,603,39,176,165,17,2,399
North Carolina,Mesic,215,24,94,58,5,1,182
North Carolina,Mebane,13309,779,2213,3073,1872,1004,8941
North Carolina,Maysville,915,94,191,228,41,16,570
North Carolina,Mayodan,2762,454,706,491,179,26,1856
North Carolina,Maxton,2598,324,596,518,74,75,1587
North Carolina,Maury,1563,437,291,468,39,0,1235
North Carolina,Millers Creek,1842,258,563,489,71,23,1404
North Carolina,Jonesville,2496,480,539,395,46,66,1526
North Carolina,Jamesville,547,80,108,133,37,11,369
North Carolina,Jamestown,3638,250,439,628,924,354,2595
North Carolina,James City,5513,617,1061,1732,560,137,4107
North Carolina,Jacksonville,68315,2373,7804,13647,4579,2220,30623
North Carolina,Jackson Heights,838,217,85,288,0,0,590
North Carolina,Jackson,511,68,118,190,42,21,439
North Carolina,JAARS,335,8,7,48,142,37,242
North Carolina,Ivanhoe,182,25,0,70,25,0,120
North Carolina,Iron Station,620,121,164,160,16,25,486
North Carolina,Ingold,525,110,0,36,41,21,208
North Carolina,Jefferson,1374,253,293,292,134,34,1006
North Carolina,Landis,3097,335,839,905,317,54,2450
North Carolina,Lansing,194,38,42,36,5,1,122
North Carolina,Lasker,124,17,41,36,4,0,98
North Carolina,Brookford,402,96,118,75,16,0,305
North Carolina,Brunswick,988,175,256,290,41,10,772
North Carolina,Bryson City,1748,248,351,335,122,112,1168
North Carolina,Buies Creek,2668,0,91,171,135,203,600
North Carolina,Bunn,365,48,92,111,21,2,274
North Carolina,Bunnlevel,770,47,148,175,36,19,425
North Carolina,Burgaw,4011,570,854,915,438,165,2942
North Carolina,Burlington,52241,6339,9591,10981,5697,2405,35013
North Carolina,Burnsville,1653,280,416,360,179,68,1303
North Carolina,Butner,7672,1272,1589,1767,404,224,5256
North Carolina,Butters,201,60,67,44,0,0,171
North Carolina,McFarlan,162,33,36,19,8,1,97
North Carolina,McLeansville,897,86,188,224,82,0,580
North Carolina,Brogden,2364,281,606,503,170,47,1607
North Carolina,Macon,143,10,40,33,20,6,109
North Carolina,Maggie Valley,1533,60,329,410,226,141,1166
North Carolina,Magnolia,1211,267,174,224,25,10,700
North Carolina,Maiden,3346,459,563,720,199,9,1950
North Carolina,Mamers,1029,93,175,186,75,0,529
North Carolina,Manns Harbor,1282,283,219,193,24,16,735
North Carolina,Manteo,1522,106,229,399,257,152,1143
North Carolina,Marble,202,86,31,25,21,1,164
North Carolina,Marietta,127,10,45,33,5,5,98
North Carolina,Marion,7914,1256,2120,1478,427,241,5522
North Carolina,Mar-Mac,3924,685,652,800,181,65,2383
North Carolina,Marshall,764,60,169,207,71,55,562
North Carolina,Marshallberg,312,14,145,107,13,0,279
North Carolina,Mars Hill,2410,78,273,330,260,174,1115
North Carolina,Madison,2278,325,681,500,137,107,1750
North Carolina,Marshville,2538,466,615,440,74,19,1614
North Carolina,Broadway,1242,92,278,376,140,67,953
North Carolina,Bridgeton,304,24,87,68,41,12,232
North Carolina,Benson,3478,619,373,829,436,165,2422
North Carolina,Bent Creek,1431,0,157,565,230,203,1155
North Carolina,Bermuda Run,2532,55,311,515,834,445,2160
North Carolina,Bessemer City,5455,781,1325,1195,156,69,3526
North Carolina,Bethania,359,11,90,134,51,9,295
North Carolina,Bethel,1849,328,379,373,179,77,1336
North Carolina,Bethlehem,4620,303,1061,1024,873,308,3569
North Carolina,Beulaville,1570,207,309,322,118,108,1064
North Carolina,Biltmore Forest,1474,15,61,138,534,383,1131
North Carolina,Biscoe,1874,403,326,231,57,15,1032
North Carolina,Black Creek,642,73,160,111,30,15,389
North Carolina,Black Mountain,8079,639,1690,1795,1222,960,6306
North Carolina,Bladenboro,1875,253,423,334,91,54,1155
North Carolina,Broad Creek,2525,207,568,639,304,103,1821
North Carolina,Blowing Rock,1206,60,119,242,365,219,1005
North Carolina,Boardman,199,50,43,54,1,4,152
North Carolina,Bogue,662,30,168,195,66,41,500
North Carolina,Boiling Spring Lakes,5610,674,865,1408,479,166,3592
North Carolina,Boiling Springs,4636,138,353,647,479,456,2073
North Carolina,Bolivia,310,23,52,63,11,13,162
North Carolina,Bolton,796,97,192,179,20,2,490
North Carolina,Bonnetsville,425,85,92,30,3,0,210
North Carolina,Boone,17966,387,458,1484,1216,967,4512
North Carolina,Boonville,1370,174,327,313,107,31,952
North Carolina,Bostic,360,39,80,98,17,16,250
North Carolina,Bowmore,26,0,19,7,0,0,26
North Carolina,Brevard,7656,535,1257,1710,1155,664,5321
North Carolina,Brices Creek,3921,98,466,1024,528,339,2455
North Carolina,Blue Clay Farms,12,0,0,0,0,12,12
North Carolina,Marvin,5938,111,140,593,1469,1040,3353
North Carolina,Matthews,29352,1136,3336,5406,7015,3325,20218
North Carolina,Cullowhee,5534,162,155,344,254,118,1033
North Carolina,Cherryville,5868,593,1289,1407,477,256,4022
North Carolina,Cherokee,2157,295,453,530,123,71,1472
North Carolina,Charlotte,792137,60061,100060,144208,143579,70288,518196
North Carolina,Chapel Hill,58766,1339,2310,4183,8835,13474,30141
North Carolina,Chadbourn,2169,307,343,502,98,35,1285
North Carolina,Cerro Gordo,154,15,26,36,12,5,94
North Carolina,Centerville,91,5,41,6,5,0,57
North Carolina,Cedar Rock,326,9,25,110,87,45,276
North Carolina,Cedar Point,1429,64,225,252,236,228,1005
North Carolina,Catawba,688,92,167,122,55,12,448
North Carolina,Caswell Beach,387,4,36,127,106,73,346
North Carolina,Castle Hayne,953,31,251,154,187,0,623
North Carolina,Castalia,363,86,96,55,22,0,259
North Carolina,Chimney Rock Village,68,1,15,32,10,5,63
North Carolina,Cashiers,109,10,27,55,17,0,109
North Carolina,Cary,151186,4838,12080,21109,36757,27295,102079
North Carolina,Carthage,2531,190,513,556,263,99,1621
North Carolina,Carrboro,20639,893,1306,1947,3993,4815,12954
North Carolina,Carolina Shores,3549,359,832,1268,499,296,3254
North Carolina,Carolina Beach,5970,208,857,1525,859,684,4133
North Carolina,Caroleen,502,46,60,220,0,0,326
North Carolina,Buxton,1250,70,220,457,76,40,863
North Carolina,Cajah's Mountain,2752,460,671,577,200,86,1994
North Carolina,Calabash,1775,170,473,519,147,94,1403
North Carolina,Calypso,545,93,103,103,22,6,327
North Carolina,Camden,577,19,19,170,30,40,278
North Carolina,Cameron,287,36,102,51,20,2,211
North Carolina,Candor,759,99,124,173,75,7,478
North Carolina,Casar,269,45,68,61,8,5,187
North Carolina,China Grove,4164,590,890,765,156,172,2573
North Carolina,Chocowinity,936,93,265,232,49,18,657
North Carolina,Claremont,1394,72,276,303,181,83,915
North Carolina,Crossnore,237,25,42,30,23,14,134
North Carolina,Cricket,1712,534,246,328,90,95,1293
North Carolina,Creswell,294,30,48,68,11,16,173
North Carolina,Creedmoor,4289,202,910,953,461,233,2759
North Carolina,Cramerton,4245,342,653,855,778,304,2932
North Carolina,Cove Creek,1072,113,245,163,117,115,753
North Carolina,Cove City,457,40,109,106,14,13,282
North Carolina,Cornelius,26866,817,2949,5171,6456,3508,18901
North Carolina,Cordova,1875,193,662,416,130,12,1413
North Carolina,Cooleemee,839,120,221,173,37,6,557
North Carolina,Conway,728,88,170,103,54,20,435
North Carolina,Conover,8221,727,1765,2014,773,472,5751
North Carolina,Connelly Springs,1854,331,388,329,79,42,1169
North Carolina,Conetoe,352,65,69,106,10,0,250
North Carolina,Concord,83903,6178,13330,17220,12046,4923,53697
North Carolina,Como,82,2,21,35,1,1,60
North Carolina,Columbus,1161,158,215,252,83,50,758
North Carolina,Columbia,795,202,174,120,30,22,548
North Carolina,Colerain,191,15,49,55,15,18,152
North Carolina,Coinjock,235,30,28,51,15,0,124
North Carolina,Cofield,301,53,59,100,17,2,231
North Carolina,Coats,2628,269,605,597,138,77,1686
North Carolina,Clyde,1311,132,218,268,158,62,838
North Carolina,Clinton,8750,1121,1802,1890,875,376,6064
North Carolina,Cliffside,327,32,115,55,13,15,230
North Carolina,Cleveland,930,129,202,233,42,45,651
North Carolina,Clemmons,19340,758,2369,3908,3950,2209,13194
North Carolina,Clayton,17869,872,2687,4294,2469,1160,11482
North Carolina,Clarkton,671,53,131,213,46,12,455
North Carolina,Bennett,190,11,103,47,10,0,171
North Carolina,Cape Carteret,2223,51,335,581,326,285,1578
North Carolina,Belwood,994,118,235,224,42,28,647
North Carolina,Belville,2437,94,251,647,391,169,1552
North Carolina,Bakersville,487,89,107,78,10,16,300
North Carolina,Bald Head Island,205,0,10,24,78,92,204
North Carolina,Balfour,1556,228,292,476,152,0,1148
North Carolina,Banner Elk,1183,29,88,210,115,77,519
North Carolina,Barker Heights,1530,189,298,384,72,36,979
North Carolina,Barker Ten Mile,853,20,98,261,207,86,672
North Carolina,Bath,270,9,49,88,53,30,229
North Carolina,Bayboro,1389,159,439,353,40,12,1003
North Carolina,Bayshore,3283,124,568,588,704,309,2293
North Carolina,Bayview,241,43,57,61,27,18,206
North Carolina,Bear Grass,137,1,37,25,4,8,75
North Carolina,Beaufort,4153,366,640,1214,419,326,2965
North Carolina,Beech Mountain,571,20,63,149,161,128,521
North Carolina,Bailey,530,52,139,109,37,6,343
North Carolina,Belhaven,2000,428,525,322,92,64,1431
North Carolina,Belmont,10387,929,1731,2022,1651,811,7144
North Carolina,Kelford,215,49,57,26,9,0,141
North Carolina,Kelly,496,33,96,192,16,0,337
North Carolina,Kenansville,926,132,185,262,64,31,674
North Carolina,Kenly,1674,279,327,267,89,43,1005
North Carolina,Kernersville,23617,1673,4485,5125,3438,1683,16404
North Carolina,Kill Devil Hills,6881,297,1388,1942,1009,339,4975
North Carolina,King,6697,538,1706,1495,950,229,4918
North Carolina,Kings Grant,8913,642,1755,2101,1454,454,6406
North Carolina,Kings Mountain,10792,1168,2828,2475,486,286,7243
North Carolina,Kingstown,742,165,232,97,31,7,532
North Carolina,Kinston,21540,2877,4843,4688,1317,846,14571
North Carolina,Kittrell,284,28,57,67,7,0,159
North Carolina,Bell Arthur,334,64,25,90,18,0,197
North Carolina,Kitty Hawk,3362,69,561,1091,520,215,2456
North Carolina,McDonald,99,12,29,33,5,1,80
North Carolina,McAdenville,660,84,129,152,108,55,528
North Carolina,Lattimore,469,27,76,83,35,20,241
North Carolina,Laurel Hill,931,108,403,151,43,32,737
North Carolina,Laurel Park,2765,136,273,803,503,423,2138
North Carolina,Laurinburg,15694,1985,3183,2784,1273,821,10046
North Carolina,Lawndale,709,88,233,152,23,17,513
North Carolina,Leggett,38,3,9,10,3,0,25
North Carolina,Leland,16122,771,1872,4298,3176,1722,11839
North Carolina,Lenoir,17978,2959,4171,3976,1169,576,12851
North Carolina,Lewiston Woodville,846,95,217,124,37,19,492
North Carolina,Lewisville,13212,413,2101,3155,2554,1211,9434
North Carolina,Lexington,19129,3657,3767,2972,1095,670,12161
North Carolina,Liberty,2674,429,442,568,268,52,1759
North Carolina,Light Oak,763,130,100,275,44,0,549
North Carolina,Macclesfield,513,91,135,91,39,9,365
North Carolina,Lilesville,464,70,139,82,21,6,318
North Carolina,Lincolnton,10696,1475,1730,2266,1146,287,6904
North Carolina,Linden,169,34,34,26,10,4,108
North Carolina,Littleton,533,117,105,100,40,31,393
North Carolina,Locust,2956,249,727,780,179,117,2052
North Carolina,Long View,5050,1024,1189,1062,167,74,3516
North Carolina,Louisburg,3499,390,463,667,274,228,2022
North Carolina,Love Valley,112,26,17,24,14,1,82
North Carolina,Lowell,3594,521,1047,840,201,148,2757
North Carolina,Lowesville,3266,272,581,828,411,210,2302
North Carolina,Lowgap,350,86,97,85,0,0,268
North Carolina,Lucama,930,148,218,185,34,5,590
North Carolina,Lumber Bridge,82,8,20,33,4,7,72
North Carolina,Lumberton,21721,3623,3971,3860,1623,930,14007
North Carolina,Lillington,3388,534,858,915,215,146,2668
North Carolina,Harrellsville,177,8,45,41,9,1,104
North Carolina,Harrells,153,19,44,37,20,3,123
North Carolina,Harmony,602,125,116,100,38,15,394
North Carolina,Gastonia,73211,7960,13117,15685,7490,3207,47459
North Carolina,Gaston,1038,238,286,171,24,13,732
North Carolina,Garysburg,1033,140,298,275,26,27,766
North Carolina,Garner,27160,1553,4544,6293,4406,1844,18640
North Carolina,Garland,674,153,134,108,39,21,455
North Carolina,Gamewell,3986,546,1014,1028,180,43,2811
North Carolina,Fuquay-Varina,21399,1213,3075,4271,3359,1579,13497
North Carolina,Fruitland,2637,480,609,570,130,152,1941
North Carolina,Frisco,111,7,7,63,17,0,94
North Carolina,Fremont,1147,156,288,235,85,25,789
North Carolina,Franklinville,1064,219,253,138,51,3,664
North Carolina,Franklinton,2319,419,515,399,141,77,1551
North Carolina,Franklin,3910,531,814,799,441,183,2768
North Carolina,Gatesville,403,25,58,102,48,28,261
North Carolina,Foxfire,1344,39,193,381,245,114,972
North Carolina,Fountain,450,96,61,92,25,4,278
North Carolina,Foscoe,1465,105,166,391,155,292,1109
North Carolina,Forest Oaks,3342,87,618,750,700,311,2466
North Carolina,Forest Hills,405,0,17,39,49,109,214
North Carolina,Forest City,7359,1174,1357,1376,320,277,4504
North Carolina,Fontana Dam,0,0,0,0,0,0,0
North Carolina,Fletcher,7394,301,1385,1979,1140,490,5295
North Carolina,Flat Rock,1466,411,226,435,55,17,1144
North Carolina,Flat Rock,3211,29,308,728,1180,544,2789
North Carolina,Five Points,979,68,228,242,92,31,661
North Carolina,Fearrington Village,2797,55,329,363,934,1016,2697
North Carolina,Fayetteville,202521,10971,29880,52491,20314,10992,124648
North Carolina,Farmville,4755,472,880,1184,467,204,3207
North Carolina,Four Oaks,1900,347,370,284,123,106,1230
North Carolina,Germanton,838,146,268,197,81,0,692
North Carolina,Gerton,255,10,67,80,0,25,182
North Carolina,Gibson,516,70,124,107,13,10,324
North Carolina,Harkers Island,1637,203,496,430,97,32,1258
North Carolina,Hampstead,4528,127,1151,751,624,398,3051
North Carolina,Hamlet,6525,629,1224,1314,305,139,3611
North Carolina,Hamilton,384,90,73,79,12,7,261
North Carolina,Hallsboro,421,52,108,115,41,35,351
North Carolina,Halifax,271,14,44,54,57,23,192
North Carolina,Half Moon,7915,374,1490,1824,617,122,4427
North Carolina,Gulf,401,49,50,139,0,53,291
North Carolina,Grover,1037,99,307,200,39,32,677
North Carolina,Grimesland,421,51,99,101,42,16,309
North Carolina,Grifton,2576,204,471,635,186,114,1610
North Carolina,Greenville,88598,3897,10128,14643,10799,6822,46289
North Carolina,Greensboro,279427,20373,40732,53721,42594,23635,181055
North Carolina,Green Level,1977,263,472,332,50,22,1139
North Carolina,Greenevers,847,178,160,122,52,16,528
North Carolina,Grantsboro,822,115,209,207,37,6,574
North Carolina,Granite Quarry,2963,126,568,659,429,113,1895
North Carolina,Granite Falls,4683,699,819,1045,356,197,3116
North Carolina,Grandfather,61,0,2,5,34,15,56
North Carolina,Graham,14468,1963,2919,2804,1248,451,9385
North Carolina,Gorman,1310,196,556,136,40,20,948
North Carolina,Goldston,285,37,61,101,26,8,233
North Carolina,Goldsboro,35952,3349,6833,8267,3226,1581,23256
North Carolina,Godwin,140,8,41,32,20,3,104
North Carolina,Gloucester,681,52,229,132,51,22,486
North Carolina,Glenville,48,0,27,21,0,0,48
North Carolina,Glen Raven,2607,319,473,508,272,174,1746
North Carolina,Glen Alpine,1513,200,274,433,121,77,1105
North Carolina,Gibsonville,6634,552,1215,1491,717,502,4477
North Carolina,Belvoir,463,71,107,85,16,0,279
North Carolina,Oakboro,1924,202,319,513,207,82,1323
North Carolina,Keener,836,127,174,158,14,0,473
North Carolina,Oriental,926,47,164,199,207,152,769
North Carolina,Ogden,6802,115,746,1742,1576,849,5028
North Carolina,Ocracoke,486,0,122,200,46,22,390
North Carolina,Ocean Isle Beach,678,16,138,146,228,93,621
North Carolina,Oak Ridge,6513,160,988,1136,1250,871,4405
North Carolina,Oak Island,7199,447,1513,2022,1088,673,5743
North Carolina,Oak City,371,68,99,86,8,2,263
North Carolina,Tobaccoville,2537,137,566,620,313,125,1761
North Carolina,Toast,1293,245,308,329,74,79,1035
North Carolina,Thomasville,27084,3457,6300,5329,2229,503,17818
North Carolina,Teachey,345,38,64,80,32,11,225
North Carolina,Taylortown,1100,64,267,268,86,7,692
North Carolina,Taylorsville,2183,342,581,371,173,55,1522
North Carolina,Tar Heel,173,11,30,60,21,4,126
North Carolina,Tarboro,11292,2008,2092,2671,731,540,8042
North Carolina,Tabor City,3946,862,841,903,221,121,2948
North Carolina,Old Fort,1033,167,281,194,60,20,722
North Carolina,Old Hundred,371,183,16,32,0,0,231
North Carolina,Orrum,52,5,20,11,2,2,40
North Carolina,Ossipee,692,84,134,207,104,12,541
North Carolina,Pinetown,71,0,36,19,7,0,62
North Carolina,Pinetops,1161,178,314,202,48,19,761
North Carolina,Pine Level,1991,239,380,425,162,79,1285
North Carolina,Pine Knoll Shores,1515,18,200,395,400,225,1238
North Carolina,Pinehurst,15313,259,2087,3380,4318,2977,13021
North Carolina,Pinebluff,1255,36,261,401,120,74,892
North Carolina,Pilot Mountain,1725,167,377,366,108,99,1117
North Carolina,Sylva,2597,261,388,540,274,225,1688
North Carolina,Pikeville,751,80,163,166,59,29,497
North Carolina,Peletier,866,90,217,209,30,21,567
North Carolina,Peachland,396,54,135,56,25,13,283
North Carolina,Patterson Springs,662,105,159,122,18,4,408
North Carolina,Parmele,334,54,101,68,18,0,241
North Carolina,Parkton,560,63,123,144,34,7,371
North Carolina,Pantego,222,13,60,55,19,10,157
North Carolina,Oxford,8650,1319,1596,2008,595,518,6036
North Carolina,Pembroke,3002,311,339,488,172,78,1388
North Carolina,Swepsonville,1275,57,246,358,160,89,910
North Carolina,Swansboro,2956,142,350,807,355,330,1984
North Carolina,Swan Quarter,344,78,88,99,0,0,265
North Carolina,Staley,363,59,88,58,11,0,216
North Carolina,Spruce Pine,2444,337,424,536,162,98,1557
North Carolina,Spring Lake,13336,517,1541,2773,934,345,6110
North Carolina,Spring Hope,1289,270,279,283,79,20,931
North Carolina,Spivey's Corner,492,84,40,119,95,11,349
North Carolina,Spindale,4279,619,981,1158,257,97,3112
North Carolina,Aberdeen,6914,642,864,1659,975,377,4517
North Carolina,Stallings,14495,645,1535,3383,3059,995,9617
North Carolina,Advance,951,42,239,141,111,104,637
North Carolina,Alamance,871,25,180,269,126,68,668
North Carolina,Sims,333,31,50,77,42,5,205
North Carolina,Alliance,696,123,139,167,34,37,500
North Carolina,Altamahaw,465,40,174,127,22,0,363
North Carolina,Andrews,2050,370,307,358,140,68,1243
North Carolina,Angier,4855,462,947,1287,345,96,3137
North Carolina,Ansonville,720,99,304,126,33,0,562
North Carolina,Ahoskie,4976,769,976,942,346,182,3215
North Carolina,Pineville,8066,498,1348,1904,1550,365,5665
North Carolina,Stanfield,1612,189,305,346,125,26,991
North Carolina,Stantonsburg,814,130,183,143,75,30,561
North Carolina,Swannanoa,4685,553,1206,886,469,109,3223
North Carolina,Surf City,2481,99,458,585,502,266,1910
North Carolina,Sunset Beach,3695,186,781,972,977,574,3490
North Carolina,Sunbury,284,36,30,54,34,22,176
North Carolina,Summerfield,10622,329,1338,1785,2507,1330,7289
North Carolina,Sugar Mountain,465,15,50,145,82,44,336
North Carolina,Stovall,388,81,79,86,10,32,288
North Carolina,Stanley,3615,543,789,827,184,88,2431
North Carolina,Stony Point,1770,150,354,246,49,17,816
North Carolina,Stoneville,1295,169,317,291,97,26,900
North Carolina,Stokesdale,5221,235,965,856,695,573,3324
North Carolina,Stokes,361,64,136,145,16,0,361
North Carolina,Stem,859,52,127,268,46,35,528
North Carolina,Stedman,1313,103,205,296,138,78,820
North Carolina,Statesville,25443,3221,4347,5352,2051,1238,16209
North Carolina,Star,870,130,204,223,49,5,611
North Carolina,Stonewall,215,19,62,44,8,3,136
North Carolina,Piney Green,13738,846,2026,3140,995,322,7329
North Carolina,Kannapolis,44520,4964,8478,10145,3647,1823,29057
North Carolina,Pink Hill,466,78,94,80,54,18,324
North Carolina,Sawmills,5130,902,1167,1236,242,118,3665
North Carolina,Saratoga,493,43,146,84,31,11,315
North Carolina,Sanford,28988,4170,4593,5554,2983,1117,18417
North Carolina,Sandyfield,473,20,108,109,23,15,275
North Carolina,Sandy Creek,304,48,65,69,10,14,206
North Carolina,Salvo,240,0,31,44,30,32,137
North Carolina,Saluda,656,40,142,129,120,62,493
North Carolina,Saxapahaw,1430,184,374,362,132,89,1141
North Carolina,Salisbury,33653,4002,6426,7091,3544,1644,22707
North Carolina,Salem,2182,337,554,494,149,112,1646
North Carolina,St. Stephens,8954,1001,1859,2121,681,247,5909
North Carolina,St. Pauls,2223,418,632,367,72,24,1513
North Carolina,St. James,4050,139,727,794,1388,1002,4050
North Carolina,St. Helena,393,17,110,99,42,25,293
North Carolina,Rutherfordton,4193,431,871,1250,546,234,3332
North Carolina,Rutherford College,1420,165,445,271,142,52,1075
North Carolina,Salemburg,374,55,70,124,29,10,288
North Carolina,Ruth,439,77,113,101,31,9,331
North Carolina,Scotch Meadows,572,19,93,62,163,65,402
North Carolina,Seaboard,736,125,199,162,46,25,557
North Carolina,Simpson,383,61,44,84,53,17,259
North Carolina,Silver Lake,5874,476,1270,1660,434,158,3998
North Carolina,Silver City,914,196,217,175,15,24,627
North Carolina,Siler City,8193,1702,1710,1019,304,277,5012
North Carolina,Shelby,20245,2029,4725,4077,1621,1179,13631
North Carolina,Sharpsburg,2228,220,426,601,72,22,1341
North Carolina,Shannon,345,113,17,59,0,10,199
North Carolina,Scotland Neck,1613,481,470,170,69,27,1217
North Carolina,Shallotte,3816,421,852,1053,299,202,2827
North Carolina,Seven Springs,76,14,10,22,10,1,57
North Carolina,Seven Lakes,4806,44,783,998,1090,480,3395
North Carolina,Seven Devils,240,2,35,44,88,45,214
North Carolina,Selma,6220,1554,909,731,239,90,3523
North Carolina,Sedalia,563,78,156,152,40,30,456
North Carolina,Seagrove,308,77,70,54,12,5,218
North Carolina,Sea Breeze,1971,108,421,446,389,166,1530
North Carolina,Severn,233,51,62,61,2,7,183
North Carolina,Apex,42220,1009,2503,6701,10312,5664,26189
North Carolina,Rural Hall,3046,328,870,789,224,82,2293
North Carolina,Tyro,3525,469,798,726,323,128,2444
North Carolina,Prospect,921,179,193,218,60,26,676
North Carolina,Proctorville,176,25,38,49,3,19,134
North Carolina,Princeville,2188,285,515,531,82,12,1425
North Carolina,Princeton,1310,118,248,341,55,20,782
North Carolina,Powellsville,279,61,94,39,4,1,199
North Carolina,Potters Hill,523,70,92,105,15,0,282
North Carolina,Porters Neck,6500,136,595,1255,1749,1107,4842
North Carolina,Pumpkin Center,1869,85,498,673,87,32,1375
North Carolina,Pollocksville,463,26,76,158,27,13,300
North Carolina,Polkton,3372,668,1036,650,39,16,2409
North Carolina,Plymouth,3736,389,1019,812,166,133,2519
North Carolina,Pleasant Hill,621,189,135,95,46,27,492
North Carolina,Pleasant Garden,4632,276,1291,1125,478,188,3358
North Carolina,Plain View,2450,241,781,435,119,80,1656
North Carolina,Pittsboro,3992,461,602,643,620,536,2862
North Carolina,Pinnacle,690,115,222,67,71,15,490
North Carolina,Polkville,496,75,129,117,34,8,363
North Carolina,Ruffin,286,23,72,48,47,9,199
North Carolina,Raeford,4830,671,535,981,440,143,2770
North Carolina,Raleigh,432520,26292,45089,72133,87563,45845,276922
North Carolina,Unionville,6295,275,1716,1401,557,242,4191
North Carolina,Valdese,4471,590,922,1047,464,393,3416
North Carolina,Rich Square,927,188,279,172,54,22,715
North Carolina,Richlands,2394,106,423,559,219,30,1337
North Carolina,Richfield,653,88,142,134,31,13,408
North Carolina,Rhodhiss,846,162,233,173,10,20,598
North Carolina,Rex,65,0,43,0,22,0,65
North Carolina,Raemon,135,32,29,15,0,0,76
North Carolina,Rennert,369,65,77,54,26,10,232
North Carolina,Red Springs,3451,479,688,457,250,121,1995
North Carolina,Red Oak,3428,246,593,983,525,129,2476
North Carolina,Red Cross,706,111,209,177,43,15,555
North Carolina,Raynham,59,6,11,15,1,2,35
North Carolina,Ranlo,3496,493,563,825,354,144,2379
North Carolina,Randleman,4136,771,1065,774,176,50,2836
North Carolina,Ramseur,1926,358,407,354,95,18,1232
North Carolina,Reidsville,14191,1288,3814,3478,1091,597,10268
North Carolina,Zebulon,4690,428,861,770,251,322,2632
North Carolina,Albemarle,15969,2157,3523,3185,1452,583,10900
North Carolina,Yanceyville,2080,506,519,413,44,59,1541
North Carolina,Wilson's Mills,2662,388,513,496,128,14,1539
North Carolina,Windsor,3652,840,874,733,197,174,2818
North Carolina,Winfall,624,83,135,152,41,18,429
North Carolina,Wingate,3742,237,513,422,316,125,1613
North Carolina,Winston-Salem,236642,22431,36246,41485,30468,19652,150282
North Carolina,Winterville,9464,336,1419,2188,1541,777,6261
North Carolina,Wilson,49478,6465,9356,9406,5014,2326,32567
North Carolina,Winton,842,138,180,182,34,11,545
North Carolina,Woodland,867,214,263,77,13,22,589
North Carolina,Aquadale,298,40,57,128,12,0,237
North Carolina,Arapahoe,498,49,175,148,36,6,414
North Carolina,Archdale,11396,1472,2541,2501,915,464,7893
North Carolina,Archer Lodge,4521,383,854,985,499,58,2779
North Carolina,Asheboro,25897,3792,5393,4813,1837,844,16679
North Carolina,Woodfin,6204,537,1346,1336,717,390,4326
North Carolina,Skippers Corner,2883,354,393,568,450,201,1966
North Carolina,Wilmington,111998,7031,14594,22253,18810,9674,72362
North Carolina,Wilkesboro,3548,568,437,840,314,202,2361
North Carolina,Wendell,6169,452,970,1096,819,488,3825
North Carolina,Wentworth,2762,313,641,563,245,108,1870
North Carolina,Wesley Chapel,8010,232,941,1291,1686,622,4772
North Carolina,West Canton,1346,149,306,348,83,25,911
North Carolina,West Jefferson,1232,231,215,295,122,55,918
North Carolina,West Marion,1413,104,381,397,69,15,966
North Carolina,Williamston,5569,573,1538,1228,356,158,3853
North Carolina,Westport,3708,53,486,829,926,403,2697
North Carolina,Whitakers,898,137,231,211,15,17,611
North Carolina,White Lake,1248,47,244,293,178,141,903
North Carolina,Youngsville,1394,115,261,351,129,55,911
North Carolina,White Plains,1075,152,283,299,99,77,910
North Carolina,Whiteville,5512,766,1031,1360,382,279,3818
North Carolina,Whitsett,756,64,168,191,157,13,593
North Carolina,Whispering Pines,3067,44,392,787,587,323,2133
North Carolina,Smithfield,11562,1639,2719,2359,1124,496,8337
North Carolina,Sneads Ferry,3714,213,351,1033,286,92,1975
North Carolina,Snow Hill,1847,311,358,446,154,51,1320
North Carolina,Autryville,426,83,51,74,15,8,231
North Carolina,Avery Creek,2493,71,320,613,382,379,1765
North Carolina,Avon,926,153,206,214,131,18,722
North Carolina,Ayden,5035,515,837,1354,289,134,3129
North Carolina,Badin,1895,326,530,443,174,27,1500
North Carolina,Spencer Mountain,21,9,2,0,0,0,11
North Carolina,Aurora,505,80,157,112,32,13,394
North Carolina,Topsail Beach,356,14,32,77,104,86,313
North Carolina,Trent Woods,4212,58,371,1052,1106,613,3200
North Carolina,Trinity,6652,723,1551,1612,541,156,4583
North Carolina,Troutman,2476,176,480,580,247,91,1574
North Carolina,Troy,3446,449,564,886,308,123,2330
North Carolina,Tryon,1624,105,226,386,376,195,1288
North Carolina,Turkey,280,43,80,50,8,0,181
North Carolina,Trenton,363,45,69,52,32,10,208
North Carolina,Aulander,785,113,187,141,18,23,482
North Carolina,Atlantic Beach,1596,94,270,424,268,207,1263
North Carolina,Atlantic,417,45,133,113,22,21,334
North Carolina,Southern Pines,13018,882,1892,3070,2195,2004,10043
North Carolina,Southern Shores,2789,63,335,699,729,430,2256
North Carolina,South Henderson,735,184,154,123,10,0,471
North Carolina,South Mills,196,17,0,170,9,0,196
North Carolina,Southmont,1422,274,229,353,128,9,993
North Carolina,Southport,3154,296,600,718,603,241,2458
North Carolina,South Rosemary,2736,393,825,511,44,92,1865
North Carolina,South Weldon,696,168,68,179,12,9,436
North Carolina,Sparta,1802,365,448,366,68,60,1307
North Carolina,Speed,95,33,28,15,0,1,77
North Carolina,Spencer,3276,458,705,712,312,107,2294
North Carolina,Asheville,86789,4745,11503,16721,17909,10662,61540
North Carolina,Ashley Heights,394,39,121,49,0,0,209
North Carolina,Askewville,231,34,103,47,4,8,196
North Carolina,Atkinson,378,34,118,97,16,17,282
North Carolina,Weldon,1623,188,382,342,146,102,1160
North Carolina,Welcome,4743,615,1104,1051,521,86,3377
North Carolina,White Oak,309,51,104,46,5,7,213
North Carolina,Webster,409,11,31,103,51,83,279
North Carolina,Roper,445,104,96,38,12,2,252
North Carolina,Roseboro,1655,149,250,503,92,71,1065
North Carolina,Weddington,10091,98,790,1746,2996,1056,6686
North Carolina,Rosman,721,123,149,85,50,19,426
North Carolina,Rougemont,838,0,126,226,258,71,681
North Carolina,Rowland,1227,192,298,236,56,55,837
North Carolina,Ronda,461,126,111,81,12,4,334
North Carolina,Roxboro,8316,1615,1887,1521,444,88,5555
North Carolina,Royal Pines,5084,73,514,1020,1104,701,3412
North Carolina,Valle Crucis,226,8,17,46,65,34,170
North Carolina,Valley Hill,2269,333,498,729,200,150,1910
North Carolina,Vanceboro,1199,91,266,260,51,19,687
North Carolina,Vandemere,271,47,89,74,9,4,223
North Carolina,Vander,1097,113,293,341,38,93,878
North Carolina,Roxobel,290,57,111,51,9,1,229
North Carolina,Rolesville,5006,171,619,1189,880,420,3279
North Carolina,Rodanthe,270,66,0,84,70,0,220
North Carolina,Rocky Point,1967,298,403,439,70,33,1243
North Carolina,Yadkinville,2946,568,694,475,207,58,2002
North Carolina,Wrightsville Beach,2540,17,136,411,760,329,1653
North Carolina,Wrightsboro,5525,385,1570,1319,494,111,3879
North Carolina,Woodlawn,726,47,136,172,109,48,512
North Carolina,Riegelwood,390,111,102,77,0,0,290
North Carolina,River Bend,3161,91,613,996,600,283,2583
North Carolina,River Road,4124,629,644,1267,607,192,3339
North Carolina,Roanoke Rapids,15557,2057,2825,3212,1325,665,10084
North Carolina,Robbins,1201,199,254,143,61,27,684
North Carolina,Robbinsville,575,146,122,141,24,0,433
North Carolina,Robersonville,1501,316,375,290,85,42,1108
North Carolina,Rockfish,3810,73,609,1050,414,189,2335
North Carolina,Rockingham,9376,1031,1863,2014,654,424,5986
North Carolina,Rockwell,1932,162,421,500,176,94,1353
North Carolina,Rocky Mount,56642,6423,12346,11226,5060,2327,37382
North Carolina,Vann Crossroads,406,109,10,58,62,0,239
North Carolina,Varnamtown,576,66,106,156,61,17,406
North Carolina,Rose Hill,1844,327,342,430,76,41,1216
North Carolina,Waco,322,68,91,50,13,9,231
North Carolina,Vass,637,103,104,151,49,13,420
North Carolina,Washington,9777,1148,2010,2014,724,652,6548
North Carolina,Washington Park,563,14,45,106,138,96,399
North Carolina,Watha,216,47,44,57,4,0,152
North Carolina,Waves,65,0,0,23,42,0,65
North Carolina,Waxhaw,11586,251,1151,1784,2810,1005,7001
North Carolina,Waynesville,9748,1309,2043,2435,1103,841,7731
North Carolina,Weaverville,3834,85,551,835,678,657,2806
North Carolina,Warrenton,932,89,200,234,88,45,656
North Carolina,Wanchese,1475,121,379,470,92,20,1082
North Carolina,Warsaw,3168,587,576,641,75,6,1885
North Carolina,Walnut Creek,870,9,65,133,259,205,671
North Carolina,Walnut Cove,1751,237,393,389,142,35,1196
North Carolina,Wallburg,3067,281,772,683,289,118,2143
North Carolina,Wallace,3962,854,1286,729,235,97,3201
North Carolina,Walkertown,4839,522,1353,1042,462,125,3504
North Carolina,Wakulla,200,0,0,106,14,0,120
North Carolina,Wake Forest,34786,1057,3517,5765,7514,4056,21909
North Carolina,Wagram,897,126,226,194,60,24,630
North Carolina,Wadesboro,5664,761,1301,1127,329,236,3754
North Carolina,Wade,562,70,97,135,31,29,362
North Carolina,Walstonburg,317,26,88,70,35,5,224
North Dakota,New Town,2306,118,380,527,216,63,1304
North Dakota,Niagara,61,9,16,11,6,0,42
North Dakota,Nome,62,1,18,17,1,1,38
North Dakota,Noonan,188,7,55,36,8,0,106
North Dakota,New Salem,831,68,219,201,97,38,623
North Dakota,Lakota,588,56,121,162,96,13,448
North Dakota,Northwood,740,52,202,165,86,32,537
North Dakota,Oakes,1975,191,420,403,259,73,1346
North Dakota,New Rockford,1428,149,310,337,178,41,1015
North Dakota,Oberon,173,14,38,23,5,2,82
North Dakota,Oriska,80,8,12,25,2,1,48
North Dakota,Orrin,0,0,0,0,0,0,0
North Dakota,Osnabrock,114,17,41,46,2,0,106
North Dakota,North River,59,2,7,14,13,5,41
North Dakota,New Leipzig,248,19,74,76,36,8,213
North Dakota,Munich,249,16,62,64,25,3,170
North Dakota,Newburg,134,5,39,41,6,1,92
North Dakota,Jud,62,1,27,13,5,0,46
North Dakota,Karlsruhe,84,9,32,14,4,1,60
North Dakota,Kathryn,72,12,25,27,3,0,67
North Dakota,LaMoure,931,72,197,216,101,18,604
North Dakota,Landa,54,19,18,5,0,0,42
North Dakota,Kenmare,975,79,318,188,111,21,717
North Dakota,Kensal,201,17,72,40,5,3,137
North Dakota,Kief,9,0,9,0,0,0,9
North Dakota,Killdeer,851,68,195,164,100,38,565
North Dakota,New England,579,63,189,151,40,12,455
North Dakota,Kindred,709,43,90,170,122,19,444
North Dakota,Kramer,40,7,9,13,3,0,32
North Dakota,Kulm,333,38,62,73,51,22,246
North Dakota,Mooreton,231,11,36,77,21,9,154
North Dakota,Mott,760,61,201,181,69,30,542
North Dakota,Mylo,10,0,6,3,1,0,10
North Dakota,Napoleon,767,143,213,171,60,5,592
North Dakota,Nash,6,0,6,0,0,0,6
North Dakota,Neche,361,30,104,61,33,6,234
North Dakota,Nekoma,34,0,11,6,9,0,26
North Dakota,Knox,34,3,27,4,0,0,34
North Dakota,Langdon,1833,180,328,599,180,41,1328
North Dakota,Mountain,85,15,31,9,11,6,72
North Dakota,Lansford,358,11,63,81,24,11,190
North Dakota,McVille,321,14,85,127,28,10,264
North Dakota,McLeod,14,0,8,6,0,0,14
North Dakota,McHenry,111,11,13,38,6,2,70
North Dakota,McClusky,302,43,104,64,22,10,243
North Dakota,Luverne,56,4,46,6,0,0,56
North Dakota,Ludden,36,4,19,2,2,0,27
North Dakota,Loraine,3,0,0,2,0,0,2
North Dakota,Loma,10,0,3,1,1,0,5
North Dakota,Wishek,947,208,227,207,103,37,782
North Dakota,Wing,127,22,26,29,27,2,106
North Dakota,Wimbledon,274,7,74,62,37,17,197
North Dakota,Wilton,921,46,206,243,85,17,597
North Dakota,Willow City,178,12,52,49,10,5,128
North Dakota,Williston,22051,1318,3966,5822,2222,895,14223
North Dakota,Wildrose,87,9,25,23,9,0,66
North Dakota,White Shield,384,14,42,102,8,4,170
North Dakota,White Earth,149,0,24,22,15,0,61
North Dakota,Wheatland,57,0,29,21,7,0,57
North Dakota,Westhope,450,38,122,108,37,15,320
North Dakota,West Fargo,29892,842,3844,7920,4865,1871,19342
North Dakota,Watford City,3728,191,683,906,459,97,2336
North Dakota,Washburn,1421,18,346,438,153,53,1008
North Dakota,Warwick,44,7,10,9,4,2,32
North Dakota,Walhalla,1084,140,339,151,74,15,719
North Dakota,Wales,37,2,15,8,1,0,26
North Dakota,Walcott,223,11,55,57,31,3,157
North Dakota,Wahpeton,7835,408,1137,2036,717,313,4611
North Dakota,Maddock,372,12,109,89,30,5,245
North Dakota,Makoti,165,8,22,39,23,2,94
North Dakota,Mandan,19962,1124,3922,4874,2918,895,13733
North Dakota,Mandaree,806,55,91,150,19,11,326
North Dakota,Erie,149,25,26,21,18,0,90
North Dakota,Esmond,81,17,30,25,2,2,76
North Dakota,Fairdale,32,3,10,8,2,1,24
North Dakota,Fairmount,363,20,84,92,31,4,231
North Dakota,Montpelier,98,7,23,27,8,0,65
North Dakota,Monango,54,2,1,8,12,0,23
North Dakota,Mohall,703,32,158,210,61,11,472
North Dakota,Minto,573,57,164,122,35,7,385
North Dakota,Minot AFB,5890,64,330,1018,310,153,1875
North Dakota,Minot,46194,2019,8297,10781,5630,2106,28833
North Dakota,Minnewaukan,226,18,46,44,49,18,175
North Dakota,Milton,60,5,31,16,2,0,54
North Dakota,Milnor,591,37,113,168,82,17,417
North Dakota,Voltaire,45,2,10,18,3,0,33
North Dakota,Michigan City,203,10,49,91,23,2,175
North Dakota,Menoken,82,5,29,19,11,0,64
North Dakota,Medora,184,8,42,44,43,6,143
North Dakota,Medina,297,27,76,63,19,8,193
North Dakota,Mayville,1787,76,280,347,253,111,1067
North Dakota,Maxbass,94,10,15,15,4,2,46
North Dakota,Max,327,19,83,77,36,0,215
North Dakota,Martin,96,5,35,24,5,2,71
North Dakota,Marmarth,154,33,52,12,6,0,103
North Dakota,Marion,139,18,27,32,33,1,111
North Dakota,Mapleton,798,30,104,248,95,13,490
North Dakota,Manvel,405,20,55,126,44,11,256
North Dakota,Mantador,82,2,22,18,1,0,43
North Dakota,Manning,22,0,12,5,5,0,22
North Dakota,Mercer,57,8,14,13,5,2,42
North Dakota,Lankin,129,6,31,37,11,0,85
North Dakota,Verona,77,12,29,16,4,1,62
North Dakota,Velva,1132,88,287,220,97,43,735
North Dakota,Sheldon,80,4,39,19,6,0,68
North Dakota,Sharon,83,15,34,13,9,0,71
North Dakota,Sentinel Butte,90,1,18,33,9,2,63
North Dakota,Selz,7,7,0,0,0,0,7
North Dakota,Selfridge,216,13,45,32,18,9,117
North Dakota,Scranton,317,9,74,107,21,9,220
North Dakota,Sawyer,336,27,91,73,46,2,239
North Dakota,Sarles,17,1,4,6,4,0,15
North Dakota,Sanborn,149,9,62,30,15,0,116
North Dakota,St. Thomas,310,37,89,83,29,10,248
North Dakota,St. John,291,33,52,53,34,8,180
North Dakota,Logan,204,0,63,45,22,0,130
North Dakota,Litchville,152,26,42,37,11,7,123
North Dakota,Lisbon,2081,149,527,486,221,54,1437
North Dakota,Linton,1042,170,277,232,79,26,784
North Dakota,Lincoln,3093,89,648,789,424,88,2038
North Dakota,Lignite,91,6,31,23,14,6,80
North Dakota,Lidgerwood,706,100,181,158,53,10,502
North Dakota,Leonard,317,20,84,70,39,10,223
North Dakota,Leith,22,0,5,4,2,2,13
North Dakota,Lehr,76,26,31,18,1,0,76
North Dakota,Leeds,505,26,82,128,55,17,308
North Dakota,Leal,19,0,9,6,1,1,17
North Dakota,Lawton,20,6,3,9,1,1,20
North Dakota,Overly,23,0,7,7,0,0,14
North Dakota,Larson,6,4,0,2,0,0,6
North Dakota,Larimore,1513,110,331,366,108,46,961
North Dakota,Shell Valley,1396,65,148,263,140,35,651
North Dakota,Sherwood,226,17,58,56,34,4,169
North Dakota,Sheyenne,192,10,47,62,21,6,146
North Dakota,Sibley,33,2,5,7,0,0,14
North Dakota,Valley City,6626,455,1435,1522,893,359,4664
North Dakota,Upham,225,20,72,51,14,0,157
North Dakota,Underwood,791,97,227,199,60,26,609
North Dakota,Tuttle,89,10,27,26,15,2,80
North Dakota,Turtle Lake,476,43,160,100,30,34,367
North Dakota,Towner,493,42,128,136,48,29,383
North Dakota,Tower City,288,11,64,91,33,2,201
North Dakota,Tolna,170,3,55,56,20,4,138
North Dakota,Tolley,29,3,14,10,0,0,27
North Dakota,Tioga,1072,119,271,340,73,21,824
North Dakota,Thompson,1067,44,175,266,164,48,697
North Dakota,Taylor,221,6,55,59,33,1,154
North Dakota,Tappen,265,33,60,45,27,2,167
North Dakota,Venturia,35,11,13,0,0,0,24
North Dakota,Sykeston,116,13,30,25,9,10,87
North Dakota,Surrey,1054,67,294,263,114,15,753
North Dakota,Streeter,83,18,22,18,8,3,69
North Dakota,Strasburg,439,93,97,97,29,2,318
North Dakota,Steele,781,36,175,142,129,46,528
North Dakota,Starkweather,123,3,19,34,17,4,77
North Dakota,Stanton,380,28,117,104,32,5,286
North Dakota,Stanley,2118,61,397,599,228,93,1378
North Dakota,Springbrook,10,0,2,5,1,0,8
North Dakota,Spiritwood Lake,106,3,23,22,35,7,90
North Dakota,Spiritwood,7,3,0,4,0,0,7
North Dakota,South Heart,295,20,58,46,50,13,187
North Dakota,Souris,68,9,11,21,1,0,42
North Dakota,Solen,75,3,20,18,4,4,49
North Dakota,Sutton,9,6,3,0,0,0,9
North Dakota,Oxbow,411,2,18,66,115,30,231
North Dakota,Conway,9,2,2,2,0,0,6
North Dakota,Palermo,130,19,48,17,16,0,100
North Dakota,Balta,150,6,53,10,0,0,69
North Dakota,Balfour,9,1,7,0,1,0,9
North Dakota,Ayr,20,1,6,5,0,0,12
North Dakota,Auburn,24,0,13,6,0,0,19
North Dakota,Ashley,771,151,172,174,99,30,626
North Dakota,Arthur,385,23,47,101,72,23,266
North Dakota,Arnegard,88,6,25,10,4,0,45
North Dakota,Argusville,449,9,47,82,87,29,254
North Dakota,Ardoch,98,38,15,0,0,0,53
North Dakota,Antler,10,2,3,0,2,3,10
North Dakota,Aneta,263,27,92,60,24,2,205
North Dakota,Anamoose,286,23,74,81,22,20,220
North Dakota,Bantry,18,3,2,7,1,0,13
North Dakota,Amidon,32,2,5,2,6,17,32
North Dakota,Ambrose,19,2,3,10,4,0,19
North Dakota,Alsen,63,0,7,19,8,0,34
North Dakota,Almont,132,6,46,22,1,1,76
North Dakota,Alice,33,5,8,13,0,0,26
North Dakota,Alexander,225,25,53,56,18,1,153
North Dakota,Alamo,72,7,11,21,7,5,51
North Dakota,Adams,142,16,31,34,23,2,106
North Dakota,Abercrombie,251,8,42,85,32,0,167
North Dakota,Forman,560,31,124,157,51,2,365
North Dakota,Fort Ransom,107,4,35,34,12,10,95
North Dakota,Fort Totten,1284,117,176,179,20,9,501
North Dakota,Fortuna,47,8,2,7,9,0,26
North Dakota,Amenia,83,8,23,20,12,0,63
North Dakota,Fort Yates,212,11,40,47,23,2,123
North Dakota,Barney,55,1,12,19,5,2,39
North Dakota,Bathgate,52,1,7,12,11,5,36
North Dakota,Butte,51,9,15,11,1,4,40
North Dakota,Burlington,1234,40,308,273,149,25,795
North Dakota,Buffalo,173,3,43,76,12,1,135
North Dakota,Bucyrus,19,4,6,8,0,0,18
North Dakota,Buchanan,43,4,13,14,3,0,34
North Dakota,Brooktree Park,18,0,8,10,0,0,18
North Dakota,Brocket,89,2,24,13,15,1,55
North Dakota,Brinsmade,81,1,15,19,1,0,36
North Dakota,Briarwood,67,0,6,11,12,9,38
North Dakota,Braddock,8,0,5,1,2,0,8
North Dakota,Bowman,1677,142,389,337,214,70,1152
North Dakota,Bowdon,123,15,43,28,12,1,99
North Dakota,Barton,10,0,5,5,0,0,10
North Dakota,Bowbells,402,45,73,97,24,10,249
North Dakota,Blanchard,11,6,0,5,0,0,11
North Dakota,Bismarck,66980,3296,11253,15457,10611,4999,45616
North Dakota,Bisbee,159,5,52,46,3,5,111
North Dakota,Binford,157,22,48,29,18,1,118
North Dakota,Beulah,3286,247,593,1000,332,124,2296
North Dakota,Berthold,372,14,63,108,40,15,240
North Dakota,Berlin,31,2,14,5,0,0,21
North Dakota,Bergen,12,2,9,0,0,0,11
North Dakota,Benedict,71,13,15,13,5,0,46
North Dakota,Belfield,969,108,227,198,51,4,588
North Dakota,Belcourt,1904,241,123,444,270,0,1078
North Dakota,Beach,955,60,173,312,117,40,702
North Dakota,Bottineau,2273,148,465,609,236,70,1528
North Dakota,Four Bears Village,702,22,94,156,28,26,326
North Dakota,Foxholm,58,0,21,5,11,0,37
North Dakota,Fredonia,46,5,22,9,1,0,37
North Dakota,Hampden,36,3,14,13,0,0,30
North Dakota,Hankinson,997,94,299,256,55,25,729
North Dakota,Hannaford,106,14,46,34,10,0,104
North Dakota,Hannah,10,0,6,1,0,0,7
North Dakota,Hansboro,15,1,1,2,7,0,11
North Dakota,Harmon,212,0,9,57,42,23,131
North Dakota,Harvey,1920,295,385,426,168,64,1338
North Dakota,Harwood,869,12,115,286,134,26,573
North Dakota,Hatton,653,78,155,201,60,19,513
North Dakota,Havana,69,11,19,26,10,0,66
North Dakota,Haynes,12,2,4,1,0,0,7
North Dakota,Hazelton,223,19,61,31,38,3,152
North Dakota,Hamilton,61,0,22,28,0,2,52
North Dakota,Hazen,2578,148,516,702,354,103,1823
North Dakota,Heil,17,4,7,3,3,0,17
North Dakota,Heimdal,5,0,5,0,0,0,5
North Dakota,Hettinger,1233,24,307,332,155,66,884
North Dakota,Hillsboro,1673,130,293,433,192,80,1128
North Dakota,Hoople,301,60,29,55,37,16,197
North Dakota,Hope,372,16,98,99,53,4,270
North Dakota,Horace,2523,73,348,552,549,129,1651
North Dakota,Hunter,353,8,62,123,32,3,228
North Dakota,Hurdsfield,58,10,21,10,7,0,48
North Dakota,Inkster,30,4,15,3,2,0,24
North Dakota,Jamestown,15418,1178,3762,3056,2027,462,10485
North Dakota,Jessie,35,11,5,12,0,0,28
North Dakota,Hebron,831,94,164,161,107,28,554
North Dakota,Hamberg,16,8,6,0,2,0,16
North Dakota,Halliday,305,17,64,65,29,11,186
North Dakota,Hague,57,10,14,20,4,0,48
North Dakota,Frontier,219,4,37,64,41,16,162
North Dakota,Fullerton,64,3,25,20,4,3,55
North Dakota,Gackle,371,47,113,90,10,9,269
North Dakota,Galesburg,131,11,33,32,12,7,95
North Dakota,Gardena,11,0,7,3,0,0,10
North Dakota,Gardner,88,0,23,16,8,0,47
North Dakota,Garrison,1377,131,445,298,158,21,1053
North Dakota,Gascoyne,11,0,2,6,2,0,10
North Dakota,Gilby,215,17,43,66,18,4,148
North Dakota,Gladstone,366,16,112,76,10,6,220
North Dakota,Glenburn,529,11,84,163,25,11,294
North Dakota,Glenfield,99,7,12,32,11,5,67
North Dakota,Glen Ullin,716,94,241,146,56,17,554
North Dakota,Golden Valley,277,26,79,77,15,0,197
North Dakota,Golva,103,12,20,37,5,0,74
North Dakota,Goodrich,149,20,43,33,11,3,110
North Dakota,Grace City,58,2,16,22,1,0,41
North Dakota,Grafton,4282,432,1230,856,306,94,2918
North Dakota,Grand Forks,54944,2185,7319,10576,6901,3931,30912
North Dakota,Grand Forks AFB,2663,7,186,450,133,142,918
North Dakota,Grandin,211,5,70,53,20,0,148
North Dakota,Grano,3,0,1,0,0,2,3
North Dakota,Granville,279,16,71,70,37,0,194
North Dakota,Great Bend,69,4,21,26,4,2,57
North Dakota,Green Acres,784,61,76,175,0,0,312
North Dakota,Grenora,236,11,49,56,15,9,140
North Dakota,Gwinner,862,45,205,222,103,24,599
North Dakota,Buxton,346,9,72,95,43,13,232
North Dakota,Page,283,11,48,51,22,0,132
North Dakota,Caledonia,20,0,0,20,0,0,20
North Dakota,Calvin,8,0,1,4,1,0,6
North Dakota,Rolette,679,62,79,126,96,25,388
North Dakota,Rolla,1316,130,235,298,146,22,831
North Dakota,Ross,88,6,10,31,5,0,52
North Dakota,Rugby,3112,331,677,859,329,52,2248
North Dakota,Ruso,8,1,1,0,0,0,2
North Dakota,Ruthville,220,0,24,48,15,0,87
North Dakota,Rutland,181,12,50,54,18,3,137
North Dakota,Ryder,122,9,28,26,5,0,68
North Dakota,Zeeland,100,5,32,26,8,0,71
North Dakota,Zap,209,26,79,40,7,4,156
North Dakota,Ypsilanti,80,7,9,28,16,0,60
North Dakota,York,43,0,12,28,0,0,40
North Dakota,Rogers,46,3,3,17,2,0,25
North Dakota,Wyndmere,479,30,130,106,57,10,333
North Dakota,Wolford,26,1,15,1,2,0,19
North Dakota,Fargo,113464,3687,13960,24884,17840,8235,68606
North Dakota,Fessenden,464,20,132,101,77,12,342
North Dakota,Fingal,94,0,25,31,4,0,60
North Dakota,Finley,421,38,114,123,44,3,322
North Dakota,Flasher,308,24,54,84,23,13,198
North Dakota,Flaxton,59,6,15,14,0,5,40
North Dakota,Forbes,33,1,6,17,1,0,25
North Dakota,Fordville,247,15,63,59,18,6,161
North Dakota,Enderlin,950,85,264,279,77,15,720
North Dakota,Emerado,360,29,87,109,27,3,255
North Dakota,Embden,67,11,14,11,8,0,44
North Dakota,Woodworth,28,11,9,2,1,1,24
North Dakota,Elliott,15,4,4,6,1,0,15
North Dakota,Rocklake,138,12,22,43,17,0,94
North Dakota,Riverdale,212,5,53,77,41,13,189
North Dakota,Park River,1480,132,309,448,149,48,1086
North Dakota,Parshall,1071,97,147,264,114,23,645
North Dakota,Pekin,78,6,15,23,9,0,53
North Dakota,Pembina,570,14,190,150,43,10,407
North Dakota,Perth,7,0,4,0,2,0,6
North Dakota,Petersburg,196,8,37,79,11,4,139
North Dakota,Pettibone,63,18,13,10,3,0,44
North Dakota,Pick City,125,17,49,21,19,0,106
North Dakota,Pillsbury,18,8,8,2,0,0,18
North Dakota,Pingree,58,1,21,10,6,2,40
North Dakota,Pisek,112,24,34,20,1,1,80
North Dakota,Plaza,239,9,51,63,17,6,146
North Dakota,Robinson,33,3,8,9,4,0,24
North Dakota,Porcupine,222,0,34,28,19,2,83
North Dakota,Portland,583,51,81,146,93,31,402
North Dakota,Powers Lake,426,25,78,77,33,21,234
North Dakota,Prairie Rose,87,0,9,21,22,4,56
North Dakota,Raleigh,3,0,0,1,2,0,3
North Dakota,Ray,527,22,107,156,44,27,356
North Dakota,Reeder,159,12,46,48,14,8,128
North Dakota,Regan,57,8,6,19,3,1,37
North Dakota,Regent,205,8,45,59,14,5,131
North Dakota,Reile's Acres,511,2,34,106,105,46,293
North Dakota,Reynolds,302,10,67,103,29,4,213
North Dakota,Rhame,176,15,44,49,8,6,122
North Dakota,Richardton,662,61,145,167,78,19,470
North Dakota,Portal,114,10,30,21,15,0,76
North Dakota,Calio,6,0,3,2,1,0,6
North Dakota,Ellendale,1466,133,215,238,236,62,884
North Dakota,Egeland,25,0,5,18,2,0,25
North Dakota,Courtenay,47,1,9,7,9,3,29
North Dakota,Elgin,600,80,173,152,56,28,489
North Dakota,Epping,97,22,19,27,4,0,72
North Dakota,Columbus,219,35,17,62,9,3,126
North Dakota,Colfax,121,2,5,42,23,5,77
North Dakota,Coleharbor,63,5,21,31,1,0,58
North Dakota,Cogswell,78,19,36,18,3,0,76
North Dakota,Clifford,19,0,2,15,1,0,18
North Dakota,Cleveland,113,5,19,31,3,2,60
North Dakota,Churchs Ferry,5,0,3,2,0,0,5
North Dakota,Christine,140,5,45,32,26,4,112
North Dakota,Center,605,67,164,151,58,1,441
North Dakota,Cayuga,43,1,21,10,4,0,36
North Dakota,Cavalier,1230,79,384,303,109,46,921
North Dakota,Cathay,53,7,10,9,6,0,32
North Dakota,Casselton,2466,69,359,606,390,135,1559
North Dakota,Carson,238,21,70,66,26,3,186
North Dakota,Carrington,2011,202,516,509,272,44,1543
North Dakota,Forest River,126,26,17,38,12,0,93
North Dakota,Carpio,140,8,31,39,10,0,88
North Dakota,Canton City,14,3,1,7,3,0,14
North Dakota,Cannon Ball,908,89,165,135,38,9,436
North Dakota,Cando,1089,73,261,308,129,37,808
North Dakota,Crary,158,15,40,35,15,5,110
North Dakota,Crosby,1064,125,361,280,128,21,915
North Dakota,Cooperstown,1091,96,284,291,121,10,802
North Dakota,Dahlen,79,0,0,11,13,0,24
North Dakota,Edmore,171,33,28,41,38,3,143
North Dakota,Edinburg,170,12,49,49,32,8,150
North Dakota,Edgeley,590,63,129,161,74,13,440
North Dakota,East Fairview,56,1,8,16,5,3,33
North Dakota,East Dunseith,587,60,69,125,14,5,273
North Dakota,Dwight,81,8,17,32,0,1,58
North Dakota,Dunseith,822,98,97,156,58,21,430
North Dakota,Dunn Center,235,28,65,54,13,6,166
North Dakota,Crystal,142,12,37,40,13,1,103
North Dakota,Drayton,714,76,177,192,84,16,545
North Dakota,Drake,361,66,94,72,18,3,253
North Dakota,Douglas,53,3,20,14,3,0,40
North Dakota,Driscoll,74,4,23,21,2,0,50
North Dakota,Dodge,133,24,32,16,5,2,79
North Dakota,Davenport,244,13,56,75,26,4,174
North Dakota,Dawson,74,3,45,2,3,0,53
North Dakota,Dazey,118,6,42,21,9,0,78
North Dakota,Deering,122,1,34,17,21,3,76
North Dakota,De Lamere,30,0,11,6,3,3,23
North Dakota,Donnybrook,85,18,26,11,7,0,62
North Dakota,Englevale,130,0,35,10,0,0,45
North Dakota,Denhoff,14,0,4,6,3,0,13
North Dakota,Des Lacs,228,7,68,43,39,16,173
North Dakota,Devils Lake,7275,591,1701,1623,749,220,4884
North Dakota,Dickey,32,3,12,5,5,2,27
North Dakota,Dickinson,21097,1393,4057,4915,2460,973,13798
Ohio,Englewood,13456,640,2631,3616,1825,962,9674
Ohio,Elyria,54050,4589,12763,13032,3583,2006,35973
Ohio,Etna,1113,77,265,206,85,17,650
Ohio,Euclid,48105,3766,10994,11993,4323,2297,33373
Ohio,Evendale,2762,101,341,417,654,539,2052
Ohio,Empire,263,14,120,47,11,4,196
Ohio,Enon,2606,192,585,687,297,253,2014
Ohio,Edon,823,67,243,175,46,15,546
Ohio,Elmore,1361,25,323,366,128,68,910
Ohio,Dover,12869,1058,3873,2359,1356,499,9145
Ohio,Donnelsville,467,22,93,96,32,36,279
Ohio,Dola,131,18,47,31,12,0,108
Ohio,Dillonvale,756,38,247,169,53,21,528
Ohio,Dillonvale,3603,203,801,698,626,162,2490
Ohio,Dexter City,128,15,41,8,7,0,71
Ohio,Devola,2708,91,496,642,396,256,1881
Ohio,Deshler,1780,112,628,222,96,44,1102
Ohio,Derby,324,48,167,42,0,0,257
Ohio,Dent,11043,457,2089,2416,2179,794,7935
Ohio,Dennison,2690,248,774,469,123,38,1652
Ohio,Delta,3350,160,856,784,277,126,2203
Ohio,Delshire,2975,171,750,619,266,137,1943
Ohio,Delphos,7261,482,2086,1550,465,330,4913
Ohio,Dellroy,315,20,91,75,12,2,200
Ohio,Delhi Hills,5172,203,1407,1129,640,262,3641
Ohio,Delaware,36794,1439,6949,6861,4587,3090,22926
Ohio,De Graff,1501,119,393,263,66,40,881
Ohio,Defiance,16571,1120,4345,3158,1501,687,10811
Ohio,Deersville,57,2,13,25,3,0,43
Ohio,Deer Park,5701,479,1467,1156,844,390,4336
Ohio,Dayton,141368,15778,26569,30414,9460,5711,87932
Ohio,Day Heights,2366,72,650,517,217,153,1609
Ohio,Darrtown,316,14,85,96,8,32,235
Ohio,Darbyville,221,43,58,31,14,4,150
Ohio,Darbydale,946,136,209,172,66,0,583
Ohio,Danville,1094,129,326,169,67,22,713
Ohio,Doylestown,3064,225,908,606,347,215,2301
Ohio,Elmwood Place,1951,399,451,343,23,19,1235
Ohio,Dresden,1707,109,507,370,100,46,1132
Ohio,Dry Ridge,2534,119,540,569,452,329,2009
Ohio,Elizabethtown,234,84,75,15,0,0,174
Ohio,Elida,1962,42,514,467,158,131,1312
Ohio,Elgin,32,3,18,7,0,0,28
Ohio,Eldorado,633,34,180,122,42,9,387
Ohio,Fairborn,33251,2924,5904,7110,3009,2422,21369
Ohio,Edison,389,36,119,90,11,6,262
Ohio,Edgewood,4418,235,1387,900,260,81,2863
Ohio,Edgerton,2166,168,726,431,119,77,1521
Ohio,Eaton Estates,1032,141,373,169,30,11,724
Ohio,Eaton,8294,712,2335,1835,415,193,5490
Ohio,East Springfield,554,0,123,135,64,0,322
Ohio,East Sparta,956,82,307,214,43,13,659
Ohio,East Rochester,283,19,111,32,16,15,193
Ohio,East Palestine,4634,420,1384,1100,218,68,3190
Ohio,East Liverpool,10999,1367,3279,2135,397,229,7407
Ohio,East Liberty,248,11,164,11,47,0,233
Ohio,Eastlake,18380,1395,5300,4081,1440,895,13111
Ohio,East Fultonham,371,21,172,39,0,13,245
Ohio,East Cleveland,17519,2449,4061,4208,794,533,12045
Ohio,East Canton,1424,68,488,310,62,59,987
Ohio,Dupont,270,27,87,38,14,5,171
Ohio,Dunlap,2040,104,458,367,350,188,1467
Ohio,Dunkirk,969,59,343,148,34,18,602
Ohio,Dundee,516,105,157,68,0,0,330
Ohio,Duncan Falls,1008,32,312,297,30,15,686
Ohio,Dublin,43224,384,2161,4713,12656,8267,28181
Ohio,Dry Run,7887,101,424,851,2177,1295,4848
Ohio,Drexel,1805,208,348,446,18,29,1049
Ohio,Fairfax,1633,90,395,322,229,91,1127
Ohio,Farmersville,923,81,238,252,52,35,658
Ohio,Wayne Lakes,703,38,235,163,41,35,512
Ohio,Adamsville,117,6,37,18,4,0,65
Ohio,Ada,6050,280,673,793,258,334,2338
Ohio,Aberdeen,1487,252,437,306,65,28,1088
Ohio,Hilltop,486,73,164,99,18,7,361
Ohio,Hillsboro,6556,786,1683,1317,549,157,4492
Ohio,Hills and Dales,282,4,19,38,66,62,189
Ohio,Hilliard,31803,719,3942,5451,6479,3905,20496
Ohio,Highpoint,1262,174,222,192,146,159,893
Ohio,Highland Holiday,461,132,152,23,7,19,333
Ohio,Highland Hills,950,199,173,189,52,26,639
Ohio,Highland Heights,8337,227,1316,1103,1655,1512,5813
Ohio,Highland,289,30,57,58,16,4,165
Ohio,Higginsport,278,57,85,48,14,6,210
Ohio,Hide-A-Way Hills,670,0,21,446,170,33,670
Ohio,Hicksville,3252,374,1021,619,142,62,2218
Ohio,Hessville,332,57,91,21,0,0,169
Ohio,Hemlock,186,11,43,39,7,12,112
Ohio,Helena,242,18,64,66,14,5,167
Ohio,Hebron,2395,328,803,393,91,36,1651
Ohio,Heath,10411,973,3023,2052,847,390,7285
Ohio,Hayesville,483,11,207,65,40,20,343
Ohio,Addyston,936,136,372,104,33,11,656
Ohio,Haydenville,134,9,63,39,0,16,127
Ohio,Adelphi,364,61,131,35,9,0,236
Ohio,Akron,198329,17878,46013,40026,17780,8831,130528
Ohio,Aquilla,301,20,88,85,11,3,207
Ohio,Apple Valley,5466,304,1331,1240,841,350,4066
Ohio,Apple Creek,1092,98,324,212,82,27,743
Ohio,Antwerp,1540,125,530,261,109,67,1092
Ohio,Antioch,147,9,41,29,15,2,96
Ohio,Ansonia,1160,131,437,170,28,16,782
Ohio,Anna,1557,38,385,362,103,72,960
Ohio,Andover,1143,152,350,202,94,32,830
Ohio,Andersonville,798,33,229,146,61,62,531
Ohio,Amsterdam,527,89,159,85,31,6,370
Ohio,Amherst,12114,707,2842,3005,1225,758,8537
Ohio,Amesville,109,4,12,23,19,17,75
Ohio,Damascus,385,29,155,70,23,9,286
Ohio,Amelia,5319,404,1091,1349,442,105,3391
Ohio,Amberley,3590,25,304,407,1028,803,2567
Ohio,Amanda,702,48,210,142,34,10,444
Ohio,Alvordton,209,24,54,49,16,12,155
Ohio,Alliance,22137,2143,6142,3563,1379,640,13867
Ohio,Alger,686,155,190,101,13,5,464
Ohio,Alexandria,590,28,168,144,33,39,412
Ohio,Albany,1116,84,359,248,109,53,853
Ohio,Adena,737,60,245,171,45,12,533
Ohio,Arcadia,678,18,230,125,40,29,442
Ohio,Haviland,192,35,59,17,9,2,122
Ohio,Harveysburg,601,29,148,129,39,27,372
Ohio,Green Meadows,2578,140,586,744,221,107,1798
Ohio,Greenhills,3590,208,547,1002,527,317,2601
Ohio,Greenfield,4761,652,1590,643,193,99,3177
Ohio,Green Camp,368,31,132,63,15,13,254
Ohio,Green,25868,1194,5700,5022,4155,2143,18214
Ohio,Graysville,79,5,27,19,2,0,53
Ohio,Gratis,1013,78,334,276,39,12,739
Ohio,Gratiot,381,31,85,82,14,1,213
Ohio,Granville South,1479,28,148,276,336,166,954
Ohio,Granville,5706,13,318,633,590,932,2486
Ohio,Grandview Heights,7014,79,527,948,1968,1569,5091
Ohio,Grandview,1452,24,365,218,156,74,837
Ohio,Grand River,387,35,110,84,29,2,260
Ohio,Grand Rapids,1057,66,247,242,84,60,699
Ohio,Grafton,6090,1131,1718,1779,232,126,4986
Ohio,Goshen,616,75,208,145,35,31,494
Ohio,Gordon,207,6,79,43,7,7,142
Ohio,Good Hope,342,0,138,59,8,10,215
Ohio,Golf Manor,3608,145,749,861,471,144,2370
Ohio,Gnadenhutten,1462,62,422,315,95,53,947
Ohio,Northwood,5316,300,1323,1663,445,127,3858
Ohio,Green Springs,1530,76,490,308,61,22,957
Ohio,Haskins,1302,22,226,330,141,69,788
Ohio,Greentown,4414,143,880,851,839,354,3067
Ohio,Greenwich,1296,119,508,188,41,42,898
Ohio,Hartville,2963,221,734,658,365,191,2169
Ohio,Hartford,320,22,98,63,20,2,205
Ohio,Harrod,440,13,139,111,15,5,283
Ohio,Harrisville,261,88,72,38,4,4,206
Ohio,Harrison,10366,570,2370,2224,1258,405,6827
Ohio,Harrisburg,394,32,137,75,33,5,282
Ohio,Harpster,231,15,90,53,4,2,164
Ohio,Harbor View,128,13,22,30,2,0,67
Ohio,Harbor Hills,1553,143,506,257,194,130,1230
Ohio,Hanoverton,370,43,144,54,10,11,262
Ohio,Hanover,1158,43,265,233,107,30,678
Ohio,Hannibal,346,34,170,28,10,33,275
Ohio,Hanging Rock,196,20,79,49,12,2,162
Ohio,Hamler,745,43,231,108,41,28,451
Ohio,Hamilton,62359,6010,17649,10873,4115,1912,40559
Ohio,Hamersville,611,49,198,94,49,8,398
Ohio,Hamden,945,206,286,139,6,6,643
Ohio,Grover Hill,374,27,114,80,10,2,233
Ohio,Groveport,5604,186,1599,1361,608,244,3998
Ohio,Grove City,37751,1598,8162,8424,5417,2194,25795
Ohio,Groesbeck,7026,638,1573,1351,667,352,4581
Ohio,Greenville,13081,1152,4620,2447,658,369,9246
Ohio,Arcanum,2161,155,602,435,146,74,1412
Ohio,Archbold,4304,320,952,769,437,257,2735
Ohio,Arlington,1471,59,367,297,193,41,957
Ohio,Venedocia,153,9,54,30,0,1,94
Ohio,Vaughnsville,227,0,73,31,36,0,140
Ohio,Midvale,799,82,280,95,19,16,492
Ohio,Vanlue,304,14,80,75,20,10,199
Ohio,Vandalia,15168,898,3247,4118,1501,900,10664
Ohio,Van Buren,391,8,91,82,35,27,243
Ohio,Valleyview,729,53,235,174,40,6,508
Ohio,Valley View,1956,92,471,429,289,141,1422
Ohio,Valley Hi,320,14,98,42,8,0,162
Ohio,Valley City,553,49,126,117,64,80,436
Ohio,Utica,2224,208,625,383,183,27,1426
Ohio,Urbancrest,995,156,241,160,16,25,598
Ohio,Urbana,11618,1212,3480,1842,780,366,7680
Ohio,Upper Sandusky,6790,520,2218,1179,467,283,4667
Ohio,Upper Arlington,34465,305,2164,3901,9173,8266,23809
Ohio,University Heights,13331,381,937,1994,2196,2257,7765
Ohio,Uniopolis,193,13,73,63,4,2,155
Ohio,Unionville Center,268,29,95,25,11,2,162
Ohio,Uniontown,3428,171,781,762,387,194,2295
Ohio,Union City,1717,287,539,223,44,8,1101
Ohio,Union,6430,255,1642,1660,378,358,4293
Ohio,Vermilion,10462,745,3346,2525,760,642,8018
Ohio,Uhrichsville,5410,712,1913,797,128,92,3642
Ohio,Verona,449,22,139,95,12,7,275
Ohio,Vickery,92,0,30,30,13,9,82
Ohio,Wayne,1077,47,357,188,27,9,628
Ohio,Waverly,4323,509,1130,930,378,212,3159
Ohio,Wauseon,7179,645,1925,1256,668,187,4681
Ohio,Waterville,5505,200,920,1244,633,630,3627
Ohio,Waterford,400,18,155,28,40,6,247
Ohio,Washingtonville,847,64,309,165,38,23,599
Ohio,Washington Court House,14057,1523,4455,2257,1084,319,9638
Ohio,Warsaw,679,60,185,138,26,18,427
Ohio,Warrensville Heights,13336,975,2592,3561,1113,601,8842
Ohio,Warren,40705,4281,12597,7192,2395,825,27290
Ohio,Wapakoneta,9776,564,2884,2059,686,333,6526
Ohio,Walton Hills,2288,145,680,562,383,160,1930
Ohio,Walnut Creek,1058,305,231,123,33,17,709
Ohio,Waldo,377,41,123,89,13,5,271
Ohio,Walbridge,3070,143,1073,801,164,66,2247
Ohio,Wakeman,978,71,307,218,63,21,680
Ohio,Waite Hill,460,6,37,62,117,144,366
Ohio,Wadsworth,21777,845,4133,4935,3284,1610,14807
Ohio,Vinton,246,27,88,27,15,7,164
Ohio,Vincent,282,9,87,82,0,0,178
Ohio,Vienna Center,651,63,192,138,39,52,484
Ohio,Versailles,2724,209,768,471,217,130,1795
Ohio,Twinsburg Heights,932,22,127,241,60,16,466
Ohio,Twinsburg,18820,710,3548,2963,3569,1979,12769
Ohio,Tuscarawas,1311,95,528,198,75,24,920
Ohio,Baltimore,2970,129,752,653,191,48,1773
Ohio,Baltic,748,96,309,102,22,11,540
Ohio,Ballville,2901,167,708,718,354,284,2231
Ohio,Bairdstown,183,12,74,33,1,0,120
Ohio,Bainbridge,810,146,235,159,40,19,599
Ohio,Bainbridge,2659,21,285,465,685,538,1994
Ohio,Bailey Lakes,543,55,163,111,24,28,381
Ohio,Avon Lake,23052,636,2986,4063,5204,2923,15812
Ohio,Avon,22046,687,3056,3817,4116,2750,14426
Ohio,Austintown,28759,1881,7848,6584,2906,1420,20639
Ohio,Austinburg,410,51,151,75,4,50,331
Ohio,Aurora,15663,549,2194,2925,3205,2204,11077
Ohio,Atwater,938,41,327,187,47,0,602
Ohio,Attica,1033,66,341,239,35,42,723
Ohio,Athens,24220,349,903,1413,1676,2712,7053
Ohio,Athalia,273,52,83,47,10,15,207
Ohio,Ashville,4144,268,1025,749,293,208,2543
Ohio,Ashtabula,18663,2381,5752,3284,533,518,12468
Ohio,Ashley,1186,167,472,130,47,27,843
Ohio,Ashland,20392,1623,5091,2840,2154,1428,13136
Ohio,Arlington Heights,947,93,289,211,26,3,622
Ohio,Bannock,253,6,78,79,0,8,171
Ohio,Barberton,26340,2671,8856,4305,1680,577,18089
Ohio,Barnesville,3832,311,1454,688,328,62,2843
Ohio,Barnhill,390,54,143,40,3,1,241
Ohio,Turpin Hills,4741,13,327,729,1330,765,3164
Ohio,Tuppers Plains,593,31,202,124,18,0,375
Ohio,Troy,25411,2064,5837,5385,2810,1320,17416
Ohio,Trotwood,24258,2558,5518,6054,1602,1022,16754
Ohio,Trinway,194,74,48,15,40,0,177
Ohio,Trimble,437,76,139,75,11,9,310
Ohio,Trenton,12176,790,3253,2219,721,230,7213
Ohio,Tremont City,440,37,127,93,20,3,280
Ohio,Toronto,4980,321,1739,1260,196,112,3628
Ohio,Tontogany,488,12,177,99,36,14,338
Ohio,Waynesburg,899,32,398,151,42,18,641
Ohio,Toledo,282275,27086,62449,62080,20485,11519,183619
Ohio,Tippecanoe,63,0,27,8,0,0,35
Ohio,Tipp City,9812,479,2360,2048,1195,801,6883
Ohio,Timberlake,704,27,184,207,88,44,550
Ohio,Tiltonsville,1327,96,355,417,90,66,1024
Ohio,Beach City,920,88,396,147,37,10,678
Ohio,Bay Village,15469,244,1518,2562,4053,2621,10998
Ohio,Bay View,566,67,221,120,38,10,456
Ohio,Batesville,87,11,33,15,3,0,62
Ohio,Batavia,1720,280,329,319,130,112,1170
Ohio,Bascom,470,20,101,127,56,26,330
Ohio,Tiro,203,28,62,22,7,2,121
Ohio,Fayette,1384,114,293,309,52,45,813
Ohio,Beckett Ridge,8825,116,909,1527,2237,1332,6121
Ohio,North Royalton,30321,1346,6730,6709,4766,2948,22499
Ohio,Hubbard,7745,374,2314,1511,890,317,5406
Ohio,Huber Heights,38897,2023,7464,10606,3696,2243,26032
Ohio,Huber Ridge,4710,249,1040,1025,609,220,3143
Ohio,Hudson,22389,271,1508,2730,5793,4722,15024
Ohio,Hunter,2131,246,675,603,47,91,1662
Ohio,Hunting Valley,837,8,30,62,217,279,596
Ohio,Huntsville,550,31,196,77,15,0,319
Ohio,Huron,7077,329,1657,1230,1153,566,4935
Ohio,Iberia,533,26,204,119,32,15,396
Ohio,Independence,7144,307,1588,1272,1231,710,5108
Ohio,Irondale,349,44,121,49,4,5,223
Ohio,Ironton,11172,841,3182,2413,836,414,7686
Ohio,Ithaca,146,5,47,25,2,1,80
Ohio,Jackson,6324,573,1780,1090,565,363,4371
Ohio,Jacksonburg,45,9,17,3,3,0,32
Ohio,Jackson Center,1675,94,503,305,66,98,1066
Ohio,Jacksonville,610,57,209,102,31,16,415
Ohio,Jamestown,2044,177,572,442,84,60,1335
Ohio,Jefferson,3199,208,967,872,133,147,2327
Ohio,Jeffersonville,1233,164,404,168,40,35,811
Ohio,Jenera,221,7,40,63,19,2,131
Ohio,Jeromesville,578,33,152,115,28,20,348
Ohio,Jerry City,472,43,143,81,21,13,301
Ohio,Jerusalem,153,18,54,26,12,2,112
Ohio,Jewett,616,63,201,116,15,2,397
Ohio,Hoytville,301,26,108,42,10,0,186
Ohio,Howland Center,6812,255,1801,1382,828,701,4967
Ohio,Howard,238,17,123,18,19,0,177
Ohio,Hopedale,1059,77,394,226,64,25,786
Ohio,Napoleon,8851,729,2632,1808,529,462,6160
Ohio,Nashville,233,26,95,18,11,1,151
Ohio,Navarre,1914,143,784,330,115,92,1464
Ohio,Neapolis,388,62,140,67,0,30,299
Ohio,Neffs,963,20,304,225,70,85,704
Ohio,Negley,198,34,113,33,0,0,180
Ohio,Nellie,109,11,39,24,1,2,77
Ohio,Nelsonville,5184,409,1007,1231,154,86,2887
Ohio,Nettle Lake,408,0,168,82,6,15,271
Ohio,Nevada,848,60,240,178,44,13,535
Ohio,Neville,60,16,9,9,2,2,38
Ohio,New Albany,9136,71,484,742,2150,2081,5528
Ohio,Johnstown,5373,358,1186,949,484,319,3296
Ohio,New Alexandria,205,36,66,47,8,10,167
Ohio,Hiram,1279,3,80,73,67,108,331
Ohio,Hockingport,165,68,35,19,0,0,122
Ohio,Holgate,1193,150,352,274,20,16,812
Ohio,Holiday City,37,0,9,9,5,0,23
Ohio,Holiday Lakes,741,29,284,113,86,32,544
Ohio,Holiday Valley,1386,93,326,358,178,137,1092
Ohio,Holland,1744,125,448,382,221,50,1226
Ohio,Hollansburg,311,31,93,50,9,3,186
Ohio,Holloway,293,37,104,62,0,0,203
Ohio,Holmesville,481,35,209,79,6,2,331
Ohio,Homeworth,304,42,138,35,19,21,255
Ohio,Hooven,680,143,181,93,4,0,421
Ohio,Newark,47829,4215,12440,9417,3614,1718,31404
Ohio,Junction City,834,68,272,131,22,4,497
Ohio,Kalida,1389,128,319,244,167,144,1002
Ohio,Kanauga,176,59,19,0,0,0,78
Ohio,Broughton,106,12,39,12,3,1,67
Ohio,Brownsville,135,42,93,0,0,0,135
Ohio,Brunswick,34512,1894,8883,7714,3773,1392,23656
Ohio,Bryan,8493,487,2707,1833,593,243,5863
Ohio,Buchtel,567,41,174,135,23,47,420
Ohio,Buckeye Lake,2724,478,792,427,136,96,1929
Ohio,Buckland,304,10,83,85,5,4,187
Ohio,Bucyrus,12045,1137,3723,2782,815,259,8716
Ohio,Buffalo,287,55,120,57,0,0,232
Ohio,Buford,275,28,85,51,16,0,180
Ohio,Burbank,227,19,91,31,7,1,149
Ohio,Burgoon,161,7,52,35,5,5,104
Ohio,Brookville,6077,368,1633,1798,440,226,4465
Ohio,Burkettsville,237,16,101,28,19,2,166
Ohio,Burton,1226,90,285,279,133,86,873
Ohio,Butler,999,64,312,218,72,11,677
Ohio,Butlerville,99,25,27,19,0,0,71
Ohio,Byesville,2248,213,822,390,42,26,1493
Ohio,Cadiz,3258,247,891,871,162,152,2323
Ohio,Cairo,410,22,152,101,16,13,304
Ohio,Calcutta,3516,358,954,904,179,265,2660
Ohio,Caldwell,1747,163,733,265,120,118,1399
Ohio,Caledonia,617,46,209,128,38,31,452
Ohio,Cambridge,10511,1047,2934,2106,593,357,7037
Ohio,Camden,2229,299,805,310,23,36,1473
Ohio,Wright-Patterson AFB,2621,93,89,423,222,315,1142
Ohio,Burlington,2243,156,676,531,178,77,1618
Ohio,Mutual,137,16,40,20,13,0,89
Ohio,Brookside,654,24,208,168,62,42,504
Ohio,Brooklyn Heights,1526,73,394,331,193,75,1066
Ohio,Kansas,51,0,22,29,0,0,51
Ohio,Kelleys Island,138,12,49,41,24,7,133
Ohio,Kent,29563,930,3178,3658,3128,2353,13247
Ohio,Kenton,7849,583,2818,1201,249,158,5009
Ohio,Kenwood,6906,135,748,1151,1495,1406,4935
Ohio,Kettering,55944,2384,10302,14380,7497,5200,39763
Ohio,Kettlersville,184,8,35,30,18,4,95
Ohio,Kidron,1032,152,196,70,78,65,561
Ohio,Kilbourne,159,8,58,28,0,0,94
Ohio,Killbuck,903,131,359,122,18,13,643
Ohio,Kimbolton,68,19,49,0,0,0,68
Ohio,Kings Mills,1313,84,186,253,308,68,899
Ohio,Brook Park,18956,1863,5753,4200,1190,466,13472
Ohio,Kingston,1085,82,360,233,64,27,766
Ohio,Kipton,245,11,70,80,15,0,176
Ohio,Kirby,76,12,43,4,1,0,60
Ohio,Kirkersville,590,18,202,130,37,22,409
Ohio,Kirtland,6836,275,1042,1580,1075,874,4846
Ohio,Kirtland Hills,686,18,104,114,122,130,488
Ohio,Kunkle,129,24,63,27,0,0,114
Ohio,La Croft,1138,75,374,233,13,65,760
Ohio,Lafayette,386,25,114,106,14,15,274
Ohio,Lafayette,382,81,93,43,43,10,270
Ohio,Broadview Heights,19268,670,2959,3359,3436,2752,13176
Ohio,Brookfield Center,1274,37,355,277,172,100,941
Ohio,Brooklyn,11002,1140,3202,2354,930,362,7988
Ohio,Kinsman Center,440,23,151,109,42,27,352
Ohio,Wren,200,10,72,79,3,5,169
Ohio,Murray City,369,13,180,65,4,4,266
Ohio,Mulberry,3572,200,871,567,569,559,2766
Ohio,Martinsburg,260,23,109,27,6,0,165
Ohio,Marshallville,702,74,258,105,36,9,482
Ohio,Marseilles,124,0,59,20,0,10,89
Ohio,Marne,698,39,143,117,115,30,444
Ohio,Marlboro,278,23,54,86,6,0,169
Ohio,Marion,36701,4318,10897,7567,1518,919,25219
Ohio,Marietta,13996,1110,3436,2743,1448,730,9467
Ohio,Mariemont,3397,22,223,303,942,794,2284
Ohio,Marengo,281,17,124,24,6,10,181
Ohio,Marblehead,933,53,248,269,150,95,815
Ohio,Marble Cliff,640,11,45,57,182,187,482
Ohio,Maplewood Park,372,75,96,82,16,0,269
Ohio,Maple Ridge,893,153,386,57,9,0,605
Ohio,Maple Heights,22792,1455,6289,5433,1522,698,15397
Ohio,Mantua,1248,29,414,301,123,40,907
Ohio,Mansfield,46998,5701,13048,9659,2956,1417,32781
Ohio,Manchester,2129,486,548,244,73,43,1394
Ohio,Malvern,1169,84,424,224,40,31,803
Ohio,Malta,802,56,223,133,60,13,485
Ohio,Malinta,318,19,95,67,9,3,193
Ohio,Maineville,1003,44,219,228,137,59,687
Ohio,Magnolia,989,26,285,191,103,41,646
Ohio,Magnetic Springs,260,30,101,31,18,0,180
Ohio,Madison,3183,168,736,679,407,167,2157
Ohio,Madeira,8858,239,1100,1326,1982,1445,6092
Ohio,Martins Ferry,6829,577,2058,1628,394,255,4912
Ohio,Martinsville,406,48,108,64,21,3,244
Ohio,Marysville,22732,1585,5152,4698,2675,1002,15112
Ohio,Mason,31654,533,4271,4410,6244,5112,20570
Ohio,Midway,196,7,92,32,7,1,139
Ohio,Mifflin,144,20,41,31,2,3,97
Ohio,Middletown,48563,5518,13069,8654,3593,1464,32298
Ohio,Middleport,2111,297,666,444,98,91,1596
Ohio,Middle Point,534,31,211,91,12,8,353
Ohio,Middlefield,2690,224,733,565,320,103,1945
Ohio,Middleburg Heights,15790,908,3468,3294,2453,1704,11827
Ohio,Miamiville,152,17,19,25,0,23,84
Ohio,Miamitown,1315,114,315,274,70,12,785
Ohio,Miamisburg,20119,1324,4974,4789,2120,1274,14481
Ohio,Miami Heights,5154,270,853,989,929,347,3388
Ohio,Meyers Lake,622,24,160,131,118,72,505
Ohio,Macksburg,150,35,59,16,1,0,111
Ohio,Metamora,673,10,174,142,52,30,408
Ohio,Mentor,46952,1841,10430,11641,7084,3740,34736
Ohio,Mendon,557,30,179,116,18,13,356
Ohio,Melrose,127,15,43,17,9,7,91
Ohio,Melmore,88,10,17,10,11,0,48
Ohio,Medina,26529,999,4822,5283,4039,1717,16860
Ohio,Mechanicsburg,1875,213,475,381,66,38,1173
Ohio,Mayfield Heights,18918,932,3690,3947,3166,2150,13885
Ohio,Mayfield,3421,115,531,548,868,556,2618
Ohio,Maumee,14083,381,2659,3295,2163,1301,9799
Ohio,Matamoras,867,119,291,187,39,19,655
Ohio,Masury,2096,96,722,421,105,75,1419
Ohio,Massillon,32215,2543,9209,6619,2223,1273,21867
Ohio,Mentor-on-the-Lake,7432,417,2427,1894,502,109,5349
Ohio,McKinley Heights,748,36,187,170,117,42,552
Ohio,Mack,11213,271,2288,2263,2080,799,7701
Ohio,McGuffey,451,49,186,57,5,5,302
Ohio,Monroeville,1382,90,444,326,86,17,963
Ohio,Montezuma,208,27,70,60,5,1,163
Ohio,Montgomery,10363,147,799,1254,2592,2412,7204
Ohio,Montpelier,4026,447,1127,742,233,110,2659
Ohio,Montrose-Ghent,4520,50,537,570,1112,1051,3320
Ohio,Moraine,6332,663,1547,1459,462,137,4268
Ohio,Moreland Hills,3305,29,154,448,981,792,2404
Ohio,Morgandale,809,59,380,149,49,23,660
Ohio,Morral,436,56,108,93,9,6,272
Ohio,Morristown,288,16,101,68,13,15,213
Ohio,Morrow,1581,135,365,323,120,41,984
Ohio,Moscow,124,8,75,18,1,0,102
Ohio,Monroe,13666,641,2681,2800,1848,695,8665
Ohio,Mount Blanchard,486,24,149,83,51,11,318
Ohio,Mount Cory,223,24,48,48,8,4,132
Ohio,Mount Eaton,215,25,57,22,14,1,119
Ohio,Mount Gilead,3624,245,1248,636,335,103,2567
Ohio,Mount Healthy,6071,394,1552,1383,470,304,4103
Ohio,Mount Healthy Heights,3276,284,740,618,144,17,1803
Ohio,Mount Orab,4018,524,1194,517,186,84,2505
Ohio,Mount Pleasant,534,44,184,116,17,19,380
Ohio,Mount Repose,4393,178,912,979,586,283,2938
Ohio,Mount Sterling,1816,135,517,391,72,15,1130
Ohio,Mount Vernon,16882,1324,4724,2442,1503,918,10911
Ohio,Mount Victory,561,47,222,94,9,24,396
Ohio,Mowrystown,293,38,81,54,12,5,190
Ohio,Mount Carmel,4706,445,1023,1069,443,135,3115
Ohio,Munroe Falls,5025,280,1193,746,827,608,3654
Ohio,Monfort Heights,12454,506,2546,2508,2116,1170,8846
Ohio,Mitiwanga,195,39,42,30,0,20,131
Ohio,Macedonia,11469,270,2382,2195,2104,1444,8395
Ohio,McDonald,3196,155,1030,652,239,95,2171
Ohio,McDermott,739,197,208,20,0,0,425
Ohio,McCutchenville,349,9,107,43,8,24,191
Ohio,McConnelsville,1871,194,605,371,80,95,1345
Ohio,McComb,1645,142,566,299,67,33,1107
Ohio,McClure,656,65,207,149,25,17,463
Ohio,Milan,1317,47,357,242,131,59,836
Ohio,Milford,6767,394,1639,1356,900,537,4826
Ohio,Milford Center,821,33,304,135,37,12,521
Ohio,Millbury,1325,34,359,363,75,65,896
Ohio,Milledgeville,178,27,33,29,4,0,93
Ohio,Mogadore,3792,163,1036,709,282,215,2405
Ohio,Miller City,103,7,51,25,4,3,90
Ohio,Millersport,1338,86,385,217,83,55,826
Ohio,Millfield,295,59,165,53,0,0,277
Ohio,Millville,782,42,250,171,42,27,532
Ohio,Milton Center,208,32,64,32,12,1,141
Ohio,Miltonsburg,60,4,34,11,0,0,49
Ohio,Mineral City,679,61,273,131,20,14,499
Ohio,Mineral Ridge,3698,450,1158,586,352,156,2702
Ohio,Minerva,3829,237,1196,771,187,194,2585
Ohio,Minerva Park,1500,75,145,301,316,189,1026
Ohio,Minford,676,105,220,135,0,59,519
Ohio,Mingo Junction,3212,134,1027,780,189,143,2273
Ohio,Minster,2905,85,692,592,337,183,1889
Ohio,Millersburg,3116,374,1148,488,140,72,2222
Ohio,Worthington,13867,203,941,1942,3789,3026,9901
Ohio,Wooster,26551,2004,5861,4225,2812,2123,17025
Ohio,Woodville,2166,86,520,481,240,111,1438
Ohio,Centerburg,1844,127,432,454,112,42,1167
Ohio,Centerville,69,8,22,14,8,6,58
Ohio,Centerville,23952,812,2814,5196,5001,3900,17723
Ohio,Chagrin Falls,4083,62,340,666,1014,833,2915
Ohio,Champion Heights,6494,409,2253,1230,580,229,4701
Ohio,Chardon,5170,237,911,1410,647,342,3547
Ohio,Chatfield,260,16,62,65,8,2,153
Ohio,Chauncey,1220,167,343,208,50,25,793
Ohio,Cherry Fork,221,14,33,16,69,9,141
Ohio,Cherry Grove,4624,71,670,899,1079,304,3023
Ohio,Chesapeake,891,102,186,229,58,24,599
Ohio,Cheshire,226,5,99,43,3,0,150
Ohio,Chesterhill,382,43,125,79,6,11,264
Ohio,Wyoming,8407,155,572,982,2159,1839,5707
Ohio,Xenia,26002,2287,6420,5368,2127,1302,17504
Ohio,Yankee Lake,90,8,24,22,15,6,75
Ohio,Yellow Springs,3683,49,272,718,736,1026,2801
Ohio,Yorkshire,71,16,28,3,2,0,49
Ohio,Yorkville,1084,70,421,219,111,18,839
Ohio,Youngstown,65573,7981,17478,13070,3486,1611,43626
Ohio,Zaleski,373,36,175,55,2,1,269
Ohio,Zanesfield,227,15,47,69,17,10,158
Ohio,Zanesville,25470,3290,6738,4705,1301,693,16727
Ohio,Zoar,199,3,63,51,42,22,181
Ohio,New Athens,223,34,91,28,8,7,168
Ohio,Celina,10373,709,3496,1923,588,459,7175
Ohio,Celeryville,380,0,67,117,0,17,201
Ohio,Cedarville,4004,45,297,225,230,166,963
Ohio,Cecil,166,19,66,22,3,1,111
Ohio,Bedford Heights,10665,960,3124,2482,871,417,7854
Ohio,Bedford,12868,852,3124,2970,1207,669,8822
Ohio,North Zanesville,3133,248,708,571,325,427,2279
Ohio,Beaverdam,468,43,147,103,12,3,308
Ohio,Beavercreek,45999,1024,6453,9236,7808,8090,32611
Ohio,Beaver,531,69,141,65,9,15,299
Ohio,Beallsville,394,38,145,74,3,8,268
Ohio,Beachwood,11801,406,1466,1937,2166,2931,8906
Ohio,Campbell,8075,920,2409,1615,301,194,5439
Ohio,Camp Dennison,252,32,69,72,17,29,219
Ohio,Canal Fulton,5483,289,1449,1277,662,252,3929
Ohio,Canal Lewisville,246,22,114,25,15,16,192
Ohio,New Baltimore,656,51,235,110,43,29,468
Ohio,Canal Winchester,7621,287,1557,1469,1237,856,5406
Ohio,Canfield,7424,123,1499,1590,1381,936,5529
Ohio,Canton,72463,7544,17481,15053,4511,2059,46648
Ohio,Carbon Hill,265,25,114,7,0,10,156
Ohio,Cardington,2352,209,743,339,87,29,1407
Ohio,Carey,3513,241,1221,694,196,36,2388
Ohio,Carlisle,5024,397,1567,957,246,138,3305
Ohio,Carroll,411,40,174,75,22,5,316
Ohio,Carrollton,3020,242,856,731,226,192,2247
Ohio,Casstown,275,12,78,64,19,1,174
Ohio,Castalia,808,51,288,119,66,35,559
Ohio,Castine,152,15,55,20,2,1,93
Ohio,Catawba,371,14,138,70,6,0,228
Ohio,Candlewood Lake,1155,43,315,252,130,95,835
Ohio,New Bavaria,107,9,27,13,14,8,71
Ohio,New Bloomington,455,124,135,37,4,0,300
Ohio,New Boston,2125,327,724,292,89,63,1495
Ohio,Newtown,2668,186,483,472,533,208,1882
Ohio,New Vienna,1424,104,394,284,36,17,835
Ohio,New Washington,991,17,340,179,65,38,639
Ohio,New Waterford,1270,126,407,273,36,24,866
Ohio,New Weston,115,36,27,11,0,2,76
Ohio,Ney,313,22,98,67,13,5,205
Ohio,Niles,18886,1478,6049,3295,1473,529,12824
Ohio,North Baltimore,3460,206,1071,629,148,36,2090
Ohio,North Bend,790,25,200,188,160,95,668
Ohio,Northbrook,10545,920,2799,1995,751,305,6770
Ohio,North Canton,17431,752,3638,3447,2771,1660,12268
Ohio,North College Hill,9361,543,2357,2482,816,336,6534
Ohio,Newtonsville,398,20,144,60,18,3,245
Ohio,North Fairfield,605,36,243,103,18,6,406
Ohio,Northgate,7677,618,2125,1729,654,196,5322
Ohio,North Hampton,398,14,103,90,32,11,250
Ohio,North Kingsville,2871,150,820,658,282,139,2049
Ohio,North Lawrence,195,20,86,29,0,0,135
Ohio,North Lewisburg,1522,98,447,262,120,16,943
Ohio,North Madison,8961,406,2311,2100,507,400,5724
Ohio,North Olmsted,32248,1690,7009,7939,4807,2210,23655
Ohio,North Perry,776,36,257,186,94,39,612
Ohio,North Randall,998,136,294,252,59,50,791
Ohio,Northridge,7161,330,2073,1957,899,291,5550
Ohio,North Ridgeville,31240,1607,6672,7230,4311,2210,22030
Ohio,North Robinson,241,42,115,33,11,0,201
Ohio,Northfield,3649,211,1321,650,285,137,2604
Ohio,Beechwood Trails,2889,58,595,588,582,340,2163
Ohio,Newton Falls,4707,467,1706,853,154,146,3326
Ohio,New Riegel,258,6,106,57,12,6,187
Ohio,New Bremen,3127,88,742,655,378,215,2078
Ohio,Newburgh Heights,2012,250,504,385,192,27,1358
Ohio,New Burlington,4881,466,1157,1128,356,136,3243
Ohio,New California,1761,0,109,244,513,153,1019
Ohio,New Carlisle,5727,763,1358,1156,291,85,3653
Ohio,Newcomerstown,3748,384,1321,651,196,82,2634
Ohio,New Concord,2670,60,323,264,193,165,1005
Ohio,New Franklin,14258,853,4327,2986,1735,613,10514
Ohio,New Hampshire,202,15,34,41,5,43,138
Ohio,New Haven CDP (Hamilton County),523,19,192,61,75,10,357
Ohio,New Haven CDP (Huron County),394,38,125,90,67,0,320
Ohio,New Holland,732,68,272,127,25,21,513
Ohio,New Straitsville,757,116,227,160,4,9,516
Ohio,New Knoxville,927,20,232,201,113,40,606
Ohio,New Lexington,4795,516,1287,898,75,132,2908
Ohio,New London,2606,242,797,368,116,40,1563
Ohio,New Madison,929,49,319,138,47,13,566
Ohio,New Marshfield,386,63,125,65,15,26,294
Ohio,New Miami,2169,393,676,283,62,45,1459
Ohio,New Middletown,1666,113,563,304,156,67,1203
Ohio,New Paris,1593,209,439,284,57,11,1000
Ohio,New Philadelphia,17397,1823,4943,3028,1210,588,11592
Ohio,New Pittsburg,285,54,123,28,19,5,229
Ohio,Newport CDP (Shelby County),152,14,39,61,0,0,114
Ohio,Newport CDP (Washington County),782,25,265,156,99,14,559
Ohio,New Richmond,2624,301,739,390,237,57,1724
Ohio,New Lebanon,4310,337,1500,897,134,6,2874
Ohio,Bellaire,4215,527,1303,758,158,110,2856
Ohio,Bellbrook,7063,214,880,1529,1371,1038,5032
Ohio,Belle Center,807,43,279,149,34,27,532
Ohio,Wheelersburg,6181,539,1660,1366,641,380,4586
Ohio,Wharton,363,17,147,53,24,3,244
Ohio,Wetherington,1305,19,143,246,429,182,1019
Ohio,West Unity,1775,144,451,389,80,42,1106
Ohio,West Union,3180,525,1008,517,86,139,2275
Ohio,West Salem,1653,164,552,249,44,15,1024
Ohio,West Rushville,217,24,55,49,5,1,134
Ohio,West Portsmouth,2978,347,895,678,102,33,2055
Ohio,Weston,1688,172,465,386,81,24,1128
Ohio,Westminster,340,13,145,31,18,0,207
Ohio,West Milton,4679,454,1022,1264,400,241,3381
Ohio,West Millgrove,140,15,39,25,6,0,85
Ohio,Whitehall,18521,2410,4657,3445,988,258,11758
Ohio,West Mansfield,754,61,276,122,41,10,510
Ohio,West Liberty,1699,111,543,334,124,48,1160
Ohio,West Leipsic,167,15,55,33,7,0,110
Ohio,Westlake,32469,956,3794,6485,7805,5059,24099
Ohio,West Lafayette,2312,250,792,378,173,53,1646
Ohio,West Jefferson,4235,413,1524,736,148,97,2918
Ohio,West Hill,1898,162,691,389,119,24,1385
Ohio,Westfield Center,1159,25,293,257,222,73,870
Ohio,West Farmington,550,62,160,62,19,7,310
Ohio,Westerville,37540,810,4962,6289,8351,4856,25268
Ohio,West Elkton,243,18,92,44,0,0,154
Ohio,West Carrollton,13051,878,3227,3499,1057,289,8950
Ohio,West Alexandria,1726,117,438,381,124,72,1132
Ohio,West Manchester,591,58,170,127,19,7,381
Ohio,Wellsville,3461,314,1027,521,107,7,1976
Ohio,Whitehouse,4219,85,688,1021,541,447,2782
Ohio,Whites Landing,342,17,132,102,47,0,298
Ohio,Woodstock,326,24,76,79,10,0,189
Ohio,Woodsfield,2412,250,786,522,121,57,1736
Ohio,Woodmere,925,27,154,201,125,122,629
Ohio,Woodlawn,3284,263,479,677,576,174,2169
Ohio,Wolfhurst,1211,199,518,106,94,12,929
Ohio,Withamsville,7116,321,1924,2013,809,211,5278
Ohio,Wintersville,4113,146,1236,972,392,252,2998
Ohio,Winesburg,256,45,82,40,12,0,179
Ohio,Windham,1852,199,606,240,51,15,1111
Ohio,Winchester,1120,110,323,182,30,19,664
Ohio,Wilson,130,13,45,31,3,2,94
Ohio,Wilmot,295,25,145,26,9,0,205
Ohio,White Oak,18664,1447,4067,3993,2373,1245,13125
Ohio,Wilmington,12428,1247,2907,2389,847,409,7799
Ohio,Willowick,14051,752,3876,3142,1527,635,9932
Ohio,Willoughby Hills,9428,478,2013,1992,1677,908,7068
Ohio,Willoughby,22433,1182,5322,5221,3253,1366,16344
Ohio,Williston,645,83,234,113,53,0,483
Ohio,Williamsport,1225,130,349,178,19,9,685
Ohio,Williamsdale,691,125,219,93,14,0,451
Ohio,Williamsburg,2536,283,636,420,153,81,1573
Ohio,Willard,6135,857,1945,883,275,85,4045
Ohio,Wilkesville,182,12,44,41,14,1,112
Ohio,Wilberforce,2278,26,118,90,62,64,360
Ohio,Wightmans Grove,0,0,0,0,0,0,0
Ohio,Wickliffe,12629,860,3207,3056,1637,673,9433
Ohio,Willshire,399,50,146,98,9,2,305
Ohio,North Star,272,14,80,48,7,8,157
Ohio,Wellston,5569,672,1815,973,337,167,3964
Ohio,Waynesville,2924,178,783,473,312,211,1957
Ohio,Blanchester,4244,428,1384,740,110,72,2734
Ohio,Blakeslee,66,4,22,20,5,0,51
Ohio,Bladensburg,103,10,71,4,0,0,85
Ohio,Blacklick Estates,8960,770,2564,1648,560,94,5636
Ohio,Bexley,13442,175,610,1227,3009,2780,7801
Ohio,Beverly,1139,121,332,242,78,44,817
Ohio,Beulah Beach,71,0,18,26,0,27,71
Ohio,Bettsville,642,46,219,133,33,13,444
Ohio,Bethesda,1382,69,426,271,49,39,854
Ohio,Bethel,2756,317,1009,313,157,64,1860
Ohio,Berlin Heights,531,66,141,126,56,28,417
Ohio,Berlin,1445,264,430,156,118,23,991
Ohio,Bloomdale,676,42,199,124,61,19,445
Ohio,Berkey,338,7,78,71,47,27,230
Ohio,Berea,19001,1025,3279,4038,2651,1465,12458
Ohio,Bentonville,198,14,77,57,0,11,159
Ohio,Benton Ridge,361,25,148,91,11,11,286
Ohio,Bentleyville,938,2,40,97,179,294,612
Ohio,Belpre,6448,708,1648,1701,471,163,4691
Ohio,Beloit,1039,104,362,239,49,33,787
Ohio,Belmore,119,15,28,27,1,4,75
Ohio,Belmont,521,38,177,114,34,14,377
Ohio,Bellville,1841,90,532,403,229,69,1323
Ohio,Bellevue,8109,402,2246,1935,514,230,5327
Ohio,Belle Valley,220,23,76,59,0,19,177
Ohio,Bellefontaine,13279,1110,3956,1831,987,537,8421
Ohio,Bergholz,765,52,220,126,49,14,461
Ohio,Wellington,4981,301,1238,1144,240,235,3158
Ohio,Bloomingburg,1079,74,357,157,67,3,658
Ohio,Bloomville,909,73,359,122,40,15,609
Ohio,Waynesfield,739,57,239,149,48,14,507
Ohio,Brimfield,3614,139,1090,680,207,246,2362
Ohio,Brilliant,1690,54,615,418,42,8,1137
Ohio,Bridgetown,13628,727,3813,2906,1601,695,9742
Ohio,Bridgeport,1799,141,709,368,82,37,1337
Ohio,Brice,110,7,17,38,11,7,80
Ohio,Brewster,2308,307,917,394,89,12,1719
Ohio,Bremen,1669,97,433,392,85,45,1052
Ohio,Brecon,425,67,200,0,0,0,267
Ohio,Brecksville,13516,358,1687,2637,2811,2272,9765
Ohio,Bratenahl,1153,19,109,200,308,421,1057
Ohio,Brady Lake,458,26,132,76,41,30,305
Ohio,Bloomingdale,189,19,36,59,10,11,135
Ohio,Bradner,957,48,316,230,51,10,655
Ohio,Bowling Green,31506,782,3690,3368,2770,2997,13607
Ohio,Bowersville,279,29,72,53,5,0,159
Ohio,Bowerston,387,33,158,74,18,4,287
Ohio,Bourneville,253,16,99,28,0,0,143
Ohio,Botkins,1320,42,418,206,112,48,826
Ohio,Boston Heights,1252,37,197,228,259,162,883
Ohio,Bolivar,1030,61,278,302,59,40,740
Ohio,Bolindale,2003,145,677,481,95,34,1432
Ohio,Boardman,34794,1675,8104,8241,4707,2592,25319
Ohio,Bluffton,4210,151,684,602,562,654,2653
Ohio,Blue Jay,1182,82,222,293,186,49,832
Ohio,Blue Ash,12102,471,1444,1888,2575,2540,8918
Ohio,Bradford,1716,149,610,297,48,18,1122
Ohio,Norton,12054,753,2940,2638,1433,707,8471
Ohio,Van Wert,10769,797,3514,1813,612,484,7220
Ohio,Norwich,96,7,41,9,7,12,76
Ohio,Sulphur Springs,102,0,41,48,0,0,89
Ohio,Sugar Grove,509,17,194,90,22,7,330
Ohio,Sugarcreek,2235,285,727,376,169,44,1601
Ohio,Sugar Bush Knolls,172,0,25,16,39,50,130
Ohio,Stryker,1195,52,356,297,73,5,783
Ohio,Struthers,10515,683,3574,1880,801,212,7150
Ohio,Summerfield,213,31,78,47,1,10,167
Ohio,Strongsville,44649,1452,7770,8615,8947,5422,32206
Ohio,Stratton,318,21,128,52,16,0,217
Ohio,Strasburg,3132,163,1179,553,264,135,2294
Ohio,Stow,34765,1302,5846,6739,6515,3754,24156
Ohio,Stoutsville,467,45,154,96,19,15,329
Ohio,Stony Ridge,321,18,110,38,81,0,247
Ohio,Stony Prairie,1328,141,442,304,42,31,960
Ohio,Streetsboro,16222,869,4017,3395,2010,942,11233
Ohio,Summerside,5167,384,1283,933,603,228,3431
Ohio,Summitville,110,5,47,20,0,6,78
Ohio,Sunbury,4771,150,1017,676,881,380,3104
Ohio,Tiffin,17793,1185,4664,3161,1087,624,10721
Ohio,Thurston,539,70,152,115,15,6,358
Ohio,Thornville,1244,17,333,241,104,30,725
Ohio,Thornport,1058,47,348,275,112,188,970
Ohio,The Village of Indian Hill,5793,30,138,252,1854,1692,3966
Ohio,The Plains,3230,232,646,598,328,272,2076
Ohio,Terrace Park,2330,19,33,210,699,454,1415
Ohio,Tedrow,227,21,65,52,7,0,145
Ohio,Taylor Creek,3451,172,790,861,441,135,2399
Ohio,Tarlton,276,26,120,20,17,2,185
Ohio,Tallmadge,17459,836,4191,3645,2345,1147,12164
Ohio,Syracuse,719,88,213,140,39,23,503
Ohio,Sylvania,18943,584,2590,4479,3513,2017,13183
Ohio,Sycamore,980,93,252,201,78,12,636
Ohio,Swanton,4040,212,1117,991,375,154,2849
Ohio,Stone Creek,157,12,70,14,6,0,102
Ohio,Stockport,529,70,158,109,14,3,354
Ohio,Stockdale,12,0,0,0,0,12,12
Ohio,Stewart,298,28,90,74,9,13,214
Ohio,South Charleston,1818,148,467,342,89,52,1098
Ohio,South Canal,1190,40,522,220,88,32,902
Ohio,South Bloomfield,2225,221,563,443,128,29,1384
Ohio,South Amherst,1807,194,614,444,93,29,1374
Ohio,Somerville,269,39,111,28,14,0,192
Ohio,Somerset,1564,96,416,341,86,29,968
Ohio,Solon,23114,518,2354,3404,4607,4679,15562
Ohio,Smithville,1157,61,309,200,170,46,786
Ohio,Smithfield,852,60,257,184,61,25,587
Ohio,Skyline Acres,1829,132,273,481,28,48,962
Ohio,Lockland,3426,553,1020,558,78,44,2253
Ohio,Lodi,2780,202,1039,543,127,33,1944
Ohio,Logan,7292,574,2023,1477,460,280,4814
Ohio,Logan Elm Village,1086,84,404,224,83,0,795
Ohio,London,9961,936,2743,1890,746,230,6545
Ohio,South Euclid,21971,885,3248,4532,3301,2535,14501
Ohio,Lockington,135,24,55,16,4,0,99
Ohio,South Lebanon,4992,263,897,630,1259,170,3219
Ohio,South Russell,3838,31,195,306,1380,717,2629
Ohio,Steubenville,18381,1445,4261,3711,1550,986,11953
Ohio,Sterling,593,49,157,101,10,19,336
Ohio,Stafford,119,8,49,24,6,0,87
Ohio,Spring Valley,508,29,139,120,33,42,363
Ohio,Springfield,60007,6833,14277,11873,3848,2082,38913
Ohio,Springdale,11194,1081,1785,2093,1501,743,7203
Ohio,Springboro,17585,341,2409,3044,3557,1816,11167
Ohio,Spencerville,2090,117,664,372,85,36,1274
Ohio,Spencer,686,50,262,144,25,3,484
Ohio,Sparta,166,7,53,36,3,2,101
Ohio,South Zanesville,2233,277,685,414,32,50,1458
Ohio,South Webster,666,66,220,88,52,48,474
Ohio,South Vienna,387,16,124,87,18,16,261
Ohio,South Solon,317,39,106,59,8,1,213
Ohio,South Salem,256,30,74,48,6,9,167
Ohio,South Point,3671,221,983,862,272,176,2514
Ohio,Lockbourne,219,44,70,24,7,0,145
Ohio,Little Hocking,267,0,51,46,87,0,184
Ohio,Lithopolis,1446,100,217,381,121,131,950
Ohio,Rittman,6520,555,2154,979,532,175,4395
Ohio,Riverlea,636,6,22,67,148,177,420
Ohio,Riverside,25075,2084,5240,5957,1918,1046,16245
Ohio,Roaming Shores,1678,91,430,305,233,103,1162
Ohio,Robertsville,391,0,138,110,6,43,297
Ohio,Rochester,179,24,64,34,2,9,133
Ohio,Rockbridge,218,0,110,25,0,0,135
Ohio,Rock Creek,393,49,154,76,3,5,287
Ohio,Rockford,1199,92,367,190,81,47,777
Ohio,Rocky Fork Point,656,194,165,99,27,15,500
Ohio,Rocky Ridge,485,33,131,105,11,5,285
Ohio,Norwalk,16892,1261,4958,3010,907,801,10937
Ohio,Lafferty,370,14,66,174,14,0,268
Ohio,LaGrange,2265,139,582,586,196,67,1570
Ohio,Lake Buckhorn,900,7,302,85,73,85,552
Ohio,Risingsun,583,18,205,100,20,3,346
Ohio,Lake Darby,4481,90,937,866,702,323,2918
Ohio,Ripley,1980,301,555,299,110,69,1334
Ohio,Ridgeway,295,17,110,50,10,11,198
Ohio,Raymond,83,8,7,8,17,15,55
Ohio,Reading,10349,1054,2751,2184,733,484,7206
Ohio,Reminderville,3743,97,664,666,526,495,2448
Ohio,Remington,114,0,16,0,62,36,114
Ohio,Rendville,32,6,5,6,4,2,23
Ohio,Reno,1156,78,373,299,26,31,807
Ohio,Republic,611,27,211,135,24,12,409
Ohio,Reynoldsburg,36899,1655,6800,8212,4774,2418,23859
Ohio,Richfield,3665,128,713,632,794,368,2635
Ohio,Richmond,364,31,154,94,16,8,303
Ohio,Richmond Dale,312,65,127,15,0,0,207
Ohio,Richmond Heights,10485,644,1825,2571,1777,1026,7843
Ohio,Richville,3329,255,1160,805,197,65,2482
Ohio,Richwood,2268,189,681,403,94,7,1374
Ohio,Ridgeville Corners,354,6,93,89,39,11,238
Ohio,Rio Grande,977,18,110,94,22,44,288
Ohio,Lorain,63778,7485,15304,14002,3009,1613,41413
Ohio,Lake Lakengren,3379,135,903,782,248,135,2203
Ohio,Lake Lorelei,1095,34,285,310,118,53,800
Ohio,Leesville,156,11,70,45,1,0,127
Ohio,Leetonia,1925,169,658,337,132,46,1342
Ohio,Leipsic,2089,226,767,283,103,71,1450
Ohio,Lewisburg,1605,137,425,371,73,24,1030
Ohio,Lewistown,95,0,64,12,0,0,76
Ohio,Lewisville,222,17,99,38,13,3,170
Ohio,Lexington,5712,202,1103,1412,668,273,3658
Ohio,Liberty Center,1125,63,414,223,50,19,769
Ohio,Lima,38232,3781,9220,7358,1556,1042,22957
Ohio,Limaville,139,6,73,16,4,6,105
Ohio,Lincoln Heights,3365,382,968,733,113,37,2233
Ohio,Lincoln Village,9417,1506,2344,1803,506,155,6314
Ohio,Lindsey,557,42,160,128,48,26,404
Ohio,Linndale,159,25,23,45,6,3,102
Ohio,Lisbon,2738,252,938,389,160,98,1837
Ohio,Leesburg,1377,134,473,255,46,30,938
Ohio,Lakeline,271,4,79,56,37,17,193
Ohio,Lebanon,20450,864,3858,4026,2786,1068,12602
Ohio,Laurelville,506,70,178,61,17,3,329
Ohio,Lake Milton,666,65,259,79,48,20,471
Ohio,Lake Mohawk,1571,0,292,484,229,143,1148
Ohio,Lakemore,3051,243,933,720,124,125,2145
Ohio,Lake Seneca,587,8,148,141,90,37,424
Ohio,Lakeside,615,31,143,64,264,113,615
Ohio,Lake Tomahawk,697,22,187,134,132,53,528
Ohio,Lakeview,1148,108,385,239,38,10,780
Ohio,Lake Waynoka,1043,0,441,213,66,100,820
Ohio,Lakewood,51155,2655,8111,10383,9805,5771,36725
Ohio,Lancaster,39312,3500,10733,8006,2935,1402,26576
Ohio,Landen,6985,98,622,1363,1442,880,4405
Ohio,Lansing,772,84,225,210,17,25,561
Ohio,La Rue,669,91,184,124,18,5,422
Ohio,Latty,186,13,70,38,13,3,137
Ohio,Laura,425,26,138,94,9,1,268
Ohio,Leavittsburg,1616,140,596,235,73,48,1092
Ohio,Rayland,403,33,133,86,23,14,289
Ohio,Lordstown,3346,252,1278,762,245,111,2648
Ohio,Loudonville,2749,248,935,535,155,81,1954
Ohio,Germantown,5521,345,1118,1429,386,400,3678
Ohio,Georgetown,4792,487,1637,677,164,188,3153
Ohio,Genoa,2405,131,523,678,202,51,1585
Ohio,Geneva-on-the-Lake,1390,138,381,302,73,74,968
Ohio,Geneva,6101,567,1897,1316,315,173,4268
Ohio,Gates Mills,2179,24,230,332,610,578,1774
Ohio,Gettysburg,598,38,199,118,9,13,377
Ohio,Garrettsville,2937,93,639,621,347,123,1823
Ohio,Gann,133,15,60,19,1,0,95
Ohio,Gambier,2482,0,83,70,130,321,604
Ohio,Gallipolis,3674,538,826,687,232,232,2515
Ohio,Galion,10227,910,3074,2174,369,245,6772
Ohio,Galena,745,38,130,123,138,43,472
Ohio,Gahanna,34095,1060,5135,6290,6893,3802,23180
Ohio,Garfield Heights,28365,2846,7611,6292,1917,875,19541
Ohio,Gibsonburg,2732,170,628,574,97,40,1509
Ohio,Gilboa,213,10,55,49,14,5,133
Ohio,Girard,9716,871,2776,1900,929,392,6868
Ohio,Shreve,1521,127,476,218,70,53,944
Ohio,Sidney,20981,1784,5881,4239,1125,873,13902
Ohio,Silver Lake,2518,45,320,436,647,375,1823
Ohio,Silverton,4769,359,853,1286,779,257,3534
Ohio,Sinking Spring,107,22,35,13,0,3,73
Ohio,Sixteen Mile Stand,3443,16,295,586,802,683,2382
Ohio,Glouster,1656,263,451,251,42,29,1036
Ohio,Gloria Glens Park,485,62,117,74,37,10,300
Ohio,Glenwillow,1010,74,183,111,124,172,664
Ohio,Glenmoor,1943,302,772,288,30,30,1422
Ohio,Glenmont,222,26,91,28,4,4,153
Ohio,Glenford,184,9,45,38,10,5,107
Ohio,Glendale,2128,63,186,343,545,472,1609
Ohio,Glencoe,285,41,108,48,6,6,209
Ohio,Glandorf,892,44,249,158,91,47,589
Ohio,Fultonham,164,16,56,20,7,2,101
Ohio,Fulton,338,22,108,59,7,0,196
Ohio,Fruit Hill,3574,15,434,841,723,407,2420
Ohio,Friendship,289,46,147,15,7,0,215
Ohio,Flushing,818,55,306,211,34,23,629
Ohio,Florida,267,12,89,53,10,10,174
Ohio,Fletcher,430,41,152,93,9,4,299
Ohio,Flat Rock,57,3,30,0,0,0,33
Ohio,Five Points,1778,5,214,358,438,265,1280
Ohio,Finneytown,12366,639,1703,2942,1686,1228,8198
Ohio,Findlay,41278,2552,8911,8310,4566,2849,27188
Ohio,Felicity,871,191,244,91,39,12,577
Ohio,Fayetteville,370,23,153,59,22,11,268
Ohio,Fairfield,42678,2478,10127,9110,5501,2598,29814
Ohio,Fairfield Beach,809,106,233,207,37,33,616
Ohio,Fairlawn,7429,229,1006,1665,1801,1062,5763
Ohio,Fairport Harbor,3100,197,903,602,337,118,2157
Ohio,Fairview,94,13,13,28,0,0,54
Ohio,Fairview Park,16552,564,3241,3653,2845,1566,11869
Ohio,Forest,1609,125,470,279,55,71,1000
Ohio,Shiloh,694,80,208,120,15,10,433
Ohio,Forest Park,18667,1287,3986,3895,2251,1034,12453
Ohio,Fort Jennings,448,27,132,87,34,22,302
Ohio,Fresno,149,25,66,22,0,0,113
Ohio,Fremont,16484,1572,4576,3321,858,386,10713
Ohio,Freeport,382,42,135,80,20,5,282
Ohio,Fredericktown,3018,133,724,751,272,157,2037
Ohio,Fredericksburg,413,48,127,56,41,10,282
Ohio,Frazeysburg,1620,158,378,319,66,0,921
Ohio,Franklin Furnace,1741,272,384,263,78,84,1081
Ohio,Franklin,11840,1356,3035,2576,599,293,7859
Ohio,Frankfort,847,117,220,189,45,65,636
Ohio,Four Bridges,3462,86,222,712,727,552,2299
Ohio,Fostoria,13187,1120,4267,2536,565,260,8748
Ohio,Fort Shawnee,6143,300,1670,1563,596,398,4527
Ohio,Fort Seneca,269,20,111,76,8,0,215
Ohio,Fort Recovery,1570,86,441,242,81,72,922
Ohio,Fort Loramie,1317,59,379,181,104,101,824
Ohio,Forestville,10535,346,1320,1932,2089,1591,7278
Ohio,Sherwood,3635,101,433,754,791,472,2551
Ohio,Sherwood,737,61,220,175,38,16,510
Ohio,Sherrodsville,257,18,85,42,6,0,151
Ohio,Roseville,2185,205,609,299,32,25,1170
Ohio,Rosewood,423,32,92,112,0,0,236
Ohio,Ross,3850,260,750,908,394,87,2399
Ohio,Rossburg,231,19,102,41,11,3,176
Ohio,Rossford,6458,247,1218,1759,723,427,4374
Ohio,Rossmoyne,2242,142,583,355,226,39,1345
Ohio,Roswell,210,27,89,25,6,4,151
Ohio,Rudolph,341,36,135,84,0,6,261
Ohio,Rushsylvania,638,31,255,76,25,4,391
Ohio,Rushville,381,40,69,84,26,1,220
Ohio,Russells Point,1118,125,372,194,31,10,732
Ohio,Russellville,650,94,225,71,14,17,421
Ohio,Russia,664,5,140,128,42,45,360
Ohio,Rutland,452,44,140,104,8,0,296
Ohio,Sabina,2352,218,729,479,149,26,1601
Ohio,Rosemount,1995,144,639,314,171,128,1396
Ohio,St. Bernard,4358,323,1220,881,288,148,2860
Ohio,Rose Farm,356,7,228,22,16,0,273
Ohio,Rogers,224,41,88,26,8,2,165
Ohio,Louisville,9132,539,2339,2124,800,395,6197
Ohio,Loveland,12451,518,2113,2146,2298,1323,8398
Ohio,Loveland Park,1272,71,478,191,115,52,907
Ohio,Lowell,492,23,170,103,31,19,346
Ohio,Lowellville,1150,97,264,270,82,24,737
Ohio,Lower Salem,59,6,14,11,0,0,31
Ohio,Lucas,577,17,173,130,21,14,355
Ohio,Lucasville,2333,221,637,297,209,157,1521
Ohio,Luckey,1005,50,262,199,80,72,663
Ohio,Ludlow Falls,255,17,80,49,6,7,159
Ohio,Lynchburg,1350,54,367,266,67,17,771
Ohio,Lyndhurst,13792,608,2107,2814,3105,1989,10623
Ohio,Lyons,492,48,162,89,37,8,344
Ohio,McArthur,1925,132,525,373,71,60,1161
Ohio,Rocky River,20187,718,2339,3401,4911,3469,14838
Ohio,Rome,71,12,41,5,0,0,58
Ohio,Lore City,300,49,86,55,7,15,212
Ohio,St. Clairsville,5133,213,1169,1421,697,405,3905
Ohio,St. Johns,179,7,56,30,0,0,93
Ohio,Sebring,4320,486,1340,762,397,125,3110
Ohio,Senecaville,432,28,160,58,14,11,271
Ohio,Seven Hills,11716,697,2824,2533,2043,1064,9161
Ohio,Seven Mile,802,67,319,106,52,31,575
Ohio,Seville,2357,132,795,479,270,114,1790
Ohio,Shadyside,3752,128,1226,883,325,217,2779
Ohio,Shaker Heights,27934,734,1914,3900,4693,7706,18947
Ohio,Sharonville,13872,896,2509,2539,1984,1441,9369
Ohio,Shawnee,834,75,299,154,44,94,666
Ohio,Shawnee,670,88,177,138,9,4,416
Ohio,Shawnee Hills,826,21,85,150,169,111,536
Ohio,Shawnee Hills,2151,58,600,618,117,82,1475
Ohio,Sheffield,4004,224,850,1036,456,362,2928
Ohio,Sheffield Lake,9063,562,2321,2156,989,318,6346
Ohio,Shelby,8910,745,2573,1964,665,291,6238
Ohio,Seaman,928,119,238,156,30,26,569
Ohio,St. Henry,2529,97,636,426,248,113,1520
Ohio,Scott,313,20,119,58,9,0,206
Ohio,Scio,868,109,221,180,40,20,570
Ohio,St. Louisville,396,26,131,72,17,5,251
Ohio,St. Martin,357,1,152,59,14,39,265
Ohio,St. Marys,8117,659,2366,1771,483,146,5425
Ohio,St. Paris,2186,157,625,384,132,31,1329
Ohio,Salem,12115,1219,3925,2384,739,322,8589
Ohio,Salem Heights,3200,104,500,713,630,279,2226
Ohio,Salesville,123,13,49,23,0,0,85
Ohio,Salineville,1239,117,438,187,21,9,772
Ohio,Sandusky,25488,2646,7000,5218,1888,847,17599
Ohio,Sandyville,277,72,56,67,13,13,221
Ohio,Sarahsville,149,5,68,22,12,0,107
Ohio,Sardinia,1503,168,335,252,34,25,814
Ohio,Sardis,479,7,191,95,11,6,310
Ohio,Savannah,410,29,141,62,31,16,279
Ohio,Sawyerwood,1249,156,421,243,116,0,936
Ohio,Sciotodale,1246,79,414,370,27,37,927
Ohio,Rawson,544,29,146,109,28,7,319
Ohio,Midland,422,52,94,63,8,1,218
Ohio,Rarden,157,19,76,25,4,0,124
Ohio,Perry Heights,8553,670,2781,2040,528,164,6183
Ohio,Perrysburg,21243,539,2374,4086,4204,3082,14285
Ohio,Perrysville,768,54,227,170,21,4,476
Ohio,Pettisville,529,20,154,137,33,34,378
Ohio,Pheasant Run,1620,160,388,256,105,53,962
Ohio,Phillipsburg,493,50,152,90,46,4,342
Ohio,Philo,866,80,253,144,47,13,537
Ohio,Pickerington,19157,583,3092,4005,2864,1509,12053
Ohio,Pigeon Creek,1041,9,98,209,270,85,671
Ohio,Piketon,2050,323,470,298,88,41,1220
Ohio,Pioneer,1653,152,462,331,62,61,1068
Ohio,Piqua,20681,2325,5488,4626,911,425,13775
Ohio,Pitsburg,410,12,141,87,19,2,261
Ohio,Plain City,4330,235,898,980,679,186,2978
Ohio,Plainfield,164,5,59,37,11,1,113
Ohio,Pleasant City,423,60,104,75,22,13,274
Ohio,Plainville,22,0,0,0,11,11,22
Ohio,Chesterland,2035,79,399,443,416,173,1510
Ohio,Chesterville,228,25,52,35,24,8,144
Ohio,Cheviot,8327,795,2010,1786,906,438,5935
Ohio,Chickasaw,363,16,135,47,46,16,260
Ohio,Chillicothe,21765,2438,5904,4393,1784,1114,15633
Ohio,Chilo,89,33,16,10,2,0,61
Ohio,Chippewa Lake,711,52,218,141,63,42,516
Ohio,Chippewa Park,838,101,373,153,30,22,679
Ohio,Perry,1636,98,380,337,162,109,1086
Ohio,Pepper Pike,6115,86,549,555,1271,1840,4301
Ohio,Peninsula,590,11,140,89,119,89,448
Ohio,Pemberville,1625,41,343,329,184,113,1010
Ohio,Oregon,20207,1511,5117,4931,1675,870,14104
Ohio,Orient,303,43,84,81,3,4,215
Ohio,Orrville,8329,569,2462,1473,781,552,5837
Ohio,Orwell,1615,168,502,318,46,45,1079
Ohio,Osgood,314,15,100,45,21,21,202
Ohio,Ostrander,1025,39,295,121,135,32,622
Ohio,Ottawa,4424,312,1146,861,483,301,3103
Ohio,Ottawa Hills,4487,127,184,398,1184,1117,3010
Ohio,Ottoville,900,36,213,191,110,22,572
Ohio,Otway,98,2,32,9,5,4,52
Ohio,Owensville,854,106,287,154,42,13,602
Ohio,Oxford,21762,454,788,895,1541,1931,5609
Ohio,Choctaw Lake,1510,22,304,343,331,116,1116
Ohio,Painesville,19694,2619,4372,3180,1268,501,11940
Ohio,Pancoastburg,124,31,70,15,0,0,116
Ohio,Pandora,1202,52,313,256,120,74,815
Ohio,Park Layne,4612,486,1003,1026,171,35,2721
Ohio,Parkman,129,9,0,89,20,11,129
Ohio,Parma,80380,5774,21253,18795,7667,3375,56864
Ohio,Parma Heights,20409,1402,5060,5177,2043,964,14646
Ohio,Parral,222,17,102,42,10,2,173
Ohio,Pataskala,15120,788,3434,2978,1862,825,9887
Ohio,Patterson,144,13,46,25,1,4,89
Ohio,Paulding,3699,389,1167,541,178,111,2386
Ohio,Payne,1109,80,448,204,45,16,793
Ohio,Peebles,1857,367,516,260,54,42,1239
Ohio,Palestine,205,14,64,50,0,2,130
Ohio,Orangeville,216,10,76,20,15,9,130
Ohio,Christiansburg,564,50,205,106,20,3,384
Ohio,Cincinnati,297397,27188,49446,51144,37121,26021,190920
Ohio,Continental,998,75,377,170,34,17,673
Ohio,Convoy,1285,38,415,203,48,37,741
Ohio,Coolville,649,105,245,55,17,9,431
Ohio,Corning,452,43,135,74,10,8,270
Ohio,Cortland,7001,244,1990,1435,1191,445,5305
Ohio,Corwin,539,58,98,108,78,39,381
Ohio,Coshocton,11153,1077,3926,1759,861,349,7972
Ohio,Covedale,6623,289,1575,1086,1093,582,4625
Ohio,Covington,2606,225,880,400,127,48,1680
Ohio,Craig Beach,1174,71,416,230,77,24,818
Ohio,Crestline,4472,475,1230,825,278,81,2889
Ohio,Creston,2235,198,798,322,68,39,1425
Ohio,Cridersville,1785,156,584,342,119,53,1254
Ohio,Crooksville,2399,267,888,413,113,35,1716
Ohio,Crown City,382,37,137,55,28,4,261
Ohio,Crystal Lakes,1377,97,420,350,63,6,936
Ohio,Crystal Rock,126,26,40,0,11,0,77
Ohio,Cumberland,479,53,128,90,9,6,286
Ohio,Curtice,1842,9,527,510,179,43,1268
Ohio,Custar,135,10,51,35,2,0,98
Ohio,Cuyahoga Falls,49287,2326,11654,10820,7630,3380,35810
Ohio,Cuyahoga Heights,616,61,182,91,52,8,394
Ohio,Cygnet,746,45,231,94,34,18,422
Ohio,Cynthiana,0,0,0,0,0,0,0
Ohio,Dalton,1717,134,527,273,219,78,1231
Ohio,Connorville,160,8,54,39,15,11,127
Ohio,Conneaut,12806,1397,4566,2422,632,304,9321
Ohio,Congress,162,22,47,21,5,0,95
Ohio,Conesville,345,20,124,86,8,4,242
Ohio,Cinnamon Lake,923,45,317,252,72,28,714
Ohio,Clarington,424,36,143,93,26,2,300
Ohio,Clarksburg,537,84,146,73,22,2,327
Ohio,Clarksville,592,40,182,90,30,7,349
Ohio,Clarktown,555,60,201,155,7,14,437
Ohio,Ravenna,11642,1251,3123,2208,761,526,7869
Ohio,Clay Center,307,8,116,49,11,7,191
Ohio,Clayton,13196,463,2511,3158,1739,1290,9161
Ohio,Cleveland,390584,57562,83734,73859,25053,14849,255057
Ohio,Cleveland Heights,45388,1897,5027,8421,7121,8221,30687
Ohio,Cleves,3365,185,857,505,363,124,2034
Ohio,Clifton,152,15,31,32,20,7,105
Ohio,Churchill,2002,147,858,338,88,27,1458
Ohio,Clinton,1160,124,353,219,85,43,824
Ohio,Clyde,6305,282,1742,1631,360,207,4222
Ohio,Coal Grove,2066,260,658,399,139,72,1528
Ohio,Coalton,642,80,164,119,31,0,394
Ohio,Coldstream,1271,16,79,137,369,240,841
Ohio,Coldwater,4327,318,1597,529,287,118,2849
Ohio,College Corner,401,56,149,94,9,5,313
Ohio,Collins,482,39,241,88,7,0,375
Ohio,Columbiana,6393,235,2159,1283,813,407,4897
Ohio,Columbus,824663,61529,137586,152745,119331,63394,534585
Ohio,Columbus Grove,1971,48,630,458,81,91,1308
Ohio,Commercial Point,1643,51,354,330,133,92,960
Ohio,Concorde Hills,663,0,21,52,157,249,479
Ohio,Cloverdale,158,15,61,18,5,1,100
Ohio,Orange,3288,98,240,410,883,741,2372
Ohio,Circleville,13706,1495,4023,2197,849,483,9047
Ohio,Olmsted Falls,8923,325,1507,2174,1445,745,6196
Ohio,Ontario,6142,383,1535,1441,751,386,4496
Ohio,Pleasant Hills,541,33,181,90,78,32,414
Ohio,Pleasant Plain,147,12,59,40,7,2,120
Ohio,Pleasant Run,4898,230,1192,1315,475,111,3323
Ohio,Pleasant Run Farm,4789,196,1021,998,659,283,3157
Ohio,Pleasantville,1175,130,293,200,43,6,672
Ohio,Plumwood,257,38,82,50,6,17,193
Ohio,Plymouth,1719,137,528,313,74,54,1106
Ohio,Poland,2846,60,516,561,464,454,2055
Ohio,Polk,301,37,88,66,18,5,214
Ohio,Pomeroy,1953,239,554,323,103,68,1287
Ohio,Portage,388,12,96,59,53,46,266
Ohio,Portage Lakes,7038,325,2133,1513,1080,333,5384
Ohio,Port Clinton,6025,450,1594,1453,486,285,4268
Ohio,Norwood,19316,2316,4031,3276,2278,1024,12925
Ohio,Port Jefferson,425,30,165,68,19,4,286
Ohio,Port Washington,610,69,245,55,10,7,386
Ohio,Port William,249,23,77,21,16,3,140
Ohio,Potsdam,326,14,125,65,15,3,222
Ohio,Pottery Addition,355,11,63,97,0,0,171
Ohio,Powell,12298,59,711,1280,3139,2374,7563
Ohio,Powhatan Point,1474,152,559,285,49,21,1066
Ohio,Proctorville,554,68,207,108,24,4,411
Ohio,Prospect,1118,35,347,189,84,84,739
Ohio,Pulaski,70,6,26,0,0,0,32
Ohio,Put-in-Bay,117,7,8,66,24,8,113
Ohio,Quaker City,501,55,224,84,6,3,372
Ohio,Quincy,667,92,182,132,25,4,435
Ohio,Racine,616,42,182,158,30,14,426
Ohio,Radnor,248,9,156,57,7,0,229
Ohio,Portsmouth,20376,2956,4392,4125,1411,731,13615
Ohio,Oak Harbor,2740,99,741,613,247,151,1851
Ohio,Pleasant Hill,1167,43,329,250,64,40,726
Ohio,Oak Hill,1684,131,412,348,81,64,1036
Ohio,Pleasant Grove,1794,60,470,409,197,67,1203
Ohio,Old Washington,357,11,163,59,7,9,249
Ohio,Old Fort,200,4,53,40,11,30,138
Ohio,Olde West Chester,97,0,15,14,8,30,67
Ohio,Ohio City,753,51,305,135,27,3,521
Ohio,Oakwood village (Cuyahoga County),3689,502,718,944,365,297,2826
Ohio,Oceola,123,34,35,8,0,0,77
Ohio,Obetz,4558,502,1193,781,275,136,2887
Ohio,Oberlin,8356,328,834,1037,553,1268,4020
Ohio,Oakwood village (Paulding County),568,38,201,109,10,15,373
Ohio,Oakwood,9118,88,453,1319,2025,2111,5996
Ohio,Octa,41,7,22,2,1,0,32
Oklahoma,Brush Creek,73,14,0,0,0,37,51
Oklahoma,Brushy,945,185,195,154,69,28,631
Oklahoma,Buffalo,1408,175,443,177,100,65,960
Oklahoma,Bull Hollow,54,9,25,9,0,0,43
Oklahoma,Burbank,115,24,43,13,3,2,85
Oklahoma,Burlington,149,5,43,18,13,9,88
Oklahoma,Burneyville,562,20,145,160,56,44,425
Oklahoma,Burns Flat,2271,161,571,320,157,34,1243
Oklahoma,Bushyhead,1359,185,254,309,63,63,874
Oklahoma,McAlester,18324,2017,4317,4031,1352,799,12516
Oklahoma,McCord,1593,108,501,390,153,28,1180
Oklahoma,McCurtain,469,66,117,78,15,5,281
Oklahoma,McLoud,4587,605,1239,1095,324,73,3336
Oklahoma,Macomb,30,5,13,0,1,0,19
Oklahoma,Madill,3839,745,896,605,221,91,2558
Oklahoma,Manchester,66,5,22,11,5,0,43
Oklahoma,Mangum,2937,272,696,675,272,72,1987
Oklahoma,Manitou,228,42,61,28,3,1,135
Oklahoma,Mannford,3105,228,793,629,276,101,2027
Oklahoma,Butler,322,35,93,55,14,1,198
Oklahoma,Brooksville,54,11,15,6,3,0,35
Oklahoma,Broken Arrow,103437,4271,17301,24416,15446,5899,67333
Oklahoma,Broken Bow,4127,446,988,701,248,54,2437
Oklahoma,Blue,194,44,85,19,0,13,161
Oklahoma,Bluejacket,316,35,66,72,7,6,186
Oklahoma,Boise City,1140,135,317,191,111,37,791
Oklahoma,Bokchito,638,87,200,108,34,3,432
Oklahoma,Bokoshe,484,89,138,83,17,1,328
Oklahoma,Boley,1098,320,328,221,39,17,925
Oklahoma,Boswell,707,94,223,109,28,14,468
Oklahoma,Bowlegs,391,62,93,93,21,8,277
Oklahoma,Box,125,18,53,46,8,0,125
Oklahoma,Bromide,118,26,36,17,7,3,89
Oklahoma,Boynton,193,26,45,32,8,3,114
Oklahoma,Braggs,270,11,59,70,13,16,169
Oklahoma,Braman,178,9,62,35,17,3,126
Oklahoma,Bray,1291,86,423,254,94,31,888
Oklahoma,Breckenridge,290,8,93,48,31,9,189
Oklahoma,Brent,808,82,230,164,47,25,548
Oklahoma,Mannsville,828,92,232,137,32,12,505
Oklahoma,Bridgeport,115,30,28,18,4,3,83
Oklahoma,Briggs,287,31,44,49,0,9,133
Oklahoma,Bristow,4263,437,1214,764,219,99,2733
Oklahoma,Bradley,107,6,40,24,3,0,73
Oklahoma,Bridge Creek,271,12,66,66,20,10,174
Oklahoma,Tecumseh,6583,449,1562,1673,324,131,4139
Oklahoma,Marietta,144,16,43,10,7,3,79
Oklahoma,Mountain Park,477,38,175,79,11,14,317
Oklahoma,Mountain View,777,84,208,160,62,33,547
Oklahoma,Mulberry,139,22,19,11,15,2,69
Oklahoma,Muldrow,3331,356,897,644,151,35,2083
Oklahoma,Mulhall,273,21,96,65,11,5,198
Oklahoma,Zion,35,0,12,6,4,2,24
Oklahoma,Zena,204,0,68,78,0,9,155
Oklahoma,Zeb,673,67,158,164,66,21,476
Oklahoma,Yukon,24746,878,4932,6451,3294,1201,16756
Oklahoma,Yeager,71,8,16,16,2,0,42
Oklahoma,Yale,1145,162,404,167,82,6,821
Oklahoma,Wynona,474,63,164,56,18,4,305
Oklahoma,Wynnewood,2235,273,637,444,151,90,1595
Oklahoma,Wyandotte,342,44,93,56,13,10,216
Oklahoma,Kinta,257,26,51,46,13,9,145
Oklahoma,Kingston,1537,220,438,274,79,45,1056
Oklahoma,Kingfisher,4755,345,1175,987,503,206,3216
Oklahoma,Kildare,71,7,23,16,3,2,51
Oklahoma,Kiefer,2055,118,541,432,171,48,1310
Oklahoma,Keys,578,20,131,139,57,43,390
Oklahoma,Keyes,238,32,86,47,18,5,188
Oklahoma,Ketchum,439,42,109,96,35,5,287
Oklahoma,Keota,651,106,149,66,17,10,348
Oklahoma,Kenwood,1011,155,305,154,65,17,696
Oklahoma,Kenton,59,0,31,14,0,0,45
Oklahoma,Mounds,1192,89,386,182,54,26,737
Oklahoma,Marble City,225,50,53,28,6,5,142
Oklahoma,Morrison,773,78,159,148,65,44,494
Oklahoma,Mooreland,1724,97,378,393,101,57,1026
Oklahoma,Marietta,2683,351,730,355,87,50,1573
Oklahoma,Marland,282,48,60,46,1,0,155
Oklahoma,Marlow,4632,498,1290,925,345,128,3186
Oklahoma,Marshall,309,43,82,55,17,0,197
Oklahoma,Martha,141,12,35,32,5,11,95
Oklahoma,Maud,917,96,237,179,25,28,565
Oklahoma,May,49,0,16,13,2,2,33
Oklahoma,Maysville,1288,188,365,164,58,16,791
Oklahoma,Mazie,207,0,47,40,10,0,97
Oklahoma,Mead,78,7,20,23,7,6,63
Oklahoma,Medford,1015,69,234,198,110,72,683
Oklahoma,Medicine Park,233,12,49,96,31,11,199
Oklahoma,Meeker,1158,93,286,266,86,41,772
Oklahoma,Meno,239,31,40,40,35,2,148
Oklahoma,Meridian,52,3,21,10,6,0,40
Oklahoma,Meridian,1085,70,337,304,62,31,804
Oklahoma,Miami,13666,1321,2941,2958,882,462,8564
Oklahoma,Midwest City,56507,4039,11050,14533,5448,2226,37296
Oklahoma,Milburn,320,48,80,73,15,3,219
Oklahoma,Mill Creek,312,41,86,62,22,1,212
Oklahoma,Millerton,287,39,86,53,7,4,189
Oklahoma,Minco,1364,119,410,258,124,25,936
Oklahoma,Moffett,128,29,43,10,3,0,85
Oklahoma,Monroe,199,25,66,52,7,0,150
Oklahoma,Moore,58615,3390,11696,14043,6070,2491,37690
Oklahoma,Morris,1511,75,287,397,88,42,889
Oklahoma,Maramec,95,20,26,15,1,2,64
Oklahoma,Stoney Point,284,18,78,27,23,3,149
Oklahoma,Strang,65,17,14,20,4,0,55
Oklahoma,Tribbey,370,62,137,66,8,3,276
Oklahoma,Tryon,527,51,154,67,31,8,311
Oklahoma,Tullahassee,284,13,97,15,6,0,131
Oklahoma,Tulsa,398082,34024,65479,81049,52325,26736,259613
Oklahoma,Tupelo,345,71,77,43,12,5,208
Oklahoma,Turley,2291,454,693,495,59,14,1715
Oklahoma,Turpin,577,71,115,93,37,0,316
Oklahoma,Tushka,286,15,62,65,30,7,179
Oklahoma,Tuskahoma,132,2,58,28,10,4,102
Oklahoma,Tuttle,6411,303,1185,1771,704,115,4078
Oklahoma,Kenefic,201,27,42,31,4,8,112
Oklahoma,Twin Oaks,227,56,47,80,0,0,183
Oklahoma,Tyrone,965,108,188,139,54,10,499
Oklahoma,Union City,1511,101,482,400,135,83,1201
Oklahoma,Valley Brook,718,120,201,126,35,2,484
Oklahoma,Valley Park,58,1,9,6,4,5,25
Oklahoma,Arpelar,281,7,93,57,20,14,191
Oklahoma,Arnett,498,43,120,128,65,12,368
Oklahoma,Armstrong,185,43,41,27,6,0,117
Oklahoma,Arkoma,1915,322,582,347,75,50,1376
Oklahoma,Ardmore,24955,2586,5591,4776,2128,1185,16266
Oklahoma,Arcadia,175,6,60,41,11,3,121
Oklahoma,Arapaho,550,63,221,94,29,6,413
Oklahoma,Apache,1282,134,314,210,109,42,809
Oklahoma,Antlers,2471,336,576,491,138,86,1627
Oklahoma,Tonkawa,3149,277,597,644,273,136,1927
Oklahoma,Anadarko,6777,719,1582,1148,478,238,4165
Oklahoma,Titanic,252,23,73,39,24,7,166
Oklahoma,Tipton,867,161,173,187,75,23,619
Oklahoma,Temple,1091,145,376,132,45,14,712
Oklahoma,Tenkiller,523,102,142,107,12,2,365
Oklahoma,Teresita,147,7,57,37,12,5,118
Oklahoma,Terlton,107,9,50,19,0,0,78
Oklahoma,Terral,390,63,128,48,15,4,258
Oklahoma,Texanna,2273,368,696,511,126,67,1768
Oklahoma,Texhoma,851,143,156,132,62,14,507
Oklahoma,Texola,54,0,49,0,5,0,54
Oklahoma,Thackerville,471,67,116,90,7,1,281
Oklahoma,The Village,9223,554,1581,1954,1964,847,6900
Oklahoma,Thomas,1220,152,279,195,141,85,852
Oklahoma,Stonewall,384,51,127,96,16,5,295
Oklahoma,Stilwell,4007,594,1018,582,240,84,2518
Oklahoma,Stillwater,47523,1045,3870,6193,5650,4888,21646
Oklahoma,Stigler,2725,412,687,459,210,56,1824
Oklahoma,Stidham,45,15,4,2,2,0,23
Oklahoma,Sterling,620,65,166,152,42,17,442
Oklahoma,Steely Hollow,157,4,34,57,6,17,118
Oklahoma,Springer,639,72,195,110,56,15,448
Oklahoma,Sportsmen Acres,371,29,88,71,10,6,204
Oklahoma,Spiro,2640,454,682,465,64,72,1737
Oklahoma,Sperry,1140,134,328,226,46,23,757
Oklahoma,Spencer,4004,470,1063,889,174,196,2792
Oklahoma,Spavinaw,350,73,108,77,6,3,267
Oklahoma,Tiawah,223,0,36,52,33,17,138
Oklahoma,Tishomingo,3075,321,586,823,145,85,1960
Oklahoma,Amorita,6,0,0,2,2,0,4
Oklahoma,Ames,239,24,81,39,11,13,168
Oklahoma,Amber,370,27,114,56,25,4,226
Oklahoma,Beggs,1189,117,421,199,47,25,809
Oklahoma,Belfonte,269,71,26,44,11,6,158
Oklahoma,Goltry,183,17,49,35,12,14,127
Oklahoma,Goldsby,1982,137,387,424,291,96,1335
Oklahoma,Glenpool,11982,727,1960,3014,1177,386,7264
Oklahoma,Glencoe,574,16,186,101,33,16,352
Oklahoma,Gideon,15,0,7,0,0,0,7
Oklahoma,Gerty,85,15,30,11,5,1,62
Oklahoma,Taloga,388,7,138,51,43,34,273
Oklahoma,Talihina,1087,153,274,192,73,40,732
Oklahoma,Talala,324,28,67,55,21,8,179
Oklahoma,Tahlequah,16354,1369,1866,2799,1638,1039,8711
Oklahoma,Tagg Flats,107,18,9,24,0,0,51
Oklahoma,Taft,176,12,68,25,4,4,113
Oklahoma,Sycamore,358,106,97,35,0,0,238
Oklahoma,Swink,83,19,25,21,3,1,69
Oklahoma,Sweetwater,186,11,54,30,18,6,119
Oklahoma,Summit,135,30,40,20,5,2,97
Oklahoma,Sulphur,5032,774,1296,832,268,190,3360
Oklahoma,Sugden,38,8,12,13,0,0,33
Oklahoma,Stuart,184,17,51,39,6,2,115
Oklahoma,Stroud,2710,292,667,683,197,50,1889
Oklahoma,Strong City,62,1,29,11,5,0,46
Oklahoma,Stringtown,340,43,110,65,18,8,244
Oklahoma,Stratford,1503,155,431,217,68,35,906
Oklahoma,Bee,137,39,74,8,0,0,121
Oklahoma,Beaver,1592,248,451,218,95,60,1072
Oklahoma,Bearden,142,14,29,36,11,4,94
Oklahoma,Bartlesville,36360,2202,7212,7385,5299,2401,24499
Oklahoma,Alva,5023,353,954,832,507,307,2953
Oklahoma,Altus,19549,2498,3345,4297,1475,771,12386
Oklahoma,Allen,831,91,290,114,36,37,568
Oklahoma,Aline,245,19,69,53,24,1,166
Oklahoma,Alex,536,62,134,112,35,12,355
Oklahoma,Alderson,309,26,86,53,30,5,200
Oklahoma,Albion,59,4,17,16,0,1,38
Oklahoma,Albany,102,4,34,36,4,0,78
Oklahoma,Akins,610,77,193,101,22,16,409
Oklahoma,Agra,300,32,88,43,10,8,181
Oklahoma,Afton,1063,130,253,196,63,17,659
Oklahoma,Addington,101,7,37,17,10,2,73
Oklahoma,Tatums,111,7,55,17,2,0,81
Oklahoma,Adair,868,60,204,221,34,16,535
Oklahoma,Achille,467,65,125,84,17,10,301
Oklahoma,Valliant,843,136,167,177,32,21,533
Oklahoma,Velma,697,48,182,125,34,11,400
Oklahoma,Vera,164,12,61,28,8,0,109
Oklahoma,Asher,413,65,135,54,20,3,277
Oklahoma,Ashland,39,4,11,17,1,1,34
Oklahoma,Atoka,3077,374,780,565,161,91,1971
Oklahoma,Atwood,47,5,13,15,5,0,38
Oklahoma,Avant,343,39,127,46,8,0,220
Oklahoma,Badger Lee,96,17,15,0,0,0,32
Oklahoma,Ballou,107,10,45,5,7,8,75
Oklahoma,Barnsdall,1085,102,374,139,87,10,712
Oklahoma,Ada,17149,1365,3101,2891,1957,1293,10607
Oklahoma,Kendrick,83,14,29,13,1,0,57
Oklahoma,Washington,689,44,119,166,58,40,427
Oklahoma,Kellyville,1367,158,355,214,39,8,774
Oklahoma,Elk City,12424,1282,3180,1936,1088,563,8049
Oklahoma,Elmer,113,15,12,39,4,2,72
Oklahoma,Elm Grove,167,20,74,16,6,8,124
Oklahoma,Elmore City,756,95,239,123,34,9,500
Oklahoma,El Reno,17852,1784,4563,3833,1044,405,11629
Oklahoma,Empire City,810,49,202,237,65,26,579
Oklahoma,Elgin,2702,118,499,670,258,163,1708
Oklahoma,Enid,50685,4767,11493,9624,4586,2503,32973
Oklahoma,Erin Springs,191,25,71,55,8,0,159
Oklahoma,Etowah,85,9,19,27,5,4,64
Oklahoma,Eufaula,2899,353,759,700,182,103,2097
Oklahoma,Evening Shade,305,33,110,53,74,8,278
Oklahoma,Fairfax,1491,162,470,255,76,38,1001
Oklahoma,Fairfield,580,47,188,59,28,33,355
Oklahoma,Erick,1105,170,274,165,90,3,702
Oklahoma,Fairland,1123,92,307,221,47,21,688
Oklahoma,Eldorado,449,44,104,95,33,8,284
Oklahoma,Edmond,86739,2268,8666,15505,17084,11718,55241
Oklahoma,Dripping Springs,29,0,14,0,3,0,17
Oklahoma,Drowning Creek,185,45,34,39,8,0,126
Oklahoma,Drummond,433,87,80,73,28,3,271
Oklahoma,Drumright,2929,291,740,552,259,89,1931
Oklahoma,Dry Creek,314,30,70,84,14,17,215
Oklahoma,Duchess Landing,258,0,58,39,0,13,110
Oklahoma,Eldon,240,15,90,23,35,16,179
Oklahoma,Duncan,23317,2385,5675,4607,2012,893,15572
Oklahoma,Dustin,295,34,100,59,13,0,206
Oklahoma,Dwight Mission,0,0,0,0,0,0,0
Oklahoma,Eagletown,642,66,242,107,12,15,442
Oklahoma,Eakly,384,54,84,60,15,8,221
Oklahoma,Earlsboro,487,64,130,112,31,14,351
Oklahoma,East Duke,349,24,87,81,31,25,248
Oklahoma,Durant,16767,1839,2918,2913,1424,1031,10125
Oklahoma,Fairmont,221,18,112,28,13,6,177
Oklahoma,Fair Oaks,56,3,12,20,8,4,47
Oklahoma,Fairview,2629,264,725,617,163,78,1847
Oklahoma,Foyil,281,35,65,44,11,10,165
Oklahoma,Francis,323,34,73,53,24,0,184
Oklahoma,Frederick,3804,663,896,505,222,152,2438
Oklahoma,Freedom,247,18,52,72,24,5,171
Oklahoma,Friendship,16,0,8,2,0,3,13
Oklahoma,Gage,473,62,124,78,39,16,319
Oklahoma,Foster,117,11,49,17,15,1,93
Oklahoma,Gans,331,48,84,59,8,5,204
Oklahoma,Garvin,197,25,54,27,8,3,117
Oklahoma,Gate,132,20,29,26,10,2,87
Oklahoma,Geary,1147,115,230,189,65,27,626
Oklahoma,Gene Autry,135,18,58,19,3,0,98
Oklahoma,Geronimo,983,51,229,198,85,31,594
Oklahoma,Norman,117353,4834,14486,20654,15663,13094,68731
Oklahoma,Garber,683,59,211,135,59,23,487
Oklahoma,Foss,174,27,60,24,19,4,134
Oklahoma,Fort Towson,620,97,176,109,38,27,447
Oklahoma,Fort Supply,447,18,140,65,28,4,255
Oklahoma,Fallis,20,1,9,4,4,0,18
Oklahoma,Fanshawe,347,36,94,63,19,17,229
Oklahoma,Fargo,335,46,89,56,24,14,229
Oklahoma,Faxon,67,10,24,15,4,4,57
Oklahoma,Felt,91,9,16,10,15,3,53
Oklahoma,Fitzhugh,285,10,64,60,37,16,187
Oklahoma,Fletcher,1140,45,290,235,124,21,715
Oklahoma,Flint Creek,810,50,332,156,43,0,581
Oklahoma,Flute Springs,62,6,30,8,3,0,47
Oklahoma,Foraker,6,0,6,0,0,0,6
Oklahoma,Forest Park,1105,45,204,302,190,158,899
Oklahoma,Forgan,382,32,129,64,26,27,278
Oklahoma,Fort Cobb,625,54,199,89,61,34,437
Oklahoma,Fort Coffee,518,78,121,76,46,8,329
Oklahoma,Fort Gibson,4121,142,901,865,524,225,2657
Oklahoma,Dover,306,39,79,42,20,5,185
Oklahoma,Norge,165,21,58,33,0,0,112
Oklahoma,Verdigris,4203,186,862,1098,458,148,2752
Oklahoma,Ratliff City,131,4,67,11,0,0,82
Oklahoma,Old Eucha,13,2,5,4,0,0,11
Oklahoma,Old Green,582,36,133,77,46,0,292
Oklahoma,Olustee,537,31,114,105,10,7,267
Oklahoma,Oologah,1135,76,257,227,125,55,740
Oklahoma,Optima,501,103,77,29,4,7,220
Oklahoma,Orlando,153,18,56,16,2,2,94
Oklahoma,Oktaha,376,45,96,84,11,2,238
Oklahoma,Osage,113,24,61,11,4,0,100
Oklahoma,Paden,585,58,182,96,12,17,365
Oklahoma,Panama,1284,197,426,205,34,18,880
Oklahoma,Panola,94,7,26,28,3,0,64
Oklahoma,Paoli,573,57,177,92,30,7,363
Oklahoma,Paradise Hill,56,7,11,7,12,5,42
Oklahoma,Park Hill,3667,389,660,576,238,196,2059
Oklahoma,Owasso,32650,1564,5133,7281,5055,1597,20630
Oklahoma,Pauls Valley,6073,769,1600,880,475,240,3964
Oklahoma,Okmulgee,12350,1015,2529,2880,911,367,7702
Oklahoma,Okemah,3276,400,721,501,220,113,1955
Oklahoma,North Enid,880,36,265,159,77,53,590
Oklahoma,North Miami,358,55,108,51,18,0,232
Oklahoma,Notchietown,291,71,101,12,37,3,224
Oklahoma,Nowata,3746,510,1097,576,215,128,2526
Oklahoma,Oak Grove,10,10,0,0,0,0,10
Oklahoma,Oakhurst,2312,327,567,504,107,57,1562
Oklahoma,Oklahoma City,610672,59213,100115,120758,76150,38548,394784
Oklahoma,Oakland,1089,220,202,126,52,20,620
Oklahoma,Oakwood,48,3,19,6,3,0,31
Oklahoma,Ochelata,380,21,138,80,22,9,270
Oklahoma,Oilton,1082,116,400,143,49,20,728
Oklahoma,Okarche,1255,61,251,390,172,29,903
Oklahoma,Okay,581,74,168,134,25,7,408
Oklahoma,Okeene,1014,113,222,266,96,28,725
Oklahoma,Oaks,336,28,95,43,11,6,183
Oklahoma,Pawhuska,3663,271,1256,900,87,41,2555
Oklahoma,Pawnee,2228,222,602,430,171,79,1504
Oklahoma,Peavine,360,33,108,55,42,11,249
Oklahoma,Porum,660,109,160,110,19,0,398
Oklahoma,Poteau,8624,831,2026,1668,538,443,5506
Oklahoma,Prague,2389,224,578,570,138,80,1590
Oklahoma,Proctor,196,15,50,63,0,13,141
Oklahoma,Prue,508,90,160,65,14,8,337
Oklahoma,Pryor Creek,9484,737,2271,1804,757,501,6070
Oklahoma,Porter,625,81,169,137,51,4,442
Oklahoma,Pump Back,218,0,56,71,10,21,158
Oklahoma,Putnam,15,2,6,7,0,0,15
Oklahoma,Quapaw,887,136,213,190,12,19,570
Oklahoma,Quinton,1026,173,208,257,36,6,680
Oklahoma,Ralston,347,45,101,66,17,1,230
Oklahoma,Ramona,530,67,187,84,33,5,376
Oklahoma,Randlett,362,50,93,93,23,9,268
Oklahoma,Purcell,6292,983,1282,1295,579,98,4237
Oklahoma,Pond Creek,941,83,215,170,91,49,608
Oklahoma,Ponca City,24846,2144,5333,5386,2299,968,16130
Oklahoma,Pocola,4026,309,1277,861,207,86,2740
Oklahoma,Peggs,753,77,197,128,53,33,488
Oklahoma,Pensacola,134,19,33,20,1,3,76
Oklahoma,Peoria,107,19,45,10,5,0,79
Oklahoma,Perkins,2861,180,660,476,261,149,1726
Oklahoma,Perry,5082,448,1120,968,719,166,3421
Oklahoma,Pettit,916,0,122,152,118,218,610
Oklahoma,Phillips,110,15,41,18,0,3,77
Oklahoma,Piedmont,6502,175,720,1478,1268,324,3965
Oklahoma,Piney,233,26,7,0,42,35,110
Oklahoma,Pinhook Corner,169,0,54,49,7,0,110
Oklahoma,Pink,2281,211,576,521,153,74,1535
Oklahoma,Pin Oak Acres,409,0,133,77,55,14,279
Oklahoma,Pittsburg,183,28,48,30,10,3,119
Oklahoma,Platter,158,48,48,17,0,0,113
Oklahoma,Pocasset,151,21,38,28,4,1,92
Oklahoma,Verden,582,84,126,109,24,10,353
Oklahoma,Noble,6626,488,1649,1247,528,188,4100
Oklahoma,Ninnekah,1018,84,299,206,90,17,696
Oklahoma,Nicut,244,45,89,40,7,7,188
Oklahoma,Wann,191,12,63,32,18,5,130
Oklahoma,Wapanucka,376,70,87,65,9,5,236
Oklahoma,Wardville,47,5,16,6,3,5,35
Oklahoma,Warner,1844,190,321,374,90,52,1027
Oklahoma,Warr Acres,10342,909,2083,2332,893,398,6615
Oklahoma,Warwick,125,14,60,20,8,3,105
Oklahoma,Wanette,279,24,67,69,12,11,183
Oklahoma,Bell,445,74,147,51,0,0,272
Oklahoma,Watts,309,53,92,43,13,0,201
Oklahoma,Wauhillau,448,30,102,59,49,26,266
Oklahoma,Waukomis,1477,93,416,269,110,35,923
Oklahoma,Waurika,2062,187,672,404,114,52,1429
Oklahoma,Wayne,683,92,178,123,43,19,455
Oklahoma,Waynoka,1187,143,328,142,83,36,732
Oklahoma,Watonga,4110,556,1285,858,214,81,2994
Oklahoma,Weatherford,11663,490,1627,1609,1336,639,5701
Oklahoma,Walters,2554,281,645,490,188,60,1664
Oklahoma,Wainwright,175,24,48,17,6,0,95
Oklahoma,Slick,93,14,37,13,0,0,64
Oklahoma,Smith Village,73,14,20,27,4,0,65
Oklahoma,Smithville,103,14,20,16,12,0,62
Oklahoma,Snake Creek,178,27,52,41,9,0,129
Oklahoma,Snyder,1549,187,296,316,129,53,981
Oklahoma,Soper,202,20,63,50,6,10,149
Oklahoma,Wakita,313,37,117,68,21,11,254
Oklahoma,Sour John,41,13,25,3,0,0,41
Oklahoma,Sparks,180,23,86,18,2,0,129
Oklahoma,Spaulding,129,23,35,27,5,2,92
Oklahoma,Vian,1270,163,353,266,40,16,838
Oklahoma,Vici,813,53,236,107,147,13,556
Oklahoma,Vinita,5610,702,1520,1105,352,183,3862
Oklahoma,Wagoner,8583,904,2281,1542,522,243,5492
Oklahoma,South Coffeyville,781,67,196,190,64,17,534
Oklahoma,Webb City,77,5,16,23,0,0,44
Oklahoma,Webbers Falls,544,77,127,103,35,9,351
Oklahoma,Welch,644,45,174,143,41,8,411
Oklahoma,Woodall,884,70,215,240,37,18,580
Oklahoma,Woodlawn Park,160,6,32,44,42,18,142
Oklahoma,Woodward,12591,1066,2944,2264,1059,579,7912
Oklahoma,Wright City,635,67,175,95,37,26,400
Oklahoma,Jefferson,13,3,8,2,0,0,13
Oklahoma,Jenks,19030,402,2112,3886,3564,2018,11982
Oklahoma,Wister,1009,146,289,203,35,10,683
Oklahoma,Jennings,250,27,98,36,7,0,168
Oklahoma,Johnson,191,25,49,40,23,6,143
Oklahoma,Jones,2860,246,771,600,176,113,1906
Oklahoma,Justice,1294,20,327,294,136,79,856
Oklahoma,Kansas,857,116,238,113,40,11,518
Oklahoma,Katie,259,25,101,39,8,7,180
Oklahoma,Kaw City,314,29,104,97,6,5,241
Oklahoma,Jet,227,10,60,49,16,12,147
Oklahoma,Winchester,522,61,177,119,25,20,402
Oklahoma,Wilson,1581,166,532,229,98,26,1051
Oklahoma,Willow,128,10,36,68,6,2,122
Oklahoma,Weleetka,946,156,188,213,35,34,626
Oklahoma,Welling,841,131,227,82,76,34,550
Oklahoma,Wellston,778,58,225,161,56,20,520
Oklahoma,West Peavine,213,53,63,21,7,11,155
Oklahoma,Westport,440,10,143,109,48,28,338
Oklahoma,West Siloam Springs,982,184,267,182,55,6,694
Oklahoma,Westville,1701,302,393,236,52,22,1005
Oklahoma,Wetumka,1288,205,289,207,70,29,800
Oklahoma,Wewoka,3436,495,817,746,199,85,2342
Oklahoma,Whitefield,463,66,95,66,54,1,282
Oklahoma,White Oak,276,5,84,74,27,2,192
Oklahoma,Whitesboro,201,11,68,35,22,2,138
Oklahoma,White Water,26,0,0,26,0,0,26
Oklahoma,Wickliffe,14,0,9,5,0,0,14
Oklahoma,Wilburton,2765,407,500,615,85,92,1699
Oklahoma,Slaughterville,4226,309,1065,934,151,79,2538
Oklahoma,Skiatook,7827,776,2119,1387,486,124,4892
Oklahoma,Skedee,57,4,15,7,3,1,30
Oklahoma,Simms,296,87,89,64,0,2,242
Oklahoma,Redbird Smith,351,46,120,97,6,32,301
Oklahoma,Red Oak,598,110,204,100,10,18,442
Oklahoma,Red Rock,344,23,108,81,10,2,224
Oklahoma,Remy,548,6,175,136,49,15,381
Oklahoma,Renfrow,13,2,11,0,0,0,13
Oklahoma,Rentiesville,141,25,43,27,17,2,114
Oklahoma,Redbird,71,9,27,9,1,0,46
Oklahoma,Reydon,155,8,74,23,13,1,119
Oklahoma,Ringwood,615,56,135,97,17,8,313
Oklahoma,Ripley,315,37,86,54,15,15,207
Oklahoma,River Bottom,164,28,62,40,12,3,145
Oklahoma,Rock Island,774,119,226,140,24,18,527
Oklahoma,Rocky,156,11,76,29,4,0,120
Oklahoma,Rocky Ford,54,5,14,7,8,0,34
Oklahoma,Ringling,1026,98,265,184,41,6,594
Oklahoma,Ravia,452,94,130,83,12,8,327
Oklahoma,Rattan,289,32,88,50,21,17,208
Oklahoma,Murphy,170,6,67,39,0,7,119
Oklahoma,Nicoma Park,2440,271,574,542,183,66,1636
Oklahoma,Nichols Hills,3839,42,118,438,1299,912,2809
Oklahoma,New Woodville,156,18,19,10,5,0,52
Oklahoma,Newkirk,2283,213,579,576,93,46,1507
Oklahoma,New Eucha,554,82,100,144,27,14,367
Oklahoma,New Cordell,2920,240,689,571,284,95,1879
Oklahoma,Newcastle,8712,438,1603,1880,1251,563,5735
Oklahoma,New Alluwe,83,14,41,10,5,0,70
Oklahoma,Nescatunga,93,21,44,5,0,0,70
Oklahoma,Nash,219,4,66,57,25,10,162
Oklahoma,Nardin,92,0,76,0,16,0,92
Oklahoma,Narcissa,73,4,16,27,5,12,64
Oklahoma,Mutual,114,17,43,13,1,2,76
Oklahoma,Mustang,19112,868,3869,5092,1990,701,12520
Oklahoma,Muskogee,38776,3808,8307,7663,3285,1432,24495
Oklahoma,Rocky Mountain,379,53,115,58,27,2,255
Oklahoma,Kemp,122,10,42,30,7,0,89
Oklahoma,Roff,658,61,185,95,30,15,386
Oklahoma,Roosevelt,302,24,91,52,20,0,187
Oklahoma,Seiling,833,62,209,179,69,26,545
Oklahoma,Seminole,7508,771,1486,1458,418,248,4381
Oklahoma,Sentinel,865,128,188,138,74,18,546
Oklahoma,Sequoyah,664,64,244,116,50,8,482
Oklahoma,Shady Grove CDP (Cherokee County),465,32,123,63,45,21,284
Oklahoma,Shady Grove CDP (McIntosh County),252,66,27,89,19,0,201
Oklahoma,Scraper,197,0,67,78,9,11,165
Oklahoma,Shady Point,1090,142,283,204,32,29,690
Oklahoma,Sharon,65,7,26,4,4,0,41
Oklahoma,Shattuck,1264,99,362,205,133,66,865
Oklahoma,Shawnee,30866,2623,6207,6338,2764,1250,19182
Oklahoma,Shidler,415,57,126,60,22,7,272
Oklahoma,Short,455,94,103,62,16,0,275
Oklahoma,Silo,334,32,72,69,35,27,235
Oklahoma,Shamrock,61,8,19,7,0,0,34
Oklahoma,Schulter,457,76,105,89,23,7,300
Oklahoma,Sayre,4603,808,1202,620,241,220,3091
Oklahoma,Sawyer,354,39,121,79,21,9,269
Oklahoma,Rose,149,14,44,19,0,9,86
Oklahoma,Rosedale,76,16,17,15,0,0,48
Oklahoma,Rosston,44,13,9,8,5,0,35
Oklahoma,Rush Springs,1312,139,403,219,51,41,853
Oklahoma,Ryan,795,146,209,134,35,12,536
Oklahoma,St. Louis,115,21,49,15,8,4,97
Oklahoma,Salem,133,20,65,11,11,0,107
Oklahoma,Salina,1304,207,333,214,109,27,890
Oklahoma,Sallisaw,8698,1025,2244,1739,530,251,5789
Oklahoma,Sams Corner,135,0,43,31,20,11,105
Oklahoma,Sand Hill,368,26,134,78,25,18,281
Oklahoma,Sand Springs,19397,1451,4299,4321,1725,724,12520
Oklahoma,Sapulpa,20399,2113,4919,4367,1440,616,13455
Oklahoma,Sasakwa,126,17,23,19,2,0,61
Oklahoma,Savanna,668,41,191,155,27,27,441
Oklahoma,Roland,3339,402,773,693,159,26,2053
Oklahoma,Bennington,316,34,96,29,41,4,204
Oklahoma,Tamaha,142,36,48,17,10,2,113
Oklahoma,Bessie,165,20,62,23,10,6,121
Oklahoma,Indianola,0,0,0,0,0,0,0
Oklahoma,Indiahoma,346,29,95,85,21,3,233
Oklahoma,Idabel,7026,883,1430,1235,591,220,4359
Oklahoma,Hydro,976,96,278,153,96,35,658
Oklahoma,Hunter,218,25,87,22,5,3,142
Oklahoma,Hulbert,679,126,144,90,40,10,410
Oklahoma,Indianola,171,27,56,20,11,1,115
Oklahoma,Hugo,5277,893,1253,853,237,116,3352
Oklahoma,Horntown,102,12,23,22,9,12,78
Oklahoma,Hoot Owl,0,0,0,0,0,0,0
Oklahoma,Hooker,1950,239,308,325,274,22,1168
Oklahoma,Hominy,3556,527,1131,642,144,127,2571
Oklahoma,Hollister,13,3,6,2,0,0,11
Oklahoma,Hollis,2061,280,450,417,212,47,1406
Oklahoma,Howe,916,146,288,149,23,5,611
Oklahoma,Holdenville,5748,1123,1541,1144,227,48,4083
Oklahoma,Inola,1934,148,490,442,119,51,1250
Oklahoma,Isabella,199,36,28,11,25,0,100
Oklahoma,Leon,88,12,38,7,7,0,64
Oklahoma,Lequire,160,22,54,25,9,8,118
Oklahoma,Lexington,2397,395,736,304,113,9,1557
Oklahoma,Liberty,331,32,100,91,15,0,238
Oklahoma,Liberty,200,8,49,46,18,7,128
Oklahoma,Lima,62,15,21,5,2,4,47
Oklahoma,Iron Post,82,4,64,8,0,0,76
Oklahoma,Limestone,579,47,106,157,79,35,424
Oklahoma,Loco,118,23,48,16,5,4,96
Oklahoma,Locust Grove,1386,169,389,221,63,20,862
Oklahoma,Lone Grove,5173,425,1458,966,347,126,3322
Oklahoma,Lone Wolf,450,34,127,109,32,24,326
Oklahoma,Jay,2572,386,656,385,106,44,1577
Oklahoma,IXL,39,10,21,2,0,0,33
Oklahoma,Lindsay,2815,237,908,550,162,59,1916
Oklahoma,Hoffman,135,25,36,14,9,2,86
Oklahoma,Hobart,3685,496,817,747,299,113,2472
Oklahoma,Hitchita,107,22,30,5,0,0,57
Oklahoma,Devol,151,7,50,32,8,1,98
Oklahoma,Dewar,898,78,262,163,38,6,547
Oklahoma,Dewey,3497,265,1145,662,81,66,2219
Oklahoma,Dibble,912,146,277,146,47,5,621
Oklahoma,Dickson,1411,151,337,238,99,59,884
Oklahoma,Dill City,605,81,202,77,26,7,393
Oklahoma,Depew,408,58,107,61,14,18,258
Oklahoma,Disney,197,29,55,57,15,1,157
Oklahoma,Dotyville,97,0,21,16,7,8,52
Oklahoma,Dougherty,244,25,80,34,11,4,154
Oklahoma,Douglas,17,2,3,5,2,0,12
Oklahoma,Long,287,39,63,40,24,15,181
Oklahoma,Longdale,203,31,81,21,0,0,133
Oklahoma,Longtown,2925,524,727,834,190,109,2384
Oklahoma,Dodge,118,4,42,14,10,0,70
Oklahoma,Dennis,137,19,18,36,11,0,84
Oklahoma,Del City,21898,1917,5010,5390,1303,580,14200
Oklahoma,Delaware,349,58,124,61,10,0,253
Oklahoma,Hitchcock,78,18,28,12,3,2,63
Oklahoma,Hinton,3219,468,796,722,167,56,2209
Oklahoma,Hillsdale,133,7,25,33,22,6,93
Oklahoma,Hickory,86,13,23,9,3,0,48
Oklahoma,Henryetta,5812,619,1634,1108,297,165,3823
Oklahoma,Hennessey,2297,287,645,392,91,66,1481
Oklahoma,Hendrix,63,7,28,8,2,0,45
Oklahoma,Helena,1452,206,612,330,100,21,1269
Oklahoma,Heavener,3394,708,724,439,141,47,2059
Oklahoma,Healdton,2784,277,1014,387,212,53,1943
Oklahoma,Davenport,849,101,262,117,16,11,507
Oklahoma,Davidson,343,74,111,22,11,2,220
Oklahoma,Davis,2738,326,628,444,215,85,1698
Oklahoma,Deer Creek,143,7,36,19,10,2,74
Oklahoma,Deer Lick,30,0,18,12,0,0,30
Oklahoma,Lenapah,258,18,77,56,8,3,162
Oklahoma,Lost City,852,57,306,146,55,4,568
Oklahoma,Lehigh,328,62,101,39,8,4,214
Oklahoma,Leedey,440,22,93,82,52,13,262
Oklahoma,Christie,150,17,68,21,0,0,106
Oklahoma,Cimarron City,153,12,32,34,26,12,116
Oklahoma,Claremore,18922,1252,4137,4541,1671,754,12355
Oklahoma,Clarita,101,19,28,5,0,6,58
Oklahoma,Clayton,729,109,191,164,34,8,506
Oklahoma,Clearview,32,4,6,9,1,0,20
Oklahoma,Chouteau,2011,202,502,434,178,55,1371
Oklahoma,Cleora,1338,86,421,314,224,53,1098
Oklahoma,Cleveland,3238,354,891,586,255,60,2146
Oklahoma,Clinton,9397,1285,2233,1307,758,399,5982
Oklahoma,Cloud Creek,94,18,33,9,0,0,60
Oklahoma,Coalgate,1998,255,557,336,140,51,1339
Oklahoma,Colbert,1420,129,385,340,79,42,975
Oklahoma,Colcord,923,103,273,117,32,8,533
Oklahoma,Cleo Springs,359,28,144,58,11,5,246
Oklahoma,Cole,621,55,196,96,39,16,402
Oklahoma,Choctaw,11828,669,2477,2723,1559,687,8115
Oklahoma,Cheyenne,917,41,275,162,71,17,566
Oklahoma,Bernice,518,71,155,151,37,9,423
Oklahoma,Kiowa,616,70,184,92,46,8,400
Oklahoma,Knowles,17,6,0,3,0,8,17
Oklahoma,Konawa,1379,188,326,294,62,56,926
Oklahoma,Krebs,2105,204,478,465,117,99,1363
Oklahoma,Kremlin,193,14,35,49,35,2,135
Oklahoma,Chickasha,16284,1778,3863,3091,1350,661,10743
Oklahoma,Lahoma,735,19,174,171,63,3,430
Oklahoma,Checotah,3324,417,901,599,83,115,2115
Oklahoma,Chelsea,1948,243,549,402,57,32,1283
Oklahoma,Cherokee,1564,154,361,390,156,77,1138
Oklahoma,Cherry Tree,866,167,180,130,29,11,517
Oklahoma,Chester,137,17,33,23,7,0,80
Oklahoma,Chewey,84,10,28,3,5,0,46
Oklahoma,Lake Aluma,75,0,7,5,15,39,66
Oklahoma,Coleman,309,43,92,56,19,3,213
Oklahoma,Collinsville,6103,338,1022,1346,794,220,3720
Oklahoma,Colony,133,18,33,30,10,1,92
Oklahoma,Dacoma,93,10,26,29,12,4,81
Oklahoma,Dale,185,0,30,39,16,13,98
Oklahoma,Lamar,140,14,44,26,11,2,97
Oklahoma,Lambert,9,0,0,2,2,0,4
Oklahoma,Lamont,298,20,57,70,35,5,187
Oklahoma,Lane,371,54,113,61,23,12,263
Oklahoma,Cyril,1171,63,359,228,141,16,807
Oklahoma,Langley,768,88,185,193,51,20,537
Oklahoma,Latta,1180,51,229,217,123,43,663
Oklahoma,Laverne,1348,202,243,229,112,54,840
Oklahoma,Lawrence Creek,231,9,79,46,9,5,148
Oklahoma,Lawton,97589,6765,19510,21285,7826,3667,59053
Oklahoma,Leach,259,18,44,48,32,19,161
Oklahoma,Lebanon,206,21,74,74,0,0,169
Oklahoma,Langston,1434,25,58,153,164,76,476
Oklahoma,Custer City,332,41,89,74,29,2,235
Oklahoma,Cushing,7879,1105,2193,1209,439,164,5110
Oklahoma,Crowder,372,41,101,78,24,17,261
Oklahoma,Comanche,1590,173,496,306,81,3,1059
Oklahoma,Commerce,2475,441,618,356,86,39,1540
Oklahoma,Connerville,44,7,25,0,12,0,44
Oklahoma,Cooperton,0,0,0,0,0,0,0
Oklahoma,Copan,768,102,233,130,53,11,529
Oklahoma,Copeland,1490,179,436,431,66,45,1157
Oklahoma,Corn,518,81,128,110,55,38,412
Oklahoma,Cornish,213,34,59,35,11,1,140
Oklahoma,Council Hill,116,23,38,22,2,0,85
Oklahoma,Covington,483,57,90,88,39,9,283
Oklahoma,Coweta,9517,702,2320,1653,904,303,5882
Oklahoma,Cowlington,142,23,44,24,6,0,97
Oklahoma,Coyle,282,16,67,33,28,9,153
Oklahoma,Crescent,1277,114,423,268,113,36,954
Oklahoma,Cromwell,270,44,56,53,19,9,181
Oklahoma,Le Flore,177,22,42,28,15,6,113
Oklahoma,Lotsee,3,0,0,0,3,0,3
Oklahoma,Lookeba,154,32,36,18,5,3,94
Oklahoma,Loyal,80,7,14,28,8,0,57
Oklahoma,Greenfield,96,17,32,16,8,2,75
Oklahoma,Gregory,156,20,25,28,21,0,94
Oklahoma,Grove,6685,541,1538,1644,931,441,5095
Oklahoma,Guthrie,10871,725,2924,1922,976,463,7010
Oklahoma,Guymon,11978,2423,2214,1386,1032,283,7338
Oklahoma,Haileyville,734,84,167,192,34,11,488
Oklahoma,Hallett,115,20,40,17,1,0,78
Oklahoma,Butler,144,14,23,23,12,12,84
Oklahoma,Byars,198,43,64,22,15,1,145
Oklahoma,Byng,1297,110,268,291,127,49,845
Oklahoma,Byron,39,11,15,9,1,0,36
Oklahoma,Cache,2919,189,732,663,215,136,1935
Oklahoma,Caddo,1145,99,301,238,101,41,780
Oklahoma,Calera,2576,161,531,627,229,17,1565
Oklahoma,Calumet,691,60,140,159,48,14,421
Oklahoma,Calvin,288,40,53,68,9,10,180
Oklahoma,Camargo,204,27,30,31,12,9,109
Oklahoma,Greasy,310,55,82,46,17,12,212
Oklahoma,Grayson,139,18,41,28,10,1,98
Oklahoma,Grant,268,70,72,40,10,4,196
Oklahoma,Granite,1835,243,592,498,100,31,1464
Oklahoma,Blanco,127,13,23,37,9,0,82
Oklahoma,Blanchard,8000,263,1702,1820,912,341,5038
Oklahoma,Blair,665,61,154,157,30,29,431
Oklahoma,Blackwell,6932,820,1707,1610,379,235,4751
Oklahoma,Blackgum,60,21,0,0,9,0,30
Oklahoma,Blackburn,76,11,32,13,4,1,61
Oklahoma,Bixby,23171,753,2719,4983,4403,1840,14698
Oklahoma,Bison,66,5,12,16,3,12,48
Oklahoma,Cameron,304,55,91,37,12,4,199
Oklahoma,Binger,586,70,184,130,28,13,425
Oklahoma,Big Cabin,258,32,67,52,9,4,164
Oklahoma,Bethel Acres,3021,132,953,662,233,87,2067
Oklahoma,Loveland,6,0,4,0,0,2,6
Oklahoma,Bethany,19478,1583,3217,4299,2143,799,12041
Oklahoma,Grainola,40,2,20,3,4,0,29
Oklahoma,Grandfield,915,118,244,143,71,16,592
Oklahoma,Grand Lake Towne,137,7,25,51,29,7,119
Oklahoma,Grandview,450,8,84,23,68,25,208
Oklahoma,Billings,519,56,133,162,14,5,370
Oklahoma,Canadian,175,15,56,30,11,1,113
Oklahoma,Hammon,523,47,130,95,34,11,317
Oklahoma,Canton,478,39,123,78,36,17,293
Oklahoma,Goodwell,1287,61,88,172,162,64,547
Oklahoma,Gore,1024,104,215,250,86,41,696
Oklahoma,Gotebo,167,22,54,50,10,0,136
Oklahoma,Gould,171,36,27,31,20,5,119
Oklahoma,Gowen,295,54,32,82,0,0,168
Oklahoma,Gracemont,220,26,64,41,6,8,145
Oklahoma,Caney,212,24,63,32,8,2,129
Oklahoma,Hardesty,289,60,47,37,12,5,161
Oklahoma,Harrah,5551,321,1220,1306,428,190,3465
Oklahoma,Hartshorne,2125,192,560,527,154,42,1475
Oklahoma,Haskell,1904,244,532,281,138,44,1239
Oklahoma,Hastings,51,10,27,14,0,0,51
Oklahoma,Haworth,262,40,82,33,13,4,172
Oklahoma,Headrick,126,21,17,22,5,4,69
Oklahoma,Lyons Switch,355,48,93,31,40,15,227
Oklahoma,Luther,1122,78,283,136,139,66,702
Oklahoma,Lucien,100,0,25,15,11,3,54
Oklahoma,Chattanooga,435,23,114,76,37,8,258
Oklahoma,Chandler,3121,336,819,607,142,91,1995
Oklahoma,Hanna,121,31,31,9,0,0,71
Oklahoma,Centrahoma,71,5,31,11,2,0,49
Oklahoma,Canute,390,36,109,76,52,1,274
Oklahoma,Central High,982,54,262,239,152,30,737
Oklahoma,Capron,3,3,0,0,0,0,3
Oklahoma,Carlisle,451,75,88,45,37,82,327
Oklahoma,Carlton Landing,9,0,2,0,5,0,7
Oklahoma,Carmen,509,23,141,74,43,26,307
Oklahoma,Carnegie,2072,236,520,385,110,42,1293
Oklahoma,Carney,621,70,164,123,32,5,394
Oklahoma,Carter,338,42,95,59,7,5,208
Oklahoma,Cartwright,588,152,133,66,7,27,385
Oklahoma,Carrier,56,1,13,16,9,4,43
Oklahoma,Cedar Crest,166,38,78,14,0,0,130
Oklahoma,Castle,137,27,29,16,0,0,72
Oklahoma,Cement,507,80,146,62,10,7,305
Oklahoma,Catoosa,7406,584,1703,1620,604,197,4708
Oklahoma,Cayuga,95,5,35,25,8,2,75
Oklahoma,Cashion,747,35,166,183,96,11,491
Oklahoma,Cedar Valley,419,12,86,96,71,70,335
Oregon,Ukiah,187,18,56,33,11,12,130
Oregon,Umapine,266,44,10,106,17,8,185
Oregon,Umatilla,6999,1023,1716,1547,191,173,4650
Oregon,Union,2109,180,475,480,145,72,1352
Oregon,Vale,1850,193,339,411,123,27,1093
Oregon,Wallowa,733,53,194,250,52,17,566
Oregon,Waldport,1943,128,415,724,156,87,1510
Oregon,Vernonia,1903,164,405,561,126,36,1292
Oregon,Tygh Valley,221,11,90,98,5,17,221
Oregon,Veneta,4687,496,771,1214,343,177,3001
Oregon,Unity,50,4,24,17,2,1,48
Oregon,Tutuilla,497,57,81,131,40,39,348
Oregon,Brookings,6376,468,1063,2168,824,426,4949
Oregon,Tumalo,537,28,28,53,127,170,406
Oregon,Tualatin,26806,1371,3028,6084,5349,2339,18171
Oregon,Troutdale,16479,924,2670,4521,1995,511,10621
Oregon,Tri-City,3645,426,1000,1123,85,59,2693
Oregon,Trail,478,65,141,164,53,0,423
Oregon,Toledo,3469,469,777,831,150,111,2338
Oregon,Tillamook,4958,463,1262,1267,259,119,3370
Oregon,Wallowa Lake,78,0,16,24,16,22,78
Oregon,Bunker Hill,1342,115,391,150,33,29,718
Oregon,Bull Mountain,9188,143,785,1750,2319,968,5965
Oregon,Brownsville,1561,91,420,425,124,52,1112
Oregon,Brooks,977,30,192,257,140,0,619
Oregon,Turner,2525,169,508,804,181,96,1758
Oregon,Wamic,61,5,15,41,0,0,61
Oregon,Cannon Beach,1549,100,260,393,310,166,1229
Oregon,Warren,1776,54,410,586,214,75,1339
Oregon,Alpine,84,0,24,26,12,0,62
Oregon,Aloha,53879,4100,8721,12096,7102,2347,34366
Oregon,Albany,51511,3455,8655,13617,5451,2881,34059
Oregon,Adrian,154,19,27,52,9,3,110
Oregon,Adams,370,23,99,114,34,4,274
Oregon,Adair Village,828,7,77,187,150,57,478
Oregon,Cascade Locks,1052,135,290,215,103,26,769
Oregon,Carlton,1869,131,367,544,102,76,1220
Oregon,Cape Meares,143,0,12,58,12,43,125
Oregon,Canyonville,2361,320,635,487,72,67,1581
Oregon,Canyon City,801,53,202,209,44,45,553
Oregon,Canby,16951,1364,2580,4265,1914,879,11002
Oregon,Camp Sherman,323,2,18,81,156,48,305
Oregon,Butteville,150,0,15,46,8,20,89
Oregon,Butte Falls,391,18,95,121,22,5,261
Oregon,Burns,2763,271,702,731,126,94,1924
Oregon,Brogan,220,28,20,98,10,0,156
Oregon,Alsea,146,6,50,37,0,0,93
Oregon,Warm Springs,3433,323,491,842,102,55,1813
Oregon,Altamont,19502,1392,4066,4999,1499,1002,12958
Oregon,Annex,230,33,62,53,4,8,160
Oregon,Warrenton,5143,278,867,1463,499,181,3288
Oregon,Wasco,431,28,125,111,25,6,295
Oregon,Waterloo,264,15,93,51,16,3,178
Oregon,Westfir,279,14,56,113,9,14,206
Oregon,Condon,561,38,210,152,36,26,462
Oregon,Columbia City,2419,128,566,741,255,128,1818
Oregon,Coburg,1149,44,139,407,143,79,812
Oregon,Cloverdale,305,6,87,90,9,21,213
Oregon,Clatskanie,1782,143,348,573,111,46,1221
Oregon,Chiloquin,815,78,143,161,72,3,457
Oregon,Chenoweth,1722,109,466,479,97,76,1227
Oregon,Central Point,17604,1521,3349,4499,1473,745,11587
Oregon,Cedar Mill,15638,309,883,2760,3557,3129,10638
Oregon,Cedar Hills,8811,322,1087,2045,1858,922,6234
Oregon,Cayuse,64,3,10,24,4,2,43
Oregon,Cave Junction,2002,234,488,510,104,122,1458
Oregon,Cascadia,199,15,64,76,0,0,155
Oregon,Amity,1558,116,412,439,90,31,1088
Oregon,Bonanza,506,86,61,121,44,10,322
Oregon,Dayville,150,6,46,34,29,7,122
Oregon,Blodgett,56,19,37,0,0,0,56
Oregon,Prescott,54,4,8,6,19,11,48
Oregon,Prairie City,813,43,222,184,72,43,564
Oregon,Powers,760,75,166,235,31,17,524
Oregon,Port Orford,1312,121,299,349,145,120,1034
Oregon,Portland,612206,38808,74192,129660,120950,81230,444840
Oregon,Plush,45,5,18,10,6,2,41
Oregon,Pistol River,112,0,71,41,0,0,112
Oregon,Prineville,9266,893,2661,2192,522,209,6477
Oregon,Pine Hollow,544,46,189,169,27,17,448
Oregon,Pilot Rock,1476,86,377,362,61,8,894
Oregon,Phoenix,4500,377,1150,1127,505,300,3459
Oregon,Philomath,4597,196,696,1119,621,518,3150
Oregon,Peoria,130,0,33,60,13,0,106
Oregon,Pendleton,16882,1055,3216,5048,1231,857,11407
Oregon,Parkdale,378,69,28,50,30,0,177
Oregon,Paisley,345,24,99,77,30,8,238
Oregon,Pine Grove,89,16,37,16,20,0,89
Oregon,Pronghorn,31,0,0,13,12,6,31
Oregon,Prospect,459,26,149,163,44,10,392
Oregon,Rainier,1961,98,518,531,141,60,1348
Oregon,Ruch,913,16,139,261,190,28,634
Oregon,Rowena,207,63,48,19,49,0,179
Oregon,Rose Lodge,1955,341,488,436,150,83,1498
Oregon,Roseburg North,6439,478,1425,1927,410,163,4403
Oregon,Roseburg,21937,1456,3999,7054,2337,1104,15950
Oregon,Rogue River,2442,207,610,679,112,133,1741
Oregon,Rockcreek,9245,251,907,2132,1858,1130,6278
Oregon,Rockaway Beach,1227,66,322,331,158,72,949
Oregon,Riverside,148,12,28,53,7,19,119
Oregon,Rivergrove,355,2,46,63,106,38,255
Oregon,Riddle,1164,111,291,351,48,11,812
Oregon,Rickreall,75,0,0,0,0,0,0
Oregon,Richland,173,15,48,32,17,14,126
Oregon,Reedsport,4111,458,931,1173,266,159,2987
Oregon,Redwood,2766,189,580,889,216,205,2079
Oregon,Redmond,27450,1847,5584,6915,2245,1090,17681
Oregon,Raleigh Hills,5751,85,500,1159,1821,762,4327
Oregon,Pacific City,963,123,224,250,73,147,817
Oregon,Hood River,7412,712,1195,1154,1180,701,4942
Oregon,Oregon City,34480,1736,6316,9893,4159,1340,23444
Oregon,Odell,2525,441,550,283,74,6,1354
Oregon,Myrtle Creek,3422,409,861,872,96,58,2296
Oregon,Mulino,2661,143,565,635,248,98,1689
Oregon,Mount Vernon,625,78,173,147,27,13,438
Oregon,Mount Hood Village,5497,249,964,1862,737,377,4189
Oregon,Mount Hood,235,0,62,64,36,15,177
Oregon,Mount Angel,3389,319,705,828,248,95,2195
Oregon,Mosier,476,42,99,148,21,33,343
Oregon,Myrtle Point,2495,278,678,613,134,81,1784
Oregon,Bandon,3070,256,492,1103,348,217,2416
Oregon,Aurora,1192,52,134,276,218,140,820
Oregon,Aumsville,3823,297,767,968,195,49,2276
Oregon,Athena,1069,91,165,339,61,50,706
Oregon,Astoria,9537,542,1583,2880,1177,976,7158
Oregon,Ashland,20556,459,1912,3802,4286,3974,14433
Oregon,Arlington,596,22,173,124,38,15,372
Oregon,Antelope,12,0,7,4,1,0,12
Oregon,Baker City,9777,750,2258,2500,942,419,6869
Oregon,Neahkahnie,80,11,12,0,57,0,80
Oregon,Nehalem,254,16,58,84,39,12,209
Oregon,Nesika Beach,430,35,146,204,31,14,430
Oregon,Oceanside,338,0,56,142,47,74,319
Oregon,O'Brien,116,0,43,42,13,0,98
Oregon,Oatfield,13852,567,2734,3802,1877,1085,10065
Oregon,Oakridge,3205,425,965,902,241,147,2680
Oregon,Oakland,691,86,145,197,46,40,514
Oregon,Oak Hills,11916,471,1145,2113,2391,1740,7860
Oregon,Oak Grove,17149,1223,2936,4843,1977,1229,12208
Oregon,Nyssa,3189,508,587,454,82,71,1702
Oregon,North Powder,515,62,78,118,41,13,312
Oregon,North Plains,1945,112,430,548,192,83,1365
Oregon,North Bend,9583,432,1892,2561,776,674,6335
Oregon,Newport,10101,720,2012,2690,1228,685,7335
Oregon,New Pine Creek,151,26,58,18,0,0,102
Oregon,New Hope,1342,69,338,422,230,59,1118
Oregon,Newberg,22566,1718,3522,4764,2667,1097,13768
Oregon,Netarts,958,41,189,272,152,102,756
Oregon,Neskowin,156,0,0,46,7,103,156
Oregon,Ontario,11089,1547,1760,2359,640,374,6680
Oregon,Holley,285,24,143,40,25,2,234
Oregon,Hines,1402,109,340,358,110,59,976
Oregon,Hillsboro,97751,7743,13262,20419,13840,9168,64432
Oregon,Donald,1115,68,242,389,93,44,836
Oregon,Drain,1194,78,449,288,17,4,836
Oregon,Dufur,640,20,130,192,40,18,400
Oregon,Dundee,3184,216,492,862,404,130,2104
Oregon,Dunes City,1263,57,289,476,148,87,1057
Oregon,Durham,1459,45,112,367,354,163,1041
Oregon,Eagle Crest,1685,141,302,568,313,254,1578
Oregon,Dillard,434,13,190,97,0,0,300
Oregon,Eagle Point,8701,396,1819,2429,625,185,5454
Oregon,Elgin,1527,68,570,399,29,32,1098
Oregon,Elkton,225,4,53,74,6,13,150
Oregon,Enterprise,1915,123,580,394,179,120,1396
Oregon,Eola,0,0,0,0,0,0,0
Oregon,Estacada,2968,282,814,604,94,100,1894
Oregon,Eugene,159615,6444,18474,35019,22240,17217,99394
Oregon,Fair Oaks,327,58,34,136,0,7,235
Oregon,Echo,734,56,230,167,63,1,517
Oregon,Detroit,119,0,28,46,17,5,96
Oregon,Deschutes River Woods,5328,311,1169,1786,370,180,3816
Oregon,Depoe Bay,1877,75,320,557,362,204,1518
Oregon,Black Butte Ranch,260,0,13,6,24,203,246
Oregon,Biggs Junction,22,0,14,0,8,0,22
Oregon,Bethany,22346,458,1203,2639,4922,4850,14072
Oregon,Bend,81780,2715,9394,21605,14926,8384,57024
Oregon,Bellfountain,101,0,17,12,0,11,40
Oregon,Beaverton,93919,6207,11042,18308,19343,9328,64228
Oregon,Beaver,193,0,72,13,31,0,116
Oregon,Beatty,0,0,0,0,0,0,0
Oregon,Bayside Gardens,618,14,172,168,169,8,531
Oregon,Bay City,1466,86,403,412,124,33,1058
Oregon,Barview,1719,265,521,492,51,32,1361
Oregon,Barlow,147,27,35,17,12,7,98
Oregon,Banks,1580,37,308,422,148,52,967
Oregon,Days Creek,316,45,110,88,6,21,270
Oregon,Dayton,2539,391,563,370,138,81,1543
Oregon,Tigard,50276,2814,5525,11697,9948,4940,34924
Oregon,Deer Island,383,64,161,75,6,0,306
Oregon,Fairview,9181,877,1412,2927,877,387,6480
Oregon,Falls City,994,92,261,287,48,31,719
Oregon,Florence,8545,640,1868,3079,1098,565,7250
Oregon,Foots Creek,623,55,193,153,71,47,519
Oregon,Grants Pass,36378,2654,7865,10153,2507,1357,24536
Oregon,Grass Valley,176,4,45,41,28,9,127
Oregon,Green,7895,581,2015,2308,368,245,5517
Oregon,Greenhorn,9,0,0,4,0,5,9
Oregon,Gresham,109308,11115,20057,25510,9468,4166,70316
Oregon,Haines,406,31,101,97,18,10,257
Oregon,Halfway,314,29,87,63,32,24,235
Oregon,Halsey,1128,47,222,330,77,48,724
Oregon,Happy Valley,16462,365,1613,3381,3186,2036,10581
Oregon,Harbor,1978,294,525,608,220,64,1711
Oregon,Harper,99,4,28,28,5,2,67
Oregon,Harrisburg,3660,158,931,756,286,94,2225
Oregon,Hayesville,19296,2661,3419,3889,1156,515,11640
Oregon,Hebo,218,15,65,86,0,32,198
Oregon,Helix,204,2,31,75,13,1,122
Oregon,Heppner,1151,95,272,268,162,25,822
Oregon,Hermiston,17121,2221,2472,3581,1197,585,10056
Oregon,Granite,23,2,8,13,0,0,23
Oregon,Boardman,3320,865,431,365,50,69,1780
Oregon,Grand Ronde,1636,202,493,383,76,29,1183
Oregon,Gopher Flats,371,34,88,116,34,15,287
Oregon,Forest Grove,22823,2190,3963,4255,2120,1173,13701
Oregon,Fort Hill,123,0,122,1,0,0,123
Oregon,Fossil,401,30,123,159,41,6,359
Oregon,Four Corners,16483,2538,2914,3861,891,288,10492
Oregon,Garden Home-Whitford,6138,177,492,1555,1561,1058,4843
Oregon,Gardiner,207,30,15,102,4,0,151
Oregon,Garibaldi,782,61,263,208,54,37,623
Oregon,Gaston,616,94,128,162,39,2,425
Oregon,Gates,464,49,133,133,31,22,368
Oregon,Gearhart,1462,53,261,425,222,96,1057
Oregon,Gervais,2562,359,477,412,76,55,1379
Oregon,Gladstone,11741,890,2278,3323,1187,440,8118
Oregon,Glasgow,596,20,257,131,47,15,470
Oregon,Glendale,801,109,147,236,21,7,520
Oregon,Glide,1916,67,439,424,156,200,1286
Oregon,Gold Beach,2346,206,473,691,202,196,1768
Oregon,Gold Hill,1194,60,305,350,123,26,864
Oregon,Government Camp,120,0,0,33,21,53,107
Oregon,Three Rivers,4232,302,973,1231,406,385,3297
Oregon,Beavercreek,3945,215,654,1243,497,158,2767
Oregon,Tetherow,128,0,17,35,19,33,104
Oregon,Lakeview,2561,243,500,659,234,112,1748
Oregon,Langlois,162,31,76,8,0,0,115
Oregon,La Pine,1664,175,498,385,152,72,1282
Oregon,Lebanon,15962,919,3344,4838,1326,505,10932
Oregon,Lexington,189,14,65,37,11,0,127
Oregon,Lincoln Beach,1198,179,244,337,146,211,1117
Oregon,Lincoln City,8386,864,1833,1950,875,667,6189
Oregon,Lakeside,1539,161,336,729,119,9,1354
Oregon,Lonerock,18,7,11,0,0,0,18
Oregon,Lookingglass,989,18,198,307,158,48,729
Oregon,Lostine,316,13,92,89,18,10,222
Oregon,Lowell,1089,88,225,298,85,43,739
Oregon,Lyons,1174,94,350,243,71,10,768
Oregon,McMinnville,33185,3061,6523,6676,2518,1872,20650
Oregon,Madras,6487,902,1054,1189,429,170,3744
Oregon,Malin,731,227,116,91,30,22,486
Oregon,Long Creek,173,14,51,64,1,2,132
Oregon,Manzanita,426,11,81,68,125,69,354
Oregon,Lake Oswego,37628,432,2516,6338,10370,7457,27113
Oregon,Lafayette,3824,506,751,649,205,135,2246
Oregon,Jefferson,3174,230,561,803,208,55,1857
Oregon,Jennings Lodge,7691,408,1585,2009,811,288,5101
Oregon,John Day,1717,135,347,397,161,122,1162
Oregon,Johnson City,573,52,190,144,42,7,435
Oregon,Jordan Valley,153,9,51,39,23,5,127
Oregon,Joseph,1053,46,274,308,113,70,811
Oregon,Junction City,5673,554,1092,1468,385,179,3678
Oregon,La Grande,13088,563,2671,3017,1375,748,8374
Oregon,Juntura,37,3,6,10,2,0,21
Oregon,Kerby,709,70,187,80,48,23,408
Oregon,King City,3464,88,850,902,629,215,2684
Oregon,Kings Valley,72,37,0,7,28,0,72
Oregon,Kirkpatrick,145,3,42,39,12,0,96
Oregon,Klamath Falls,21261,1873,3968,5256,1594,1205,13896
Oregon,Labish Village,218,84,31,0,20,0,135
Oregon,Lacomb,633,49,77,221,33,4,384
Oregon,Keizer,37115,2719,6376,9171,4070,1830,24166
Oregon,Marion,232,68,23,82,0,0,173
Oregon,Maupin,593,45,172,175,42,41,475
Oregon,Maywood Park,872,24,99,258,191,89,661
Oregon,Wood Village,3971,557,614,793,191,57,2212
Oregon,Woodburn,24496,4717,4032,4091,1314,626,14780
Oregon,Winston,5363,361,1097,1676,173,73,3380
Oregon,Winchester Bay,316,27,58,105,59,58,307
Oregon,Wimer,647,11,210,271,63,33,588
Oregon,Wilsonville,20837,677,2777,5256,3542,2215,14467
Oregon,Williams,1037,41,363,265,159,20,848
Oregon,Yachats,658,25,97,196,126,121,565
Oregon,Willamina,1811,177,476,391,77,70,1191
Oregon,Wheeler,397,20,103,139,23,28,313
Oregon,West Slope,7536,225,849,1317,1610,1248,5249
Oregon,West Scio,127,0,0,28,13,0,41
Oregon,Westport,309,36,93,145,11,0,285
Oregon,Weston,723,73,166,179,38,14,470
Oregon,West Linn,25963,341,2337,5394,6174,3810,18056
Oregon,West Haven-Sylvan,7991,80,491,1545,2373,1907,6396
Oregon,White City,9296,1328,2052,2042,273,73,5768
Oregon,Yamhill,1132,33,181,327,99,43,683
Oregon,Yoncalla,1155,140,333,352,22,25,872
Oregon,The Dalles,15136,1612,2677,4037,1249,611,10186
Oregon,Medford,77579,7112,14298,18482,8270,4101,52263
Oregon,Mehama,196,19,89,50,0,0,158
Oregon,Melrose,809,115,174,194,80,57,620
Oregon,Merlin,1481,46,474,623,34,63,1240
Oregon,Merrill,885,173,191,119,33,16,532
Oregon,Metolius,1131,192,234,173,37,15,651
Oregon,Metzger,4035,236,952,759,672,317,2936
Oregon,Mill City,1781,241,393,419,100,43,1196
Oregon,Millersburg,1661,137,343,373,202,58,1113
Oregon,Milton-Freewater,7089,1190,963,1395,292,209,4049
Oregon,Milwaukie,20566,860,3780,6495,2602,1311,15048
Oregon,Mission,970,80,131,221,39,27,498
Oregon,Mitchell,122,24,37,37,4,1,103
Oregon,Molalla,8726,687,1562,2448,461,219,5377
Oregon,Monmouth,9869,350,1199,1577,974,634,4734
Oregon,Monument,89,9,22,30,2,3,66
Oregon,Moro,372,26,82,102,34,11,255
Oregon,Jeffers Gardens,344,7,96,95,9,9,216
Oregon,Jacksonville,2827,82,611,647,620,482,2442
Oregon,Monroe,677,69,178,175,32,6,460
Oregon,Irrigon,2217,242,418,394,93,35,1182
Oregon,Cove,606,46,169,152,37,10,414
Oregon,Cottage Grove,9819,978,2104,2458,564,242,6346
Oregon,Corvallis,54981,1239,3579,7090,9630,8040,29578
Oregon,Cornelius,12186,2406,1751,2044,652,177,7030
Oregon,Coquille,3846,374,781,1433,217,197,3002
Oregon,Coos Bay,16062,1299,3701,4007,1421,956,11384
Oregon,Rufus,242,32,79,72,5,4,192
Oregon,St. Helens,13055,1119,2881,3153,1112,272,8537
Oregon,St. Paul,386,20,89,86,43,15,253
Oregon,Salem,160008,13526,26272,35399,16981,10763,102941
Oregon,Sandy,10134,453,2142,2781,849,430,6655
Oregon,Scappoose,6839,345,1474,1623,635,348,4425
Oregon,Sodaville,367,27,87,109,18,15,256
Oregon,Crabtree,526,61,144,88,22,15,330
Oregon,Sisters,2596,139,375,631,323,213,1681
Oregon,Scio,832,52,172,194,73,9,500
Oregon,Scotts Mills,459,41,93,99,47,19,299
Oregon,Seaside,6483,573,1365,1674,568,439,4619
Oregon,Selma,675,134,109,295,47,58,643
Oregon,Seneca,188,36,54,54,15,0,159
Oregon,Seventh Mountain,203,0,10,19,132,42,203
Oregon,Shady Cove,2960,280,806,836,305,126,2353
Oregon,Shaniko,6,4,2,0,0,0,6
Oregon,Shedd,161,13,31,46,9,0,99
Oregon,Sheridan,6048,742,1687,1774,315,179,4697
Oregon,Sherwood,18880,485,1818,4233,3453,1617,11606
Oregon,Siletz,1736,191,417,508,34,29,1179
Oregon,Silverton,9436,437,1484,2495,1206,638,6260
Oregon,Island City,1186,50,288,306,106,29,779
Oregon,Crane,136,0,17,50,13,10,90
Oregon,Silver Lake,93,0,35,44,7,0,86
Oregon,Creswell,5085,156,947,1741,438,101,3383
Oregon,Crawfordsville,269,57,67,90,10,0,224
Oregon,Independence,8772,757,1139,1754,605,251,4506
Oregon,Imbler,315,15,60,99,45,8,227
Oregon,Idaville,389,43,150,104,13,6,316
Oregon,Idanha,198,27,62,51,5,3,148
Oregon,Huntington,323,72,77,91,12,3,255
Oregon,Hubbard,3219,488,501,535,151,93,1768
Oregon,Terrebonne,1182,73,320,401,75,11,880
Oregon,Tangent,1022,86,176,303,78,30,673
Oregon,Talent,6244,409,1030,1539,833,435,4246
Oregon,Takilma,266,0,39,63,39,40,181
Oregon,Ione,255,13,74,69,34,4,194
Oregon,Sutherlin,7821,835,1762,2337,316,220,5470
Oregon,Sweet Home,9140,629,2211,2288,377,157,5662
Oregon,Springfield,60235,5423,12242,15406,4456,1797,39324
Oregon,Damascus,10748,574,2226,3123,1012,708,7643
Oregon,South Lebanon,1148,59,378,351,16,45,849
Oregon,Spray,148,12,59,40,2,0,113
Oregon,Sunriver,1022,12,209,165,207,255,848
Oregon,Stafford,1892,86,203,411,475,203,1378
Oregon,Stanfield,2241,265,487,513,136,51,1452
Oregon,Stayton,7809,933,1521,1632,469,303,4858
Oregon,Sublimity,2796,115,654,624,411,198,2002
Oregon,Summerville,78,2,30,18,3,2,55
Oregon,Summit,98,9,9,0,44,36,98
Oregon,Sumpter,175,9,54,86,16,0,165
Oregon,Dallas,14896,737,3113,4130,1465,596,10041
Oregon,Culver,1414,160,261,319,73,29,842
Pennsylvania,Bellwood borough,1811,87,635,328,115,39,1204
Pennsylvania,New Berlinville,1453,78,596,275,208,32,1189
Pennsylvania,New Berlin borough,964,44,297,186,90,41,658
Pennsylvania,New Bedford,934,41,362,230,90,38,761
Pennsylvania,New Beaver borough,1554,110,626,243,94,43,1116
Pennsylvania,New Baltimore borough,167,7,71,29,7,0,114
Pennsylvania,Beaver Springs,575,59,210,67,21,14,371
Pennsylvania,New Alexandria borough,635,19,261,145,55,48,528
Pennsylvania,Benson borough,177,17,69,30,4,2,122
Pennsylvania,Bendersville borough,738,69,215,95,46,14,439
Pennsylvania,Ben Avon Heights borough,362,1,19,22,93,118,253
Pennsylvania,Ben Avon borough,1692,17,181,255,383,377,1213
Pennsylvania,Beavertown borough,957,64,378,130,46,28,646
Pennsylvania,Bechtelsville borough,878,53,277,163,66,30,589
Pennsylvania,Bedford borough,2778,153,930,449,283,227,2042
Pennsylvania,Beech Creek borough,715,67,287,129,32,26,541
Pennsylvania,Beech Mountain Lakes,1723,71,499,284,358,167,1379
Pennsylvania,Belfast,1083,18,411,158,146,101,834
Pennsylvania,Beaver Meadows borough,644,31,304,121,39,7,502
Pennsylvania,Bellefonte borough,6285,463,1739,1216,977,313,4708
Pennsylvania,Belle Vernon borough,1100,138,364,165,64,16,747
Pennsylvania,Belleville,1853,154,771,262,166,67,1420
Pennsylvania,Bellevue borough,8329,482,2014,1862,1319,669,6346
Pennsylvania,Belmont,2665,179,871,476,338,221,2085
Pennsylvania,Bell Acres borough,1444,47,262,212,235,263,1019
Pennsylvania,Avonia,1087,21,222,212,164,188,807
Pennsylvania,Beaverdale,1144,90,407,195,71,15,778
Pennsylvania,Avonmore borough,985,82,346,202,50,32,712
Pennsylvania,Baden borough,4075,278,1439,787,359,267,3130
Pennsylvania,Baidland,1637,125,506,354,233,127,1345
Pennsylvania,Baileyville,378,18,200,0,0,0,218
Pennsylvania,Roulette,782,30,350,132,27,16,555
Pennsylvania,Rouseville borough,560,39,179,102,25,6,351
Pennsylvania,Rouzerville,922,51,438,140,68,0,697
Pennsylvania,Rowes Run,456,49,203,88,16,0,356
Pennsylvania,Royalton borough,1031,59,416,159,79,12,725
Pennsylvania,Royersford borough,4782,210,1260,1016,633,225,3344
Pennsylvania,Bainbridge,1623,80,609,180,133,25,1027
Pennsylvania,Bairdford,1101,33,462,99,178,56,828
Pennsylvania,Bakerstown,2328,55,279,398,667,207,1606
Pennsylvania,Baldwin borough,19803,1010,5380,4258,2443,1151,14242
Pennsylvania,Bally borough,1273,89,462,197,114,48,910
Pennsylvania,Bangor borough,5233,399,1439,1020,441,108,3407
Pennsylvania,Barkeyville borough,245,22,96,28,18,14,178
Pennsylvania,Barrville,269,124,6,10,15,0,155
Pennsylvania,Bath borough,2680,244,713,464,251,78,1750
Pennsylvania,Baumstown,521,42,95,137,30,8,312
Pennsylvania,Beallsville borough,483,39,169,95,24,20,347
Pennsylvania,Bear Creek Village borough,316,24,29,70,47,48,218
Pennsylvania,Bear Lake borough,148,29,65,14,0,0,108
Pennsylvania,Bear Rocks,944,9,298,251,86,89,733
Pennsylvania,Beaver borough,4467,204,897,992,848,437,3378
Pennsylvania,Beaver Falls,8768,811,2141,1304,472,242,4970
Pennsylvania,New Bethlehem borough,858,94,274,122,105,42,637
Pennsylvania,New Florence borough,806,96,279,113,38,13,539
Pennsylvania,New Britain borough,3026,48,447,490,447,237,1669
Pennsylvania,Sheffield,1132,86,385,213,69,47,800
Pennsylvania,Sheatown,720,73,299,113,69,44,598
Pennsylvania,Sheakleyville borough,175,21,50,12,16,5,104
Pennsylvania,Shavertown,2392,32,526,658,300,199,1715
Pennsylvania,Shartlesville,519,52,243,104,31,0,430
Pennsylvania,Sharpsville borough,4320,141,1281,947,410,199,2978
Pennsylvania,Sharpsburg borough,3426,332,1019,696,325,102,2474
Pennsylvania,Sharon Hill borough,5693,265,1788,963,234,332,3582
Pennsylvania,Sharon,13754,1288,4043,2375,1326,480,9512
Pennsylvania,Shanor-Northvue,5028,202,1356,943,724,551,3776
Pennsylvania,Shanksville borough,240,4,79,41,22,12,158
Pennsylvania,Shamokin Dam borough,1664,118,507,331,222,94,1272
Pennsylvania,Shamokin,7253,844,2818,955,280,152,5049
Pennsylvania,Shade Gap borough,133,32,33,11,1,0,77
Pennsylvania,Sewickley Hills borough,607,8,105,94,99,125,431
Pennsylvania,Sewickley Heights borough,722,5,55,68,175,189,492
Pennsylvania,Sewickley borough,3837,72,357,639,808,845,2721
Pennsylvania,Seward borough,420,82,142,69,27,10,330
Pennsylvania,Seven Valleys borough,485,73,193,59,29,16,370
Pennsylvania,Seven Springs borough,11,0,0,6,5,0,11
Pennsylvania,Seven Fields borough,2888,25,147,338,913,552,1975
Pennsylvania,Seneca,1278,43,453,198,177,64,935
Pennsylvania,Seltzer,266,32,165,40,0,7,244
Pennsylvania,Sellersville borough,4233,187,1222,950,504,231,3094
Pennsylvania,Selinsgrove borough,5720,317,1162,674,400,331,2884
Pennsylvania,Scranton,76064,7280,19253,12592,6924,3400,49449
Pennsylvania,New Brighton borough,5958,429,1836,1168,518,192,4143
Pennsylvania,Shelocta borough,157,7,53,23,6,4,93
Pennsylvania,Shenandoah borough,4964,889,1661,633,123,53,3359
Pennsylvania,New Buffalo borough,111,25,41,19,3,0,88
Pennsylvania,Newburg borough (Clearfield County),89,24,27,9,2,0,62
Pennsylvania,Newburg borough (Cumberland County),280,16,100,52,23,7,198
Pennsylvania,New Castle,22682,2181,7435,3830,1669,741,15856
Pennsylvania,New Castle Northwest,1194,84,517,188,164,67,1020
Pennsylvania,New Centerville borough,148,17,49,15,14,9,104
Pennsylvania,New Columbia,737,46,321,151,0,12,530
Pennsylvania,New Columbus borough,225,10,87,44,17,4,162
Pennsylvania,New Cumberland borough,7274,408,1799,1382,1085,746,5420
Pennsylvania,New Eagle borough,2049,190,713,419,148,40,1510
Pennsylvania,Newell borough,586,39,213,88,33,13,386
Pennsylvania,Shrewsbury borough,3841,271,1102,671,459,225,2728
Pennsylvania,Shoemakersville borough,1435,117,495,265,108,25,1010
Pennsylvania,Shirleysburg borough,122,14,62,8,3,0,87
Pennsylvania,Shiremanstown borough,1533,54,388,312,246,67,1067
Pennsylvania,Shippingport borough,172,27,45,47,2,2,123
Pennsylvania,Shippenville borough,583,18,181,136,60,26,421
Pennsylvania,Shippensburg University,2281,0,0,6,1,24,31
Pennsylvania,Shippensburg borough,5527,523,1414,812,392,345,3486
Pennsylvania,Shinglehouse borough,935,99,279,193,52,76,699
Pennsylvania,Shiloh,11652,837,3339,2113,1526,676,8491
Pennsylvania,Shillington borough,5268,384,1479,894,622,363,3742
Pennsylvania,Shickshinny borough,791,107,262,160,57,27,613
Pennsylvania,Sheppton,184,14,86,15,0,0,115
Pennsylvania,Shenandoah Heights,1208,0,529,220,114,75,938
Pennsylvania,Avondale borough,1506,371,202,141,103,49,866
Pennsylvania,Avon,1787,202,689,241,65,51,1248
Pennsylvania,Ronks,288,30,170,21,7,0,228
Pennsylvania,Avis borough,1650,94,499,370,98,45,1106
Pennsylvania,Altamont,688,45,210,210,78,8,551
Pennsylvania,Altoona,45814,3388,15148,7143,3700,1599,30978
Pennsylvania,Ambler borough,6513,388,1286,1244,1071,669,4658
Pennsylvania,Ambridge borough,6931,570,1899,1627,472,227,4795
Pennsylvania,Amity Gardens,3100,129,646,546,499,306,2126
Pennsylvania,Ancient Oaks,7359,185,961,1166,1574,1149,5035
Pennsylvania,Annville,4828,214,880,644,382,183,2303
Pennsylvania,Apollo borough,1566,163,470,246,118,35,1032
Pennsylvania,Applewold borough,323,26,111,54,31,14,236
Pennsylvania,Arcadia University,627,0,0,5,0,3,8
Pennsylvania,Archbald borough,7049,388,1703,1472,1059,529,5151
Pennsylvania,Ardmore,12698,541,1221,1599,2924,2878,9163
Pennsylvania,Arendtsville borough,910,99,212,129,51,40,531
Pennsylvania,Aristes,311,11,157,32,18,12,230
Pennsylvania,Arlington Heights,5371,333,1289,996,1096,338,4052
Pennsylvania,Armagh borough,121,7,55,21,10,7,100
Pennsylvania,Arnold,5053,419,1668,1181,191,77,3536
Pennsylvania,Arnold City,540,67,223,170,17,0,477
Pennsylvania,Mohnton borough,3041,157,779,559,359,214,2068
Pennsylvania,Mohrsville,618,62,229,102,45,18,456
Pennsylvania,Monaca borough,5706,390,1803,1331,589,151,4264
Pennsylvania,Monessen,7584,569,2551,1633,638,287,5678
Pennsylvania,Monongahela,4235,338,1452,856,316,112,3074
Pennsylvania,Davidsville,1208,55,441,149,123,173,941
Pennsylvania,Dawson borough,470,37,164,89,22,24,336
Pennsylvania,Alsace Manor,402,45,160,72,22,0,299
Pennsylvania,Dayton borough,457,21,214,34,37,10,316
Pennsylvania,Almedia,1024,66,425,187,91,82,851
Pennsylvania,Allison Park,21864,504,3511,3474,4371,3580,15440
Pennsylvania,Dauphin borough,1045,29,248,223,98,53,651
Pennsylvania,Aaronsburg CDP (Centre County),523,32,250,59,47,23,411
Pennsylvania,Aaronsburg CDP (Washington County),281,44,129,73,10,5,261
Pennsylvania,Abbottstown borough,943,125,312,159,29,24,649
Pennsylvania,Ackermanville,900,79,141,124,149,11,504
Pennsylvania,Adamsburg borough,203,12,50,55,11,10,138
Pennsylvania,Adamstown borough,1987,117,520,368,285,115,1405
Pennsylvania,Adamsville,52,8,17,10,3,4,42
Pennsylvania,Addison borough,214,19,74,35,6,7,141
Pennsylvania,Akron borough,3949,403,1072,669,502,212,2858
Pennsylvania,Alba borough,118,12,52,18,2,1,85
Pennsylvania,Albion borough,1522,123,519,300,96,61,1099
Pennsylvania,Albrightsville,159,7,17,64,0,0,88
Pennsylvania,Alburtis borough,2411,122,533,460,296,129,1540
Pennsylvania,Aldan borough,4158,183,1258,805,538,266,3050
Pennsylvania,Alexandria borough,406,18,139,58,29,19,263
Pennsylvania,Alfarata,159,26,53,8,5,13,105
Pennsylvania,Aliquippa,9296,778,2779,2055,589,412,6613
Pennsylvania,Alleghenyville,1137,44,291,113,267,73,788
Pennsylvania,Allenport,728,49,243,128,21,30,471
Pennsylvania,Allenport borough,496,33,142,70,65,58,368
Pennsylvania,Allensville,448,102,123,15,5,3,248
Pennsylvania,Allentown,119261,16646,26030,19250,7625,3711,73262
Pennsylvania,Allenwood,466,68,121,98,24,7,318
Pennsylvania,Allison,662,24,387,97,40,0,548
Pennsylvania,Allport,282,25,117,14,14,0,170
Pennsylvania,Deemston borough,737,50,249,111,65,68,543
Pennsylvania,Deer Lake,428,0,157,43,56,13,269
Pennsylvania,Deer Lake borough,750,25,180,172,83,54,514
Pennsylvania,Rose Valley borough,921,15,44,79,202,342,682
Pennsylvania,Roseville borough,159,7,58,41,14,3,123
Pennsylvania,Rossiter,621,52,237,120,23,8,440
Pennsylvania,Rosslyn Farms borough,438,0,24,53,132,119,328
Pennsylvania,Rote,674,43,268,105,30,22,468
Pennsylvania,Rothsville,2681,160,544,482,510,122,1818
Pennsylvania,Arnot,469,71,169,73,22,13,348
Pennsylvania,Arona borough,332,37,146,51,8,7,249
Pennsylvania,Ashland borough,2772,296,1113,479,187,57,2132
Pennsylvania,Ashley borough,2753,235,902,593,166,86,1982
Pennsylvania,Ashville borough,199,20,65,50,3,4,142
Pennsylvania,Aspers,447,33,118,57,75,9,292
Pennsylvania,Aspinwall borough,2795,68,354,417,593,611,2043
Pennsylvania,Atglen borough,1469,122,285,204,116,82,809
Pennsylvania,Athens borough,3326,204,1107,549,302,188,2350
Pennsylvania,Atkinson Mills,236,25,74,38,15,0,152
Pennsylvania,Atlantic,49,8,27,6,0,0,41
Pennsylvania,Atlas,969,81,498,140,22,12,753
Pennsylvania,Atlasburg,310,0,112,78,33,0,223
Pennsylvania,Atwood borough,108,13,44,11,8,1,77
Pennsylvania,Auburn borough,811,109,284,108,42,19,562
Pennsylvania,Audubon,8801,169,1143,879,2102,1654,5947
Pennsylvania,Austin borough,518,38,229,77,20,6,370
Pennsylvania,Avalon borough,4681,170,1418,1078,650,301,3617
Pennsylvania,Avella,915,100,251,137,99,43,630
Pennsylvania,Roseto borough,1675,132,483,370,109,74,1168
Pennsylvania,Roscoe borough,797,39,245,169,67,55,575
Pennsylvania,Scottdale borough,4305,182,1616,867,420,143,3228
Pennsylvania,Ronco,60,29,31,0,0,0,60
Pennsylvania,Defiance,229,0,83,21,0,20,124
Pennsylvania,Delano,380,17,178,89,10,3,297
Pennsylvania,Rices Landing borough,460,38,132,77,27,40,314
Pennsylvania,Riceville,59,6,12,19,0,3,40
Pennsylvania,Richboro,6322,214,1151,906,1203,1070,4544
Pennsylvania,Richfield,448,78,216,46,35,26,401
Pennsylvania,Richland borough,1796,194,661,308,120,35,1318
Pennsylvania,Richlandtown borough,1268,48,388,220,130,94,880
Pennsylvania,Ridgway borough,3986,183,1169,1019,339,256,2966
Pennsylvania,Ridley Park borough,7020,388,1603,1657,1016,496,5160
Pennsylvania,Riegelsville borough,838,44,219,188,120,92,663
Pennsylvania,Rimersburg borough,927,94,314,121,39,23,591
Pennsylvania,Avoca borough,2659,155,838,550,249,126,1918
Pennsylvania,Ringtown borough,686,33,261,128,56,45,523
Pennsylvania,Riverside borough,2049,104,529,294,247,256,1430
Pennsylvania,Riverview Park,2549,152,761,531,349,253,2046
Pennsylvania,Roaring Spring borough,2560,158,866,426,206,50,1706
Pennsylvania,Robesonia borough,2057,147,725,378,168,66,1484
Pennsylvania,Robinson,595,38,249,111,15,0,413
Pennsylvania,Rochester borough,3610,321,1194,790,194,109,2608
Pennsylvania,Rockhill borough,344,31,141,55,18,4,249
Pennsylvania,Rockledge borough,2542,116,657,490,303,149,1715
Pennsylvania,Rockwood borough,862,78,307,133,39,14,571
Pennsylvania,Rogersville,187,26,55,38,21,7,147
Pennsylvania,Rohrsburg,132,8,38,22,14,10,92
Pennsylvania,Rome borough,345,27,132,42,21,4,226
Pennsylvania,Riverside,302,14,104,86,13,7,224
Pennsylvania,Scotland,1119,63,231,286,147,46,773
Pennsylvania,Easton,26996,3118,6011,4562,1839,1124,16654
Pennsylvania,Schuylkill Haven borough,5321,484,1531,781,573,176,3545
Pennsylvania,Curwensville borough,2562,147,940,463,245,84,1879
Pennsylvania,Curtisville,975,52,395,114,79,42,682
Pennsylvania,Cumbola,401,29,138,84,30,5,286
Pennsylvania,Crucible,932,89,157,104,157,12,519
Pennsylvania,Croydon,9853,966,3485,1708,648,189,6996
Pennsylvania,Crown,212,27,67,48,8,6,156
Pennsylvania,Cross Roads borough,556,34,156,107,53,13,363
Pennsylvania,Cross Creek,139,3,50,34,9,0,96
Pennsylvania,Cressona borough,1841,141,565,377,101,66,1250
Pennsylvania,Cresson borough,1675,112,434,345,190,68,1149
Pennsylvania,Crenshaw,469,27,185,80,29,16,337
Pennsylvania,Creekside borough,320,21,117,43,8,23,212
Pennsylvania,Cranesville borough,546,24,212,94,24,22,376
Pennsylvania,Crafton borough,5920,182,1490,1249,1030,424,4375
Pennsylvania,Crabtree,332,16,120,55,5,4,200
Pennsylvania,Courtdale borough,695,82,222,168,59,21,552
Pennsylvania,Coudersport borough,2489,181,585,397,347,220,1730
Pennsylvania,Corsica borough,302,20,100,51,18,6,195
Pennsylvania,Corry,6509,482,1992,1161,537,193,4365
Pennsylvania,Cornwells Heights,1415,66,368,416,133,105,1088
Pennsylvania,Cornwall borough,4177,222,1269,611,723,578,3403
Pennsylvania,Coraopolis borough,5642,419,1394,1216,816,275,4120
Pennsylvania,Coral,578,79,62,106,133,0,380
Pennsylvania,Coplay borough,3216,300,1053,777,273,100,2503
Pennsylvania,Cooperstown borough,519,35,199,105,20,14,373
Pennsylvania,Mont Alto borough,1880,115,567,280,53,66,1081
Pennsylvania,Montandon,935,88,351,126,50,6,621
Pennsylvania,Monroeville municip,28346,1207,5887,6169,5111,3174,21548
Pennsylvania,Montgomery borough,1515,82,435,282,81,41,921
Pennsylvania,Monroe borough,658,17,182,104,83,16,402
Pennsylvania,Sand Hill,2321,114,855,487,112,106,1674
Pennsylvania,Connellsville,7550,722,2530,1322,520,144,5238
Pennsylvania,Conneautville borough,931,56,309,132,59,54,610
Pennsylvania,Conneaut Lakeshore,2788,186,830,552,280,293,2141
Pennsylvania,Conneaut Lake borough,601,41,201,116,56,15,429
Pennsylvania,Confluence borough,716,75,293,93,56,25,542
Pennsylvania,Conestoga,1109,109,357,163,96,72,797
Pennsylvania,Conashaugh Lakes,1350,63,469,118,122,13,785
Pennsylvania,Commodore,397,37,136,69,0,10,252
Pennsylvania,Colwyn borough,2559,175,575,458,277,83,1568
Pennsylvania,Colver,717,103,211,174,27,32,547
Pennsylvania,Columbus,724,57,268,131,59,47,562
Pennsylvania,Columbia borough,10394,1193,3651,1396,587,256,7083
Pennsylvania,Colony Park,1419,31,224,195,304,182,936
Pennsylvania,Colonial Park,13196,787,2919,2652,1531,1131,9020
Pennsylvania,St. Clairsville borough,74,5,42,3,3,2,55
Pennsylvania,St. Lawrence borough,1915,104,523,350,245,92,1314
Pennsylvania,St. Marys,12845,826,4729,2156,1282,525,9518
Pennsylvania,St. Michael,577,139,196,75,70,39,519
Pennsylvania,St. Petersburg borough,280,39,102,51,8,10,210
Pennsylvania,St. Vincent College,1266,27,25,0,0,27,79
Pennsylvania,Salisbury borough,805,65,302,164,42,39,612
Pennsylvania,Salix,1167,83,425,285,100,54,947
Pennsylvania,Salladasburg borough,254,16,68,66,15,7,172
Pennsylvania,Saltillo borough,297,18,125,26,18,5,192
Pennsylvania,Saltsburg borough,799,54,279,138,74,27,572
Pennsylvania,Salunga,2850,122,730,499,598,199,2148
Pennsylvania,Sanatoga,8480,369,2136,1547,1086,554,5692
Pennsylvania,Sandy,1205,81,464,348,31,19,943
Pennsylvania,Montgomeryville,13104,234,1701,1969,3026,1866,8796
Pennsylvania,Montoursville borough,4591,211,1288,1116,559,270,3444
Pennsylvania,Montrose borough,1716,58,464,437,135,125,1219
Pennsylvania,Muir,519,26,177,101,34,13,351
Pennsylvania,Muncy borough,2476,171,624,433,334,207,1769
Pennsylvania,Mundys Corner,1896,88,762,343,116,98,1407
Pennsylvania,Munhall borough,11351,569,3294,2416,1211,681,8171
Pennsylvania,Murrysville municip,20181,526,3388,3589,4034,3345,14882
Pennsylvania,Muse,2622,110,520,390,503,213,1736
Pennsylvania,Myerstown borough,3111,196,1213,402,124,69,2004
Pennsylvania,Nanticoke,10356,868,3095,2219,739,381,7302
Pennsylvania,Nanty-Glo borough,2657,310,986,379,116,74,1865
Pennsylvania,Daisytown borough,352,23,120,58,36,8,245
Pennsylvania,Dale borough,1138,131,409,176,51,8,775
Pennsylvania,Dallas borough,2793,67,458,528,475,362,1890
Pennsylvania,Dallastown borough,4019,370,1369,573,230,169,2711
Pennsylvania,Dalmatia,467,47,180,80,24,12,343
Pennsylvania,Dalton borough,1318,19,168,257,271,248,963
Pennsylvania,Danville borough,4686,388,1479,684,474,336,3361
Pennsylvania,Darby borough,10693,855,2781,1824,370,194,6024
Pennsylvania,Darlington borough,398,22,108,50,13,4,197
Pennsylvania,Dauberville,928,41,313,127,87,60,628
Pennsylvania,New Albany borough,320,20,109,48,5,0,182
Pennsylvania,Nesquehoning borough,3295,312,1104,629,168,156,2369
Pennsylvania,Nescopeck borough,1744,162,586,352,117,23,1240
Pennsylvania,Nemacolin,728,70,170,146,69,102,557
Pennsylvania,Needmore,102,22,32,15,4,3,76
Pennsylvania,Nazareth borough,5701,501,1571,1043,863,296,4274
Pennsylvania,Narberth borough,4292,71,365,420,1011,1257,3124
Pennsylvania,Naomi,32,13,19,0,0,0,32
Pennsylvania,Muhlenberg Park,2052,183,766,261,173,129,1512
Pennsylvania,Mount Wolf borough,1790,171,662,260,131,59,1283
Pennsylvania,Mountville borough,2837,158,935,601,284,147,2125
Pennsylvania,Mount Union borough,2436,211,911,353,136,105,1716
Pennsylvania,Montrose Manor,550,33,163,90,74,61,421
Pennsylvania,Monument,204,27,89,5,5,0,126
Pennsylvania,Moosic borough,5718,544,1494,1187,470,467,4162
Pennsylvania,Morgantown,1111,126,168,205,91,45,635
Pennsylvania,Morrisdale,750,137,374,51,22,17,601
Pennsylvania,Morrisville borough,8666,519,1893,1909,1228,544,6093
Pennsylvania,Morrisville,754,36,266,142,45,72,561
Pennsylvania,Morton borough,2681,204,691,559,270,259,1983
Pennsylvania,Moscow borough,2239,70,442,481,294,280,1567
Pennsylvania,Moshannon,254,31,96,53,5,0,185
Pennsylvania,Mount Aetna,336,61,137,21,26,7,252
Pennsylvania,Mountainhome,1075,88,362,161,145,65,821
Pennsylvania,Mountain Top,11378,332,2362,2546,1640,1230,8110
Pennsylvania,Connoquenessing borough,527,35,128,88,84,26,361
Pennsylvania,Mount Carbon borough,88,4,36,27,2,6,75
Pennsylvania,Mount Cobb,1554,90,380,397,145,61,1073
Pennsylvania,Mount Eagle,74,2,43,11,4,0,60
Pennsylvania,Mount Gretna borough,256,2,16,25,53,128,224
Pennsylvania,Mount Gretna Heights,211,0,68,30,43,51,192
Pennsylvania,Mount Holly Springs borough,1794,153,587,409,163,33,1345
Pennsylvania,Mount Jewett borough,928,80,294,127,75,57,633
Pennsylvania,Mount Joy borough,7891,461,2401,1255,801,472,5390
Pennsylvania,Mount Morris,844,79,302,118,79,54,632
Pennsylvania,Mount Oliver borough,3399,421,825,590,175,68,2079
Pennsylvania,Mount Penn borough,3160,188,946,515,288,100,2037
Pennsylvania,Mount Pleasant borough,4428,290,1362,956,469,278,3355
Pennsylvania,Mount Pleasant Mills,580,41,206,88,26,9,370
Pennsylvania,Mount Pocono borough,3106,259,536,637,259,277,1968
Pennsylvania,Mount Carmel borough,5810,598,1945,939,493,246,4221
Pennsylvania,Conshohocken borough,7890,384,1262,897,2254,1203,6000
Pennsylvania,Conway borough,2198,144,694,485,176,110,1609
Pennsylvania,Conyngham borough,1996,7,344,499,293,352,1495
Pennsylvania,Eagleville CDP (Centre County),373,43,156,65,14,5,283
Pennsylvania,Eagleview,1824,21,238,275,469,455,1458
Pennsylvania,Eagles Mere borough,121,0,14,14,32,44,104
Pennsylvania,Eagle Lake,0,0,0,0,0,0,0
Pennsylvania,Dushore borough,640,42,238,132,64,39,515
Pennsylvania,Duryea borough,4935,243,1381,1109,599,343,3675
Pennsylvania,Duquesne,5556,383,1617,902,280,143,3325
Pennsylvania,Dupont borough,2711,192,772,598,250,152,1964
Pennsylvania,Dunnstown,1362,95,356,277,197,74,999
Pennsylvania,Dunmore borough,13810,585,3348,2599,1627,1386,9545
Pennsylvania,Dunlo,114,12,64,0,0,0,76
Pennsylvania,Dunlevy borough,378,24,154,55,27,11,271
Pennsylvania,Duncansville borough,1283,80,421,258,165,24,948
Pennsylvania,Duncannon borough,1598,159,480,293,112,75,1119
Pennsylvania,Dunbar borough,1085,145,421,164,53,21,804
Pennsylvania,Dudley borough,171,15,70,23,13,2,123
Pennsylvania,Duboistown borough,1195,104,346,285,134,53,922
Pennsylvania,DuBois,7672,466,2599,1471,673,301,5510
Pennsylvania,Dublin borough,2120,142,451,383,316,145,1437
Pennsylvania,Dryville,627,0,148,149,47,94,438
Pennsylvania,Dry Tavern,569,23,166,146,57,55,447
Pennsylvania,Driftwood borough,74,14,40,9,0,0,63
Pennsylvania,Drexel Hill,27999,975,5791,4953,4545,2947,19211
Pennsylvania,Dravosburg borough,1864,95,718,407,208,43,1471
Pennsylvania,Doylestown borough,8344,389,1601,1596,1814,1203,6603
Pennsylvania,Downingtown borough,7930,566,1764,1383,1308,455,5476
Pennsylvania,Douglassville,780,27,331,93,98,14,563
Pennsylvania,Eagleville CDP (Montgomery County),4726,398,1389,654,457,441,3339
Pennsylvania,Earlston,1021,182,458,102,19,47,808
Pennsylvania,East Bangor borough,1182,137,363,196,72,20,788
Pennsylvania,East Berlin borough,1418,95,475,239,108,58,975
Pennsylvania,Schubert,104,32,54,18,0,0,104
Pennsylvania,Schoeneck,806,158,269,105,50,0,582
Pennsylvania,Schnecksville,2774,92,498,566,316,389,1861
Pennsylvania,Schlusser,5228,278,1802,929,581,248,3838
Pennsylvania,Schellsburg borough,325,18,123,62,22,17,242
Pennsylvania,Schaefferstown,1137,183,383,82,70,23,741
Pennsylvania,Scalp Level borough,801,107,283,102,51,19,562
Pennsylvania,Sayre borough,5513,451,1552,905,809,181,3898
Pennsylvania,Saylorsburg,334,17,124,81,44,0,266
Pennsylvania,Saxton borough,738,68,224,120,32,39,483
Pennsylvania,Saxonburg borough,1477,111,476,357,156,88,1188
Pennsylvania,Saw Creek,3455,387,660,792,230,281,2350
Pennsylvania,Sankertown borough,659,55,280,86,51,22,494
Pennsylvania,Dorneyville,4530,117,677,1136,899,575,3404
Pennsylvania,Sandy Ridge,237,39,112,16,0,0,167
Pennsylvania,East Prospect borough,1139,94,298,175,77,23,667
Pennsylvania,East Pittsburgh borough,1827,117,501,380,99,31,1128
Pennsylvania,East Petersburg borough,4518,189,1186,886,605,296,3162
Pennsylvania,East McKeesport borough,2140,105,701,508,147,77,1538
Pennsylvania,Eastlawn Gardens,3275,66,712,735,427,190,2130
Pennsylvania,East Lansdowne borough,2672,166,742,517,290,146,1861
Pennsylvania,East Greenville borough,2968,169,851,518,319,96,1953
Pennsylvania,East Freedom,1027,136,297,131,16,0,580
Pennsylvania,East Earl,952,116,218,90,101,30,555
Pennsylvania,East Conemaugh borough,1141,103,396,208,38,34,779
Pennsylvania,East Butler borough,699,57,247,160,31,4,499
Pennsylvania,East Brady borough,1053,98,413,148,74,28,761
Pennsylvania,East Berwick,1922,166,609,501,192,103,1571
Pennsylvania,Sandy Lake borough,642,42,239,104,62,15,462
Pennsylvania,Schwenksville borough,1376,56,369,334,216,57,1032
Pennsylvania,Dormont borough,8555,242,1615,1829,1857,892,6435
Pennsylvania,Donegal borough,173,37,71,18,4,6,136
Pennsylvania,Rupert,179,7,100,21,3,6,137
Pennsylvania,Rural Valley borough,866,57,263,162,112,33,627
Pennsylvania,Russell,1242,69,407,227,199,101,1003
Pennsylvania,Russellton,1661,147,292,601,272,0,1312
Pennsylvania,Rutherford,4817,353,1192,1069,498,109,3221
Pennsylvania,Rutledge borough,771,10,111,111,137,134,503
Pennsylvania,Saegertown borough,993,109,299,177,82,38,705
Pennsylvania,St. Clair borough,2950,298,1105,489,127,72,2091
Pennsylvania,New Schaefferstown,268,23,95,27,22,24,191
Pennsylvania,New Stanton borough,2414,63,534,501,355,181,1634
Pennsylvania,Newton Hamilton borough,212,25,83,14,12,2,136
Pennsylvania,Newtown borough,2110,13,203,326,516,485,1543
Pennsylvania,Newtown,214,26,104,27,6,0,163
Pennsylvania,Newtown Grant,3709,47,455,630,962,619,2713
Pennsylvania,New Tripoli,719,4,187,84,82,79,436
Pennsylvania,Newville borough,1358,155,438,163,101,71,928
Pennsylvania,New Washington borough,49,7,22,6,2,0,37
Pennsylvania,New Wilmington borough,2377,64,237,176,209,250,936
Pennsylvania,Nicholson borough,736,54,213,122,71,37,497
Pennsylvania,Nittany,568,65,273,30,48,28,444
Pennsylvania,Nixon,1313,42,153,250,289,212,946
Pennsylvania,Noblestown,494,0,104,82,90,48,324
Pennsylvania,Norristown borough,34500,3861,8530,5238,3225,1297,22151
Pennsylvania,Northampton borough,9895,878,2673,2108,950,320,6929
Pennsylvania,North Apollo borough,1419,129,484,206,118,42,979
Pennsylvania,North Belle Vernon borough,1989,77,629,395,163,116,1380
Pennsylvania,Coopersburg borough,2309,251,770,377,220,104,1722
Pennsylvania,New Salem borough,835,80,195,177,81,61,594
Pennsylvania,New Salem,410,18,131,78,30,20,277
Pennsylvania,Newry borough,317,33,109,37,26,5,210
Pennsylvania,New Ringgold borough,287,34,89,50,10,16,199
Pennsylvania,Donaldson,289,16,141,38,2,0,197
Pennsylvania,Dillsburg borough,2572,148,684,470,320,156,1778
Pennsylvania,Dicksonville,445,16,163,53,32,8,272
Pennsylvania,Dewart,1463,142,495,253,140,31,1061
Pennsylvania,Devon,1930,36,61,64,428,537,1126
Pennsylvania,DeSales University,937,0,0,0,10,10,20
Pennsylvania,Derry borough,2629,123,754,595,210,150,1832
Pennsylvania,Denver borough,3864,300,1137,670,386,159,2652
Pennsylvania,Delta borough,632,44,173,162,32,18,429
Pennsylvania,Delmont borough,2657,114,663,475,394,235,1881
Pennsylvania,Delaware Water Gap borough,678,5,142,172,139,48,506
Pennsylvania,New Freedom borough,4542,187,811,868,837,296,2999
Pennsylvania,New Freeport,84,17,31,3,3,0,54
Pennsylvania,Donora borough,4697,302,1438,753,353,255,3101
Pennsylvania,New Galilee borough,451,41,139,81,30,10,301
Pennsylvania,New Hope borough,2519,17,211,385,730,504,1847
Pennsylvania,New Jerusalem,624,77,249,29,16,52,423
Pennsylvania,New Kensington,12874,1071,3789,2528,1371,711,9470
Pennsylvania,New Kingstown,342,0,85,67,41,46,239
Pennsylvania,New Lebanon borough,174,12,49,29,5,2,97
Pennsylvania,Newmanstown,2658,376,771,350,181,51,1729
Pennsylvania,New Market,623,92,238,57,58,8,453
Pennsylvania,New Milford borough,891,75,230,186,69,22,582
Pennsylvania,New Morgan borough,67,5,4,3,0,0,12
Pennsylvania,New Oxford borough,2286,263,673,334,101,88,1459
Pennsylvania,New Paris borough,199,8,92,40,7,5,152
Pennsylvania,New Philadelphia borough,1035,99,433,157,68,18,775
Pennsylvania,Newport borough,1450,106,436,232,119,51,944
Pennsylvania,New Holland borough,5408,520,1766,812,483,143,3724
Pennsylvania,Dover borough,1992,208,612,294,120,84,1318
Pennsylvania,Gilbertsville,4926,236,1283,964,638,349,3470
Pennsylvania,East Salem,243,12,59,73,3,0,147
Pennsylvania,Wellersburg borough,232,20,88,42,9,3,162
Pennsylvania,Weissport East,1388,106,548,264,123,69,1110
Pennsylvania,Weissport borough,368,62,136,64,10,5,277
Pennsylvania,Weigelstown,12684,899,3736,2284,1338,629,8886
Pennsylvania,Weedville,611,55,176,130,76,27,464
Pennsylvania,Webster,318,26,124,39,16,0,205
Pennsylvania,Weatherly borough,2472,159,917,521,168,60,1825
Pennsylvania,Wellsboro borough,3313,135,863,578,507,401,2484
Pennsylvania,Waynesburg borough,4109,162,765,552,384,229,2092
Pennsylvania,Wayne Heights,2912,93,867,454,369,66,1849
Pennsylvania,Waymart borough,1369,147,390,275,59,38,909
Pennsylvania,Waverly,568,0,43,44,193,171,451
Pennsylvania,Wattsburg borough,508,31,153,92,22,5,303
Pennsylvania,Watsontown borough,2222,160,862,373,179,67,1641
Pennsylvania,Waterford borough,1374,64,471,224,125,71,955
Pennsylvania,Washingtonville borough,213,34,83,16,11,5,149
Pennsylvania,Waynesboro borough,10731,1087,3253,1800,755,451,7346
Pennsylvania,Washington Boro,704,57,274,75,62,52,520
Pennsylvania,Wellsville borough,282,28,110,38,25,12,213
Pennsylvania,Wescosville,5807,210,1021,868,1040,918,4057
Pennsylvania,Hollidaysburg borough,5812,241,1776,843,1086,457,4403
Pennsylvania,Holiday Pocono,510,35,176,145,24,0,380
Pennsylvania,Hokendauqua,3191,134,1014,564,370,191,2273
Pennsylvania,Hiller,1066,68,476,146,72,58,820
Pennsylvania,West Grove borough,2860,304,569,423,262,182,1740
Pennsylvania,Westfield borough,1143,185,411,175,52,22,845
Pennsylvania,West Falls,395,23,182,64,55,17,341
Pennsylvania,Wernersville borough,2515,193,775,491,263,154,1876
Pennsylvania,West Fairview,1380,111,372,207,121,26,837
Pennsylvania,West Easton borough,1304,132,404,256,103,14,909
Pennsylvania,West Decatur,468,51,158,91,40,14,354
Pennsylvania,West Conshohocken borough,1306,49,262,161,390,227,1089
Pennsylvania,West Chester borough,19181,803,2000,1689,3190,1507,9189
Pennsylvania,West Brownsville borough,861,56,414,89,107,39,705
Pennsylvania,West Alexander,447,12,175,68,23,7,285
Pennsylvania,Wesleyville borough,3270,195,1002,664,344,107,2312
Pennsylvania,West Elizabeth borough,565,29,229,102,32,3,395
Pennsylvania,Homeacre-Lyndora,6979,324,1818,1604,913,509,5168
Pennsylvania,Washington,13642,1320,3850,2279,1166,453,9068
Pennsylvania,Warren,9478,567,2629,1765,1002,624,6587
Pennsylvania,Verona borough,2560,90,648,619,287,79,1723
Pennsylvania,Venango borough,272,25,106,45,12,3,191
Pennsylvania,Van Voorhis,151,19,72,37,7,7,142
Pennsylvania,Vandling borough,786,56,248,152,72,52,580
Pennsylvania,Vandergrift borough,5095,389,1508,1187,257,148,3489
Pennsylvania,Vanderbilt borough,527,70,171,110,45,8,404
Pennsylvania,Hilldale,1005,40,297,280,171,75,863
Pennsylvania,Versailles borough,1682,148,583,382,107,36,1256
Pennsylvania,Highspire borough,2249,239,726,483,188,25,1661
Pennsylvania,Hickory Hills,644,13,246,116,33,18,426
Pennsylvania,Hickory,776,18,288,105,102,18,531
Pennsylvania,Hershey,14469,842,2349,2024,2524,2436,10175
Pennsylvania,Herndon borough,377,42,144,31,26,5,248
Pennsylvania,Hermitage,16185,670,4403,3129,2279,1631,12112
Pennsylvania,Herminie,860,64,277,126,76,0,543
Pennsylvania,Hereford,658,94,332,73,19,9,527
Pennsylvania,Highland Park,1139,197,362,222,77,15,873
Pennsylvania,Warrior Run borough,546,33,188,139,27,7,394
Pennsylvania,Vicksburg,420,82,54,33,50,50,269
Pennsylvania,Village Shires,4066,153,676,774,656,625,2884
Pennsylvania,Warminster Heights,4164,895,968,559,177,59,2658
Pennsylvania,Wanamie,744,51,268,189,24,18,550
Pennsylvania,Wampum borough,578,51,230,99,37,14,431
Pennsylvania,Walnuttown,416,90,144,31,8,0,273
Pennsylvania,Walnutport borough,2164,141,798,444,132,67,1582
Pennsylvania,Waller,105,12,44,16,5,2,79
Pennsylvania,Wallenpaupack Lake Estates,1315,58,406,280,116,42,902
Pennsylvania,Village Green-Green Ridge,7569,403,2263,1483,715,445,5309
Pennsylvania,Wallaceton borough,333,49,140,44,16,1,250
Pennsylvania,Wakefield,657,144,189,52,13,5,403
Pennsylvania,Wagner,221,21,105,0,12,0,138
Pennsylvania,Vowinckel,151,5,94,9,0,0,108
Pennsylvania,Volant borough,108,3,29,19,22,7,80
Pennsylvania,Virginville,264,22,95,59,7,28,211
Pennsylvania,Vintondale borough,395,84,111,64,14,4,277
Pennsylvania,Vinco,1192,104,320,281,128,44,877
Pennsylvania,Wall borough,779,71,215,170,51,8,515
Pennsylvania,Hendersonville,356,23,97,53,49,15,237
Pennsylvania,Homer City borough,1745,91,529,290,240,84,1234
Pennsylvania,Hometown,1291,66,336,238,193,157,990
Pennsylvania,West Hazleton borough,4549,763,1060,528,283,70,2704
Pennsylvania,West Hamburg,2020,244,666,311,83,156,1460
Pennsylvania,Jefferson borough (Greene County),257,21,77,36,35,12,181
Pennsylvania,Jeddo borough,138,6,55,45,5,11,122
Pennsylvania,Jeannette,9464,636,3338,1823,891,232,6920
Pennsylvania,Jamison City,94,8,34,26,9,0,77
Pennsylvania,Jamestown borough,602,56,216,108,28,17,425
Pennsylvania,West Hills,1119,36,395,320,130,54,935
Pennsylvania,James City,206,21,90,37,10,13,171
Pennsylvania,Jacksonwald,3223,134,549,608,591,306,2188
Pennsylvania,Jacksonville CDP (Indiana County),623,54,231,134,43,7,469
Pennsylvania,Jacksonville CDP (Centre County),94,2,33,11,4,2,52
Pennsylvania,Jackson Center borough,205,22,79,26,11,6,144
Pennsylvania,Ivyland borough,1026,54,179,229,158,82,702
Pennsylvania,Irwin borough,3906,170,983,958,672,149,2932
Pennsylvania,Irvona borough,759,73,320,114,28,10,545
Pennsylvania,Jacobus borough,1813,84,470,366,220,107,1247
Pennsylvania,Iola,200,28,68,32,3,0,131
Pennsylvania,West Homestead borough,1784,65,563,381,230,121,1360
Pennsylvania,Westland,95,0,0,38,0,0,38
Pennsylvania,West Reading borough,4191,372,1168,799,446,162,2947
Pennsylvania,West Pittston borough,4814,257,1308,1013,637,287,3502
Pennsylvania,West Pittsburg,953,100,336,206,49,21,712
Pennsylvania,Westover borough,341,40,139,47,13,5,244
Pennsylvania,Weston,357,5,114,111,43,7,280
Pennsylvania,West Newton borough,2585,183,766,594,276,108,1927
Pennsylvania,West Nanticoke,711,96,215,173,51,30,565
Pennsylvania,West Kittanning borough,1176,55,373,273,128,63,892
Pennsylvania,Westmont borough,5039,46,1065,839,956,740,3646
Pennsylvania,West Mifflin borough,20237,958,5890,4883,2306,719,14756
Pennsylvania,West Middletown borough,113,6,52,15,7,5,85
Pennsylvania,West Middlesex borough,901,62,273,175,56,39,605
Pennsylvania,West Mayfield borough,1286,78,363,321,130,21,913
Pennsylvania,West Liberty borough,357,21,111,55,32,20,239
Pennsylvania,West Leechburg borough,1303,74,451,251,177,61,1014
Pennsylvania,West Lawn,1790,111,561,314,132,107,1225
Pennsylvania,West Milton,839,53,307,140,96,13,609
Pennsylvania,Homestead borough,3144,206,1032,583,224,120,2165
Pennsylvania,Intercourse,1728,269,310,175,156,63,973
Pennsylvania,Ingram borough,3308,122,960,745,456,216,2499
Pennsylvania,Hublersburg,58,0,17,20,0,0,37
Pennsylvania,Howard borough,806,33,228,212,58,37,568
Pennsylvania,Houtzdale borough,783,77,303,131,59,16,586
Pennsylvania,Houston borough,1328,86,494,240,92,33,945
Pennsylvania,Houserville,1962,10,257,266,580,312,1425
Pennsylvania,Hostetter,952,155,237,222,98,8,720
Pennsylvania,Horsham,14587,820,2729,3128,2261,1571,10509
Pennsylvania,Hudson,1571,135,605,338,158,31,1267
Pennsylvania,Hopwood,1937,169,750,300,95,110,1424
Pennsylvania,Hopeland,562,115,162,36,43,8,364
Pennsylvania,Hop Bottom borough,295,25,116,49,8,2,200
Pennsylvania,Hooversville borough,613,78,257,66,42,19,462
Pennsylvania,Hookstown borough,119,19,45,29,4,0,97
Pennsylvania,Honey Brook borough,1689,120,471,292,175,73,1131
Pennsylvania,Honesdale borough,4315,454,1140,652,471,179,2896
Pennsylvania,Homewood borough,101,22,29,22,14,0,87
Pennsylvania,Hopewell borough,239,19,65,48,9,2,143
Pennsylvania,Inkerman,1802,175,539,474,150,54,1392
Pennsylvania,Hughestown borough,1566,107,537,298,158,88,1188
Pennsylvania,Hulmeville borough,926,47,283,187,86,50,653
Pennsylvania,Industry borough,1896,112,559,458,186,52,1367
Pennsylvania,Indian Mountain Lake,4249,194,1095,729,343,191,2552
Pennsylvania,Indian Lake borough,403,14,88,84,109,67,362
Pennsylvania,Indiana borough,14050,183,1331,1189,1148,809,4660
Pennsylvania,Imperial,2616,223,494,541,270,184,1712
Pennsylvania,Idaville,199,4,93,32,11,30,170
Pennsylvania,Hyndman borough,831,107,329,118,20,15,589
Pennsylvania,Hughesville borough,1982,99,576,358,171,95,1299
Pennsylvania,Hydetown borough,491,61,236,78,18,2,395
Pennsylvania,Hyde Park,3367,316,697,582,241,95,1931
Pennsylvania,Hyde,1228,160,413,207,48,0,828
Pennsylvania,Huntingdon borough,7060,325,1549,1088,630,423,4015
Pennsylvania,Hunterstown,521,104,200,40,50,25,419
Pennsylvania,Hunker borough,318,13,126,74,23,9,245
Pennsylvania,Hummels Wharf,1536,154,493,220,143,107,1117
Pennsylvania,Hummelstown borough,4555,225,1152,777,536,289,2979
Pennsylvania,Hyde Park borough,426,22,194,78,26,18,338
Pennsylvania,West Sunbury borough,146,4,30,43,14,2,93
Pennsylvania,Hemlock Farms,3470,89,811,774,464,308,2446
Pennsylvania,Heilwood,601,44,286,59,25,9,423
Pennsylvania,Manor borough,3281,158,819,634,293,389,2293
Pennsylvania,Manorville borough,403,10,104,83,45,35,277
Pennsylvania,Mansfield borough,3521,95,621,330,381,346,1773
Pennsylvania,Maple Glen,6801,160,962,976,1590,1010,4698
Pennsylvania,Mapleton borough,472,39,188,70,4,5,306
Pennsylvania,Mapletown,165,27,50,18,10,12,117
Pennsylvania,Marcus Hook borough,2434,232,751,310,120,34,1447
Pennsylvania,Manns Choice borough,300,50,102,35,12,6,205
Pennsylvania,Marianna borough,510,53,168,82,15,4,322
Pennsylvania,Marienville,4308,927,1946,551,143,46,3613
Pennsylvania,Marietta borough,2594,246,934,414,222,56,1872
Pennsylvania,Marion,939,81,306,126,0,14,527
Pennsylvania,Marion Center borough,456,22,171,71,25,8,297
Pennsylvania,Park Crest,587,30,185,110,51,36,412
Pennsylvania,Paris,808,78,343,166,81,6,674
Pennsylvania,Pardeesville,371,111,136,64,8,0,319
Pennsylvania,Marianne,1227,53,386,155,149,185,928
Pennsylvania,Paradise,1110,107,311,97,91,43,649
Pennsylvania,Manheim borough,4864,327,1860,620,347,126,3280
Pennsylvania,Mammoth,472,40,181,88,73,29,411
Pennsylvania,McKean borough,453,14,153,71,50,35,323
Pennsylvania,McKeansburg,159,11,53,29,20,3,116
Pennsylvania,McKeesport,19637,1968,6221,3801,1109,619,13718
Pennsylvania,McKees Rocks borough,6075,655,1873,1052,386,105,4071
Pennsylvania,McKnightstown,151,0,111,40,0,0,151
Pennsylvania,McMurray,4745,47,623,761,1080,721,3232
Pennsylvania,McSherrystown borough,3049,259,980,531,67,85,1922
Pennsylvania,Manchester borough,2753,226,1002,283,351,85,1947
Pennsylvania,Macungie borough,3111,198,753,554,464,258,2227
Pennsylvania,Madison borough,377,19,169,94,18,15,315
Pennsylvania,Madisonburg,265,33,89,5,34,10,171
Pennsylvania,Mahaffey borough,330,20,144,46,9,11,230
Pennsylvania,Mahanoy City borough,4089,418,1280,622,260,66,2646
Pennsylvania,Mainville,122,20,41,26,7,0,94
Pennsylvania,Maitland,247,13,82,48,32,0,175
Pennsylvania,Malvern borough,3263,129,303,504,649,668,2253
Pennsylvania,McVeytown borough,341,30,151,53,31,7,272
Pennsylvania,McGovern,2594,93,638,557,461,129,1878
Pennsylvania,Paoli,5652,216,995,876,1317,990,4394
Pennsylvania,Palmyra borough,7432,500,2330,1281,941,435,5487
Pennsylvania,Oley,1288,61,403,130,223,14,831
Pennsylvania,Old Orchard,2275,141,535,539,315,206,1736
Pennsylvania,Old Forge borough,8225,563,2592,1636,1069,475,6335
Pennsylvania,Oklahoma borough,677,39,271,153,51,28,542
Pennsylvania,East Rochester borough,547,36,191,121,37,14,399
Pennsylvania,Oil City,10296,682,3423,1829,748,276,6958
Pennsylvania,Ohioville borough,3497,193,1151,901,241,111,2597
Pennsylvania,Oliver,2931,388,889,489,249,34,2049
Pennsylvania,Ohiopyle borough,33,5,14,0,6,0,25
Pennsylvania,Oakwood,2168,275,724,479,94,31,1603
Pennsylvania,Oakmont borough,6398,305,1181,1202,1301,1031,5020
Pennsylvania,Oakland borough,636,52,206,136,28,14,436
Pennsylvania,Oakland CDP (Lawrence County),1379,202,344,242,87,21,896
Pennsylvania,Oakland CDP (Cambria County),1464,119,624,349,132,54,1278
Pennsylvania,Oak Hills,2280,71,478,448,379,272,1648
Pennsylvania,Oakdale borough,1432,100,472,291,165,69,1097
Pennsylvania,Oberlin,440,30,128,93,23,0,274
Pennsylvania,Palo Alto borough,1044,129,403,167,32,8,739
Pennsylvania,Olyphant borough,5166,299,1254,1392,705,343,3993
Pennsylvania,Orangeville borough,460,53,201,66,19,17,356
Pennsylvania,Palmerton borough,5352,851,1656,858,267,131,3763
Pennsylvania,Palmer Heights,3657,88,1168,878,472,229,2835
Pennsylvania,Palmdale,1153,98,327,146,165,52,788
Pennsylvania,Paint borough,905,114,343,147,106,41,751
Pennsylvania,Oxford borough,5163,704,1289,541,451,211,3196
Pennsylvania,Oval,426,25,117,70,42,18,272
Pennsylvania,Oswayo borough,176,20,65,27,9,0,121
Pennsylvania,Oneida,165,18,48,39,16,0,121
Pennsylvania,Osceola Mills borough,1135,71,414,257,40,20,802
Pennsylvania,Orwigsburg borough,3041,252,793,526,374,441,2386
Pennsylvania,Orviston,83,13,19,2,12,8,54
Pennsylvania,Orrtanna,196,10,81,32,11,4,138
Pennsylvania,Orrstown borough,252,36,89,30,6,13,174
Pennsylvania,Oreland,5817,195,986,871,923,723,3698
Pennsylvania,Orchard Hills,1891,168,734,408,66,25,1401
Pennsylvania,Orbisonia borough,523,48,212,50,33,8,351
Pennsylvania,Orwin,346,41,98,61,30,4,234
Pennsylvania,Hellertown borough,5858,350,1535,1203,669,311,4068
Pennsylvania,McEwensville borough,367,16,139,74,20,1,250
Pennsylvania,McDonald borough,2159,212,778,346,182,129,1647
Pennsylvania,Harrison City,151,0,56,58,21,0,135
Pennsylvania,Harrisburg,49232,6204,11208,7619,3808,2026,30865
Pennsylvania,Harmony borough,823,45,205,165,130,77,622
Pennsylvania,Harmonsburg,168,0,81,35,21,0,137
Pennsylvania,Harleysville,9285,472,1483,1719,1798,928,6400
Pennsylvania,Harleigh,988,36,292,305,92,86,811
Pennsylvania,Hanover borough,15403,1581,4838,2482,1184,706,10791
Pennsylvania,Harrisville borough,910,53,328,133,74,44,632
Pennsylvania,Hannasville,174,9,62,16,21,12,120
Pennsylvania,Hamburg borough,4316,512,1436,792,282,141,3163
Pennsylvania,Hallstead borough,1114,137,339,193,60,44,773
Pennsylvania,Hallam borough,2670,114,868,582,231,125,1920
Pennsylvania,Halifax borough,952,72,321,140,28,12,573
Pennsylvania,Halfway House,2806,127,581,423,502,301,1934
Pennsylvania,Guys Mills,119,10,32,19,3,0,64
Pennsylvania,Guilford,2552,83,659,317,414,324,1797
Pennsylvania,Hampton,812,42,319,35,35,0,431
Pennsylvania,Grove City borough,8210,339,1416,891,1077,478,4201
Pennsylvania,Hartleton borough,249,25,88,33,13,2,161
Pennsylvania,Harveys Lake borough,2793,265,708,664,358,241,2236
Pennsylvania,Heidlersburg,786,89,197,190,14,26,516
Pennsylvania,Heidelberg borough,1324,91,481,280,142,49,1043
Pennsylvania,Hegins,871,90,286,177,62,25,640
Pennsylvania,Heckscherville,113,5,50,25,5,0,85
Pennsylvania,Hebron,987,277,393,104,9,18,801
Pennsylvania,Hazleton,25087,3886,6434,3623,1120,636,15699
Pennsylvania,Haysville borough,79,2,14,21,16,6,59
Pennsylvania,Hartstown,169,12,51,38,13,10,124
Pennsylvania,Hawthorn borough,449,53,173,50,13,8,297
Pennsylvania,Hawk Run,648,62,211,98,11,12,394
Pennsylvania,Haverford College,1310,0,0,0,16,99,115
Pennsylvania,Hatfield borough,3302,277,751,576,512,175,2291
Pennsylvania,Hatboro borough,7405,298,1583,1743,1032,559,5215
Pennsylvania,Hastings borough,1253,48,409,269,123,41,890
Pennsylvania,Hasson Heights,1630,70,519,279,213,65,1146
Pennsylvania,Harwick,885,91,284,230,112,26,743
Pennsylvania,Hawley borough,1364,114,417,265,105,58,959
Pennsylvania,McElhattan,593,52,241,124,21,8,446
Pennsylvania,Grindstone,461,30,168,76,13,0,287
Pennsylvania,Grier City,378,30,46,128,34,29,267
Pennsylvania,Loretto borough,1238,22,36,32,34,56,180
Pennsylvania,Lower Allen,6919,175,1685,1590,1241,519,5210
Pennsylvania,Lower Burrell,11593,470,3555,2190,1692,714,8621
Pennsylvania,Loyalhanna,3551,241,1173,690,387,119,2610
Pennsylvania,Lucerne Mines,617,47,269,147,8,0,471
Pennsylvania,Lumber City borough,78,4,30,19,8,5,66
Pennsylvania,Lumber City,198,26,99,29,0,0,154
Pennsylvania,Lorane,4070,337,1133,807,587,286,3150
Pennsylvania,Luzerne borough,2853,327,812,622,237,115,2113
Pennsylvania,Lynnwood-Pricedale,1976,95,700,383,204,90,1472
Pennsylvania,Lyons borough,583,90,211,82,41,3,427
Pennsylvania,McAdoo borough,2522,199,895,434,50,96,1674
Pennsylvania,McAlisterville,1148,142,337,53,65,33,630
Pennsylvania,McClure borough,1016,142,394,132,46,30,744
Pennsylvania,McConnellsburg borough,1045,131,365,128,92,42,758
Pennsylvania,McConnellstown,1233,49,418,238,176,66,947
Pennsylvania,Lykens borough,1680,248,582,222,87,47,1186
Pennsylvania,Grill,1587,87,284,387,255,126,1139
Pennsylvania,Lorain borough,801,49,299,124,26,28,526
Pennsylvania,Long Branch borough,456,25,166,89,43,17,340
Pennsylvania,Greenwood,2151,129,925,472,93,12,1631
Pennsylvania,Greenville borough,5892,307,1663,950,330,213,3463
Pennsylvania,Green Tree borough,4653,118,963,976,995,519,3571
Pennsylvania,Greens Landing,817,94,178,115,29,61,477
Pennsylvania,Greensburg,14669,684,3349,2726,2145,1100,10004
Pennsylvania,Greensboro borough,222,15,60,39,24,19,157
Pennsylvania,Greenock,1905,36,698,503,131,51,1419
Pennsylvania,Longfellow,216,35,107,22,10,0,174
Pennsylvania,Green Lane borough,473,22,169,53,56,30,330
Pennsylvania,Greenfields,1000,86,299,221,125,27,758
Pennsylvania,Littlestown borough,4442,328,1203,914,364,164,2973
Pennsylvania,Liverpool borough,763,70,260,146,34,52,562
Pennsylvania,Lock Haven,9790,714,1878,926,547,361,4426
Pennsylvania,Locustdale,166,32,75,22,3,5,137
Pennsylvania,Loganton borough,559,48,175,110,23,6,362
Pennsylvania,Loganville borough,1147,74,266,210,146,81,777
Pennsylvania,Green Hills borough,41,0,5,18,5,3,31
Pennsylvania,West View borough,6735,335,1482,1550,1119,395,4881
Pennsylvania,West Waynesburg,296,73,105,58,0,0,236
Pennsylvania,Westwood,1224,80,454,272,12,54,872
Pennsylvania,Kutztown borough,5018,320,1040,698,582,411,3051
Pennsylvania,Kulpsville,8864,287,1551,1439,1802,1335,6414
Pennsylvania,Kulpmont borough,2894,289,1152,350,214,170,2175
Pennsylvania,Kreamer,797,84,268,144,78,66,640
Pennsylvania,Kratzerville,448,29,181,72,28,19,329
Pennsylvania,Koppel borough,696,35,247,172,61,7,522
Pennsylvania,Knoxville borough,635,66,219,111,36,3,435
Pennsylvania,Kutztown University,3822,2,9,57,14,3,85
Pennsylvania,Knox borough,1110,81,298,178,128,64,749
Pennsylvania,Kittanning borough,3947,483,1232,730,339,140,2924
Pennsylvania,Kistler borough,360,40,112,54,31,6,243
Pennsylvania,Kiskimere,67,7,30,4,14,0,55
Pennsylvania,Kirkwood,345,85,43,25,6,10,169
Pennsylvania,Kingston borough,13074,746,3171,3054,1836,1223,10030
Pennsylvania,King of Prussia,19761,769,3188,2629,4709,3225,14520
Pennsylvania,Kersey,858,69,418,86,34,12,619
Pennsylvania,Klingerstown,66,9,21,13,4,1,48
Pennsylvania,Kerrtown,271,16,52,17,0,0,85
Pennsylvania,Kylertown,355,95,166,0,15,0,276
Pennsylvania,Laflin borough,1539,38,355,280,254,226,1153
Pennsylvania,Woodbury borough,218,11,90,32,23,8,164
Pennsylvania,Lanesboro borough,437,33,158,85,22,3,301
Pennsylvania,Landisville,1810,54,341,201,335,331,1262
Pennsylvania,Landisburg borough,241,24,76,35,8,1,144
Pennsylvania,Landingville borough,94,7,40,9,7,6,69
Pennsylvania,Lancaster,59344,8557,13074,7402,4449,2603,36085
Pennsylvania,Lampeter,1549,40,222,314,333,52,961
Pennsylvania,Laceyville borough,466,52,154,55,34,10,305
Pennsylvania,Lamar,611,62,262,109,26,16,475
Pennsylvania,Lake Winola,705,41,202,137,87,63,530
Pennsylvania,Lakemont,2338,127,804,475,258,40,1704
Pennsylvania,Lake Meade,2470,43,503,533,441,295,1815
Pennsylvania,Lake Latonka,869,0,149,164,231,124,668
Pennsylvania,Lake Heritage,1646,22,282,379,278,233,1194
Pennsylvania,Lake City borough,3001,149,872,521,194,77,1813
Pennsylvania,Lake Arthur Estates,713,79,296,129,34,0,538
Pennsylvania,Lake Wynonah,2430,101,712,618,230,142,1803
Pennsylvania,Woodcock borough,130,7,65,20,6,6,104
Pennsylvania,Kennett Square borough,6117,1602,822,617,588,281,3910
Pennsylvania,Kenmar,4557,321,1201,708,472,378,3080
Pennsylvania,Jennerstown borough,631,29,190,125,94,40,478
Pennsylvania,Jenkintown borough,4444,49,558,558,1139,809,3113
Pennsylvania,Jefferson Hills borough,11115,332,2388,2088,2064,1153,8025
Pennsylvania,Jefferson borough (York County),571,75,183,78,49,29,414
Pennsylvania,Carrolltown borough,859,63,338,129,45,48,623
Pennsylvania,Carroll Valley borough,3900,63,705,854,531,421,2574
Pennsylvania,Cashtown,290,0,172,0,58,0,230
Pennsylvania,Jermyn borough,2251,190,703,460,204,57,1614
Pennsylvania,Cassandra borough,155,11,54,30,9,1,105
Pennsylvania,Cassville borough,114,9,48,21,4,0,82
Pennsylvania,Castanea,1195,58,442,224,88,50,862
Pennsylvania,Castle Shannon borough,8293,436,2402,1771,1275,488,6372
Pennsylvania,Catasauqua borough,6505,454,1846,1346,542,321,4509
Pennsylvania,Catawissa borough,1473,115,506,207,139,60,1027
Pennsylvania,Cecil-Bishop,2561,101,583,494,423,189,1790
Pennsylvania,Cedar Crest,354,53,192,9,5,4,263
Pennsylvania,Casselman borough,92,7,32,13,0,0,52
Pennsylvania,Kennerdell,217,23,92,57,12,3,187
Pennsylvania,Jerome,973,114,393,186,77,18,788
Pennsylvania,Jerseytown,131,18,43,19,11,12,103
Pennsylvania,Kenilworth,1786,83,442,337,286,116,1264
Pennsylvania,Kenhorst borough,2870,181,923,574,347,71,2096
Pennsylvania,Kempton,103,8,35,22,18,0,83
Pennsylvania,Kelayres,475,48,164,120,16,16,364
Pennsylvania,Karns City borough,204,20,95,32,4,0,151
Pennsylvania,Kapp Heights,1062,156,363,126,74,16,735
Pennsylvania,Kane borough,3658,271,1292,610,297,106,2576
Pennsylvania,Jersey Shore borough,4333,458,1144,705,340,64,2711
Pennsylvania,Juniata Terrace borough,730,51,204,132,25,12,424
Pennsylvania,Jonestown borough,1702,44,433,397,127,56,1057
Pennsylvania,Jonestown,57,13,23,12,0,0,48
Pennsylvania,Johnstown,20369,2158,7029,3453,947,551,14138
Pennsylvania,Johnsonburg borough,2465,186,1060,384,99,39,1768
Pennsylvania,Joffre,697,48,220,123,61,13,465
Pennsylvania,Jim Thorpe borough,4712,362,1528,916,450,182,3438
Pennsylvania,Jessup borough,4609,282,1244,771,648,257,3202
Pennsylvania,Julian,193,14,100,34,6,3,157
Pennsylvania,Cementon,1356,108,344,359,72,108,991
Pennsylvania,Woodland Heights,1160,37,369,215,106,64,791
Pennsylvania,Woodside,2485,28,164,193,588,714,1687
Pennsylvania,Buck Run,185,15,88,25,11,6,145
Pennsylvania,Buffington,332,106,148,74,3,0,331
Pennsylvania,Bulger,305,0,130,62,8,0,200
Pennsylvania,Burgettstown borough,1388,121,415,270,134,42,982
Pennsylvania,Burlington borough,178,5,57,19,9,5,95
Pennsylvania,Burnham borough,2044,173,756,313,150,20,1412
Pennsylvania,Burnside borough,216,17,100,35,3,5,160
Pennsylvania,Buckhorn,404,25,123,72,36,34,290
Pennsylvania,Butler,13517,1018,3729,3038,970,405,9160
Pennsylvania,Cairnbrook,584,51,246,79,48,11,435
Pennsylvania,California borough,6657,324,1494,647,518,400,3383
Pennsylvania,Callensburg borough,171,33,63,18,0,0,114
Pennsylvania,Callery borough,415,30,88,97,31,18,264
Pennsylvania,Callimont borough,40,9,14,5,4,4,36
Pennsylvania,Caln,1554,94,267,209,175,140,885
Pennsylvania,Calumet,1327,104,491,314,68,7,984
Pennsylvania,Byrnedale,498,18,134,122,19,7,300
Pennsylvania,Cambridge Springs borough,2532,238,775,536,263,97,1909
Pennsylvania,Bryn Mawr,3436,47,213,271,395,553,1479
Pennsylvania,Bruin borough,446,50,181,51,17,13,312
Pennsylvania,Bridgeport borough,4571,352,1341,820,498,418,3429
Pennsylvania,Bridgeville borough,5135,335,1434,1043,729,411,3952
Pennsylvania,Bridgewater borough,722,48,173,162,115,50,548
Pennsylvania,Brisbin borough,308,38,96,68,27,1,230
Pennsylvania,Bristol borough,9634,782,3380,1616,471,399,6648
Pennsylvania,Brittany Farms-The Highlands,3894,188,702,605,803,498,2796
Pennsylvania,Broad Top City borough,455,57,196,72,3,13,341
Pennsylvania,Bryn Athyn borough,1360,44,111,259,261,173,848
Pennsylvania,Brockway borough,1975,73,752,384,154,90,1453
Pennsylvania,Brookhaven borough,8054,581,2040,1619,1059,773,6072
Pennsylvania,Brookville borough,3888,225,1311,631,375,246,2788
Pennsylvania,Broomall,10859,735,2677,2145,1696,886,8139
Pennsylvania,Brownstown borough,766,26,279,145,67,18,535
Pennsylvania,Brownstown,2788,410,557,373,356,161,1857
Pennsylvania,Brownsville borough,2407,327,761,333,211,76,1708
Pennsylvania,Browntown,1451,118,480,279,122,37,1036
Pennsylvania,Brodheadsville,1769,94,420,501,202,24,1241
Pennsylvania,Woodlyn,10249,697,3337,1751,754,392,6931
Pennsylvania,Campbelltown,4053,119,789,696,573,521,2698
Pennsylvania,Canadohta Lake,536,37,227,90,41,31,426
Pennsylvania,Yeadon borough,11506,582,2762,2583,1280,698,7905
Pennsylvania,Yatesville borough,658,31,176,118,102,62,489
Pennsylvania,Yardley borough,2406,28,269,316,614,487,1714
Pennsylvania,Wyomissing borough,10475,306,1657,1656,1849,2079,7547
Pennsylvania,Wyoming borough,3066,215,688,763,409,243,2318
Pennsylvania,Wyndmoor,5611,341,612,707,1290,1213,4163
Pennsylvania,Wyncote,3207,157,485,424,533,698,2297
Pennsylvania,Yeagertown,1053,215,218,243,21,12,709
Pennsylvania,Wylandville,323,52,122,55,30,0,259
Pennsylvania,Wyalusing borough,472,34,167,89,40,27,357
Pennsylvania,Wrightsville borough,2436,347,876,299,90,56,1668
Pennsylvania,Woxall,1288,44,293,211,226,127,901
Pennsylvania,Worthville borough,69,1,35,9,8,2,55
Pennsylvania,Worthington borough,648,31,224,109,42,24,430
Pennsylvania,Wormleysburg borough,3066,162,627,472,667,348,2276
Pennsylvania,Woodward,158,16,35,33,13,3,100
Pennsylvania,Wyano,430,50,230,50,11,8,349
Pennsylvania,Camp Hill borough,7886,225,1177,1335,1804,1178,5719
Pennsylvania,Yoe borough,1067,99,357,175,60,26,717
Pennsylvania,Yorkana borough,242,16,99,25,13,7,160
Pennsylvania,Canonsburg borough,8944,618,2482,1622,1434,524,6680
Pennsylvania,Canton borough,1984,146,745,248,116,70,1325
Pennsylvania,Carbondale,8773,837,3119,1460,645,323,6384
Pennsylvania,Carlisle borough,18945,1155,3866,2772,2273,1934,12000
Pennsylvania,Carmichaels borough,360,33,123,67,46,20,289
Pennsylvania,Carnegie borough,7953,402,2087,1665,1101,479,5734
Pennsylvania,Carnot-Moon,12546,550,1766,2141,2181,1331,7969
Pennsylvania,York,43853,6132,11603,5276,2133,915,26059
Pennsylvania,Zion,1977,4,561,374,210,210,1359
Pennsylvania,Yukon,669,72,331,111,54,0,568
Pennsylvania,Youngwood borough,2998,200,964,551,250,88,2053
Pennsylvania,Youngsville borough,1818,92,596,403,121,55,1267
Pennsylvania,Youngstown borough,338,13,98,79,27,14,231
Pennsylvania,York Springs borough,692,158,126,84,32,16,416
Pennsylvania,Yorklyn,2046,83,699,381,96,38,1297
Pennsylvania,York Haven borough,698,85,222,71,57,9,444
Pennsylvania,Zelienople borough,3766,196,850,710,590,414,2760
Pennsylvania,Centerport borough,292,26,74,58,25,20,203
Pennsylvania,Centerville borough (Crawford County),188,25,60,30,15,7,137
Pennsylvania,Parker,685,74,268,84,24,12,462
Pennsylvania,Ligonier borough,1483,46,322,341,358,163,1230
Pennsylvania,Lilly borough,802,37,404,89,62,26,618
Pennsylvania,Lima,2170,120,636,261,606,193,1816
Pennsylvania,Lime Ridge,780,37,371,83,53,4,548
Pennsylvania,Lincoln borough,1021,61,374,241,77,32,785
Pennsylvania,Lincoln Park,1598,27,411,135,314,132,1019
Pennsylvania,Lincoln University,1787,9,6,47,4,0,66
Pennsylvania,Lightstreet,919,124,220,156,112,100,712
Pennsylvania,Lincolnville,156,0,60,33,9,5,107
Pennsylvania,Linglestown,6338,314,1617,1364,979,364,4638
Pennsylvania,Linntown,1303,27,211,234,279,282,1033
Pennsylvania,Linwood,3449,241,1162,506,137,88,2134
Pennsylvania,Lionville,6637,125,995,1068,1471,904,4563
Pennsylvania,Lititz borough,9208,555,2475,1670,1363,773,6836
Pennsylvania,Little Britain,244,0,50,78,24,14,166
Pennsylvania,Little Meadows borough,218,7,91,68,20,14,200
Pennsylvania,Linesville borough,843,65,321,175,66,39,666
Pennsylvania,Plymouth borough,5895,446,1925,1155,373,144,4043
Pennsylvania,Liberty borough (Tioga County),200,12,55,46,7,5,125
Pennsylvania,Lewistown borough,8326,706,2892,1379,391,284,5652
Pennsylvania,Leetsdale borough,1281,73,277,271,228,82,931
Pennsylvania,Lehighton borough,5388,454,1898,915,271,250,3788
Pennsylvania,Leith-Hatfield,2745,197,958,449,304,260,2168
Pennsylvania,Lemont,2346,15,69,443,490,455,1472
Pennsylvania,Lemont Furnace,847,139,255,86,10,5,495
Pennsylvania,Lemoyne borough,4614,196,900,1057,590,436,3179
Pennsylvania,Lenape Heights,1145,63,411,208,50,77,809
Pennsylvania,Liberty borough (Allegheny County),2537,81,910,621,248,53,1913
Pennsylvania,Lenhartsville borough,182,10,76,30,7,2,125
Pennsylvania,Leola,7104,682,1734,998,802,467,4683
Pennsylvania,Le Raysville borough,275,22,92,39,21,9,183
Pennsylvania,Level Green,4043,114,1006,758,720,307,2905
Pennsylvania,Levittown,51805,2784,16656,10766,4248,1651,36105
Pennsylvania,Lewisberry borough,418,31,112,123,31,16,313
Pennsylvania,Lewisburg borough,5781,525,770,698,477,358,2828
Pennsylvania,Lewis Run borough,611,10,240,108,57,22,437
Pennsylvania,Lenkerville,550,27,248,82,54,10,421
Pennsylvania,Leesport borough,1844,113,601,310,182,76,1282
Pennsylvania,Plymouth Meeting,5796,139,797,1161,1169,1122,4388
Pennsylvania,Pocono Mountain Lake Estates,741,38,230,181,118,40,607
Pennsylvania,Wilkes-Barre,41108,4326,10586,6954,2752,1193,25811
Pennsylvania,Wilcox,407,19,190,68,13,7,297
Pennsylvania,Wilburton Number Two,89,7,20,24,11,0,62
Pennsylvania,Wilburton Number One,178,21,85,9,4,6,125
Pennsylvania,Wiconsico,850,106,292,110,47,14,569
Pennsylvania,Wickerham Manor-Fisher,2223,114,507,479,394,267,1761
Pennsylvania,Whitfield,4785,118,870,992,1082,467,3529
Pennsylvania,Wilkinsburg borough,15866,1074,3542,3437,2130,1440,11623
Pennsylvania,White Oak borough,7842,388,2487,1864,961,440,6140
Pennsylvania,White Haven borough,1173,72,408,265,88,7,840
Pennsylvania,Whitehall borough,13920,851,3446,2533,2206,1477,10513
Pennsylvania,Whitaker borough,1211,71,375,291,54,45,836
Pennsylvania,Wheatland borough,838,55,313,160,54,9,591
Pennsylvania,West York borough,4583,295,1389,995,203,44,2926
Pennsylvania,West Wyomissing,3147,176,1186,555,253,119,2289
Pennsylvania,West Wyoming borough,2706,90,903,554,412,106,2065
Pennsylvania,White Mills,738,44,272,94,77,39,526
Pennsylvania,Plymptonville,1087,126,334,222,101,34,817
Pennsylvania,Williamsburg borough,1271,90,427,221,78,44,860
Pennsylvania,Williamstown borough,1279,114,444,234,60,32,884
Pennsylvania,Pocono Pines,942,25,156,223,196,142,742
Pennsylvania,Woodbourne,3768,51,323,490,999,762,2625
Pennsylvania,Womelsdorf borough,2850,276,819,411,226,133,1865
Pennsylvania,Wolfdale,2958,320,1057,568,282,26,2253
Pennsylvania,Witmer,617,66,53,272,17,16,424
Pennsylvania,Winterstown borough,520,60,212,84,24,31,411
Pennsylvania,Winfield,805,80,244,135,79,70,608
Pennsylvania,Williamsport,29339,2457,6900,4853,2196,1270,17676
Pennsylvania,Windsor borough,1401,157,510,124,61,27,879
Pennsylvania,Wind Gap borough,2709,218,863,655,255,62,2053
Pennsylvania,Windber borough,4062,304,1287,788,441,161,2981
Pennsylvania,Wilson borough,7838,525,2353,1785,558,184,5405
Pennsylvania,Wilmore borough,252,5,84,37,25,9,160
Pennsylvania,Wilmerding borough,1766,164,607,319,90,39,1219
Pennsylvania,Willow Street,7562,328,2133,1654,1255,836,6206
Pennsylvania,Willow Grove,15545,644,3263,2908,2565,1449,10829
Pennsylvania,Wind Ridge,207,15,98,20,7,3,143
Pennsylvania,Leeper,156,2,83,37,4,18,144
Pennsylvania,Leechburg borough,2056,108,642,472,143,109,1474
Pennsylvania,Lebanon South,2427,197,735,386,234,123,1675
Pennsylvania,Pennside,4094,363,1033,701,438,246,2781
Pennsylvania,Penn State Erie (Behrend),1651,0,0,15,17,0,32
Pennsylvania,Pennville,1637,108,665,210,253,47,1283
Pennsylvania,Pennwyn,714,63,224,148,119,0,554
Pennsylvania,Penn Wynne,5568,53,474,561,1200,1700,3988
Pennsylvania,Penryn,872,79,310,181,88,90,748
Pennsylvania,Perkasie borough,8498,329,1985,1679,1240,572,5805
Pennsylvania,Penns Creek,586,50,260,77,41,11,439
Pennsylvania,Perryopolis borough,1797,132,557,334,169,112,1304
Pennsylvania,Petrolia borough,243,16,82,58,4,1,161
Pennsylvania,Philadelphia,1555072,184130,346344,233308,152759,107468,1024009
Pennsylvania,Philipsburg borough,2740,188,954,515,206,103,1966
Pennsylvania,Phoenixville borough,16562,940,3874,2379,3310,1408,11911
Pennsylvania,Picture Rocks borough,815,31,196,175,80,55,537
Pennsylvania,Pikes Creek,287,13,75,53,22,12,175
Pennsylvania,Pillow borough,280,32,87,32,19,12,182
Pennsylvania,Petersburg borough,541,37,191,103,7,4,342
Pennsylvania,Pine Glen,217,14,82,36,10,3,145
Pennsylvania,Pennsbury Village borough,743,16,120,118,263,107,624
Pennsylvania,Penn Lake Park borough,291,17,70,82,37,33,239
Pennsylvania,Parkesburg borough,3659,269,1028,615,262,165,2339
Pennsylvania,Park Forest Village,9457,206,964,1007,1718,1793,5688
Pennsylvania,Parkside borough,2280,100,648,432,216,142,1538
Pennsylvania,Parkville,7141,551,2334,1280,326,195,4686
Pennsylvania,Parryville borough,629,59,211,95,47,8,420
Pennsylvania,Patterson Heights borough,630,9,101,138,151,58,457
Pennsylvania,Patton borough,1920,165,778,343,110,60,1456
Pennsylvania,Pennsburg borough,3872,248,965,675,349,223,2460
Pennsylvania,Paxtang borough,1519,57,309,320,226,177,1089
Pennsylvania,Paxtonville,194,10,89,42,7,6,154
Pennsylvania,Pen Argyl borough,3557,316,739,687,256,156,2154
Pennsylvania,Penbrook borough,2983,208,794,561,308,117,1988
Pennsylvania,Pen Mar,1075,46,330,234,105,55,770
Pennsylvania,Penn borough,545,20,128,121,24,9,302
Pennsylvania,Penndel borough,2785,98,796,485,204,144,1727
Pennsylvania,Penn Estates,6318,426,1137,1353,671,454,4041
Pennsylvania,Paxtonia,4998,226,883,1100,943,448,3600
Pennsylvania,Pine Grove borough,2081,186,640,355,132,55,1368
Pennsylvania,Pine Grove Mills,940,0,279,231,162,160,832
Pennsylvania,Pine Ridge,2652,392,607,492,239,134,1864
Pennsylvania,Laporte borough,331,43,139,59,10,39,290
Pennsylvania,Larksville borough,4453,358,1424,889,444,205,3320
Pennsylvania,Latrobe borough,8191,399,2195,1814,756,497,5661
Pennsylvania,Lattimer,714,31,136,258,66,50,541
Pennsylvania,Laureldale borough,3884,431,1446,659,235,119,2890
Pennsylvania,Laurel Mountain borough,208,0,20,78,33,12,143
Pennsylvania,Laurel Run borough,517,58,210,88,42,30,428
Pennsylvania,Lansford borough,3871,451,1261,843,107,100,2762
Pennsylvania,Laurelton,262,24,115,29,3,8,179
Pennsylvania,Lavelle,529,76,196,99,85,13,469
Pennsylvania,Lawnton,3794,237,994,761,461,217,2670
Pennsylvania,Lawrence,343,41,120,69,49,8,287
Pennsylvania,Lawrence Park,3902,212,974,693,561,191,2631
Pennsylvania,Lawrenceville borough,565,39,147,123,42,31,382
Pennsylvania,Lawson Heights,2192,75,732,569,248,174,1798
Pennsylvania,Lebanon,25555,4167,7084,3102,1041,673,16067
Pennsylvania,Laurys Station,1095,82,280,206,139,81,788
Pennsylvania,Lansdowne borough,10614,530,2089,2249,1590,968,7426
Pennsylvania,Lansdale borough,16441,1003,3399,3144,2478,1230,11254
Pennsylvania,Langhorne Manor borough,1494,100,202,190,168,158,818
Pennsylvania,Pitcairn borough,3270,155,963,683,283,157,2241
Pennsylvania,Pittsburgh,305928,17430,58724,49566,39961,38038,203719
Pennsylvania,Pittston,7698,612,2403,1545,547,362,5469
Pennsylvania,Plainfield,338,0,124,119,0,9,252
Pennsylvania,Plains,3900,230,1438,828,401,242,3139
Pennsylvania,Platea borough,461,42,180,60,29,8,319
Pennsylvania,Pleasant Gap,2849,80,931,570,387,152,2120
Pennsylvania,Pleasant Hill,2648,147,636,448,262,193,1686
Pennsylvania,Pleasant Hills borough,8284,191,1731,1891,1598,879,6290
Pennsylvania,Pleasant View,967,50,425,154,70,31,730
Pennsylvania,Pleasantville borough (Bedford County),208,14,110,18,9,4,155
Pennsylvania,Pleasantville borough (Venango County),866,43,289,182,80,26,620
Pennsylvania,Plum borough,27458,1139,5940,5939,4471,2424,19913
Pennsylvania,Plumsteadville,3256,21,411,446,728,289,1895
Pennsylvania,Plumville borough,305,35,123,32,24,0,214
Pennsylvania,Langeloth,608,68,237,121,32,37,495
Pennsylvania,Langhorne borough,1488,41,459,273,197,167,1137
Pennsylvania,Nuremberg,423,46,158,51,0,3,258
Pennsylvania,Numidia,224,8,57,35,19,14,133
Pennsylvania,Oklahoma,1032,137,343,211,7,6,704
Pennsylvania,Noxen,678,59,269,108,27,18,481
Pennsylvania,Sugar Notch borough,944,75,335,149,108,25,692
Pennsylvania,Sugar Grove borough,554,28,165,111,71,22,397
Pennsylvania,Sugarcreek borough,5200,322,2210,939,264,105,3840
Pennsylvania,Sturgeon,1370,39,385,176,228,113,941
Pennsylvania,Stroudsburg borough,5516,589,1071,1042,497,356,3555
Pennsylvania,Strong,18,0,18,0,0,0,18
Pennsylvania,Strodes Mills,535,20,237,101,17,35,410
Pennsylvania,Summerhill borough,451,15,163,80,52,18,328
Pennsylvania,Strausstown borough,270,36,93,45,24,6,204
Pennsylvania,Strasburg borough,2864,136,717,470,351,218,1892
Pennsylvania,Stoystown borough,287,14,110,52,35,21,232
Pennsylvania,Stowe,3763,370,1098,669,252,86,2475
Pennsylvania,Stouchsburg,537,94,180,75,34,24,407
Pennsylvania,Stormstown,2410,29,286,280,550,453,1598
Pennsylvania,Stony Creek Mills,841,172,200,98,70,59,599
Pennsylvania,Stonybrook,1999,106,468,344,362,272,1552
Pennsylvania,Strattanville borough,720,55,272,96,52,10,485
Pennsylvania,Stonerstown,499,20,170,94,43,12,339
Pennsylvania,Summerville borough,511,31,209,74,32,22,368
Pennsylvania,Summit Station,163,12,104,19,28,0,163
Pennsylvania,Millville borough,942,100,300,138,103,59,700
Pennsylvania,Millwood,629,145,181,82,8,0,416
Pennsylvania,Milroy,1556,171,601,205,104,55,1136
Pennsylvania,Milton borough,6993,807,2257,1164,374,267,4869
Pennsylvania,Minersville borough,4310,508,1488,564,148,209,2917
Pennsylvania,Mingoville,707,0,255,158,73,11,497
Pennsylvania,Mocanaqua,717,75,271,112,32,27,517
Pennsylvania,Summit Hill borough,2981,196,1137,460,234,174,2201
Pennsylvania,Modena borough,625,120,134,61,31,12,358
Pennsylvania,Swarthmore borough,6195,86,385,332,927,1555,3285
Pennsylvania,Sutersville borough,610,59,218,111,35,8,431
Pennsylvania,Susquehanna Trails,2910,305,737,580,141,23,1786
Pennsylvania,Susquehanna Depot borough,1558,194,512,247,68,52,1073
Pennsylvania,Sun Valley,2261,113,705,364,308,47,1537
Pennsylvania,Sunrise Lake,1625,88,477,407,219,11,1202
Pennsylvania,Sunbury,9758,1451,3240,1389,401,177,6658
Pennsylvania,Swartzville,2038,165,565,408,395,73,1606
Pennsylvania,Mill Village borough,422,15,162,86,19,14,296
Pennsylvania,Stoneboro borough,1005,49,402,200,86,33,770
Pennsylvania,Stockdale borough,354,36,98,79,44,22,279
Pennsylvania,Foxburg borough,212,17,71,37,16,20,161
Pennsylvania,Fountain Springs,390,32,199,77,15,0,323
Pennsylvania,Fountain Hill borough,4614,492,1060,873,473,487,3385
Pennsylvania,Foundryville,108,38,30,33,7,0,108
Pennsylvania,Foster Brook,1052,60,313,186,139,34,732
Pennsylvania,Forty Fort borough,4170,75,1006,886,610,545,3122
Pennsylvania,Fort Washington,5931,158,515,705,1392,1275,4045
Pennsylvania,Fox Chapel borough,5413,17,124,448,1108,1892,3589
Pennsylvania,Fort Loudon,928,61,479,160,0,12,712
Pennsylvania,Forksville borough,97,0,42,28,1,5,76
Pennsylvania,Forestville,363,41,130,92,32,10,305
Pennsylvania,Forest Hills borough,6491,97,1241,1144,1409,1264,5155
Pennsylvania,Forest City borough,2162,220,750,353,205,56,1584
Pennsylvania,Ford Cliff borough,435,24,182,104,27,4,341
Pennsylvania,Ford City borough,2928,192,1057,597,216,32,2094
Pennsylvania,Force,273,38,88,24,35,0,185
Pennsylvania,Fort Indiantown Gap,39,0,20,19,0,0,39
Pennsylvania,Stockertown borough,1156,64,239,271,138,83,795
Pennsylvania,Fox Chase,1344,117,393,336,219,16,1081
Pennsylvania,Frankfort Springs borough,102,6,36,31,4,3,80
Pennsylvania,Stillwater borough,199,13,69,20,24,15,141
Pennsylvania,Stiles,1099,65,254,229,95,98,741
Pennsylvania,Stewartstown borough,2126,161,594,413,249,104,1521
Pennsylvania,Stevens,375,79,142,88,10,8,327
Pennsylvania,Steelton borough,5956,358,1618,1069,258,166,3469
Pennsylvania,State Line,2372,252,717,413,214,79,1675
Pennsylvania,State College borough,42129,316,1363,2012,3331,4799,11821
Pennsylvania,Frackville borough,3757,214,1276,634,319,127,2570
Pennsylvania,Starrucca borough,223,22,52,52,13,6,145
Pennsylvania,Starbrick,498,37,299,61,28,0,425
Pennsylvania,Spry,4896,228,1366,942,615,411,3562
Pennsylvania,Fredericksburg CDP (Crawford County),771,17,249,129,94,66,555
Pennsylvania,Franklintown borough,527,8,141,145,24,0,318
Pennsylvania,Franklin Park borough,14062,106,1323,1594,3320,3164,9507
Pennsylvania,Franklin,6401,624,1862,1032,632,238,4388
Pennsylvania,Franklin borough,299,38,115,34,28,9,224
Pennsylvania,Star Junction,455,34,227,63,23,16,363
Pennsylvania,Foot of Ten,791,107,355,141,13,12,628
Pennsylvania,Millvale borough,3721,309,1032,983,371,92,2787
Pennsylvania,Millheim borough,890,66,296,152,79,29,622
Pennsylvania,Sylvania borough,237,13,68,47,15,7,150
Pennsylvania,Sykesville borough,1131,102,354,253,52,25,786
Pennsylvania,Swoyersville borough,5025,323,1457,1175,593,330,3878
Pennsylvania,Swissvale borough,8932,390,2076,1869,1301,1128,6764
Pennsylvania,Sweden Valley,200,10,75,37,8,4,134
Pennsylvania,Marion Heights borough,709,60,209,156,41,27,493
Pennsylvania,Marklesburg borough,250,1,77,42,17,16,153
Pennsylvania,Table Rock,56,10,8,16,0,0,34
Pennsylvania,Markleysburg borough,259,39,126,26,7,4,202
Pennsylvania,Mars borough,1276,58,312,318,165,100,953
Pennsylvania,Marshallton,1301,136,486,177,106,9,914
Pennsylvania,Martinsburg borough,1776,171,710,244,201,126,1452
Pennsylvania,Martins Creek,504,27,215,137,38,0,417
Pennsylvania,Marysville borough,2525,156,808,515,204,115,1798
Pennsylvania,Masontown borough,3416,212,1423,356,209,117,2317
Pennsylvania,Masthope,682,36,81,202,119,92,530
Pennsylvania,Marlin,491,59,176,58,61,24,378
Pennsylvania,Matamoras borough,2310,131,623,414,272,185,1625
Pennsylvania,Tamaqua borough,6949,791,2004,1389,540,166,4890
Pennsylvania,Tatamy borough,992,24,204,184,182,84,678
Pennsylvania,Republic,1005,68,331,145,45,28,617
Pennsylvania,Revloc,660,76,189,112,73,0,450
Pennsylvania,Rew,67,7,21,8,7,7,50
Pennsylvania,Reynolds Heights,1858,181,624,238,97,8,1148
Pennsylvania,Reynoldsville borough,2734,156,1067,441,136,139,1939
Pennsylvania,Rheems,1610,20,406,211,280,79,996
Pennsylvania,Thompsontown borough,794,99,252,159,39,31,580
Pennsylvania,Tarentum borough,4507,290,1517,856,478,103,3244
Pennsylvania,Thompson borough,343,48,90,67,19,15,239
Pennsylvania,Tharptown (Uniontown),495,60,226,93,17,21,417
Pennsylvania,Nuangola borough,778,34,187,170,103,75,569
Pennsylvania,Templeton,310,37,133,29,6,3,208
Pennsylvania,Temple,1487,133,575,213,158,31,1110
Pennsylvania,Telford borough,4881,464,1177,946,638,221,3446
Pennsylvania,Taylorstown,151,6,67,20,9,2,104
Pennsylvania,Taylor borough,6176,497,2034,1028,693,189,4441
Pennsylvania,The Hideout,2662,95,740,410,389,468,2102
Pennsylvania,Millsboro,542,13,124,118,69,18,342
Pennsylvania,Mather,505,65,149,106,51,0,371
Pennsylvania,Mayfield borough,1764,70,577,415,174,66,1302
Pennsylvania,Midway,1880,150,791,309,143,168,1561
Pennsylvania,Midway borough,886,59,316,130,60,7,572
Pennsylvania,Mifflin borough,626,89,232,41,40,29,431
Pennsylvania,Mifflinburg borough,3530,286,1115,592,298,160,2451
Pennsylvania,Mifflintown borough,1084,108,330,169,34,39,680
Pennsylvania,Mifflinville,1377,138,471,196,128,93,1026
Pennsylvania,Milesburg borough,855,47,293,107,121,10,578
Pennsylvania,Midland borough,2589,349,598,467,114,49,1577
Pennsylvania,Milford borough,1067,57,286,273,150,101,867
Pennsylvania,Millbourne borough,1155,155,301,111,114,48,729
Pennsylvania,Mill Creek borough,373,49,158,50,2,4,263
Pennsylvania,Millersburg borough,2544,325,753,475,127,90,1770
Pennsylvania,Millerstown borough,741,25,212,144,61,57,499
Pennsylvania,Millersville borough,8358,278,1258,881,688,493,3598
Pennsylvania,Millerton,347,19,110,93,4,26,252
Pennsylvania,Mill Hall borough,1565,133,531,213,116,74,1067
Pennsylvania,Milford Square,1115,0,354,156,104,99,713
Pennsylvania,Mattawana,399,83,111,45,6,0,245
Pennsylvania,Middletown,7380,561,1845,1581,1036,332,5355
Pennsylvania,Middleport borough,399,52,180,78,23,5,338
Pennsylvania,Maytown,4095,44,1227,571,475,237,2554
Pennsylvania,Meadowlands,999,57,377,247,40,72,793
Pennsylvania,Meadowood,2620,196,763,564,416,183,2122
Pennsylvania,Meadville,13224,999,2758,1975,1309,1114,8155
Pennsylvania,Mechanicsburg borough,8984,620,1956,1878,1389,760,6603
Pennsylvania,Mechanicsville borough,496,39,209,58,30,16,352
Pennsylvania,Media borough,5336,210,678,1065,1288,897,4138
Pennsylvania,Middletown borough,8942,754,2655,1502,694,307,5912
Pennsylvania,Mercer borough,1964,142,512,353,222,113,1342
Pennsylvania,Meridian,3605,126,846,880,498,318,2668
Pennsylvania,Mertztown,838,132,312,130,0,0,574
Pennsylvania,Meshoppen borough,450,75,163,57,6,1,302
Pennsylvania,Messiah College,2371,0,0,13,0,32,45
Pennsylvania,Mexico,308,45,144,37,10,4,240
Pennsylvania,Meyersdale borough,1933,250,734,290,120,52,1446
Pennsylvania,Middleburg borough,1408,132,381,217,83,25,838
Pennsylvania,Mercersburg borough,1417,206,454,190,96,108,1054
Pennsylvania,Renovo borough,1229,138,437,181,39,7,802
Pennsylvania,Folsom,8163,289,2362,1640,1192,305,5788
Pennsylvania,Flying Hills,2356,134,454,326,598,386,1898
Pennsylvania,Etna borough,3432,203,873,979,413,104,2572
Pennsylvania,Espy,1735,121,491,271,261,101,1245
Pennsylvania,Ernest borough,355,18,123,70,36,8,255
Pennsylvania,Erie,100678,8495,26902,15344,9459,4552,64752
Pennsylvania,Ephrata borough,13617,1146,4210,2129,1318,605,9408
Pennsylvania,Enon Valley borough,359,24,110,75,32,13,254
Pennsylvania,Enola,6235,363,1824,1228,441,150,4006
Pennsylvania,Evansburg,2371,34,303,459,450,339,1585
Pennsylvania,Enlow,1247,125,211,367,83,60,846
Pennsylvania,Englewood,720,23,332,76,77,0,508
Pennsylvania,Emsworth borough,2429,96,445,597,383,173,1694
Pennsylvania,Emporium borough,1917,160,689,393,152,58,1452
Pennsylvania,Emmaus borough,11342,765,3041,2049,1764,771,8390
Pennsylvania,Emlenton borough,706,38,234,94,77,32,475
Pennsylvania,Emigsville,2933,218,815,538,198,82,1851
Pennsylvania,Emerald Lakes,3822,196,996,697,275,90,2254
Pennsylvania,Enhaut,877,153,278,195,37,46,709
Pennsylvania,Elysburg,1892,101,556,260,214,233,1364
Pennsylvania,Evans City borough,1760,119,463,413,183,136,1314
Pennsylvania,Everson borough,736,69,322,123,42,3,559
Pennsylvania,Sligo borough,620,38,235,95,66,19,453
Pennsylvania,Slickville,313,19,193,41,24,0,277
Pennsylvania,Slatington borough,4263,307,1396,864,250,89,2906
Pennsylvania,Slatedale,612,39,253,67,20,0,379
Pennsylvania,Slabtown,115,18,39,33,2,3,95
Pennsylvania,Skyline View,3895,60,951,640,731,457,2839
Pennsylvania,Skippack,3977,92,559,731,795,535,2712
Pennsylvania,Everett borough,1769,167,648,273,65,23,1176
Pennsylvania,Sinking Spring borough,4042,145,823,823,599,238,2628
Pennsylvania,Silverdale borough,923,15,220,192,96,117,640
Pennsylvania,Silkworth,979,87,290,132,121,77,707
Pennsylvania,Siglerville,97,23,50,0,8,0,81
Pennsylvania,Sierra View,5088,197,1400,1238,326,243,3404
Pennsylvania,Sidman,556,14,163,41,24,97,339
Pennsylvania,Export borough,990,42,292,243,77,28,682
Pennsylvania,Exeter borough,5625,394,1719,988,592,444,4137
Pennsylvania,Simpson,1267,81,393,329,104,58,965
Pennsylvania,Slippery Rock borough,3633,133,279,305,216,379,1312
Pennsylvania,Elverson borough,1353,106,334,314,178,120,1052
Pennsylvania,Ellwood City borough,7836,571,2237,1508,835,373,5524
Pennsylvania,Edgewood borough,3093,52,226,469,678,926,2351
Pennsylvania,Edenburg,803,47,223,174,103,36,583
Pennsylvania,Edenborn,226,16,55,60,16,0,147
Pennsylvania,Eddystone borough,2521,195,683,496,68,69,1511
Pennsylvania,Eddington,1937,110,536,403,196,72,1317
Pennsylvania,Economy borough,9189,407,2482,1959,1516,752,7116
Pennsylvania,Ebensburg borough,3265,212,775,598,484,379,2448
Pennsylvania,Edgewood,2232,310,747,381,155,43,1636
Pennsylvania,Eau Claire borough,353,51,120,49,17,3,240
Pennsylvania,East Waterford,178,25,83,11,0,0,119
Pennsylvania,East Washington borough,2244,23,412,289,344,312,1380
Pennsylvania,East Vandergrift borough,742,40,300,132,66,20,558
Pennsylvania,Eastvale borough,237,25,92,21,4,4,146
Pennsylvania,East Uniontown,2532,221,991,383,211,47,1853
Pennsylvania,East Stroudsburg borough,9967,740,1566,1384,796,472,4958
Pennsylvania,East Side borough,247,22,117,52,12,3,206
Pennsylvania,East York,8247,781,1590,1758,1228,843,6200
Pennsylvania,Elrama,290,13,105,92,0,0,210
Pennsylvania,Edgeworth borough,1657,6,76,118,484,433,1117
Pennsylvania,Edinboro borough,6443,140,906,785,692,547,3070
Pennsylvania,Ellsworth borough,741,85,270,96,40,15,506
Pennsylvania,Ellport borough,1108,83,343,235,108,20,789
Pennsylvania,Elkland borough,1928,154,732,296,112,51,1345
Pennsylvania,Elizabethville borough,1736,195,613,232,52,57,1149
Pennsylvania,Elizabethtown borough,11591,500,2601,1743,1226,730,6800
Pennsylvania,Elizabeth borough,1391,107,388,362,97,53,1007
Pennsylvania,Elim,3760,158,1160,566,638,275,2797
Pennsylvania,Edie,44,0,28,6,10,0,44
Pennsylvania,Elgin borough,168,7,83,22,2,5,119
Pennsylvania,Elderton borough,342,28,132,52,35,20,267
Pennsylvania,Elco borough,303,48,142,32,12,3,237
Pennsylvania,Eighty Four,764,81,200,190,40,30,541
Pennsylvania,Ehrenfeld borough,211,22,71,42,7,1,143
Pennsylvania,Egypt,2512,114,684,652,254,138,1842
Pennsylvania,Effort,2312,69,507,377,211,192,1356
Pennsylvania,Edwardsville borough,4773,330,1393,801,301,182,3007
Pennsylvania,Eldred borough,648,41,227,110,28,29,435
Pennsylvania,Folcroft borough,6630,394,1988,1083,634,173,4272
Pennsylvania,Slippery Rock University,2138,4,10,18,0,0,32
Pennsylvania,Smethport borough,1587,114,482,363,110,119,1188
Pennsylvania,Fallston borough,217,7,71,56,18,6,158
Pennsylvania,Falls Creek borough,1160,65,406,238,40,29,778
Pennsylvania,Fairview-Ferndale,1689,200,690,272,117,68,1347
Pennsylvania,Fairview,2668,82,858,338,442,198,1918
Pennsylvania,Fairview borough,200,22,58,25,14,4,123
Pennsylvania,Fairless Hills,8789,430,2739,2080,824,250,6323
Pennsylvania,Fairhope,1258,11,488,305,35,71,910
Pennsylvania,Falmouth,269,27,87,72,11,0,197
Pennsylvania,Fairfield borough,543,46,190,78,46,45,405
Pennsylvania,Fairchance borough,1820,119,672,305,123,52,1271
Pennsylvania,Factoryville borough,1119,20,184,166,82,44,496
Pennsylvania,Eyers Grove,82,0,47,16,10,0,73
Pennsylvania,Exton,4772,158,640,547,1150,1042,3537
Pennsylvania,Spring Ridge,844,0,186,121,289,120,716
Pennsylvania,Spring Mount,2361,81,555,484,286,297,1703
Pennsylvania,Springmont,620,2,120,83,133,101,439
Pennsylvania,Fairdale,1772,184,469,246,225,105,1229
Pennsylvania,Spring Mills,268,16,127,47,26,6,222
Pennsylvania,Farmersville,945,400,123,43,86,53,705
Pennsylvania,Farrell,4852,449,1302,991,389,88,3219
Pennsylvania,Flourtown,4845,120,610,780,947,920,3377
Pennsylvania,Flora Dale,26,26,0,0,0,0,26
Pennsylvania,Flemington borough,1342,88,445,195,119,81,928
Pennsylvania,Fleetwood borough,4082,283,1140,802,380,182,2787
Pennsylvania,Fivepointville,1380,101,325,249,158,52,885
Pennsylvania,Finleyville borough,434,15,142,96,41,10,304
Pennsylvania,Fernville,496,21,186,66,50,63,386
Pennsylvania,Farmington,867,32,153,228,95,62,570
Pennsylvania,Ferndale borough,1578,67,513,309,124,49,1062
Pennsylvania,Fellsburg,1107,60,370,316,108,83,937
Pennsylvania,Feasterville,3349,162,680,854,363,140,2199
Pennsylvania,Fayetteville,3007,166,919,617,331,82,2115
Pennsylvania,Fayette City borough,567,43,158,101,36,0,338
Pennsylvania,Faxon,1264,59,290,253,196,215,1013
Pennsylvania,Fawn Lake Forest,523,15,143,139,39,94,430
Pennsylvania,Fawn Grove borough,427,18,147,62,24,36,287
Pennsylvania,Felton borough,603,57,201,102,39,8,407
Pennsylvania,Slovan,461,77,139,35,57,0,308
Pennsylvania,Spring House,3541,47,493,464,872,742,2618
Pennsylvania,Spring Grove borough,2308,93,758,381,153,90,1475
Pennsylvania,South Fork borough,960,82,343,129,32,26,612
Pennsylvania,South Connellsville borough,1819,147,668,360,102,28,1305
Pennsylvania,South Coatesville borough,1408,68,439,206,125,56,894
Pennsylvania,South Bethlehem borough,446,54,146,70,25,31,326
Pennsylvania,Souderton borough,6697,506,1859,1136,812,353,4666
Pennsylvania,Soudersburg,414,0,242,53,85,14,394
Pennsylvania,Somerset borough,6127,492,1793,1032,662,380,4359
Pennsylvania,South Greensburg borough,2067,118,579,504,244,124,1569
Pennsylvania,Snydertown borough,335,6,160,44,22,17,249
Pennsylvania,S.N.P.J. borough,18,4,6,2,2,0,14
Pennsylvania,Snow Shoe borough,905,36,310,135,78,12,571
Pennsylvania,Smoketown,395,145,51,31,32,0,259
Pennsylvania,Smock,543,33,217,104,39,9,402
Pennsylvania,Smithton borough,409,27,128,103,26,2,286
Pennsylvania,Smithfield borough,1017,60,321,145,72,19,617
Pennsylvania,Smicksburg borough,41,4,12,13,1,0,30
Pennsylvania,Snydertown,341,0,141,28,67,26,262
Pennsylvania,Spring Hill,891,33,336,126,82,15,592
Pennsylvania,South Heights borough,449,37,190,90,32,13,362
Pennsylvania,South New Castle borough,742,58,289,138,18,32,535
Pennsylvania,Springdale borough,3407,180,1087,783,305,169,2524
Pennsylvania,Spring City borough,3331,210,1169,493,288,140,2300
Pennsylvania,Springboro borough,425,37,142,51,24,14,268
Pennsylvania,Spinnerstown,1941,84,362,394,367,86,1293
Pennsylvania,Speers borough,1163,31,387,269,135,105,927
Pennsylvania,Spartansburg borough,281,25,111,40,32,12,220
Pennsylvania,South Williamsport borough,6354,289,1624,1206,631,365,4115
Pennsylvania,Southmont borough,2204,31,496,392,444,231,1594
Pennsylvania,Southwest Greensburg borough,2021,40,495,508,299,156,1498
Pennsylvania,Southview,110,26,81,0,0,0,107
Pennsylvania,South Uniontown,1200,97,407,270,113,54,941
Pennsylvania,South Temple,1635,123,586,180,105,49,1043
Pennsylvania,South Renovo borough,422,53,191,55,20,18,337
Pennsylvania,South Pottstown,1924,172,476,353,283,115,1399
Pennsylvania,South Philipsburg,336,33,150,65,0,0,248
Pennsylvania,South Park Township,13504,334,2845,3073,2339,1183,9774
Pennsylvania,South Waverly borough,1217,73,426,252,98,76,925
Pennsylvania,Renningers,511,32,135,40,106,40,353
Pennsylvania,Terre Hill borough,1492,217,414,143,118,41,933
Pennsylvania,Reinholds,1914,49,430,454,127,155,1215
Pennsylvania,Chevy Chase Heights,1626,83,394,206,144,248,1075
Pennsylvania,Chewton,444,34,200,66,37,13,350
Pennsylvania,Cheyney University,866,0,5,31,5,20,61
Pennsylvania,Chicora borough,942,19,332,155,93,28,627
Pennsylvania,Chinchilla,2182,97,515,348,346,286,1592
Pennsylvania,Christiana borough,962,131,295,133,91,27,677
Pennsylvania,Church Hill,1415,71,426,286,189,162,1134
Pennsylvania,Cheswick borough,1758,60,471,447,333,115,1426
Pennsylvania,Churchill borough,3009,23,384,457,781,754,2399
Pennsylvania,Churchville,3855,43,650,712,754,408,2567
Pennsylvania,Clairton,6752,389,2200,1532,479,161,4761
Pennsylvania,Clarence,625,42,296,91,29,3,461
Pennsylvania,Clarendon borough,506,62,160,63,22,17,324
Pennsylvania,Clarion borough,5298,166,677,531,632,549,2555
Pennsylvania,Clark borough,535,34,227,77,73,10,421
Pennsylvania,Clarks Green borough,1450,13,215,199,359,262,1048
Pennsylvania,Churchtown,418,64,116,32,14,18,244
Pennsylvania,Clarks Summit borough,5067,199,654,1096,1039,861,3849
Pennsylvania,Chest Springs borough,196,11,56,32,13,2,114
Pennsylvania,Chester Heights borough,2573,62,348,500,425,525,1860
Pennsylvania,Central City borough,1018,79,446,152,42,36,755
Pennsylvania,Centralia borough,11,2,2,7,0,0,11
Pennsylvania,Centre Hall borough,1244,45,358,246,153,80,882
Pennsylvania,Cetronia,1684,64,386,315,338,137,1240
Pennsylvania,Chalfant borough,897,46,250,211,128,86,721
Pennsylvania,Chalfont borough,4054,183,638,834,792,362,2809
Pennsylvania,Chalkhill,153,0,71,22,10,23,126
Pennsylvania,Chester Hill borough,909,64,271,147,65,35,582
Pennsylvania,Chambersburg borough,20519,2498,4890,2895,1921,1032,13236
Pennsylvania,Charleroi borough,4062,325,1147,757,215,141,2585
Pennsylvania,Chase,833,28,155,175,167,79,604
Pennsylvania,Cherry Tree borough,409,36,139,55,22,1,253
Pennsylvania,Cherry Valley borough,53,0,22,10,8,3,43
Pennsylvania,Cherryville,1444,34,419,385,244,104,1186
Pennsylvania,Chester,34016,4148,9207,4801,1491,578,20225
Pennsylvania,Chesterbrook,4478,80,272,473,1516,1215,3556
Pennsylvania,Chapman borough,172,14,67,18,21,10,130
Pennsylvania,Centerville borough (Washington County),3221,197,1054,597,193,174,2215
Pennsylvania,Clarksville borough,201,20,70,30,13,5,138
Pennsylvania,Claysburg,1881,158,615,238,93,16,1120
Pennsylvania,Pocono Ranch Lands,1073,85,190,301,94,58,728
Pennsylvania,Pocono Springs,1080,65,353,248,90,80,836
Pennsylvania,Pocono Woodland Lakes,3019,75,759,490,454,205,1983
Pennsylvania,Point Marion borough,998,132,337,160,92,29,750
Pennsylvania,Polk borough,745,252,203,90,31,5,581
Pennsylvania,Rennerdale,766,16,127,183,155,99,580
Pennsylvania,Portage borough,2561,231,776,492,189,107,1795
Pennsylvania,Collinsburg,1128,44,346,213,97,62,762
Pennsylvania,Port Allegany borough,2096,115,575,398,139,171,1398
Pennsylvania,Valley View CDP (Schuylkill County),1458,117,637,238,97,38,1127
Pennsylvania,Valley-Hi borough,6,4,2,0,0,0,6
Pennsylvania,Valley Green,4171,154,1021,764,578,118,2635
Pennsylvania,Valencia borough,553,28,140,112,114,91,485
Pennsylvania,Utica borough,166,18,50,32,9,6,115
Pennsylvania,Ursina borough,267,43,89,34,23,8,197
Pennsylvania,Upper St. Clair,19385,125,1509,2420,4734,4327,13115
Pennsylvania,Valley View CDP (York County),2547,123,553,372,480,266,1794
Pennsylvania,Clay,1976,301,431,193,165,99,1189
Pennsylvania,Collingdale borough,8786,512,2340,1816,694,289,5651
Pennsylvania,Cokeburg borough,588,60,225,115,35,22,457
Pennsylvania,Claysville borough,1035,66,303,213,81,6,669
Pennsylvania,Clearfield borough,6106,527,1865,1229,561,240,4422
Pennsylvania,Cleona borough,2125,75,759,445,212,64,1555
Pennsylvania,Clifton Heights borough,6658,419,2069,1115,485,235,4323
Pennsylvania,Clinton,524,0,223,102,39,29,393
Pennsylvania,Clintonville borough,435,27,193,49,21,16,306
Pennsylvania,Clymer borough,1237,84,452,179,102,49,866
Pennsylvania,Collegeville borough,5296,104,508,454,841,460,2367
Pennsylvania,Coal Center borough,83,11,20,7,0,6,44
Pennsylvania,Coaldale borough (Schuylkill County),2222,207,687,447,122,76,1539
Pennsylvania,Coalmont borough,127,9,43,24,0,3,79
Pennsylvania,Coalport borough,495,28,183,123,10,8,352
Pennsylvania,Coatesville,13152,1630,3221,1636,660,302,7449
Pennsylvania,Coburn,142,8,41,21,3,3,76
Pennsylvania,Cochranton borough,1303,62,398,260,105,45,870
Pennsylvania,Cochranville,657,63,264,99,64,17,507
Pennsylvania,Coaldale borough (Bedford County),159,21,54,24,4,0,103
Pennsylvania,Upper Exeter,629,45,142,164,88,61,500
Pennsylvania,Bentleyville borough,2554,200,793,526,201,50,1770
Pennsylvania,Berlin borough,1922,203,792,296,116,71,1478
Pennsylvania,Breinigsville,5018,123,725,969,875,584,3276
Pennsylvania,Brave,189,24,52,25,7,0,108
Pennsylvania,Brandonville,220,13,111,38,0,4,166
Pennsylvania,Branchdale,434,20,170,56,10,7,263
Pennsylvania,Bradford Woods borough,1202,19,87,182,357,266,911
Pennsylvania,Bradford,8608,814,2492,1426,566,405,5703
Pennsylvania,Bradenville,767,49,232,109,42,0,432
Pennsylvania,Brentwood borough,9598,453,2251,2200,1462,429,6795
Pennsylvania,Braddock Hills borough,1733,133,545,383,235,93,1389
Pennsylvania,Brackenridge borough,3244,174,992,717,250,187,2320
Pennsylvania,Boyertown borough,4053,416,1205,626,307,164,2718
Pennsylvania,Bowmansville,2082,99,458,250,342,180,1329
Pennsylvania,Bowmanstown borough,1119,89,476,185,81,45,876
Pennsylvania,Bowers,240,45,90,22,38,0,195
Pennsylvania,Boswell borough,1282,120,519,195,51,47,932
Pennsylvania,Boston,374,0,233,16,50,21,320
Pennsylvania,Braddock borough,1989,216,705,378,76,39,1414
Pennsylvania,Boothwyn,5345,306,1622,1224,522,100,3774
Pennsylvania,Bressler,1307,133,450,196,130,73,982
Pennsylvania,Brickerville,1533,96,485,200,159,80,1020
Pennsylvania,Norwood borough,5897,314,1814,1183,478,235,4024
Pennsylvania,Norvelt,1173,32,414,308,125,74,953
Pennsylvania,North York borough,1671,173,584,268,105,25,1155
Pennsylvania,Northwood,386,18,201,57,0,0,276
Pennsylvania,Northwest Harborcreek,9216,501,2538,1874,1234,550,6697
Pennsylvania,North Warren,1780,208,542,285,263,129,1427
Pennsylvania,North Wales borough,3248,88,688,660,480,308,2224
Pennsylvania,Briar Creek borough,704,117,297,84,54,13,565
Pennsylvania,North Vandergrift,426,21,153,108,36,6,324
Pennsylvania,North Philipsburg,778,69,359,137,36,18,619
Pennsylvania,North Irwin borough,801,42,213,204,78,23,560
Pennsylvania,Northern Cambria borough,3716,268,1174,701,302,109,2554
Pennsylvania,North East borough,4229,294,1036,747,507,205,2789
Pennsylvania,North Charleroi borough,1305,138,428,252,136,46,1000
Pennsylvania,North Catasauqua borough,2833,152,883,533,276,232,2076
Pennsylvania,North Braddock borough,4829,441,1350,1090,257,114,3252
Pennsylvania,Northumberland borough,3756,291,1332,578,450,253,2904
Pennsylvania,Benton borough,1087,93,345,117,95,50,700
Pennsylvania,Bonneauville borough,1881,140,599,335,98,49,1221
Pennsylvania,Boiling Springs,2929,43,681,489,519,346,2078
Pennsylvania,Birchwood Lakes,1570,144,372,341,67,34,958
Pennsylvania,Big Run borough,605,21,211,94,51,7,384
Pennsylvania,Biglerville borough,1195,145,308,181,107,60,801
Pennsylvania,Bigler,464,42,114,42,6,0,204
Pennsylvania,Big Beaver borough,1918,115,559,409,239,182,1504
Pennsylvania,Big Bass Lake,1453,125,364,323,157,91,1060
Pennsylvania,Beurys Lake,122,8,48,29,11,10,106
Pennsylvania,Bird-in-Hand,616,152,136,40,26,25,379
Pennsylvania,Bethlehem,75004,6375,16314,13162,7474,5570,48895
Pennsylvania,Bethel,736,123,289,51,69,0,532
Pennsylvania,Bethany borough,227,3,56,39,37,25,160
Pennsylvania,Bessemer borough,1186,84,429,204,89,34,840
Pennsylvania,Berwyn,3113,47,433,308,697,657,2142
Pennsylvania,Berwick borough,10328,1052,3383,1327,699,297,6758
Pennsylvania,Berrysburg borough,377,42,124,59,38,2,265
Pennsylvania,Bernville borough,814,83,221,158,65,29,556
Pennsylvania,Bethel Park municip,32322,985,6361,5467,7234,3816,23863
Pennsylvania,Bolivar borough,440,31,158,80,22,17,308
Pennsylvania,Birdsboro borough,5155,363,1601,1021,410,214,3609
Pennsylvania,Black Lick,1523,153,534,277,9,29,1002
Pennsylvania,Bobtown,778,89,316,101,68,20,594
Pennsylvania,Boalsburg,4017,120,358,638,1035,645,2796
Pennsylvania,Blue Ridge Summit,994,57,357,284,10,45,753
Pennsylvania,Blue Bell,5985,59,587,740,1487,1560,4433
Pennsylvania,Blue Ball,1056,108,354,77,102,0,641
Pennsylvania,Blossburg borough,1568,138,409,274,167,62,1050
Pennsylvania,Bloomsburg,14631,739,2377,1477,834,653,6080
Pennsylvania,Birmingham borough,109,2,20,28,21,7,78
Pennsylvania,Blooming Valley borough,331,25,145,46,31,12,259
Pennsylvania,Blawnox borough,1570,126,461,271,151,177,1186
Pennsylvania,Blandon,7231,405,1714,1508,831,294,4752
Pennsylvania,Blandburg,369,13,179,38,3,0,233
Pennsylvania,Blanchard,693,104,243,74,37,17,475
Pennsylvania,Blakely borough,6496,374,1994,1436,769,492,5065
Pennsylvania,Blairsville borough,3356,147,831,748,377,165,2268
Pennsylvania,Blain borough,276,20,95,29,7,8,159
Pennsylvania,Bloomfield borough,1347,120,380,236,128,96,960
Pennsylvania,Upland borough,3234,500,889,343,179,39,1950
Pennsylvania,Pomeroy,245,47,8,44,58,28,185
Pennsylvania,Unionville borough,221,18,87,19,19,11,154
Pennsylvania,Friendsville borough,147,23,49,28,8,2,110
Pennsylvania,Friedensburg,833,57,362,135,54,49,657
Pennsylvania,Friedens,1758,141,632,211,175,68,1227
Pennsylvania,Freeport borough,1790,109,501,391,134,51,1186
Pennsylvania,Freemansburg borough,2618,259,683,495,258,114,1809
Pennsylvania,Freeland borough,3498,195,1294,553,357,104,2503
Pennsylvania,Freedom borough,1621,107,442,382,108,38,1077
Pennsylvania,Frizzleburg,613,64,320,89,24,33,530
Pennsylvania,Freeburg borough,639,45,171,124,60,22,422
Pennsylvania,Fredericktown,504,34,217,27,17,29,324
Pennsylvania,Fredericksburg CDP (Lebanon County),1374,120,509,251,123,27,1030
Pennsylvania,Port Carbon borough,1779,152,677,299,98,50,1276
Pennsylvania,Port Clinton borough,210,30,79,42,8,3,162
Pennsylvania,Portersville borough,267,4,87,50,26,29,196
Pennsylvania,Portland borough,431,20,130,87,50,47,334
Pennsylvania,Port Matilda borough,698,12,285,95,101,3,496
Pennsylvania,Fredonia borough,526,41,204,61,18,8,332
Pennsylvania,Port Royal borough,861,85,330,141,31,20,607
Pennsylvania,Frystown,258,56,76,28,0,0,160
Pennsylvania,Galeton borough,1241,115,444,226,58,31,874
Pennsylvania,Girard borough,3054,107,771,554,435,165,2032
Pennsylvania,Gilberton borough,799,67,352,104,30,4,557
Pennsylvania,Gibsonia,2801,38,569,538,494,220,1859
Pennsylvania,Gibraltar,682,101,255,235,32,16,639
Pennsylvania,Gettysburg borough,7615,581,959,880,491,507,3418
Pennsylvania,Georgetown CDP (Luzerne County),1782,132,450,429,158,25,1194
Pennsylvania,Georgetown CDP (Lancaster County),986,236,237,48,50,25,596
Pennsylvania,Fullerton,15662,1254,3563,3269,1592,1096,10774
Pennsylvania,Georgetown borough,164,14,39,39,20,4,116
Pennsylvania,Geistown borough,2368,139,626,478,316,239,1798
Pennsylvania,University of Pittsburgh Johnstown,1523,0,0,2,0,0,2
Pennsylvania,Garrett borough,414,55,191,33,8,7,294
Pennsylvania,Gardners,214,42,133,8,5,8,196
Pennsylvania,Garden View,2504,258,913,533,151,125,1980
Pennsylvania,Gap,1865,120,518,263,236,44,1181
Pennsylvania,Gallitzin borough,1495,84,584,237,98,25,1028
Pennsylvania,Geneva,154,17,67,21,3,6,114
Pennsylvania,Girardville borough,1298,167,487,189,58,10,911
Pennsylvania,Port Trevorton,725,107,219,81,30,3,440
Pennsylvania,Potlicker Flats,152,17,89,19,0,7,132
Pennsylvania,Ramey borough,434,34,134,88,24,13,293
Pennsylvania,Rankin borough,2190,242,571,389,101,46,1349
Pennsylvania,Ranshaw,401,83,134,57,16,50,340
Pennsylvania,Raubsville,935,37,371,177,108,49,742
Pennsylvania,Rauchtown,649,54,222,118,37,22,453
Pennsylvania,Ravine,598,38,217,154,27,0,436
Pennsylvania,Reading,88057,17552,18042,10074,3237,1366,50271
Pennsylvania,Ramblewood,1110,0,154,106,265,252,777
Pennsylvania,Reamstown,3666,225,1197,594,452,211,2679
Pennsylvania,Red Hill borough,2508,179,867,453,284,91,1874
Pennsylvania,Red Lion borough,6332,705,1989,1039,434,111,4278
Pennsylvania,Reedsville,499,56,196,75,26,10,363
Pennsylvania,Refton,153,26,78,12,0,0,116
Pennsylvania,Rehrersburg,381,58,77,29,21,14,199
Pennsylvania,Reiffton,5028,149,986,733,647,815,3330
Pennsylvania,Reinerton,370,53,162,22,38,25,300
Pennsylvania,Rebersburg,500,23,182,85,33,21,344
Pennsylvania,Port Vue borough,3785,262,1203,1096,228,118,2907
Pennsylvania,Rainsburg borough,138,11,39,22,7,0,79
Pennsylvania,Quentin,459,5,147,73,34,24,283
Pennsylvania,Pottsgrove,3344,207,770,469,659,351,2456
Pennsylvania,Pottstown borough,22586,2421,6205,3936,1698,904,15164
Pennsylvania,Pottsville,14025,1300,4716,2418,1040,555,10029
Pennsylvania,Pringle borough,956,69,358,167,81,57,732
Pennsylvania,Progress,9294,486,2231,2186,1313,435,6651
Pennsylvania,Prompton borough,272,18,61,56,27,8,170
Pennsylvania,Prospect borough,1258,69,359,244,170,72,914
Pennsylvania,Railroad borough,222,25,64,37,15,8,149
Pennsylvania,Prospect Park,277,13,93,64,49,5,224
Pennsylvania,Punxsutawney borough,5899,594,2001,902,407,212,4116
Pennsylvania,Pymatuning Central,2223,210,873,379,153,142,1757
Pennsylvania,Pymatuning North,276,34,123,50,15,4,226
Pennsylvania,Pymatuning South,450,39,165,73,21,27,325
Pennsylvania,Quakertown borough,8917,774,2516,1584,982,370,6226
Pennsylvania,Quarryville borough,2687,196,985,345,194,63,1783
Pennsylvania,Queens Gate,1328,80,253,148,226,173,880
Pennsylvania,Prospect Park borough,6468,364,1626,1399,908,145,4442
Pennsylvania,Glasgow borough,76,10,23,17,1,3,54
Pennsylvania,Gastonville,2740,172,984,493,259,164,2072
Pennsylvania,Glenburn,905,13,136,143,175,171,638
Pennsylvania,Troutville borough,186,12,69,34,14,10,139
Pennsylvania,Trooper,5959,333,1115,853,924,795,4020
Pennsylvania,Trexlertown,2251,84,557,300,495,165,1601
Pennsylvania,Trevose,3516,347,965,659,408,130,2509
Pennsylvania,Trevorton,1494,154,587,267,102,58,1168
Pennsylvania,Glassport borough,4454,398,1474,927,384,94,3277
Pennsylvania,Tremont borough,1807,297,753,166,52,18,1286
Pennsylvania,Troxelville,254,39,46,28,27,7,147
Pennsylvania,Treasure Lake,3621,64,793,629,591,293,2370
Pennsylvania,Trainer borough,1805,155,551,277,83,20,1086
Pennsylvania,Trafford borough,3335,148,998,623,370,309,2448
Pennsylvania,Townville borough,379,23,157,67,26,9,282
Pennsylvania,Tower City borough,1283,117,495,220,58,23,913
Pennsylvania,Towanda borough,2878,251,681,391,382,224,1929
Pennsylvania,Towamensing Trails,1889,45,500,506,184,215,1450
Pennsylvania,Toughkenamon,1797,247,400,114,117,56,934
Pennsylvania,Trappe borough,3550,113,617,546,708,407,2391
Pennsylvania,Topton borough,2119,96,680,392,245,109,1522
Pennsylvania,Troy borough,1505,179,484,203,156,62,1084
Pennsylvania,Trumbauersville borough,1016,49,304,147,161,45,706
Pennsylvania,Unionville,1108,96,467,206,52,16,837
Pennsylvania,Uniontown,10150,1218,3507,1624,717,341,7407
Pennsylvania,Union Deposit,604,73,100,124,27,39,363
Pennsylvania,Union Dale borough,267,3,110,65,23,17,218
Pennsylvania,Union City borough,3252,265,1162,551,167,76,2221
Pennsylvania,Ulysses borough,635,68,202,89,16,33,408
Pennsylvania,Tyrone borough,5415,352,1811,880,533,131,3707
Pennsylvania,Trucksville,2108,58,378,676,194,214,1520
Pennsylvania,Tylersburg,82,12,27,24,14,0,77
Pennsylvania,Twilight borough,201,7,53,59,26,9,154
Pennsylvania,Tuscarora,1022,109,340,222,45,28,744
Pennsylvania,Turtle Creek borough,5324,210,1753,1233,355,203,3754
Pennsylvania,Turbotville borough,654,36,213,96,64,33,442
Pennsylvania,Tunnelhill borough,368,19,160,65,25,9,278
Pennsylvania,Tunkhannock borough,1906,127,588,297,295,106,1413
Pennsylvania,Tullytown borough,1857,120,673,371,151,41,1356
Pennsylvania,Tyler Run,1521,46,387,321,312,205,1271
Pennsylvania,Toftrees,2875,5,399,462,739,756,2361
Pennsylvania,Tresckow,890,27,377,194,41,19,658
Pennsylvania,Tipton,908,14,363,163,91,63,694
Pennsylvania,Gouglersville,534,28,177,111,70,26,412
Pennsylvania,Gordonville,428,63,125,96,29,0,313
Pennsylvania,Gordon borough,865,34,293,146,77,52,602
Pennsylvania,Goodville,835,91,162,125,12,0,390
Pennsylvania,Goldsboro borough,1003,29,258,224,75,30,616
Pennsylvania,Gold Key Lake,1794,83,461,536,103,88,1271
Pennsylvania,Glenside,7667,156,1004,1324,1395,1002,4881
Pennsylvania,Gouldsboro,641,56,214,126,72,33,501
Pennsylvania,Glenshaw,8773,336,2089,1506,1661,1276,6868
Pennsylvania,Glen Osborne borough,582,4,60,59,156,126,405
Pennsylvania,Titusville,5438,497,1553,827,398,227,3502
Pennsylvania,Glen Lyon,1732,163,696,309,7,23,1198
Pennsylvania,Glen Hope borough,149,24,60,28,12,2,126
Pennsylvania,Glenfield borough,197,13,39,50,19,11,132
Pennsylvania,Glendon borough,424,27,170,63,45,7,312
Pennsylvania,Glen Campbell borough,227,22,85,29,4,9,149
Pennsylvania,Glen Rock borough,1863,109,519,309,254,73,1264
Pennsylvania,Graceton,161,28,84,37,0,0,149
Pennsylvania,Glenolden borough,7159,427,2316,1222,884,261,5110
Pennsylvania,Grantley,3895,51,309,319,434,348,1461
Pennsylvania,Grampian borough,410,19,134,47,29,12,241
Pennsylvania,Tionesta borough,405,38,143,96,53,23,353
Pennsylvania,Tioga borough,664,98,170,101,48,2,419
Pennsylvania,Timblin borough,207,13,79,17,16,0,125
Pennsylvania,Timber Hills,265,28,108,39,39,12,226
Pennsylvania,Tidioute borough,770,43,309,166,14,25,557
Pennsylvania,Throop borough,4052,223,1257,877,382,221,2960
Pennsylvania,Three Springs borough,455,46,199,77,19,10,351
Pennsylvania,Thorndale,3765,180,933,849,848,234,3044
Pennsylvania,Dickson City borough,6005,350,2082,1127,638,414,4611
Pennsylvania,Thompsonville,3748,149,454,608,910,614,2735
Pennsylvania,Greencastle borough,4031,316,1077,664,449,282,2788
Pennsylvania,Great Bend borough,787,103,291,126,32,33,585
Pennsylvania,Grazierville,615,36,316,57,0,13,422
Pennsylvania,Gratz borough,827,94,322,128,25,9,578
Pennsylvania,Grassflat,647,114,217,81,20,5,437
Pennsylvania,Grapeville,550,43,121,125,10,39,338
Pennsylvania,Thornburg borough,507,3,50,70,130,121,374
Pennsylvania,Granville,493,48,195,92,0,0,335
Puerto Rico,G. L. García comunidad,1303,,,,,,0
Puerto Rico,Rafael González comunidad,2102,,,,,,0
Puerto Rico,Antón Ruíz comunidad,2636,,,,,,0
Puerto Rico,San Germán zona urb,12202,,,,,,0
Puerto Rico,María Antonia comunidad,1059,,,,,,0
Puerto Rico,Corazón comunidad,2192,,,,,,0
Puerto Rico,Rafael Capó comunidad,1666,,,,,,0
Puerto Rico,Bayamón zona urb,177709,,,,,,0
Puerto Rico,Loíza zona urb,3465,,,,,,0
Puerto Rico,Manatí zona urb,13606,,,,,,0
Puerto Rico,Palomas comunidad (Comerío Municipio),1636,,,,,,0
Puerto Rico,Suárez comunidad,2108,,,,,,0
Puerto Rico,Rafael Hernández comunidad,1459,,,,,,0
Puerto Rico,San José comunidad,2664,,,,,,0
Puerto Rico,Luis M. Cintrón comunidad,2130,,,,,,0
Puerto Rico,El Mangó comunidad,1693,,,,,,0
Puerto Rico,Mayagüez zona urb,67110,,,,,,0
Puerto Rico,Río Cañas Abajo comunidad,926,,,,,,0
Puerto Rico,Añasco zona urb,5025,,,,,,0
Puerto Rico,Santa Bárbara comunidad,5691,,,,,,0
Puerto Rico,Imbéry comunidad,4103,,,,,,0
Puerto Rico,H. Rivera Colón comunidad,2156,,,,,,0
Puerto Rico,Guánica zona urb,7404,,,,,,0
Puerto Rico,Río Grande zona urb,13013,,,,,,0
Puerto Rico,Coquí comunidad,2562,,,,,,0
Puerto Rico,Búfalo comunidad,953,,,,,,0
Puerto Rico,Las Marías zona urb,677,,,,,,0
Puerto Rico,Breñas comunidad,2741,,,,,,0
Puerto Rico,Vega Alta zona urb,10033,,,,,,0
Puerto Rico,Vega Baja zona urb,25251,,,,,,0
Puerto Rico,Vieques comunidad,2949,,,,,,0
Puerto Rico,Vieques zona urb,2365,,,,,,0
Puerto Rico,Villalba zona urb,3513,,,,,,0
Puerto Rico,Yabucoa zona urb,6604,,,,,,0
Puerto Rico,Yauco zona urb,17815,,,,,,0
Puerto Rico,Yaurel comunidad,1063,,,,,,0
Puerto Rico,Comerío zona urb,4031,,,,,,0
Puerto Rico,Aceitunas comunidad,2103,,,,,,0
Puerto Rico,Adjuntas zona urb,4129,,,,,,0
Puerto Rico,Vayas comunidad,562,,,,,,0
Puerto Rico,Aguada zona urb,2707,,,,,,0
Puerto Rico,Aguas Buenas zona urb,3483,,,,,,0
Puerto Rico,Aguas Claras comunidad,2573,,,,,,0
Puerto Rico,Aguilita comunidad,4530,,,,,,0
Puerto Rico,Aibonito zona urb,8541,,,,,,0
Puerto Rico,Alianza comunidad,2581,,,,,,0
Puerto Rico,Animas comunidad,1389,,,,,,0
Puerto Rico,Anon Raices comunidad,216,,,,,,0
Puerto Rico,Arecibo zona urb,43152,,,,,,0
Puerto Rico,Arroyo zona urb,6540,,,,,,0
Puerto Rico,Bairoa La Veinticinco comunidad,202,,,,,,0
Puerto Rico,Bajadero comunidad,3414,,,,,,0
Puerto Rico,Aguadilla zona urb,11690,,,,,,0
Puerto Rico,Utuado zona urb,8075,,,,,,0
Puerto Rico,Trujillo Alto zona urb,47679,,,,,,0
Puerto Rico,Toa Baja zona urb,1582,,,,,,0
Puerto Rico,Quebradillas zona urb,4834,,,,,,0
Puerto Rico,Ramos comunidad,1866,,,,,,0
Puerto Rico,Rodriguez Hevia comunidad,141,,,,,,0
Puerto Rico,Sabana comunidad,860,,,,,,0
Puerto Rico,Sabana Eneas comunidad,1260,,,,,,0
Puerto Rico,Sabana Grande zona urb,10043,,,,,,0
Puerto Rico,Sabana Hoyos comunidad,2036,,,,,,0
Puerto Rico,Sabana Seca comunidad,8867,,,,,,0
Puerto Rico,Salinas zona urb,4791,,,,,,0
Puerto Rico,San Antonio comunidad (Aguadilla Municipio),1533,,,,,,0
Puerto Rico,San Antonio comunidad (Dorado Municipio),7945,,,,,,0
Puerto Rico,San Antonio comunidad (Quebradillas Municipio),1856,,,,,,0
Puerto Rico,San Isidro comunidad,6743,,,,,,0
Puerto Rico,San Juan zona urb,357627,,,,,,0
Puerto Rico,San Lorenzo zona urb,8255,,,,,,0
Puerto Rico,Santa Clara comunidad,1103,,,,,,0
Puerto Rico,Santa Isabel zona urb,6223,,,,,,0
Puerto Rico,Santo Domingo comunidad,3630,,,,,,0
Puerto Rico,Stella comunidad,1146,,,,,,0
Puerto Rico,Tallaboa comunidad,873,,,,,,0
Puerto Rico,Tallaboa Alta comunidad,1826,,,,,,0
Puerto Rico,Tibes comunidad,574,,,,,,0
Puerto Rico,Tiburones comunidad,1860,,,,,,0
Puerto Rico,Tierras Nuevas Poniente comunidad,3513,,,,,,0
Puerto Rico,Toa Alta zona urb,3387,,,,,,0
Puerto Rico,Bajandas comunidad,730,,,,,,0
Puerto Rico,Quebrada del Agua comunidad,1221,,,,,,0
Puerto Rico,Barahona comunidad,1918,,,,,,0
Puerto Rico,Barranquitas zona urb,2095,,,,,,0
Puerto Rico,Comunas comunidad,1392,,,,,,0
Puerto Rico,Corcovado comunidad,1622,,,,,,0
Puerto Rico,Corozal zona urb,9550,,,,,,0
Puerto Rico,Corral Viejo comunidad,422,,,,,,0
Puerto Rico,Coto Laurel comunidad,2209,,,,,,0
Puerto Rico,Coto Norte comunidad,1296,,,,,,0
Puerto Rico,Culebra zona urb,1401,,,,,,0
Puerto Rico,Daguao comunidad,1396,,,,,,0
Puerto Rico,Dorado zona urb,12773,,,,,,0
Puerto Rico,Duque comunidad,1429,,,,,,0
Puerto Rico,El Combate comunidad,264,,,,,,0
Puerto Rico,Coco comunidad,6151,,,,,,0
Puerto Rico,El Negro comunidad,1226,,,,,,0
Puerto Rico,El Paraiso comunidad,1775,,,,,,0
Puerto Rico,El Tumbao comunidad,2115,,,,,,0
Puerto Rico,Emajagua comunidad,2940,,,,,,0
Puerto Rico,Esperanza comunidad,1153,,,,,,0
Puerto Rico,Espino comunidad,1357,,,,,,0
Puerto Rico,Fajardo zona urb,26777,,,,,,0
Puerto Rico,Florida zona urb,4585,,,,,,0
Puerto Rico,Fuig comunidad,1024,,,,,,0
Puerto Rico,Galateo comunidad,2361,,,,,,0
Puerto Rico,Garrochales comunidad,1131,,,,,,0
Puerto Rico,Río Blanco comunidad,1525,,,,,,0
Puerto Rico,El Ojo comunidad,1190,,,,,,0
Puerto Rico,Coamo zona urb,11604,,,,,,0
Puerto Rico,Cidra zona urb,5519,,,,,,0
Puerto Rico,Ciales zona urb,2154,,,,,,0
Puerto Rico,Bartolo comunidad,1289,,,,,,0
Puerto Rico,Betances comunidad,974,,,,,,0
Puerto Rico,Boqueron comunidad (Cabo Rojo Municipio),2677,,,,,,0
Puerto Rico,Buena Vista comunidad (Arroyo Municipio),990,,,,,,0
Puerto Rico,Buena Vista comunidad (Humacao Municipio),989,,,,,,0
Puerto Rico,Cabo Rojo zona urb,10132,,,,,,0
Puerto Rico,Cacao comunidad,1102,,,,,,0
Puerto Rico,Caguas zona urb,80556,,,,,,0
Puerto Rico,Calzada comunidad,241,,,,,,0
Puerto Rico,Campanilla comunidad,5781,,,,,,0
Puerto Rico,Campo Rico comunidad,2619,,,,,,0
Puerto Rico,Camuy zona urb,3108,,,,,,0
Puerto Rico,Candelaria comunidad,15586,,,,,,0
Puerto Rico,Candelaria Arenas comunidad,5021,,,,,,0
Puerto Rico,Candelero Abajo comunidad,671,,,,,,0
Puerto Rico,Candelero Arriba comunidad,1634,,,,,,0
Puerto Rico,Capitanejo comunidad,3901,,,,,,0
Puerto Rico,Carolina zona urb,150712,,,,,,0
Puerto Rico,Carrizales comunidad,2539,,,,,,0
Puerto Rico,Cayey zona urb,16727,,,,,,0
Puerto Rico,Cayuco comunidad,1224,,,,,,0
Puerto Rico,Ceiba zona urb,5704,,,,,,0
Puerto Rico,Ceiba comunidad,3135,,,,,,0
Puerto Rico,Celada comunidad,4612,,,,,,0
Puerto Rico,Central Aguirre comunidad,1222,,,,,,0
Puerto Rico,Barceloneta zona urb,3841,,,,,,0
Puerto Rico,Quebrada comunidad,1012,,,,,,0
Puerto Rico,Cerrillos Hoyos comunidad,952,,,,,,0
Puerto Rico,Puerto Real comunidad,6408,,,,,,0
Puerto Rico,Jobos comunidad,2286,,,,,,0
Puerto Rico,Jayuya zona urb,2950,,,,,,0
Puerto Rico,Jauca comunidad,1676,,,,,,0
Puerto Rico,Jagual comunidad,1096,,,,,,0
Puerto Rico,Isabela zona urb,11201,,,,,,0
Puerto Rico,Ingenio comunidad,4485,,,,,,0
Puerto Rico,Indios comunidad,1568,,,,,,0
Puerto Rico,Humacao zona urb,18061,,,,,,0
Puerto Rico,Hormigueros zona urb,11825,,,,,,0
Puerto Rico,Hato Candal comunidad,1520,,,,,,0
Puerto Rico,Hato Arriba comunidad,704,,,,,,0
Puerto Rico,Juncal comunidad,850,,,,,,0
Puerto Rico,Hatillo zona urb,4139,,,,,,0
Puerto Rico,Gurabo zona urb,7943,,,,,,0
Puerto Rico,Guaynabo zona urb,72972,,,,,,0
Puerto Rico,Guayanilla zona urb,4160,,,,,,0
Puerto Rico,Levittown comunidad,26786,,,,,,0
Puerto Rico,Guayama zona urb,23379,,,,,,0
Puerto Rico,Guayabal comunidad,2141,,,,,,0
Puerto Rico,Pueblito del Río comunidad,1672,,,,,,0
Puerto Rico,Pájaros comunidad,10711,,,,,,0
Puerto Rico,Palomas comunidad (Yauco Municipio),2067,,,,,,0
Puerto Rico,Palmer comunidad,1058,,,,,,0
Puerto Rico,Palmas del Mar comunidad,1653,,,,,,0
Puerto Rico,Hacienda San Jose comunidad,3152,,,,,,0
Puerto Rico,Juncos zona urb,8463,,,,,,0
Puerto Rico,La Alianza comunidad,2071,,,,,,0
Puerto Rico,La Dolores comunidad,3516,,,,,,0
Puerto Rico,Lluveras comunidad,1639,,,,,,0
Puerto Rico,Lomas comunidad,1068,,,,,,0
Puerto Rico,Los Llanos comunidad,2252,,,,,,0
Puerto Rico,Los Panes comunidad,384,,,,,,0
Puerto Rico,Los Prados comunidad,2296,,,,,,0
Puerto Rico,Luquillo zona urb,8352,,,,,,0
Puerto Rico,Luyando comunidad,3223,,,,,,0
Puerto Rico,Magas Arriba comunidad,1269,,,,,,0
Puerto Rico,Maguayo comunidad,1205,,,,,,0
Puerto Rico,Maricao zona urb,747,,,,,,0
Puerto Rico,Martorell comunidad,2434,,,,,,0
Puerto Rico,Las Piedras zona urb,6099,,,,,,0
Puerto Rico,Las Ollas comunidad,1936,,,,,,0
Puerto Rico,Las Ochenta comunidad,654,,,,,,0
Puerto Rico,Las Croabas comunidad,866,,,,,,0
Puerto Rico,Las Carolinas comunidad,2453,,,,,,0
Puerto Rico,Lares zona urb,5059,,,,,,0
Puerto Rico,La Plena comunidad,603,,,,,,0
Puerto Rico,La Playa comunidad,2428,,,,,,0
Puerto Rico,La Parguera comunidad,855,,,,,,0
Puerto Rico,Lamboglia comunidad,1387,,,,,,0
Puerto Rico,La Luisa comunidad,1847,,,,,,0
Puerto Rico,La Liga comunidad,246,,,,,,0
Puerto Rico,Lajas zona urb,4306,,,,,,0
Puerto Rico,La Fermina comunidad,2899,,,,,,0
Puerto Rico,Palmas comunidad,1713,,,,,,0
Puerto Rico,Palmarejo comunidad (Lajas Municipio),1390,,,,,,0
Puerto Rico,La Yuca comunidad,581,,,,,,0
Puerto Rico,Pajonal comunidad,581,,,,,,0
Puerto Rico,Liborio Negrón Torres comunidad,1534,,,,,,0
Puerto Rico,Cabán comunidad,3419,,,,,,0
Puerto Rico,Juana Díaz zona urb,7396,,,,,,0
Puerto Rico,Las Marías comunidad,1902,,,,,,0
Puerto Rico,San Sebastián zona urb,9843,,,,,,0
Puerto Rico,Vázquez comunidad,1841,,,,,,0
Puerto Rico,Rosa Sánchez comunidad,849,,,,,,0
Puerto Rico,Benítez comunidad,1379,,,,,,0
Puerto Rico,Parcelas Peñuelas comunidad,808,,,,,,0
Puerto Rico,Peñuelas zona urb,5453,,,,,,0
Puerto Rico,Fránquez comunidad,2837,,,,,,0
Puerto Rico,Río Lajas comunidad,2788,,,,,,0
Puerto Rico,Boquerón comunidad,1431,,,,,,0
Puerto Rico,Bayamón comunidad,1893,,,,,,0
Puerto Rico,Canóvanas zona urb,7762,,,,,,0
Puerto Rico,Mariano Colón comunidad,2476,,,,,,0
Puerto Rico,Marueño comunidad,906,,,,,,0
Puerto Rico,Luis Lloréns Torres comunidad,3193,,,,,,0
Puerto Rico,Maunabo zona urb,1520,,,,,,0
Puerto Rico,Miranda comunidad,1603,,,,,,0
Puerto Rico,Moca zona urb,3772,,,,,,0
Puerto Rico,Monte Verde comunidad,108,,,,,,0
Puerto Rico,Monserrate comunidad,2261,,,,,,0
Puerto Rico,Monte Grande comunidad,3003,,,,,,0
Puerto Rico,Cataño zona urb,26680,,,,,,0
Puerto Rico,Peña Pobre comunidad,966,,,,,,0
Puerto Rico,Rincón zona urb,1355,,,,,,0
Puerto Rico,Palo Seco comunidad,850,,,,,,0
Puerto Rico,Punta Santiago comunidad,5514,,,,,,0
Puerto Rico,Olimpo comunidad,1547,,,,,,0
Puerto Rico,Naranjito zona urb,1805,,,,,,0
Puerto Rico,Naguabo zona urb,4790,,,,,,0
Puerto Rico,Mucarabones comunidad,972,,,,,,0
Puerto Rico,Morovis zona urb,2406,,,,,,0
Puerto Rico,Mora comunidad,2245,,,,,,0
Puerto Rico,Pueblito del Carmen comunidad,439,,,,,,0
Puerto Rico,Potala Pastillo comunidad,2891,,,,,,0
Puerto Rico,Ponce zona urb,126302,,,,,,0
Puerto Rico,Pole Ojea comunidad,2021,,,,,,0
Puerto Rico,Playita Cortada comunidad,1339,,,,,,0
Puerto Rico,Orocovis zona urb,991,,,,,,0
Puerto Rico,Playita comunidad (Salinas Municipio),450,,,,,,0
Puerto Rico,Playita comunidad (Yabucoa Municipio),1750,,,,,,0
Puerto Rico,Parcelas de Navarro comunidad,1551,,,,,,0
Puerto Rico,Parcelas La Milagrosa comunidad,1075,,,,,,0
Puerto Rico,Parcelas Mandry comunidad,654,,,,,,0
Puerto Rico,Parcelas Nuevas comunidad,1406,,,,,,0
Puerto Rico,Parcelas Viejas Borinquen comunidad,658,,,,,,0
Puerto Rico,Palmarejo comunidad (Coamo Municipio),1131,,,,,,0
Puerto Rico,Patillas zona urb,4380,,,,,,0
Puerto Rico,Piedra Aguza comunidad,2537,,,,,,0
Puerto Rico,Piedra Gorda comunidad,2082,,,,,,0
Puerto Rico,Playa Fortuna comunidad,1190,,,,,,0
Puerto Rico,Pastos comunidad,1336,,,,,,0
Rhode Island,Newport East,11091,673,2125,2272,1796,1015,7881
Rhode Island,Newport,24459,1393,3455,3893,4983,3485,17209
Rhode Island,Narragansett Pier,3957,201,360,555,975,694,2785
Rhode Island,Misquamicut,349,4,68,60,107,45,284
Rhode Island,Melville,1327,29,140,218,165,121,673
Rhode Island,Kingston,6969,45,119,257,381,335,1137
Rhode Island,Hopkinton,396,29,111,117,84,18,359
Rhode Island,Hope Valley,1733,12,418,321,226,88,1065
Rhode Island,Harrisville,1833,133,370,443,166,126,1238
Rhode Island,Harmony,876,91,236,133,152,74,686
Rhode Island,Greenville,8419,570,1723,1863,1310,803,6269
Rhode Island,Foster Center,325,71,55,53,68,16,263
Rhode Island,East Providence,47266,6018,10439,8690,5529,3329,34005
Rhode Island,Cumberland Hill,8439,474,1725,1674,1003,984,5860
Rhode Island,Cranston,80761,6867,17915,15165,10529,6479,56955
Rhode Island,Pascoag,4583,419,1239,1075,479,147,3359
Rhode Island,Chepachet,1656,124,381,397,257,113,1272
Rhode Island,Charlestown,1207,54,165,292,267,233,1011
Rhode Island,Central Falls,19378,4890,3240,1894,706,268,10998
Rhode Island,Carolina,787,40,117,250,117,118,642
Rhode Island,Bradford,1158,221,268,113,84,62,748
Rhode Island,Ashaway,1108,35,401,194,136,66,832
Rhode Island,Greene,863,60,261,180,134,45,680
Rhode Island,Clayville,159,10,49,16,18,39,132
Rhode Island,Pawtucket,71395,10384,15436,13537,5686,3054,48097
Rhode Island,Quonochontaug,558,20,96,98,123,102,439
Rhode Island,Providence,178680,27028,24014,22898,16150,14479,104569
Rhode Island,Woonsocket,41213,6007,10529,8130,2817,1339,28822
Rhode Island,Westerly,17957,1395,3938,4053,2364,1341,13091
Rhode Island,Weekapaug,430,0,35,88,125,121,369
Rhode Island,Watch Hill,184,0,28,31,91,25,175
Rhode Island,Wyoming,96,10,41,45,0,0,96
Rhode Island,Wakefield-Peacedale,8862,347,1471,1305,1431,1320,5874
Rhode Island,Valley Falls,12088,1238,2184,2945,1585,797,8749
Rhode Island,Tiverton,7407,627,1797,1522,1172,778,5896
Rhode Island,Warwick,81855,5319,16823,19411,12714,6723,60990
South Carolina,Clemson,14664,233,825,1385,1585,2444,6472
South Carolina,Modoc,241,7,66,106,17,36,232
South Carolina,Monarch Mill,1941,396,640,311,30,22,1399
South Carolina,Moncks Corner,9108,954,1979,2355,642,300,6230
South Carolina,Monetta,171,21,49,33,16,10,129
South Carolina,Mount Carmel,204,71,39,13,14,12,149
South Carolina,Mount Croghan,122,17,40,27,4,5,93
South Carolina,Mount Pleasant,74952,1274,6766,13644,19854,11029,52567
South Carolina,Mountville,115,0,56,23,7,0,86
South Carolina,Mulberry,424,59,90,51,14,6,220
South Carolina,Mullins,4560,723,1060,806,455,128,3172
South Carolina,Myrtle Beach,29198,3088,6197,6307,4201,1866,21659
South Carolina,Murrells Inlet,8823,446,1879,2470,1354,1054,7203
South Carolina,Oak Grove,10183,749,2212,2389,1066,429,6845
South Carolina,Norway,300,26,105,72,27,16,246
South Carolina,North Myrtle Beach,14824,930,3516,4022,2715,1516,12699
South Carolina,Northlake,4168,141,719,990,594,419,2863
South Carolina,North Hartsville,3282,426,784,524,311,146,2191
South Carolina,North Charleston,104146,12031,19581,21336,9263,4044,66255
South Carolina,North Augusta,22037,1418,3954,5415,3325,1616,15728
South Carolina,Murphys Estates,1496,228,281,274,54,56,893
South Carolina,North,800,138,142,168,37,32,517
South Carolina,Ninety Six,2011,145,536,391,109,99,1280
South Carolina,Nichols,355,60,97,79,30,6,272
South Carolina,Newry,113,65,28,11,0,0,104
South Carolina,Newport,3795,100,787,825,671,384,2767
South Carolina,New Ellenton,2431,291,680,506,167,11,1655
South Carolina,Newberry,10279,1507,2137,1067,758,532,6001
South Carolina,Neeses,278,39,73,43,26,12,193
South Carolina,Norris,818,147,199,147,38,15,546
South Carolina,Clearwater,4497,548,1522,779,218,164,3231
South Carolina,Chesterfield,1410,236,288,180,127,55,886
South Carolina,City View,1672,514,349,223,58,0,1144
South Carolina,Lowndesville,126,28,30,15,0,0,73
South Carolina,Loris,2500,305,599,563,210,123,1800
South Carolina,Lodge,96,7,33,33,8,8,89
South Carolina,Lockhart,544,106,224,70,0,0,400
South Carolina,Livingston,152,14,37,27,7,6,91
South Carolina,Little River,9617,787,2357,2741,1467,563,7915
South Carolina,Little Mountain,259,10,36,70,24,40,180
South Carolina,Lincolnville,1299,170,326,287,65,41,889
South Carolina,Liberty,3254,457,772,641,229,108,2207
South Carolina,Lexington,19447,839,2954,4151,3223,2074,13241
South Carolina,Lesslie,2218,264,538,607,138,66,1613
South Carolina,Laurens,9122,1369,1952,1907,737,381,6346
South Carolina,Laurel Bay,6318,246,752,1297,242,135,2672
South Carolina,Latta,1242,180,298,206,96,70,850
South Carolina,Langley,1116,301,331,185,21,0,838
South Carolina,Lowrys,202,33,45,48,13,15,154
South Carolina,Lugoff,8248,402,1676,1627,912,536,5153
South Carolina,Luray,176,22,67,12,6,0,107
South Carolina,Lydia,404,87,161,56,9,0,313
South Carolina,Chester,5527,769,1259,747,353,285,3413
South Carolina,Meggett,1432,110,305,337,248,114,1114
South Carolina,Mayo,1119,224,226,246,91,0,787
South Carolina,Mayesville,544,93,131,98,38,29,389
South Carolina,Mauldin,24396,1119,4149,5341,3965,2106,16680
South Carolina,Marion,6793,564,1528,1392,397,355,4236
South Carolina,Manning,4056,699,889,689,250,125,2652
South Carolina,Clarks Hill,330,78,77,47,9,0,211
South Carolina,McCormick,2707,629,815,532,156,33,2165
South Carolina,McClellanville,517,7,85,87,146,64,389
South Carolina,McBee,775,124,208,122,29,12,495
South Carolina,Lancaster,8853,1144,2145,1509,650,406,5854
South Carolina,Landrum,2642,280,603,571,172,120,1746
South Carolina,Lane,472,34,148,112,36,10,340
South Carolina,Lynchburg,297,52,76,92,9,19,248
South Carolina,Lyman,3350,291,721,923,379,158,2472
South Carolina,McConnells,264,27,64,52,32,9,184
South Carolina,McColl,2399,404,687,373,78,36,1578
South Carolina,Wellford,2472,282,832,499,102,35,1750
South Carolina,West Columbia,15757,1715,2687,3377,2446,1322,11547
South Carolina,Gaffney,12562,1875,2949,1768,1182,566,8340
South Carolina,Gantt,14693,2520,3168,2246,847,527,9308
South Carolina,Garden City,9246,861,2530,2568,1277,428,7664
South Carolina,Gaston,1466,137,364,283,68,29,881
South Carolina,Gayle Mill,893,265,174,112,12,11,574
South Carolina,Georgetown,9079,977,2184,1919,560,301,5941
South Carolina,Gifford,363,79,92,38,0,0,209
South Carolina,Gilbert,715,113,106,131,61,25,436
South Carolina,Glendale,175,45,53,33,16,5,152
South Carolina,Gloverville,2925,627,666,433,90,62,1878
South Carolina,Golden Grove,2404,292,660,477,167,168,1764
South Carolina,Goose Creek,39408,1692,6280,9616,4131,1995,23714
South Carolina,Govan,59,21,7,16,11,0,55
South Carolina,Gramling,0,0,0,0,0,0,0
South Carolina,Graniteville,2516,331,572,443,87,27,1460
South Carolina,Gray Court,711,168,155,146,31,8,508
South Carolina,Great Falls,1944,330,391,281,95,80,1177
South Carolina,Greeleyville,485,20,162,116,8,13,319
South Carolina,Greenville,61734,5116,8432,10280,10557,7197,41582
South Carolina,Gadsden,2143,248,761,420,101,57,1587
South Carolina,Greenwood,23254,3967,3898,3449,2045,846,14205
South Carolina,Furman,264,61,94,12,4,3,174
South Carolina,Fort Mill,12525,796,1894,2655,1965,919,8229
South Carolina,Ehrhardt,636,74,141,184,28,37,464
South Carolina,Elgin,1542,189,319,323,135,65,1031
South Carolina,Elgin,2781,247,922,541,120,43,1873
South Carolina,Elko,168,27,25,26,6,14,98
South Carolina,Elloree,712,99,184,130,73,23,509
South Carolina,Enoree,652,110,120,215,27,0,472
South Carolina,Estill,2244,337,561,320,108,30,1356
South Carolina,Eureka Mill,1451,239,372,225,64,25,925
South Carolina,Eutawville,332,70,92,61,17,10,250
South Carolina,Fairfax,1908,205,550,260,153,41,1209
South Carolina,Fairforest,2090,340,537,411,47,0,1335
South Carolina,Fair Play,645,104,193,137,86,24,544
South Carolina,Fingerville,24,12,12,0,0,0,24
South Carolina,Five Forks,16398,360,1271,2248,3505,2624,10008
South Carolina,Florence,38000,2856,7019,7843,4686,3135,25539
South Carolina,Folly Beach,2715,0,134,848,733,512,2227
South Carolina,Forest Acres,10545,266,762,2230,2362,1924,7544
South Carolina,Forestbrook,5111,276,1096,1475,519,283,3649
South Carolina,Fort Lawn,940,166,262,148,24,18,618
South Carolina,Fountain Inn,8399,486,1748,1960,779,306,5279
South Carolina,Greer,27186,2701,4384,5045,3608,1732,17470
South Carolina,Hampton,2726,252,612,583,211,124,1782
South Carolina,Hanahan,19707,1299,3672,4547,2537,1026,13081
South Carolina,Jenkinsville,71,10,42,7,0,0,59
South Carolina,Jefferson,757,103,207,103,67,32,512
South Carolina,Jamestown,123,11,32,42,13,3,101
South Carolina,James Island,11544,551,2008,2653,2259,1086,8557
South Carolina,Jacksonboro,558,62,118,59,17,39,295
South Carolina,Jackson,1661,154,531,397,82,27,1191
South Carolina,Iva,1085,247,257,177,40,14,735
South Carolina,Isle of Palms,4274,33,244,744,1468,911,3400
South Carolina,Islandton,42,0,3,9,10,0,22
South Carolina,Irwin,1518,250,561,294,48,0,1153
South Carolina,Irmo,11704,572,2053,2407,1803,850,7685
South Carolina,Inman Mills,1793,281,391,352,92,28,1144
South Carolina,Inman,2182,288,446,470,154,75,1433
South Carolina,India Hook,4118,304,878,737,677,326,2922
South Carolina,Hopkins,2985,737,959,340,170,44,2250
South Carolina,Honea Path,3649,569,807,892,251,52,2571
South Carolina,Homeland Park,6419,1280,1977,1058,84,81,4480
South Carolina,Hollywood,4872,531,1177,1142,632,559,4041
South Carolina,Holly Hill,1407,282,336,175,113,55,961
South Carolina,Joanna,1307,184,299,331,56,19,889
South Carolina,Johnsonville,2011,251,348,385,176,78,1238
South Carolina,Johnston,2284,458,679,224,94,70,1525
South Carolina,Jonesville,833,192,254,113,24,17,600
South Carolina,Hardeeville,4353,421,618,792,607,291,2729
South Carolina,Harleyville,657,73,205,132,33,11,454
South Carolina,Hartsville,7851,806,1379,1211,898,723,5017
South Carolina,Heath Springs,713,105,197,127,32,21,482
South Carolina,Hemingway,460,23,151,90,30,48,342
South Carolina,Hickory Grove,443,77,138,54,41,16,326
South Carolina,Hilda,439,103,114,91,13,2,323
South Carolina,Lamar,913,173,229,136,100,20,658
South Carolina,Lake Wylie,10738,258,1361,2061,2382,1097,7159
South Carolina,Edisto Beach,600,8,81,156,181,159,585
South Carolina,Lakewood,2670,377,683,539,180,76,1855
South Carolina,Lake Secession,1310,286,370,247,40,55,998
South Carolina,Lake Murray of Richland,5915,279,684,1041,1547,855,4406
South Carolina,Lake City,6728,1197,1318,1127,455,191,4288
South Carolina,Ladson,14770,1472,3130,3398,812,610,9422
South Carolina,Kline,189,26,51,31,5,0,113
South Carolina,Kingstree,3233,410,647,675,317,97,2146
South Carolina,Kiawah Island,1432,5,108,151,598,556,1418
South Carolina,Kershaw,2303,263,665,364,117,71,1480
South Carolina,Judson,1916,511,506,262,70,24,1373
South Carolina,Lake View,818,103,214,160,75,33,585
South Carolina,Edisto,2321,323,561,365,130,52,1431
South Carolina,Edgefield,4723,938,1703,880,206,203,3930
South Carolina,East Sumter,1315,209,241,250,89,25,814
South Carolina,Timmonsville,2283,426,519,459,163,17,1584
South Carolina,Tigerville,2060,0,8,38,21,21,88
South Carolina,Tega Cay,8609,107,701,1431,2410,993,5642
South Carolina,Taylors,22475,1868,4068,5527,2689,1487,15639
South Carolina,Tatum,129,4,43,32,4,6,89
South Carolina,Sycamore,217,45,58,31,13,9,156
South Carolina,Swansea,746,68,220,174,12,52,526
South Carolina,Surfside Beach,4090,279,695,1286,717,386,3363
South Carolina,Sumter,40851,4140,6115,8882,3808,2902,25847
South Carolina,Summit,564,37,108,147,59,11,362
South Carolina,Summerville,46200,2117,8170,10148,5678,3601,29714
South Carolina,Summerton,1093,185,269,233,65,37,789
South Carolina,Sullivan's Island,2067,36,58,300,601,511,1506
South Carolina,Stuckey,262,27,72,72,15,11,197
South Carolina,Stateburg,1714,90,258,343,291,156,1138
South Carolina,Startex,1137,210,176,154,17,0,557
South Carolina,Starr,150,15,30,45,7,3,100
South Carolina,Springfield,588,90,165,106,42,26,429
South Carolina,Springdale,2727,147,708,606,320,153,1934
South Carolina,Travelers Rest,4834,351,708,1120,281,300,2760
South Carolina,Trenton,286,37,44,71,28,25,205
South Carolina,Troy,92,10,24,26,8,6,74
South Carolina,Turbeville,1052,115,220,171,78,50,634
South Carolina,Hodges,132,8,23,42,11,13,97
South Carolina,Welcome,6390,1197,1513,1095,362,140,4307
South Carolina,Wedgefield,1553,165,377,338,105,43,1028
South Carolina,Watts Mills,1822,266,495,294,52,10,1117
South Carolina,Waterloo,160,38,42,33,9,6,128
South Carolina,Warrenville,1008,172,338,166,61,46,783
South Carolina,Ware Shoals,2459,399,688,375,125,40,1627
South Carolina,Ware Place,143,19,89,9,0,0,117
South Carolina,Ward,90,23,34,20,0,2,79
South Carolina,Springdale,2151,442,641,275,184,0,1542
South Carolina,Walterboro,5312,576,1319,1127,397,297,3716
South Carolina,Walhalla,4234,959,847,606,169,124,2705
South Carolina,Wagener,774,116,157,153,66,37,529
South Carolina,Wade Hampton,20205,1733,3016,4661,3691,1659,14760
South Carolina,Varnville,2277,236,626,424,142,77,1505
South Carolina,Vance,82,7,19,25,9,0,60
South Carolina,Valley Falls,5885,303,778,1073,614,151,2919
South Carolina,Utica,1388,274,212,356,54,20,916
South Carolina,Union,8144,1152,1762,1520,707,317,5458
South Carolina,Ulmer,45,3,0,12,7,6,28
South Carolina,Wallace,860,208,231,126,62,33,660
South Carolina,Westminster,2435,341,736,440,120,122,1759
South Carolina,Spartanburg,37465,4113,6067,6633,3666,2800,23279
South Carolina,Southern Shops,4533,1232,796,488,195,5,2716
South Carolina,Cordova,231,11,54,47,12,10,134
South Carolina,Coronaca,165,0,26,31,40,0,97
South Carolina,Cottageville,853,106,240,166,53,11,576
South Carolina,Coward,708,126,221,108,14,7,476
South Carolina,Cowpens,1702,302,395,371,136,34,1238
South Carolina,Cross Anchor,180,15,35,6,0,0,56
South Carolina,Cross Hill,523,82,147,96,27,16,368
South Carolina,Dalzell,4462,339,676,782,315,222,2334
South Carolina,Darlington,6212,883,1410,1115,596,271,4275
South Carolina,Denmark,3425,411,330,641,307,38,1727
South Carolina,Dentsville,14151,1250,2304,3164,1501,1035,9254
South Carolina,Dillon,6705,1410,1286,1362,303,108,4469
South Carolina,Donalds,335,54,64,74,22,11,225
South Carolina,Due West,1214,57,122,94,99,102,474
South Carolina,Duncan,3231,192,831,661,299,85,2068
South Carolina,Dunean,4048,695,1106,590,221,50,2662
South Carolina,Easley,20374,2140,4248,4382,2152,1170,14092
South Carolina,East Gaffney,3274,777,989,443,56,90,2355
South Carolina,Eastover,765,189,167,75,23,12,466
South Carolina,Cope,56,10,6,17,4,6,43
South Carolina,Conway,19356,1602,3106,3843,1583,1010,11144
South Carolina,Converse,607,69,98,104,0,47,318
South Carolina,Columbia,131958,9519,14804,19938,17354,12873,74488
South Carolina,South Congaree,2246,149,564,523,148,64,1448
South Carolina,Society Hill,560,155,114,87,30,16,402
South Carolina,Socastee,21641,1851,4960,5462,1746,732,14751
South Carolina,Snelling,281,26,59,67,15,13,180
South Carolina,Smyrna,49,11,14,8,1,0,34
South Carolina,Smoaks,143,7,49,39,16,5,116
South Carolina,Slater-Marietta,2386,622,369,365,139,20,1515
South Carolina,Six Mile,918,78,139,211,119,66,613
South Carolina,Simpsonville,19706,1185,4199,4016,2828,1315,13543
South Carolina,South Sumter,2255,318,436,435,92,21,1302
South Carolina,Silverstreet,158,4,31,43,28,7,113
South Carolina,Shell Point,2331,54,571,528,157,256,1566
South Carolina,Sharon,486,35,176,98,18,3,330
South Carolina,Seven Oaks,16185,842,2353,3445,2584,1778,11002
South Carolina,Seneca,8184,943,1691,1768,1049,549,6000
South Carolina,Clifton,433,105,150,113,0,0,368
South Carolina,Clinton,8561,1167,1549,1111,533,424,4784
South Carolina,Clio,665,96,184,132,19,36,467
South Carolina,Clover,5442,467,1259,1085,500,136,3447
South Carolina,Cokesbury,142,37,20,25,0,20,102
South Carolina,Shiloh,104,27,47,7,9,0,90
South Carolina,Chesnee,717,192,157,123,26,11,509
South Carolina,Hilton Head Island,39071,2179,5823,7879,9516,5845,31242
South Carolina,Cheraw,5800,1011,1124,1122,419,270,3946
South Carolina,Santee,1009,102,255,171,70,38,636
South Carolina,Sans Souci,8288,1436,1546,1540,554,307,5383
South Carolina,Sangaree,8157,677,1171,2373,767,188,5176
South Carolina,Saluda,3585,649,736,419,209,70,2083
South Carolina,Salley,329,44,99,53,36,22,254
South Carolina,Salem,137,22,40,35,8,1,106
South Carolina,St. Stephen,1640,216,493,265,60,44,1078
South Carolina,St. Matthews,1947,329,465,313,211,57,1375
South Carolina,St. George,2192,283,486,456,185,56,1466
South Carolina,St. Andrews,21779,1332,3618,4781,2266,1195,13192
South Carolina,Russellville,437,15,15,213,57,29,329
South Carolina,Ruby,379,48,89,56,33,27,253
South Carolina,Rowesville,321,55,58,84,21,1,219
South Carolina,Cherryvale,2051,442,268,445,113,13,1281
South Carolina,York,7945,1209,1857,1323,427,332,5148
South Carolina,Yemassee,893,102,243,189,49,5,588
South Carolina,Roebuck,2670,265,797,444,195,107,1808
South Carolina,Rockville,156,4,30,55,35,21,145
South Carolina,Rock Hill,69196,5133,11654,13958,8101,3909,42755
South Carolina,Riverview,404,137,163,39,24,16,379
South Carolina,Ridgeway,456,36,57,102,57,26,278
South Carolina,Saxon,3623,715,690,521,116,34,2076
South Carolina,Scotia,163,20,77,30,9,5,141
South Carolina,Scranton,839,146,265,174,16,17,618
South Carolina,Seabrook Island,1688,35,103,359,572,553,1622
South Carolina,Beaufort,12839,822,1551,2672,1685,1279,8009
South Carolina,Batesburg-Leesville,5251,736,1193,842,287,256,3314
South Carolina,Barnwell,4664,535,702,1070,251,107,2665
South Carolina,Bamberg,3501,468,619,773,373,252,2485
South Carolina,Aynor,713,100,149,110,63,29,451
South Carolina,Awendaw,1415,187,241,285,185,65,963
South Carolina,Atlantic Beach,285,30,82,47,16,12,187
South Carolina,Arial,2155,271,528,464,156,73,1492
South Carolina,Arcadia Lakes,956,23,72,182,236,235,748
South Carolina,Arcadia,3159,480,461,367,309,53,1670
South Carolina,Ridgeville,1929,587,711,232,94,24,1648
South Carolina,Antreville,120,67,17,31,1,1,117
South Carolina,Anderson,26978,3532,4747,5311,2485,1327,17402
South Carolina,Allendale,3261,518,780,481,282,45,2106
South Carolina,Alcolu,470,66,87,128,35,30,346
South Carolina,Aiken,30183,2232,4546,5320,5019,4062,21179
South Carolina,Abbeville,5197,713,1431,917,306,104,3471
South Carolina,Woodford,160,29,58,24,9,1,121
South Carolina,West Pelzer,921,149,255,169,44,11,628
South Carolina,West Union,316,62,68,44,8,9,191
South Carolina,Whitmire,1357,229,264,299,69,40,901
South Carolina,Sellers,191,68,58,30,8,8,172
South Carolina,Andrews,2842,321,776,520,130,22,1769
South Carolina,Belton,4247,656,1096,740,371,168,3031
South Carolina,Ridge Spring,921,108,317,165,43,38,671
South Carolina,Richburg,445,64,107,78,23,13,285
South Carolina,Pawleys Island,97,0,12,23,47,15,97
South Carolina,Patrick,439,58,148,90,7,11,314
South Carolina,Parksville,128,4,36,53,3,1,97
South Carolina,Parker,12571,2824,2699,1486,531,168,7708
South Carolina,Pamplico,1181,154,222,200,64,39,679
South Carolina,Pageland,2745,578,742,377,177,76,1950
South Carolina,Pacolet,2453,419,720,425,72,39,1675
South Carolina,Oswego,11,11,0,0,0,0,11
South Carolina,Orangeburg,13685,1136,2093,2084,1305,938,7556
South Carolina,Olar,213,25,74,45,17,3,164
South Carolina,Olanta,544,86,106,106,38,23,359
South Carolina,Oakland,1081,116,203,245,95,27,686
South Carolina,Wilkinson Heights,2723,259,459,636,188,200,1742
South Carolina,Williams,131,11,33,36,12,9,101
South Carolina,Williamston,4029,335,1025,885,264,196,2705
South Carolina,Willington,126,8,26,36,11,0,81
South Carolina,Williston,3069,388,846,498,193,81,2006
South Carolina,Windsor,71,12,15,20,3,3,53
South Carolina,Winnsboro,3419,414,786,774,161,165,2300
South Carolina,Winnsboro Mills,2111,691,489,206,80,66,1532
South Carolina,Woodfield,9776,896,1949,2242,913,324,6324
South Carolina,Paxville,215,19,43,57,4,4,127
South Carolina,Peak,51,5,11,6,4,3,29
South Carolina,Pelion,705,39,175,144,86,19,463
South Carolina,Pelzer,82,3,26,23,3,2,57
South Carolina,Rembert,220,29,34,114,18,0,195
South Carolina,Reidville,764,45,166,198,62,44,515
South Carolina,Reevesville,261,41,34,51,36,12,174
South Carolina,Red Hill,14357,1233,3362,2985,1381,730,9691
South Carolina,Red Bank,8920,888,2253,1883,971,409,6404
South Carolina,Ravenel,2544,331,793,455,107,79,1765
South Carolina,Quinby,1253,59,268,343,106,66,842
South Carolina,Prosperity,1112,177,233,221,97,52,780
South Carolina,Promised Land,496,192,139,90,0,20,441
South Carolina,Privateer,2805,274,568,546,138,111,1637
South Carolina,Ridgeland,4030,693,949,804,263,136,2845
South Carolina,Princeton,57,0,20,19,7,0,46
South Carolina,Port Royal,11513,387,1337,2099,677,948,5448
South Carolina,Pomaria,102,17,24,25,9,2,77
South Carolina,Plum Branch,106,2,42,12,21,0,77
South Carolina,Pinopolis,1098,15,92,323,304,231,965
South Carolina,Pinewood,686,113,159,89,30,22,413
South Carolina,Pine Ridge,1990,91,409,526,235,95,1356
South Carolina,Piedmont,5648,683,1636,1168,293,102,3882
South Carolina,Pickens,3148,645,518,608,192,47,2010
South Carolina,Perry,303,65,84,30,13,1,193
South Carolina,Pendleton,3089,471,543,756,267,219,2256
South Carolina,Powdersville,8230,649,1615,1559,980,557,5360
South Carolina,Belvedere,5706,755,1373,1205,266,265,3864
South Carolina,Woodruff,4104,1092,1064,458,246,30,2890
South Carolina,Berea,14091,2230,3189,2371,784,391,8965
South Carolina,Burnettown,2753,305,705,486,199,41,1736
South Carolina,Burton,6266,611,1038,1500,472,174,3795
South Carolina,Calhoun Falls,1733,375,474,331,49,0,1229
South Carolina,Camden,6982,801,945,1794,1160,613,5313
South Carolina,Cameron,472,38,110,123,64,23,358
South Carolina,Campobello,525,65,112,144,22,22,365
South Carolina,Cane Savannah,805,51,265,215,47,42,620
South Carolina,Carlisle,360,58,120,72,17,2,269
South Carolina,Catawba,1044,254,285,186,35,16,776
South Carolina,Cayce,13554,899,2379,2850,1579,882,8589
South Carolina,Centerville,6806,651,1524,1776,614,292,4857
South Carolina,Bennettsville,8834,2069,2153,1271,451,265,6209
South Carolina,Central Pacolet,155,38,40,14,1,0,93
South Carolina,Chapin,1605,77,324,413,225,58,1097
South Carolina,Charleston,127694,5543,15457,22404,26754,15788,85946
South Carolina,Buffalo,1544,188,529,210,46,16,989
South Carolina,Bucksport,839,133,306,188,39,0,666
South Carolina,Central,5160,283,797,649,304,416,2449
South Carolina,Boykin,103,0,33,37,21,4,95
South Carolina,Bethune,290,35,93,45,22,19,214
South Carolina,Brunson,547,51,163,146,20,13,393
South Carolina,Briarcliffe Acres,493,9,38,81,131,135,394
South Carolina,Branchville,1255,118,318,238,72,30,776
South Carolina,Bradley,149,21,31,38,12,6,108
South Carolina,Bowman,816,107,254,148,83,25,617
South Carolina,Bonneau Beach,2170,304,795,492,42,33,1666
South Carolina,Bonneau,487,69,117,86,34,1,307
South Carolina,Boiling Springs,8743,539,1331,1897,1161,827,5755
South Carolina,Blythewood,2479,82,369,468,520,297,1736
South Carolina,Bluffton,14607,660,2055,3105,1967,1216,9003
South Carolina,Blenheim,137,12,64,25,3,3,107
South Carolina,Brookdale,4289,573,697,782,333,249,2634
South Carolina,Blackville,2203,379,684,354,73,24,1514
South Carolina,Bishopville,3342,468,836,619,169,32,2124
South Carolina,Blacksburg,1975,272,493,299,37,28,1129
South Dakota,Agency Village,170,10,20,40,0,0,70
South Dakota,Agar,71,0,20,20,8,0,48
South Dakota,Aberdeen,27418,1479,5871,5339,3746,1306,17741
South Dakota,Davis,49,3,11,18,1,2,35
South Dakota,Dante,101,5,12,25,8,3,53
South Dakota,Dallas,98,9,40,32,1,0,82
South Dakota,Dakota Dunes,2970,47,250,609,389,616,1911
South Dakota,Akaska,31,4,19,4,4,0,31
South Dakota,Custer,1899,92,479,526,284,67,1448
South Dakota,Crooks,1329,59,279,270,171,46,825
South Dakota,Crocker,0,0,0,0,0,0,0
South Dakota,Cresbard,148,15,31,43,10,9,108
South Dakota,Cow Creek,20,0,0,5,5,0,10
South Dakota,Albee,10,2,6,2,0,0,10
South Dakota,Java,137,13,36,27,13,9,98
South Dakota,Cottonwood,6,0,4,0,2,0,6
South Dakota,Alexandria,671,16,138,129,84,12,379
South Dakota,Deadwood,1211,67,409,321,140,40,977
South Dakota,Allen,658,135,28,51,0,0,214
South Dakota,Alpena,261,50,74,55,11,3,193
South Dakota,Altamont,28,6,6,8,0,0,20
South Dakota,Anderson,325,33,50,95,43,15,236
South Dakota,Andover,94,10,18,35,7,4,74
South Dakota,Antelope,1126,216,106,184,15,29,550
South Dakota,Arlington,1013,85,249,202,108,30,674
South Dakota,Armour,870,87,223,159,81,39,589
South Dakota,Artas,5,1,3,0,1,0,5
South Dakota,Artesian,168,37,46,41,14,2,140
South Dakota,Ashland Heights,891,29,210,278,101,16,634
South Dakota,Alcester,847,96,218,175,76,29,594
South Dakota,Corsica,610,115,166,107,59,23,470
South Dakota,Corn Creek,72,11,7,9,4,0,31
South Dakota,Ashton,142,11,39,35,4,0,89
South Dakota,Butler,14,2,8,2,1,0,13
South Dakota,Bushnell,100,0,33,15,21,2,71
South Dakota,Burke,635,51,182,142,100,15,490
South Dakota,Bullhead,298,38,52,21,16,1,128
South Dakota,Buffalo Gap,103,8,33,27,17,5,90
South Dakota,Buffalo,359,11,60,89,64,9,233
South Dakota,Bryant,372,36,117,67,20,3,243
South Dakota,Bruce,168,11,47,37,19,0,114
South Dakota,Brookings,22974,542,2449,2660,3175,1867,10693
South Dakota,Broadland,37,0,6,15,1,1,23
South Dakota,Winfred,52,17,21,0,0,11,49
South Dakota,Winner,2855,321,579,592,340,136,1968
South Dakota,Wolsey,462,30,145,80,51,5,311
South Dakota,Wood,23,0,10,12,0,1,23
South Dakota,Woonsocket,597,40,197,132,69,16,454
South Dakota,Worthing,930,53,192,224,92,38,599
South Dakota,Wounded Knee,590,125,51,58,10,0,244
South Dakota,Yale,110,15,44,19,3,0,81
South Dakota,Yankton,14531,890,3449,2861,1962,745,9907
South Dakota,Camp Crook,85,2,27,13,5,3,50
South Dakota,Canistota,592,44,148,84,43,25,344
South Dakota,Canova,88,5,30,20,7,4,66
South Dakota,Canton,3258,131,810,724,415,143,2223
South Dakota,Conde,134,15,57,24,18,5,119
South Dakota,Columbia,136,10,52,26,17,10,115
South Dakota,Colton,705,37,215,167,53,11,483
South Dakota,Colonial Pine Hills,1906,67,246,466,389,180,1348
South Dakota,Colome,320,10,80,63,27,2,182
South Dakota,Colman,665,12,154,149,51,14,380
South Dakota,Clear Lake,1284,124,369,270,95,58,916
South Dakota,Clark,1141,114,356,255,120,21,866
South Dakota,Claremont,139,7,32,32,15,2,88
South Dakota,Corona,113,7,35,14,23,0,79
South Dakota,Claire City,80,4,29,19,4,0,56
South Dakota,Chelsea,34,0,10,7,5,5,27
South Dakota,Chancellor,315,18,91,71,29,3,212
South Dakota,Chamberlain,2582,173,481,551,291,161,1657
South Dakota,Central City,170,21,78,25,4,0,128
South Dakota,Centerville,804,32,215,224,81,24,576
South Dakota,Cavour,118,3,43,31,7,0,84
South Dakota,Castlewood,668,14,168,123,60,18,383
South Dakota,Carthage,173,8,44,60,11,1,124
South Dakota,Caputa,0,0,0,0,0,0,0
South Dakota,Chester,334,21,80,77,49,9,236
South Dakota,Astoria,141,10,36,40,10,3,99
South Dakota,Bath,251,0,73,70,0,0,143
South Dakota,Aurora Center,62,6,11,6,6,5,34
South Dakota,Henry,355,15,118,72,13,0,218
South Dakota,Hecla,176,23,69,41,21,5,159
South Dakota,Hazel,81,6,20,16,5,0,47
South Dakota,Hayti,371,17,95,59,32,16,219
South Dakota,Hartford,2887,93,534,537,417,145,1726
South Dakota,Harrison,113,3,26,19,18,8,74
South Dakota,Harrisburg,4942,72,434,1305,859,198,2868
South Dakota,Hermosa,412,23,119,93,45,10,290
South Dakota,Hamill,0,0,0,0,0,0,0
South Dakota,Dolton,29,7,6,7,0,0,20
South Dakota,Draper,71,7,21,22,6,0,56
South Dakota,Dupree,586,44,113,77,38,8,280
South Dakota,Eagle Butte,1271,88,264,217,47,24,640
South Dakota,Eden,93,12,29,17,9,11,78
South Dakota,Edgemont,827,78,272,252,54,21,677
South Dakota,Egan,310,26,83,75,15,1,200
South Dakota,Groton,1873,52,414,429,276,66,1237
South Dakota,Herreid,534,24,167,91,48,9,339
South Dakota,Herrick,119,20,27,27,9,2,85
South Dakota,Hetland,35,0,12,3,0,0,15
South Dakota,Isabel,132,6,44,20,8,5,83
South Dakota,Iroquois,270,14,57,74,10,7,162
South Dakota,Irene,543,35,138,92,42,8,315
South Dakota,Ipswich,1002,71,205,232,101,46,655
South Dakota,Interior,70,2,37,7,0,2,48
South Dakota,Huron,13159,1644,2731,2618,1288,369,8650
South Dakota,Hurley,374,6,104,108,28,16,262
South Dakota,Humboldt,653,36,158,166,89,28,477
South Dakota,Hudson,318,20,103,99,17,3,242
South Dakota,Howard,1094,89,278,182,110,63,722
South Dakota,Hoven,400,48,162,69,12,5,296
South Dakota,Hot Springs,3542,190,818,968,477,151,2604
South Dakota,Hosmer,227,31,60,44,5,5,145
South Dakota,Hitchcock,107,7,22,22,16,5,72
South Dakota,Hillsview,0,0,0,0,0,0,0
South Dakota,Hill City,1422,93,282,226,128,51,780
South Dakota,Highmore,898,59,317,179,65,9,629
South Dakota,Elk Point,2080,169,456,382,262,121,1390
South Dakota,Aurora,705,27,162,138,129,11,467
South Dakota,Elkton,728,23,138,160,62,28,411
South Dakota,Erwin,67,1,17,27,1,6,52
South Dakota,Belvidere,68,0,17,32,2,0,51
South Dakota,Belle Fourche,5702,432,1351,1475,463,99,3820
South Dakota,Johnson Siding,736,53,210,214,147,62,686
South Dakota,Kadoka,777,47,189,162,73,39,510
South Dakota,Doland,194,14,61,44,24,5,148
South Dakota,Dimock,155,5,42,35,15,5,102
South Dakota,De Smet,1171,101,342,265,140,40,888
South Dakota,Beresford,2211,111,441,468,243,135,1398
South Dakota,Delmont,255,18,51,63,27,11,170
South Dakota,Bath Corner,129,0,25,36,23,21,105
South Dakota,Jefferson,577,34,158,136,66,14,408
South Dakota,Batesland,136,15,15,28,12,0,70
South Dakota,Bancroft,20,3,5,9,0,0,17
South Dakota,Baltic,1070,53,208,247,124,35,667
South Dakota,Badger,68,2,23,18,8,3,54
South Dakota,Avon,690,29,149,122,71,32,403
South Dakota,Dell Rapids,3693,152,813,841,516,94,2416
South Dakota,Big Stone City,566,42,187,153,34,3,419
South Dakota,Bijou Hills,0,0,0,0,0,0,0
South Dakota,Bison,317,23,115,84,22,7,251
South Dakota,Estelline,901,82,218,180,56,5,541
South Dakota,Ethan,352,19,74,96,38,0,227
South Dakota,Eureka,771,211,163,163,89,18,644
South Dakota,Britton,1522,104,377,397,109,41,1028
South Dakota,Bristol,325,28,110,80,37,12,267
South Dakota,Bridgewater,540,82,103,117,33,6,341
South Dakota,Brentford,78,5,17,23,4,2,51
South Dakota,Brant Lake,192,10,33,72,24,21,160
South Dakota,Brandt,85,5,28,16,9,3,61
South Dakota,Brandon,9497,120,1442,2377,1369,364,5672
South Dakota,Bradley,78,16,28,12,2,0,58
South Dakota,Box Elder,8959,360,1065,2191,559,306,4481
South Dakota,Bowdle,561,62,146,122,35,17,382
South Dakota,Bonesteel,299,29,102,45,36,9,221
South Dakota,Blunt,324,19,128,40,13,11,211
South Dakota,Blucksberg Mountain,541,68,127,90,61,36,382
South Dakota,Blackhawk,2893,160,485,865,430,74,2014
South Dakota,Emery,491,20,109,88,43,21,281
South Dakota,Harrold,98,8,36,29,5,2,80
South Dakota,Gayville,392,22,103,76,36,27,264
South Dakota,Gregory,1479,166,334,359,110,42,1011
South Dakota,Oglala,1404,133,185,321,63,27,729
South Dakota,Okaton,6,0,6,0,0,0,6
South Dakota,Okreek,373,20,33,80,70,0,203
South Dakota,Ola,0,0,0,0,0,0,0
South Dakota,Oldham,160,5,45,25,14,2,91
South Dakota,Olivet,53,4,25,6,6,0,41
South Dakota,Onaka,12,0,6,3,2,0,11
South Dakota,Oelrichs,137,19,52,31,13,3,118
South Dakota,Onida,750,24,183,166,89,13,475
South Dakota,Ortley,36,3,14,7,6,0,30
South Dakota,Parker,1142,56,324,262,100,27,769
South Dakota,Parkston,1691,168,299,422,175,38,1102
South Dakota,Parmelee,729,88,41,137,16,0,282
South Dakota,Peever,208,8,50,28,15,8,109
South Dakota,Philip,718,63,217,166,69,25,540
South Dakota,Pickstown,192,12,31,57,36,8,144
South Dakota,Orient,63,3,36,9,0,1,49
South Dakota,Oacoma,556,45,170,102,60,15,392
South Dakota,Nunda,64,9,24,6,5,5,49
South Dakota,Northville,181,0,23,19,41,6,89
South Dakota,Sturgis,6657,443,1676,1479,654,239,4491
South Dakota,Stratford,72,5,20,16,5,0,46
South Dakota,Strandburg,79,3,31,18,6,0,58
South Dakota,Storla,11,0,0,11,0,0,11
South Dakota,Stockholm,112,5,40,24,4,2,75
South Dakota,Stickney,257,16,52,84,35,7,194
South Dakota,Springfield,1942,222,650,478,154,54,1558
South Dakota,Spring Creek,211,33,28,24,0,0,85
South Dakota,Spencer,113,15,34,20,7,4,80
South Dakota,Spearfish,10980,382,2109,2278,1360,659,6788
South Dakota,South Shore,179,15,58,29,23,7,132
South Dakota,Soldier Creek,115,51,15,21,0,0,87
South Dakota,Sisseton,2668,311,584,472,149,140,1656
South Dakota,Sioux Falls,164341,9777,29009,33684,23872,11423,107765
South Dakota,North Eagle Butte,2091,189,397,370,94,33,1083
South Dakota,North Sioux City,2597,235,639,493,278,124,1769
South Dakota,North Spearfish,2054,67,591,530,272,151,1611
South Dakota,Piedmont,930,24,169,175,115,13,496
South Dakota,Summerset,2221,49,327,490,296,75,1237
South Dakota,Pierpont,125,6,42,35,11,1,95
South Dakota,Pine Lakes Addition,291,13,32,25,80,34,184
South Dakota,Rosebud,1665,186,144,320,72,23,745
South Dakota,Rosholt,495,35,111,144,39,12,341
South Dakota,Roslyn,195,21,69,35,17,3,145
South Dakota,Roswell,7,0,7,0,0,0,7
South Dakota,Running Water,63,19,0,6,17,0,42
South Dakota,St. Charles,20,0,9,8,0,0,17
South Dakota,St. Francis,610,57,93,125,24,2,301
South Dakota,Roscoe,330,48,77,43,30,5,203
South Dakota,St. Lawrence,169,8,51,49,11,2,121
South Dakota,Salem,1476,92,409,331,173,47,1052
South Dakota,Scotland,859,117,192,143,112,42,606
South Dakota,Selby,857,93,262,169,59,5,588
South Dakota,Seneca,13,0,1,6,0,1,8
South Dakota,Sherman,76,1,29,15,2,2,49
South Dakota,Shindler,601,8,104,150,101,21,384
South Dakota,Sinai,130,12,21,21,11,9,74
South Dakota,St. Onge,31,0,31,0,0,0,31
South Dakota,Rockham,94,0,22,11,2,0,35
South Dakota,Richland,66,20,23,9,0,6,58
South Dakota,Revillo,100,9,44,1,8,7,69
South Dakota,Pine Ridge,3562,378,511,585,173,39,1686
South Dakota,Plankinton,654,85,160,125,53,32,455
South Dakota,Pollock,155,24,56,33,17,4,134
South Dakota,Porcupine,1369,183,213,295,25,0,716
South Dakota,Prairie City,4,0,3,0,1,0,4
South Dakota,Presho,522,18,154,96,71,38,377
South Dakota,Pringle,165,10,71,45,13,0,139
South Dakota,Pukwana,235,15,71,61,14,6,167
South Dakota,Quinn,92,2,28,24,8,1,63
South Dakota,Ramona,144,11,58,31,12,2,114
South Dakota,Rapid City,71692,3932,13290,16461,9238,4732,47653
South Dakota,Ravinia,114,11,22,19,0,5,57
South Dakota,Raymond,55,17,17,7,11,0,52
South Dakota,Redfield,2581,136,742,583,231,112,1804
South Dakota,Ree Heights,64,4,39,14,0,0,57
South Dakota,Reliance,223,11,65,43,18,8,145
South Dakota,Renner Corner,270,34,102,82,17,8,243
South Dakota,Pierre,13938,1060,2619,2963,2309,887,9838
South Dakota,Grenville,90,23,25,9,10,14,81
South Dakota,Summit,338,44,65,54,22,5,190
South Dakota,Tea,4427,94,558,910,758,171,2491
South Dakota,Ferney,30,0,30,0,0,0,30
South Dakota,Fedora,23,0,10,0,12,1,23
South Dakota,Faulkton,782,55,212,181,96,29,573
South Dakota,Farmer,2,1,1,0,0,0,2
South Dakota,Faith,387,35,112,79,24,16,266
South Dakota,Fairview,52,8,23,8,1,0,40
South Dakota,Fairfax,138,7,66,18,15,2,108
South Dakota,Flandreau,2082,226,455,369,279,116,1445
South Dakota,Fairburn,60,5,19,9,13,0,46
South Dakota,Willow Lake,334,29,85,48,25,16,203
South Dakota,Whitewood,925,42,274,148,70,30,564
South Dakota,White Rock,2,1,1,0,0,0,2
South Dakota,White River,572,49,112,126,47,14,348
South Dakota,White Lake,421,33,115,95,33,9,285
South Dakota,White Horse,202,29,33,38,0,7,107
South Dakota,Whitehorse,162,18,32,21,5,0,76
South Dakota,Wilmot,433,66,118,73,62,4,323
South Dakota,Florence,377,11,115,90,14,5,235
South Dakota,Forestburg,128,5,25,30,8,7,75
South Dakota,Fort Pierre,2244,183,504,455,238,168,1548
South Dakota,Green Valley,599,82,203,140,94,11,530
South Dakota,Green Grass,14,0,5,0,0,5,10
South Dakota,Goodwin,176,12,56,34,10,0,112
South Dakota,Goodwill,623,72,88,103,20,0,283
South Dakota,Glenham,91,5,47,7,12,2,73
South Dakota,Gettysburg,1260,77,321,261,208,48,915
South Dakota,Geddes,204,22,72,49,25,6,174
South Dakota,Gary,260,35,117,27,13,3,195
South Dakota,Garretson,1210,39,274,273,111,62,759
South Dakota,Garden City,45,7,15,9,5,0,36
South Dakota,Gann Valley,18,0,2,16,0,0,18
South Dakota,Fulton,78,4,29,15,5,5,58
South Dakota,Fruitdale,42,5,8,14,3,1,31
South Dakota,Freeman,1298,128,302,250,158,91,929
South Dakota,Frederick,284,27,62,76,28,6,199
South Dakota,Frankfort,92,8,33,25,1,0,67
South Dakota,Fort Thompson,1286,129,282,186,25,16,638
South Dakota,White,490,26,131,119,43,35,354
South Dakota,Tabor,405,18,82,106,35,13,254
South Dakota,Wetonka,3,0,0,1,1,0,2
South Dakota,Wessington Springs,842,86,226,214,79,45,650
South Dakota,Vermillion,10746,189,1259,802,1177,1255,4682
South Dakota,Verdon,4,0,4,0,0,0,4
South Dakota,Veblen,508,58,110,65,42,35,310
South Dakota,Valley Springs,778,36,205,186,85,24,536
South Dakota,Vale,128,10,61,17,20,0,108
South Dakota,Utica,86,5,13,30,1,4,53
South Dakota,Tyndall,1043,102,274,243,103,29,751
South Dakota,Viborg,840,91,269,174,67,29,630
South Dakota,Two Strike,298,54,32,78,10,0,174
South Dakota,Turton,43,4,4,11,11,0,30
South Dakota,Tulare,239,5,58,59,28,5,155
South Dakota,Tripp,646,99,160,131,49,18,457
South Dakota,Trent,278,8,68,106,12,0,194
South Dakota,Toronto,205,7,71,27,25,6,136
South Dakota,Tolstoy,24,4,10,9,1,0,24
South Dakota,Timber Lake,476,51,111,81,31,14,288
South Dakota,Twin Brooks,54,2,25,10,0,0,37
South Dakota,Vienna,48,3,12,11,0,0,26
South Dakota,Vilas,12,1,3,0,1,1,6
South Dakota,Virgil,14,6,5,3,0,0,14
South Dakota,Wessington,293,22,79,35,12,8,156
South Dakota,Wentworth,164,7,79,26,16,3,131
South Dakota,Webster,1798,153,422,415,192,57,1239
South Dakota,Waverly,9,0,3,3,3,0,9
South Dakota,Waubay,645,51,182,116,42,25,416
South Dakota,Watertown,21919,1237,5801,4626,2329,668,14661
South Dakota,Wasta,104,6,36,25,9,2,78
South Dakota,Warner,441,15,130,94,58,15,312
South Dakota,Ward,50,0,2,20,1,1,24
South Dakota,Wanblee,801,31,129,148,25,20,353
South Dakota,Wallace,104,0,21,24,8,2,55
South Dakota,Wall,724,11,174,190,80,39,494
South Dakota,Wakonda,329,36,70,75,35,25,241
South Dakota,Wagner,1572,139,372,305,116,77,1009
South Dakota,Volin,220,12,57,38,10,3,120
South Dakota,Volga,2401,61,420,433,337,106,1357
South Dakota,Vivian,52,0,9,24,0,7,40
South Dakota,Westport,118,10,31,30,20,0,91
South Dakota,Rapid Valley,8516,207,1594,2627,640,327,5395
South Dakota,Platte,1543,114,485,316,144,31,1090
South Dakota,Mansfield,111,9,15,18,20,0,62
South Dakota,Marty,479,30,91,107,5,0,233
South Dakota,Martin,954,86,164,247,117,36,650
South Dakota,Marion,784,68,211,226,76,27,608
South Dakota,Manderson-White Horse Creek,681,178,104,62,0,0,344
South Dakota,Madison,6972,312,1337,1166,1016,323,4154
South Dakota,McLaughlin,551,65,68,138,34,25,330
South Dakota,McIntosh,230,21,57,34,28,6,146
South Dakota,Lowry,7,4,1,2,0,0,7
South Dakota,Lower Brule,587,72,92,112,12,5,293
South Dakota,Loomis,7,0,0,7,0,0,7
South Dakota,Marvin,23,6,8,8,0,0,22
South Dakota,Long Lake,26,1,6,6,4,0,17
South Dakota,Little Eagle,332,37,50,70,11,0,168
South Dakota,Lily,2,0,0,2,0,0,2
South Dakota,Letcher,205,2,49,66,3,6,126
South Dakota,Lesterville,122,13,52,18,3,4,90
South Dakota,Leola,505,43,137,138,21,4,343
South Dakota,Lennox,2371,108,566,577,222,48,1521
South Dakota,Lemmon,1309,167,326,328,107,63,991
South Dakota,Lebanon,34,3,12,5,1,0,21
South Dakota,Lead,3082,188,827,643,507,124,2289
South Dakota,La Plant,193,34,14,22,0,0,70
South Dakota,Long Hollow,298,17,51,52,0,7,127
South Dakota,Meadow View Addition,382,29,141,114,23,10,317
South Dakota,Mellette,192,3,49,59,17,3,131
South Dakota,Menno,601,128,157,126,64,30,505
South Dakota,Norris,165,13,45,9,0,3,70
South Dakota,Nisland,328,22,105,63,14,5,209
South Dakota,New Witten,57,5,20,15,12,0,52
South Dakota,New Underwood,543,24,159,161,55,15,414
South Dakota,New Holland,38,19,19,0,0,0,38
South Dakota,Newell,721,55,201,148,70,23,497
South Dakota,New Effington,197,17,68,45,5,1,136
South Dakota,Naples,28,2,6,1,1,0,10
South Dakota,Murdo,393,29,119,101,54,9,312
South Dakota,Mount Vernon,541,26,121,114,60,11,332
South Dakota,Mound City,71,11,42,7,9,2,71
South Dakota,Morristown,45,6,15,16,4,0,41
South Dakota,Morningside,72,23,32,4,0,0,59
South Dakota,Montrose,469,28,119,84,57,11,299
South Dakota,Monroe,162,15,31,37,12,2,97
South Dakota,Mobridge,3302,285,851,739,437,120,2432
South Dakota,Mitchell,15543,982,2637,3599,1896,824,9938
South Dakota,Mission Hill,245,12,61,51,8,10,142
South Dakota,Mission,1211,98,108,211,73,63,553
South Dakota,Milltown,11,0,0,0,6,5,11
South Dakota,Miller,1537,159,324,366,194,69,1112
South Dakota,Milbank,3269,179,958,656,335,50,2178
South Dakota,Midland,152,10,60,24,7,4,105
South Dakota,Langford,395,29,79,67,59,18,252
South Dakota,Lane,90,10,29,8,7,0,54
South Dakota,Lake Preston,581,35,176,145,40,17,413
South Dakota,Keystone,318,34,58,89,20,14,215
South Dakota,Lake Norden,586,34,148,126,48,20,376
South Dakota,Lake Madison,859,25,231,198,213,82,749
South Dakota,Lake City,32,3,3,20,2,0,28
South Dakota,Lake Andes,874,62,176,149,53,18,458
South Dakota,La Bolt,101,4,28,15,14,1,62
South Dakota,Kyle,983,133,91,153,28,9,414
South Dakota,Kranzburg,157,7,42,45,14,0,108
South Dakota,Kimball,549,52,163,119,52,4,390
South Dakota,Kidder,0,0,0,0,0,0,0
South Dakota,Kennebec,326,8,99,65,25,15,212
South Dakota,Kaylor,77,0,54,7,0,16,77
South Dakota,Lake Poinsett,441,10,113,109,81,61,374
Tennessee,Grand Junction,446,64,144,85,15,12,320
Tennessee,Graball,196,6,87,23,6,8,130
Tennessee,Gordonsville,1444,135,502,206,52,46,941
Tennessee,Fairfield Glade,8216,338,2124,2260,1582,1303,7607
Tennessee,Gleason,1428,210,359,181,111,40,901
Tennessee,Gilt Edge,535,63,146,92,22,11,334
Tennessee,Gray,1811,121,386,377,307,122,1313
Tennessee,Goodlettsville,16672,1354,3838,3703,2141,1156,12192
Tennessee,Graysville,1934,394,541,272,30,7,1244
Tennessee,Grimsley,1373,247,494,190,31,15,977
Tennessee,Greenbrier,6611,519,1626,1361,537,318,4361
Tennessee,Greeneville,15031,1936,3466,2754,1261,925,10342
Tennessee,Greenfield,2262,272,542,386,138,82,1420
Tennessee,Green Hill,6741,209,1449,1588,1130,344,4720
Tennessee,Gibson,356,36,69,69,21,10,205
Tennessee,Gruetli-Laager,1966,317,554,306,72,29,1278
Tennessee,Guys,504,68,146,73,26,37,350
Tennessee,Halls,2547,330,659,414,96,46,1545
Tennessee,Greenback,1021,122,255,245,53,11,686
Tennessee,Germantown,39262,668,2645,6015,10812,7358,27498
Tennessee,Gadsden,458,61,153,77,27,21,339
Tennessee,Gates,792,85,187,146,8,12,438
Tennessee,Fairmount,2984,30,374,380,559,420,1763
Tennessee,Fairview,8121,673,1559,1521,1012,408,5173
Tennessee,Fall Branch,1557,106,393,429,126,58,1112
Tennessee,Falling Water,1277,111,207,364,173,141,996
Tennessee,Farragut,21374,365,1703,3199,4814,4214,14295
Tennessee,Fayetteville,7060,947,1880,1095,566,215,4703
Tennessee,Fincastle,1315,212,334,247,131,30,954
Tennessee,Finger,376,63,98,40,18,14,233
Tennessee,Gatlinburg,4099,539,1005,1116,381,203,3244
Tennessee,Flat Top Mountain,331,8,89,142,33,5,277
Tennessee,Forest Hills,4969,24,311,500,1484,1207,3526
Tennessee,Franklin,68549,2458,6406,10356,16167,9568,44955
Tennessee,Friendship,775,112,164,115,19,3,413
Tennessee,Friendsville,912,86,297,169,57,25,634
Tennessee,Gainesboro,962,208,264,108,42,24,646
Tennessee,Gallatin,32518,3196,6473,6926,3063,1788,21446
Tennessee,Gallaway,828,150,259,84,14,14,521
Tennessee,Garland,310,19,88,63,30,9,209
Tennessee,Fairgarden,347,0,258,18,14,0,290
Tennessee,Fairfield,271,110,37,21,0,0,168
Tennessee,Trenton,4188,778,911,822,233,106,2850
Tennessee,Etowah,3493,402,963,814,134,98,2411
Tennessee,Dover,1894,193,496,273,159,115,1236
Tennessee,Dodson Branch,1342,185,532,268,9,25,1019
Tennessee,Dickson,14951,1543,4233,2368,943,551,9638
Tennessee,Decherd,2703,417,732,410,96,52,1707
Tennessee,Decaturville,983,186,315,133,39,23,696
Tennessee,Decatur,1523,172,519,327,51,28,1097
Tennessee,Dayton,7355,1277,1748,1240,237,192,4694
Tennessee,Darden,364,58,72,62,10,9,211
Tennessee,Dowelltown,355,35,95,64,31,10,235
Tennessee,Dandridge,2860,362,656,562,247,160,1987
Tennessee,Cumberland City,353,32,100,46,20,14,212
Tennessee,Crump,1166,202,405,170,52,8,837
Tennessee,Crossville,11245,1515,2388,2044,916,396,7259
Tennessee,Cross Plains,1928,182,456,439,125,49,1251
Tennessee,Crab Orchard,786,170,220,91,22,6,509
Tennessee,Cowan,1436,298,402,225,75,27,1027
Tennessee,Covington,9036,1232,2409,1447,446,268,5802
Tennessee,Cottontown,439,24,110,127,8,34,303
Tennessee,Cumberland Gap,427,35,35,40,79,51,240
Tennessee,Eva,191,50,79,13,15,7,164
Tennessee,Doyle,474,66,223,39,4,13,345
Tennessee,Ducktown,411,120,126,85,17,9,357
Tennessee,Harriman,6267,926,1429,1576,326,215,4472
Tennessee,Ethridge,613,63,181,106,36,2,388
Tennessee,Estill Springs,2142,217,591,495,193,46,1542
Tennessee,Erwin,6028,875,1720,1161,337,207,4300
Tennessee,Erin,1346,269,320,229,60,28,906
Tennessee,Enville,203,34,47,67,6,5,159
Tennessee,Englewood,1869,274,554,324,51,19,1222
Tennessee,Elkton,633,80,206,77,64,31,458
Tennessee,Dresden,2924,417,877,350,254,158,2056
Tennessee,Elizabethton,14058,1817,3124,3070,1222,794,10027
Tennessee,Eastview,885,89,266,194,48,25,622
Tennessee,East Ridge,21275,2131,4577,4888,1981,897,14474
Tennessee,East Cleveland,1612,273,319,352,32,10,986
Tennessee,Eagleville,714,54,196,97,77,48,472
Tennessee,Eagleton Village,4360,580,1179,996,269,108,3132
Tennessee,Dyersburg,16932,1924,4254,2486,1699,941,11304
Tennessee,Dyer,2330,288,794,432,147,38,1699
Tennessee,Dunlap,5022,928,1333,1044,235,200,3740
Tennessee,Elgin,261,28,155,24,0,2,209
Tennessee,Cottage Grove,89,8,35,25,2,0,70
Tennessee,Harrison,7601,605,1980,1948,719,499,5751
Tennessee,Hartsville/Trousdale,7884,1135,2278,1148,351,413,5325
Tennessee,Medina,3944,169,570,804,521,236,2300
Tennessee,Maynardville,2425,398,643,326,101,29,1497
Tennessee,Maury City,665,118,198,105,27,6,454
Tennessee,Mason,1384,266,389,172,56,14,897
Tennessee,Mascot,2666,300,755,549,168,57,1829
Tennessee,Maryville,27993,1887,4709,5269,4013,2438,18316
Tennessee,Martin,11199,527,1546,1789,948,550,5360
Tennessee,Manchester,10298,1231,2740,1839,799,410,7019
Tennessee,Madisonville,4743,633,1181,948,103,116,2981
Tennessee,McMinnville,13651,2242,3710,2062,731,439,9184
Tennessee,McLemoresville,325,33,91,70,19,11,224
Tennessee,McKenzie,5551,754,1075,826,408,298,3361
Tennessee,McEwen,1812,243,540,329,114,69,1295
Tennessee,Lynnville,334,51,98,45,28,5,227
Tennessee,Lyles,593,84,289,50,60,0,483
Tennessee,Medon,238,39,52,63,19,0,173
Tennessee,Luttrell,880,203,260,134,13,14,624
Tennessee,Memphis,657167,67804,123564,120727,65761,39176,417032
Tennessee,Middleton,647,37,167,118,54,20,396
Tennessee,Moscow,626,98,215,61,33,4,411
Tennessee,Morristown,29247,4485,7473,4478,1954,1132,19522
Tennessee,Morrison,613,124,165,68,19,16,392
Tennessee,Mooresburg,966,132,295,259,0,0,686
Tennessee,Monterey,2863,507,946,256,178,31,1918
Tennessee,Monteagle,1436,170,418,259,136,76,1059
Tennessee,Tracy City,1440,310,361,216,47,51,985
Tennessee,Mitchellville,153,34,56,24,2,1,117
Tennessee,Minor Hill,615,74,193,78,42,5,392
Tennessee,Millington,11113,865,2612,2650,858,583,7568
Tennessee,Millersville,6579,524,1597,1684,512,231,4548
Tennessee,Milledgeville,204,49,70,49,2,3,173
Tennessee,Milan,7817,713,1981,1653,570,271,5188
Tennessee,Midtown,1669,240,363,313,131,71,1118
Tennessee,Middle Valley,12235,1012,2711,2951,1395,802,8871
Tennessee,Michie,622,135,216,106,21,12,490
Tennessee,Mosheim,2632,423,800,470,95,47,1835
Tennessee,Louisville,4092,346,807,914,541,380,2988
Tennessee,Loretto,2092,248,681,400,151,109,1589
Tennessee,Lafayette,4819,1073,1408,544,184,145,3354
Tennessee,Knoxville,183066,14259,33577,34763,20961,13319,116879
Tennessee,Kingston Springs,2767,146,465,651,350,199,1811
Tennessee,Kingston,5865,508,1453,1477,629,265,4332
Tennessee,Kingsport,52898,4704,13051,10580,5610,4003,37948
Tennessee,Kimball,1392,171,370,238,116,61,956
Tennessee,Kenton,1100,148,451,191,54,13,857
Tennessee,Jonesborough,5189,566,1176,986,661,414,3803
Tennessee,Johnson City,64978,4479,10179,10658,9649,6801,41766
Tennessee,Jellico,2391,581,653,334,113,101,1782
Tennessee,Jefferson City,8396,902,1795,1423,741,315,5176
Tennessee,Jasper,3278,408,828,621,325,151,2333
Tennessee,Jamestown,1816,422,450,254,118,16,1260
Tennessee,Jackson,67161,5318,13315,11879,7996,4048,42556
Tennessee,Jacksboro,1981,319,677,347,141,67,1551
Tennessee,La Follette,7218,1531,1893,1287,312,103,5126
Tennessee,Loudon,5653,1006,1184,908,211,185,3494
Tennessee,La Grange,99,14,21,21,23,10,89
Tennessee,Lakeland,12556,413,1926,2282,2122,1419,8162
Tennessee,Lookout Mountain,1871,5,68,214,597,451,1335
Tennessee,Lone Oak,971,202,247,234,57,60,800
Tennessee,Lobelville,957,146,274,144,51,28,643
Tennessee,Livingston,4067,698,998,668,167,169,2700
Tennessee,Linden,948,174,289,154,23,27,667
Tennessee,Liberty,267,43,102,21,21,4,191
Tennessee,Lexington,7802,977,1713,1640,621,256,5207
Tennessee,Lewisburg,11321,1832,3208,1850,524,192,7606
Tennessee,Lenoir City,8943,1471,1978,1383,407,204,5443
Tennessee,Lebanon,28638,3442,6736,4466,2899,1425,18968
Tennessee,Lawrenceburg,10487,1730,2746,1913,503,352,7244
Tennessee,La Vergne,34081,2760,7732,5712,2860,1046,20110
Tennessee,Lakewood Park,783,127,147,109,19,0,402
Tennessee,Lake Tansi,3972,374,1106,930,338,172,2920
Tennessee,Lakesite,1912,140,348,446,312,97,1343
Tennessee,Lake City,1812,403,553,215,41,9,1221
Tennessee,Mountain City,2543,422,703,598,145,99,1967
Tennessee,Mount Carmel,5441,571,1650,1090,414,87,3812
Tennessee,Mount Juliet,28395,1119,4559,5681,4616,1973,17948
Tennessee,Ramer,317,34,116,47,13,13,223
Tennessee,Puryear,677,90,277,114,19,24,524
Tennessee,Pulaski,7648,1109,1910,1204,499,278,5000
Tennessee,Powells Crossroads,1359,134,437,290,80,34,975
Tennessee,Portland,11963,1297,2783,2411,684,253,7428
Tennessee,Pleasant View,4215,305,849,668,602,236,2660
Tennessee,Pleasant Hill,492,98,118,69,86,61,432
Tennessee,Plainview,1851,266,656,264,90,39,1315
Tennessee,Pittman Center,423,61,104,96,49,28,338
Tennessee,Piperton,1709,96,324,350,349,165,1284
Tennessee,Pine Crest,2330,238,590,424,313,130,1695
Tennessee,Pikeville,2018,349,516,317,83,63,1328
Tennessee,Pigeon Forge,6039,930,1670,889,327,442,4258
Tennessee,Philadelphia,1020,187,285,126,28,22,648
Tennessee,Petros,473,95,223,89,0,0,407
Tennessee,Red Bank,11793,824,2563,2602,1491,734,8214
Tennessee,Petersburg,698,103,240,62,13,21,439
Tennessee,Iron City,208,21,79,26,0,0,126
Tennessee,Huntland,723,124,237,132,41,9,543
Tennessee,Helenwood,686,38,330,119,67,0,554
Tennessee,Henderson,6474,720,947,915,242,274,3098
Tennessee,Hendersonville,54168,2299,10946,11801,8444,3769,37259
Tennessee,Henning,879,287,252,122,12,3,676
Tennessee,Henry,545,113,156,42,14,7,332
Tennessee,Hickory Valley,211,55,95,15,6,3,174
Tennessee,Hillsboro,305,17,45,117,27,10,216
Tennessee,Hohenwald,3699,485,1265,496,190,101,2537
Tennessee,Hollow Rock,633,84,185,101,25,12,407
Tennessee,Hopewell,1922,109,494,518,234,195,1550
Tennessee,Hornbeak,392,52,144,74,15,1,286
Tennessee,Hornsby,309,34,74,58,15,0,181
Tennessee,Humboldt,8325,1134,2145,2083,447,202,6011
Tennessee,Hunter,1684,133,526,308,195,39,1201
Tennessee,Huntingdon,3962,773,1151,690,92,108,2814
Tennessee,Huntsville,1401,303,383,216,60,36,998
Tennessee,Pelham,428,6,142,90,75,5,318
Tennessee,Pegram,2166,199,548,486,229,75,1537
Tennessee,Parsons,2542,363,693,526,84,53,1719
Tennessee,Nolensville,6361,112,495,975,1383,721,3686
Tennessee,Niota,875,113,237,104,81,23,558
Tennessee,New Union,1801,93,463,402,132,112,1202
Tennessee,New Tazewell,2984,687,1002,480,169,37,2375
Tennessee,Newport,6874,1059,1982,1451,260,158,4910
Tennessee,New Market,1418,204,408,270,77,77,1036
Tennessee,New Johnsonville,1960,163,667,338,195,41,1404
Tennessee,New Hope,961,123,254,163,47,29,616
Tennessee,New Deal,352,49,114,43,5,0,211
Tennessee,Newbern,3314,385,1004,534,100,122,2145
Tennessee,Nashville-Davidson metropolitan government (balance),634512,55463,104315,111753,100002,57470,429003
Tennessee,Murfreesboro,117983,5750,15738,21757,18652,8457,70354
Tennessee,Munford,6044,254,1347,1552,277,185,3615
Tennessee,Mowbray Mountain,1537,251,370,322,107,93,1143
Tennessee,Mount Pleasant,4657,606,1122,988,308,196,3220
Tennessee,Normandy,79,16,25,11,9,0,61
Tennessee,Norris,2036,103,339,336,405,347,1530
Tennessee,Oakdale,198,23,58,38,1,4,124
Tennessee,Oak Grove CDP (Sumner County),245,15,44,43,15,21,138
Tennessee,Parrottsville,274,37,106,38,8,1,190
Tennessee,Parker's Crossroads,310,65,85,64,28,4,246
Tennessee,Park City,2734,230,726,343,341,88,1728
Tennessee,Paris,10166,1315,3240,1342,538,349,6784
Tennessee,Palmer,695,149,260,68,10,0,487
Tennessee,Orme,125,27,33,39,0,3,102
Tennessee,Orlinda,1016,97,281,165,78,23,644
Tennessee,Harrogate,4355,370,1011,723,510,302,2916
Tennessee,Ooltewah,323,27,47,101,71,47,293
Tennessee,Olivet,1413,159,428,246,117,52,1002
Tennessee,Oliver Springs,3767,357,1037,721,139,171,2425
Tennessee,Obion,1071,141,337,172,60,19,729
Tennessee,Oak Ridge,29310,1657,4768,5855,4105,3989,20374
Tennessee,Oakland,7106,299,1492,1920,1158,392,5261
Tennessee,Oak Hill,4658,59,245,546,1444,1117,3411
Tennessee,Oak Grove CDP (Washington County),5099,345,1312,1037,518,164,3376
Tennessee,Oneida,3730,368,953,594,205,222,2342
Tennessee,Cornersville,1315,127,344,288,101,37,897
Tennessee,Flintville,614,107,308,61,15,0,491
Tennessee,Coopertown,4343,227,1030,1094,259,248,2858
Tennessee,Bruceton,1641,254,486,218,124,26,1108
Tennessee,Clarksburg,395,58,135,46,18,14,271
Tennessee,Clarkrange,701,69,197,164,14,29,473
Tennessee,Church Hill,6725,624,2016,1345,579,241,4805
Tennessee,Christiana,2781,183,866,358,192,222,1821
Tennessee,Chesterfield,366,40,131,67,0,11,249
Tennessee,Chattanooga,174483,17431,32164,36198,20258,11809,117860
Tennessee,Charlotte,1577,389,424,226,65,6,1110
Tennessee,Charleston,834,106,172,183,25,15,501
Tennessee,Chapel Hill,1573,135,396,300,149,49,1029
Tennessee,Central,2258,482,638,337,171,70,1698
Tennessee,Centerville,3572,609,890,626,280,283,2688
Tennessee,Centertown,249,15,70,71,12,10,178
Tennessee,Adams,840,77,175,227,74,12,565
Tennessee,Adamsville,2306,510,635,287,211,66,1709
Tennessee,Alamo,2281,378,611,431,119,44,1583
Tennessee,Alcoa,8737,762,2015,2022,864,287,5950
Tennessee,Alexandria,988,88,293,231,30,14,656
Tennessee,Algood,3581,445,1006,633,264,130,2478
Tennessee,Allardt,610,91,214,110,49,16,480
Tennessee,Altamont,1174,311,397,94,24,8,834
Tennessee,Andersonville,347,68,118,42,29,27,284
Tennessee,Apison,2505,104,552,561,431,196,1844
Tennessee,Ardmore,1182,156,380,213,84,33,866
Tennessee,Arlington,11635,380,1169,2417,1620,844,6430
Tennessee,Townsend,426,21,127,139,52,37,376
Tennessee,Ashland City,4650,439,963,1094,436,165,3097
Tennessee,Toone,443,50,163,92,13,7,325
Tennessee,Three Way,1641,86,364,420,241,167,1278
Tennessee,Sneedville,1309,236,323,189,61,23,832
Tennessee,Soddy-Daisy,13158,1484,3521,2701,998,717,9421
Tennessee,Somerville,3115,425,789,426,249,211,2100
Tennessee,South Carthage,1487,209,525,245,43,19,1041
Tennessee,South Cleveland,6458,870,1769,1397,346,268,4650
Tennessee,South Fulton,2448,279,750,411,156,107,1703
Tennessee,South Pittsburg,3107,356,625,765,210,103,2059
Tennessee,Sparta,5074,749,1415,1100,160,174,3598
Tennessee,Spencer,1726,280,645,191,60,75,1251
Tennessee,Spring City,2248,358,617,400,93,73,1541
Tennessee,Springfield,16639,2209,4342,2782,1009,544,10886
Tennessee,Spring Hill,32831,517,4043,6405,6313,2313,19591
Tennessee,Spurgeon,3961,234,1053,966,332,168,2753
Tennessee,Stanton,396,48,115,61,0,6,230
Tennessee,Stantonville,291,53,133,24,8,6,224
Tennessee,Summertown,721,100,172,171,13,18,474
Tennessee,Sunbright,454,30,183,72,26,7,318
Tennessee,Surgoinsville,1986,238,615,383,84,73,1393
Tennessee,Sweetwater,5872,924,1706,970,424,283,4307
Tennessee,Tazewell,2293,398,700,286,107,76,1567
Tennessee,Telford,810,146,206,225,41,0,618
Tennessee,Tellico Plains,820,186,244,128,26,18,602
Tennessee,Tellico Village,6136,0,1139,1093,2232,1471,5935
Tennessee,Tennessee Ridge,1459,211,415,222,80,43,971
Tennessee,Thompson's Station,2862,56,412,478,583,267,1796
Tennessee,Tiptonville,4396,1022,1562,585,213,46,3428
Tennessee,Athens,13634,1365,3102,2364,1255,787,8873
Tennessee,Atoka,8845,453,1719,2327,800,468,5767
Tennessee,Atwood,905,163,293,187,51,14,708
Tennessee,Wildwood,1314,78,230,357,88,104,857
Tennessee,Whitwell,1978,473,548,264,45,19,1349
Tennessee,Whiteville,4568,1274,1683,696,87,10,3750
Tennessee,White Pine,2274,405,571,401,41,67,1485
Tennessee,White House,10810,446,2018,2297,1406,531,6698
Tennessee,White Bluff,3299,389,1016,699,156,132,2392
Tennessee,Benton,1897,299,479,326,72,38,1214
Tennessee,Berry Hill,668,45,118,83,214,94,554
Tennessee,Bethel Springs,772,108,170,152,36,13,479
Tennessee,Bethpage,309,25,146,105,7,0,283
Tennessee,Big Sandy,533,106,213,88,8,9,424
Tennessee,Blaine,1943,259,592,317,114,52,1334
Tennessee,Bloomingdale,9730,1255,3251,1968,439,171,7084
Tennessee,Blountville,2364,437,749,538,178,91,1993
Tennessee,Bluff City,1863,176,394,453,169,48,1240
Tennessee,Bolivar,5219,790,1530,861,245,187,3613
Tennessee,Bon Aqua Junction,994,212,422,91,15,11,751
Tennessee,Bowman,301,60,72,66,0,0,198
Tennessee,Braden,259,45,70,55,30,8,208
Tennessee,Bradford,1295,124,391,196,92,54,857
Tennessee,Bransford,217,44,86,41,0,0,171
Tennessee,Brentwood,39974,427,2372,4790,10901,7057,25547
Tennessee,Brighton,2954,276,679,459,235,108,1757
Tennessee,Bristol,26674,3160,5681,5539,2867,1877,19124
Tennessee,Brownsville,10016,1377,2850,1403,599,475,6704
Tennessee,Wildwood Lake,3475,755,963,455,164,113,2450
Tennessee,Williston,413,42,123,64,27,6,262
Tennessee,Winchester,8502,1090,1759,1930,886,453,6118
Tennessee,Winfield,799,181,239,127,37,18,602
Tennessee,Auburntown,311,31,106,50,16,11,214
Tennessee,Baileyton,531,63,186,96,7,12,364
Tennessee,Baneberry,534,39,136,170,73,42,460
Tennessee,Banner Hill,1529,393,477,176,95,12,1153
Tennessee,Bartlett,58107,2277,10154,12691,8867,5008,38997
Tennessee,Baxter,1517,212,405,201,71,27,916
Tennessee,Bean Station,3089,461,988,439,109,82,2079
Tennessee,Beersheba Springs,573,231,133,26,32,4,426
Tennessee,Bell Buckle,400,24,62,67,74,49,276
Tennessee,Belle Meade,2857,20,49,216,779,828,1892
Tennessee,Bells,2552,422,649,399,216,36,1722
Tennessee,Yorkville,448,29,109,62,30,49,279
Tennessee,Smyrna,43580,3157,8973,9130,4913,1651,27824
Tennessee,Wrigley,174,46,62,0,18,0,126
Tennessee,Woodbury,2720,406,698,513,211,69,1897
Tennessee,Copperhill,428,66,127,99,16,8,316
Tennessee,Celina,1674,286,468,222,69,78,1123
Tennessee,Cedar Hill,394,68,122,42,9,5,246
Tennessee,Castalian Springs,923,86,414,79,66,0,645
Tennessee,Caryville,2418,358,683,441,122,40,1644
Tennessee,Carthage,2025,387,645,318,99,40,1489
Tennessee,Camden,3578,548,1189,534,143,151,2565
Tennessee,Calhoun,503,51,129,124,25,21,350
Tennessee,Byrdstown,996,157,307,149,32,16,661
Tennessee,Burns,1536,175,461,297,79,46,1058
Tennessee,Burlison,409,47,126,78,27,12,290
Tennessee,Woodland Mills,443,23,189,70,19,17,318
Tennessee,Smithville,4611,724,1255,581,290,147,2997
Tennessee,Clarksville,143618,6657,24612,33111,13842,6700,84922
Tennessee,Bulls Gap,593,82,227,78,12,23,422
Tennessee,Viola,56,11,20,18,0,1,50
Tennessee,Vanleer,338,83,78,41,22,4,228
Tennessee,Unionville,1396,274,498,105,83,27,987
Tennessee,Union City,10722,1245,2634,1709,816,631,7035
Tennessee,Unicoi,3598,360,1010,787,181,167,2505
Tennessee,Tusculum,2677,270,528,393,228,129,1548
Tennessee,Vonore,1775,186,419,320,109,72,1106
Tennessee,Tullahoma,19022,1617,4341,3774,1906,1120,12758
Tennessee,Trimble,502,66,155,108,31,11,371
Tennessee,Trezevant,923,149,260,149,61,23,642
Tennessee,Seymour,11059,905,3127,2404,940,639,8015
Tennessee,Slayden,174,54,59,25,3,0,141
Tennessee,Sewanee,2642,17,69,91,175,475,827
Tennessee,Sevierville,15903,1831,3988,2942,1324,613,10698
Tennessee,Troy,1450,192,446,262,72,34,1006
Tennessee,Selmer,4491,593,1127,1043,311,123,3197
Tennessee,Walden,2052,83,230,329,420,372,1434
Tennessee,Walnut Grove CDP (Hardin County),259,103,33,57,19,0,212
Tennessee,Signal Mountain,8456,241,627,1371,2094,1628,5961
Tennessee,Shelbyville,20779,3502,5264,3169,855,328,13118
Tennessee,Sharon,989,118,369,146,100,13,746
Tennessee,Shackle Island,3029,20,354,751,635,350,2110
Tennessee,Westmoreland,2003,237,595,259,98,32,1221
Tennessee,Waynesboro,2425,308,807,376,168,84,1743
Tennessee,Walland,240,11,89,23,34,9,166
Tennessee,Waverly,4111,251,1271,784,385,124,2815
Tennessee,Watauga,376,52,126,70,8,7,263
Tennessee,Wartrace,653,74,239,75,65,17,470
Tennessee,Wartburg,804,160,240,131,47,36,614
Tennessee,Walterhill,326,43,77,34,44,19,217
Tennessee,Walnut Hill,2301,331,537,541,171,149,1729
Tennessee,Walnut Grove CDP (Sumner County),987,83,419,165,15,0,682
Tennessee,Watertown,1462,165,522,274,71,34,1066
Tennessee,Scotts Hill,825,78,299,159,35,28,599
Tennessee,Silerton,84,8,30,16,3,7,64
Tennessee,Saulsbury,191,23,56,9,5,1,94
Tennessee,Ridgeside,563,9,30,97,158,87,381
Tennessee,Ridgetop,2338,185,716,441,235,69,1646
Tennessee,Ripley,8291,1154,2112,1102,486,281,5135
Tennessee,Rives,232,29,97,36,3,0,165
Tennessee,Robbins,180,24,109,0,5,6,144
Tennessee,Rockford,789,71,219,173,57,88,608
Tennessee,Rockvale,753,0,98,242,100,29,469
Tennessee,Ridgely,1902,413,453,245,49,59,1219
Tennessee,Rockwood,5466,979,1458,1217,127,156,3937
Tennessee,Sale Creek,2657,232,1140,647,101,15,2135
Tennessee,Rossville,662,39,138,179,96,40,492
Tennessee,Rural Hill,1716,17,477,621,263,75,1453
Tennessee,Rutherford,1199,155,411,166,40,23,795
Tennessee,Rutledge,1286,214,445,170,68,31,928
Tennessee,St. Joseph,986,169,274,192,31,11,677
Tennessee,Savannah,7032,1093,2188,1116,321,270,4988
Tennessee,Rogersville,4400,635,1401,780,327,171,3314
Tennessee,Riceville,671,58,272,154,13,15,512
Tennessee,Roan Mountain,1591,301,434,249,70,19,1073
Tennessee,Cleveland,42895,4686,7647,8051,3978,2358,26720
Tennessee,Sardis,460,58,217,42,16,14,347
Tennessee,Samburg,180,87,38,29,14,0,168
Tennessee,Red Boiling Springs,1314,326,306,178,20,26,856
Tennessee,Cookeville,31831,2542,6292,4426,3178,1934,18372
Tennessee,Columbia,35627,3493,8525,7522,2710,1145,23395
Tennessee,Colonial Heights,3512,178,912,742,553,204,2589
Tennessee,Collinwood,1029,171,276,179,29,37,692
Tennessee,Saltillo,557,136,137,151,19,18,461
Tennessee,Clifton,2666,659,1100,314,76,15,2164
Tennessee,Collierville,47434,1066,4736,8143,10712,6082,30739
Tennessee,Collegedale,9918,457,1211,2225,1474,741,6108
Tennessee,Coalmont,668,146,184,79,17,35,461
Tennessee,Coalfield,2690,184,1007,461,133,39,1824
Tennessee,Clinton,9918,927,2512,2212,1077,544,7272
Texas,Runge,1128,250,284,145,30,24,733
Texas,Rosharon,2120,288,523,394,0,49,1254
Texas,Rosita,2824,615,315,437,52,32,1451
Texas,Ross,249,31,43,62,16,15,167
Texas,Rosser,312,70,96,31,8,8,213
Texas,Rotan,1459,215,378,253,100,60,1006
Texas,Round Mountain,166,3,67,29,8,17,124
Texas,Round Rock,109690,6368,13099,22637,17353,7503,66960
Texas,Roxton,518,47,115,154,14,12,342
Texas,Rowlett,58296,3666,8478,13883,8479,3623,38129
Texas,Runaway Bay,1598,74,379,450,212,115,1230
Texas,Royse City,10128,680,1867,1678,922,376,5523
Texas,Rule,608,109,163,117,21,15,425
Texas,Rosenberg,33600,5053,7099,5193,1908,666,19919
Texas,Sabinal,1981,362,295,315,128,18,1118
Texas,Rusk,5594,1223,1345,1033,297,105,4003
Texas,Round Top,73,2,13,24,14,17,70
Texas,Rose Hill Acres,448,26,126,118,34,7,311
Texas,Ropesville,358,82,77,83,22,6,270
Texas,Rosebud,1401,194,375,231,84,40,924
Texas,Berryville,1123,117,246,238,76,44,721
Texas,Benjamin Perez,0,0,0,0,0,0,0
Texas,Benjamin,258,29,61,36,47,8,181
Texas,Benbrook,22144,1011,3974,5877,3356,1821,16039
Texas,Benavides,1705,274,359,276,139,81,1129
Texas,Belton,19766,1922,2958,2726,1787,974,10367
Texas,Bellville,4171,376,771,990,633,263,3033
Texas,Bells,1538,126,297,348,112,29,912
Texas,Bellmead,10022,1979,1419,1743,355,116,5612
Texas,Bertram,1461,103,331,440,70,5,949
Texas,Bellevue,307,44,89,81,16,2,232
Texas,Beeville,13192,1895,2307,2782,563,356,7903
Texas,Bee Cave,5362,38,349,746,1356,968,3457
Texas,Bedias,310,40,129,60,10,10,249
Texas,Bedford,48559,1834,7476,13483,8880,3518,35191
Texas,Beckville,966,134,174,240,22,15,585
Texas,Beaumont,117676,11248,22876,23375,11804,5418,74721
Texas,Beasley,572,83,159,104,28,6,380
Texas,Granite Shoals,4988,810,1044,798,260,93,3005
Texas,Granjeno,288,52,62,56,8,5,183
Texas,Bellaire,17869,257,650,1643,3773,5520,11843
Texas,Beverly Hills,1827,332,393,334,40,5,1104
Texas,Bevil Oaks,1308,33,247,464,200,51,995
Texas,Bigfoot,234,57,69,108,0,0,234
Texas,Roscoe,1394,226,250,262,102,44,884
Texas,Roman Forest,2068,101,482,481,161,57,1282
Texas,Roma Creek,425,92,41,22,48,4,207
Texas,Roma,10041,3275,1039,853,572,271,6010
Texas,Rollingwood,1603,7,33,109,405,469,1023
Texas,Rogers,957,139,322,175,16,2,654
Texas,Rocky Mound,68,19,6,9,3,1,38
Texas,Rockwall,40830,2218,5078,8897,6969,3366,26528
Texas,Rocksprings,1285,234,319,163,100,20,836
Texas,Rockport,9992,861,1834,2459,1154,699,7007
Texas,Rockdale,5507,539,1600,1059,507,169,3874
Texas,Rochester,322,78,68,42,10,12,210
Texas,Roby,772,110,156,159,51,3,479
Texas,Combes,3019,614,680,381,108,77,1860
Texas,Comanche,4224,875,979,510,243,56,2663
Texas,Columbus,3631,507,1058,512,468,83,2628
Texas,Colorado City,4122,813,1024,607,256,69,2769
Texas,Colmesneil,643,41,217,145,30,9,442
Texas,Big Spring,28054,4331,5735,5972,1687,698,18423
Texas,Big Sandy,1843,273,300,364,100,26,1063
Texas,Big Lake,3146,643,784,414,147,57,2045
Texas,Rose City,386,54,103,86,17,11,271
Texas,Colorado Acres,98,25,21,8,0,0,54
Texas,San Carlos I,180,51,11,0,0,0,62
Texas,Sadler,403,18,83,130,27,0,258
Texas,Westworth Village,2584,225,368,631,394,137,1755
Texas,Westwood Shores,1391,120,307,349,125,37,938
Texas,Westway,3868,1092,431,287,70,17,1897
Texas,West University Place,15412,96,375,923,3708,5326,10428
Texas,West Tawakoni,1707,258,548,339,73,29,1247
Texas,West Sharyland,1986,583,94,252,63,0,992
Texas,Highlands,7515,729,1778,1660,130,194,4491
Texas,Highland Park,8916,101,179,680,2893,2336,6189
Texas,Highland Haven,451,13,90,164,98,35,400
Texas,Horseshoe Bay,3557,91,572,965,997,440,3065
Texas,Higgins,466,63,102,84,30,10,289
Texas,Hidalgo,13287,2591,1823,1208,857,283,6762
Texas,Hico,1408,229,315,306,83,67,1000
Texas,Hickory Creek,3774,120,567,1088,651,223,2649
Texas,Hewitt,14022,676,2267,3368,2284,1179,9774
Texas,Hermleigh,384,39,94,73,28,17,251
Texas,Hereford,15257,2535,2583,2229,860,348,8555
Texas,Henrietta,3047,216,878,685,178,65,2022
Texas,Henderson,13695,2067,2837,2717,1089,437,9147
Texas,Hempstead,6432,855,785,738,306,48,2732
Texas,Hideaway,3026,44,521,1143,656,400,2764
Texas,Hemphill,1441,189,386,276,42,23,916
Texas,Hornsby Bend,7441,1366,1338,1519,506,45,4774
Texas,Hooks,2757,266,829,460,106,65,1726
Texas,Highland Village,15793,286,1333,2790,4268,1999,10676
Texas,Hill Country Village,793,11,36,108,184,220,559
Texas,Hillcrest,762,41,137,216,146,64,604
Texas,Hillsboro,8360,1416,1292,1391,336,248,4683
Texas,Hillside Acres,0,0,0,0,0,0,0
Texas,Hilltop CDP (Frio County),226,141,52,21,0,0,214
Texas,Hilltop CDP (Starr County),29,21,8,0,0,0,29
Texas,Hilltop Lakes,985,47,314,221,133,134,849
Texas,Hilshire Village,727,31,49,78,187,168,513
Texas,Horizon City,18981,1487,2653,3477,1493,490,9600
Texas,Hitchcock,7325,695,1630,1754,336,142,4557
Texas,Holiday Lakes,948,195,223,81,7,2,508
Texas,Holland,1038,117,253,190,35,0,595
Texas,Holliday,1614,108,471,341,164,37,1121
Texas,Holly Lake Ranch,2926,181,815,940,478,110,2524
Texas,Hollywood Park,3218,121,378,608,932,562,2601
Texas,Homestead Meadows North,4564,887,704,589,187,158,2525
Texas,Homestead Meadows South,5811,1642,930,568,185,11,3336
Texas,Hondo,8987,1470,2084,1367,522,160,5603
Texas,Honey Grove,1975,264,432,282,181,73,1232
Texas,Holiday Beach,453,112,141,127,57,16,453
Texas,Helotes,8125,264,985,1761,1403,901,5314
Texas,Heidelberg,1806,273,190,372,86,31,952
Texas,Hedwig Village,2653,81,145,312,596,575,1709
Texas,Sanderson,828,128,251,172,62,48,661
Texas,Sanctuary,380,23,99,91,26,5,244
Texas,San Carlos II,225,54,14,0,0,0,68
Texas,Grape Creek,2935,311,755,702,183,18,1969
Texas,San Carlos,3731,1093,420,387,128,0,2028
Texas,San Benito,24486,5257,3888,3455,976,346,13922
Texas,San Augustine,2481,467,564,414,102,74,1621
Texas,San Antonio,1413881,164836,228794,272467,144053,78101,888251
Texas,San Angelo,97595,10360,18328,18322,8752,4745,60507
Texas,Sandia,648,241,0,53,0,0,294
Texas,Sam Rayburn,1060,67,298,264,196,74,899
Texas,Sammy Martinez,96,9,10,6,0,0,25
Texas,Saline?o North,26,5,13,0,0,0,18
Texas,Saline?o,117,61,9,11,0,0,81
Texas,Salado,1642,56,219,341,320,395,1331
Texas,St. Paul,670,81,132,166,8,0,387
Texas,St. Paul,1183,74,173,247,194,57,745
Texas,St. Jo,1113,114,229,233,83,36,695
Texas,St. Hedwig,2149,75,741,449,231,76,1572
Texas,Saginaw,21270,1018,4208,4879,2140,687,12932
Texas,Samnorwood,13,0,0,0,7,0,7
Texas,San Diego,4528,1029,797,808,109,45,2788
Texas,Sandoval,9,0,0,0,0,6,6
Texas,Sand Springs,920,112,214,264,64,6,660
Texas,Hedley,392,64,77,96,13,9,259
Texas,Hebron,475,12,22,81,121,60,296
Texas,Hebbronville,4583,837,897,875,272,78,2959
Texas,Heath,7793,129,737,1227,1966,1133,5192
Texas,Hearne,4439,917,1076,630,122,35,2780
Texas,H. Cuellar Estates,27,0,6,0,5,0,11
Texas,Hays,333,9,91,60,60,16,236
Texas,Hawley,612,80,129,109,64,5,387
Texas,Hawkins,1441,90,305,334,119,56,904
Texas,Hawk Cove,396,80,156,65,1,0,302
Texas,Havana,516,87,120,31,38,0,276
Texas,San Juan,182,60,25,0,0,0,85
Texas,San Juan,35692,8601,4796,4049,1413,675,19534
Texas,San Isidro,351,72,64,47,12,12,207
Texas,Sanger,7410,380,1508,1720,614,176,4398
Texas,Sanford,157,31,43,33,2,4,113
Texas,San Fernando,39,39,0,0,0,0,39
Texas,San Felipe,709,114,209,144,45,24,536
Texas,San Elizario,9158,2227,1175,684,285,27,4398
Texas,Sandy Point,138,21,60,15,8,2,106
Texas,Sandy Hollow-Escondidas,582,100,121,135,0,13,369
Texas,Sachse,22585,1093,3422,5084,3315,1477,14391
Texas,Grapeland,1784,203,472,375,160,45,1255
Texas,Hutchins,5669,1065,1405,1054,251,55,3830
Texas,Grays Prairie,349,30,109,77,32,1,249
Texas,Anacua,14,0,0,0,14,0,14
Texas,Amistad,10,0,3,5,0,2,10
Texas,Horseshoe Bend,662,87,285,47,0,57,476
Texas,Amherst,957,163,224,161,47,7,602
Texas,Ames,1216,63,290,230,20,6,609
Texas,Amaya,25,5,11,5,0,0,21
Texas,Amarillo,196571,20569,30534,45382,18703,8983,124171
Texas,Amargosa,15,7,8,0,0,0,15
Texas,Amada Acres,0,0,0,0,0,0,0
Texas,Alvord,1554,86,449,281,91,11,918
Texas,Bayview,424,24,49,71,113,47,304
Texas,Beach City,2447,184,404,654,373,89,1704
Texas,Bear Creek,407,10,45,84,105,53,297
Texas,Haslet,1565,63,184,402,288,104,1041
Texas,Haskell,3284,857,747,592,232,66,2494
Texas,Hartley,637,230,78,34,53,16,411
Texas,Hart,1216,380,274,121,39,11,825
Texas,Harper,1035,170,201,168,166,50,755
Texas,Harlingen,65801,10166,10031,11326,5120,2033,38676
Texas,Harker Heights,28199,1376,3458,6599,3428,1788,16649
Texas,Hargill,380,182,29,9,20,0,240
Texas,Anahuac,2056,227,478,379,90,81,1255
Texas,Anderson,248,31,42,44,12,53,182
Texas,Andrews,12696,1846,2486,2282,676,184,7474
Texas,Angleton,19153,2547,4130,4127,1257,585,12646
Texas,Atascocita,70773,3503,9228,16380,10532,4372,44015
Texas,Aspermont,996,169,245,170,53,10,647
Texas,Asherton,967,277,147,138,33,15,610
Texas,Arroyo Gardens,403,134,37,83,35,0,289
Texas,Arroyo Colorado Estates,575,225,0,48,0,0,273
Texas,Arp,961,92,232,201,72,23,620
Texas,Arlington,379716,36003,54907,75856,47746,21520,236032
Texas,Argyle,3612,48,400,719,885,488,2540
Texas,Arcola,2638,520,397,247,228,39,1431
Texas,Archer City,1662,136,476,322,94,16,1044
Texas,Hardin,854,112,225,154,63,34,588
Texas,Aransas Pass,8067,1200,2115,1685,559,165,5724
Texas,Appleby,565,22,121,113,51,23,330
Texas,Anton,1236,242,159,253,61,31,746
Texas,Anthony,5305,800,1293,1163,260,151,3667
Texas,Anson,2148,265,467,261,134,72,1199
Texas,Annona,375,74,91,65,9,4,243
Texas,Annetta South,620,2,75,124,185,44,430
Texas,Annetta North,469,22,46,111,118,64,361
Texas,Annetta,1394,42,133,336,252,165,928
Texas,Anna,9733,721,1593,2377,855,471,6017
Texas,Angus,502,86,86,118,17,9,316
Texas,Aquilla,166,41,63,35,7,0,146
Texas,Happy,754,82,143,154,67,17,463
Texas,Hamlin,1627,120,556,258,122,21,1077
Texas,Hamilton,2985,461,882,470,329,103,2245
Texas,Irving,228776,29767,29754,35614,31331,19918,146384
Texas,Iredell,377,31,109,74,28,16,258
Texas,Iraan,1208,166,194,219,135,11,725
Texas,Iowa Park,6386,407,1572,1644,332,199,4154
Texas,Iowa Colony,1232,176,249,262,130,17,834
Texas,Iola,486,70,127,70,21,5,293
Texas,Ingram,2044,310,469,383,37,19,1218
Texas,Ingleside on the Bay,565,28,129,153,85,36,431
Texas,Ingleside,9554,756,1990,2105,595,231,5677
Texas,Inez,2148,128,441,556,108,66,1299
Texas,Italy,1864,197,399,436,120,42,1194
Texas,Industry,231,31,49,33,29,20,162
Texas,Indian Springs,807,176,150,98,47,32,503
Texas,Indian Lake,913,186,165,126,51,23,551
Texas,Indian Hills,2876,1041,215,138,7,7,1408
Texas,Imperial,345,61,88,58,24,10,241
Texas,Impact,11,0,10,0,1,0,11
Texas,Iglesia Antigua,421,129,78,33,10,0,250
Texas,Idalou,2373,282,506,454,192,75,1509
Texas,Iago,76,0,8,17,21,0,46
Texas,Huxley,377,51,126,92,12,11,292
Texas,Hutto,20052,859,3654,5071,2088,549,12221
Texas,Indio,0,0,0,0,0,0,0
Texas,Athens,12777,1803,1609,2853,1061,475,7801
Texas,Itasca,1660,338,284,355,47,34,1058
Texas,Jacinto City,10751,3613,1753,1216,156,78,6816
Texas,Haltom City,43625,6906,8584,8185,2360,1083,27118
Texas,Hallsville,3888,120,685,944,615,267,2631
Texas,Hallsburg,548,12,153,190,39,7,401
Texas,Hallettsville,2582,421,717,435,216,123,1912
Texas,Hale Center,2486,529,501,354,109,29,1522
Texas,Hackberry,1530,290,183,224,180,78,955
Texas,Gutierrez,21,0,0,6,0,0,6
Texas,Guthrie,147,17,53,27,21,9,127
Texas,Gustine,574,136,171,32,49,10,398
Texas,Gunter,1441,218,225,281,129,87,940
Texas,Ivanhoe,1184,99,342,283,66,27,817
Texas,Gun Barrel City,5856,871,1936,1058,453,121,4439
Texas,Guadalupe Guerra,13,4,0,0,0,0,4
Texas,Gruver,1112,137,180,182,114,32,645
Texas,Groveton,1365,215,321,175,47,39,797
Texas,Groves,15845,1274,4175,3874,1296,221,10840
Texas,Groom,561,40,77,160,62,29,368
Texas,Groesbeck,4326,676,938,752,218,113,2697
Texas,Grey Forest,540,18,31,164,81,79,373
Texas,Houston,2217706,331568,321009,336921,265572,166445,1421515
Texas,Howardwick,440,66,139,87,18,22,332
Texas,Jacksboro,4461,709,1191,764,158,143,2965
Texas,Guerra,0,0,0,0,0,0,0
Texas,Grapevine,49609,2253,5713,9821,10184,5116,33087
Texas,Atlanta,5635,564,1492,1006,600,144,3806
Texas,Aurora,1561,128,296,265,126,60,875
Texas,Chula Vista CDP (Zavala County),363,86,19,57,0,0,162
Texas,Chula Vista CDP (Maverick County),3438,1214,294,275,39,0,1822
Texas,Chula Vista CDP (Cameron County),491,151,108,32,0,0,291
Texas,Christoval,309,63,48,91,21,14,237
Texas,Christine,392,68,86,59,4,5,222
Texas,Chireno,408,64,108,74,13,4,263
Texas,China Spring,1345,149,294,379,38,22,882
Texas,China Grove,1299,91,304,382,157,64,998
Texas,China,891,92,306,223,46,15,682
Texas,Chilton,640,168,119,37,16,0,340
Texas,Chillicothe,796,213,158,149,56,19,595
Texas,Childress,6085,499,1629,1268,451,175,4022
Texas,Chico,1217,150,453,177,13,3,796
Texas,Chester,329,33,70,65,19,6,193
Texas,Charlotte,2031,552,489,151,33,44,1269
Texas,Chapeno,60,12,6,0,0,0,18
Texas,Chaparrito,31,31,0,0,0,0,31
Texas,Channing,207,7,53,59,8,8,135
Texas,Channelview,39379,7033,7129,6012,1376,684,22234
Texas,Chandler,2820,116,576,737,366,154,1949
Texas,Cesar Chavez,1700,292,427,141,78,0,938
Texas,Cibolo,23977,650,2631,5131,3512,2347,14271
Texas,Cienegas Terrace,2888,839,456,123,75,0,1493
Texas,Cinco Ranch,17015,197,828,2594,4481,2980,11080
Texas,Circle D-KC Estates,1962,288,437,389,270,76,1460
Texas,Collinsville,1744,125,338,391,126,42,1022
Texas,Colleyville,24453,287,1728,3715,6981,4232,16943
Texas,College Station,101141,2596,5238,10661,11040,10985,40520
Texas,Coleman,4508,611,1252,905,227,50,3045
Texas,Coldspring,911,141,243,126,39,17,566
Texas,Coffee City,281,34,58,102,22,13,229
Texas,Cockrell Hill,4284,1233,781,353,42,36,2445
Texas,Coahoma,749,60,199,161,70,15,505
Texas,Clyde,3733,250,981,724,236,48,2239
Texas,Clute,11324,1797,1919,2322,579,206,6823
Texas,Central Gardens,4317,210,1011,1092,547,330,3190
Texas,Cloverleaf,23285,5108,3599,2865,888,320,12780
Texas,Hurst,38458,3816,6781,8782,4725,2188,26292
Texas,Cleveland,7728,1335,1830,1069,332,133,4699
Texas,Cleburne,29780,4134,5558,5560,2177,951,18380
Texas,Clear Lake Shores,1235,15,163,319,347,167,1011
Texas,Claude,1214,100,199,335,100,70,804
Texas,Clarksville City,768,74,221,183,23,27,528
Texas,Clarksville,3204,507,940,496,200,57,2200
Texas,Clarendon,1993,198,408,424,101,61,1192
Texas,Citrus City,4141,1317,270,114,43,12,1756
Texas,Cisco,3833,468,647,948,265,102,2430
Texas,Clint,820,141,149,179,74,19,562
Texas,Centerville,958,144,281,177,82,16,700
Texas,Center,5262,984,1056,836,304,185,3365
Texas,Celina,6894,183,930,1293,1318,420,4144
Texas,Barstow,462,120,90,53,4,2,269
Texas,Barry,360,28,108,67,17,4,224
Texas,Barrett,4720,542,1009,1014,375,99,3039
Texas,Barrera,0,0,0,0,0,0,0
Texas,Bardwell,626,161,129,44,4,0,338
Texas,Banquete,684,126,171,106,33,0,436
Texas,Bangs,1674,248,376,459,95,19,1197
Texas,Bandera,1207,117,270,310,66,18,781
Texas,B and E,698,230,18,59,4,0,311
Texas,Balmorhea,584,106,83,122,42,3,356
Texas,Bartlett,2226,496,652,295,68,15,1526
Texas,Ballinger,3732,519,1012,560,277,74,2442
Texas,Balch Springs,24948,4517,3835,3217,803,186,12558
Texas,Baird,1841,180,493,484,112,36,1305
Texas,Bailey's Prairie,780,75,107,170,97,42,491
Texas,Bailey,214,37,53,47,6,0,143
Texas,Bacliff,8753,1463,1159,1864,679,336,5501
Texas,Azle,10860,1130,2331,2836,1183,552,8032
Texas,Avinger,393,46,104,82,28,11,271
Texas,Avery,434,43,128,74,26,11,282
Texas,Austwell,124,19,39,31,16,6,111
Texas,Austin,887061,73309,97443,141303,174710,101388,588153
Texas,Balcones Heights,2930,351,676,712,132,102,1973
Texas,Aubrey,2852,241,505,722,258,118,1844
Texas,Carthage,6856,792,1142,1745,504,137,4320
Texas,Casas,42,15,0,15,0,0,30
Texas,Celeste,779,61,218,161,33,12,485
Texas,Cedar Point,762,72,222,187,52,70,603
Texas,Cedar Park,60841,1701,6524,12798,11459,5344,37826
Texas,Cedar Hill,47089,2401,6583,11016,5426,3339,28765
Texas,Catarina,139,31,56,29,8,0,124
Texas,Castroville,2860,354,627,615,309,173,2078
Texas,Castle Hills,4311,347,358,957,854,721,3237
Texas,Cashion Community,275,21,64,77,34,10,206
Texas,Greatwood,12198,329,677,1595,3061,1964,7626
Texas,Green Valley Farms,451,151,96,72,52,10,381
Texas,Casa Blanca,31,17,0,0,0,0,17
Texas,Greenville,26058,3360,5395,5102,1833,1103,16793
Texas,Hudson,4775,492,860,910,263,84,2609
Texas,Hudson Bend,2823,93,305,562,811,330,2101
Texas,Hudson Oaks,2123,116,293,572,439,116,1536
Texas,Hughes Springs,1902,291,461,273,86,33,1144
Texas,Hull,529,67,197,132,52,0,448
Texas,Humble,15516,2097,2916,3234,1117,406,9770
Texas,Hungerford,64,8,48,8,0,0,64
Texas,Hunters Creek Village,4620,43,161,247,1372,1145,2968
Texas,Huntington,2268,318,484,622,48,73,1545
Texas,Huntsville,40129,4184,8105,6172,3081,1326,22868
Texas,Gregory,2137,481,417,255,77,25,1255
Texas,Clifton,3385,547,704,716,272,124,2363
Texas,Yznaga,23,0,23,0,0,0,23
Texas,Wheeler,1593,255,325,287,86,26,979
Texas,Cranfills Gap,265,58,57,39,24,8,186
Texas,Crawford,671,38,139,195,30,33,435
Texas,Creedmoor,177,48,40,23,20,5,136
Texas,Cresson,785,31,236,185,100,28,580
Texas,Crockett,6616,921,1539,948,493,216,4117
Texas,Crosby,2600,356,619,479,101,43,1598
Texas,Crosbyton,1770,336,394,285,88,34,1137
Texas,Cross Mountain,2725,25,192,490,650,597,1954
Texas,Cross Plains,1187,148,325,164,49,9,695
Texas,Cross Roads,1016,45,169,190,196,116,716
Texas,Cross Timber,295,21,97,57,25,18,218
Texas,Crowell,773,138,198,135,91,22,584
Texas,Crowley,14174,987,2294,3495,1423,580,8779
Texas,Crystal City,7381,1622,1181,999,283,80,4165
Texas,Cuero,7024,983,1567,1241,456,275,4522
Texas,Cuevitas,0,0,0,0,0,0,0
Texas,Cumby,811,63,246,108,50,29,496
Texas,Cumings,1408,53,143,288,132,168,784
Texas,Cuney,88,12,17,35,3,0,67
Texas,Cushing,589,44,161,95,34,18,352
Texas,Cut and Shoot,1327,246,377,199,23,16,861
Texas,Crane,3756,628,682,656,208,87,2261
Texas,Daingerfield,2815,380,682,586,135,80,1863
Texas,Crandall,3059,223,634,666,297,90,1910
Texas,Coyote Acres,447,53,89,54,29,0,225
Texas,Conroe,63521,10029,10584,10511,5857,3056,40037
Texas,Converse,20450,1598,3102,4712,2099,1198,12709
Texas,Cool,241,40,67,56,5,11,179
Texas,Coolidge,727,197,107,106,9,21,440
Texas,Cooper,2096,364,584,360,117,75,1500
Texas,Coppell,40602,906,3064,5674,10316,6878,26838
Texas,Copperas Cove,33005,1351,5032,10267,2623,1101,20374
Texas,Copper Canyon,1128,43,147,264,325,123,902
Texas,Corinth,20614,477,2632,4717,3162,1998,12986
Texas,Corpus Christi,316513,37695,56986,66049,27306,15162,203198
Texas,Corral City,16,0,2,10,0,0,12
Texas,Corrigan,1742,269,344,274,26,28,941
Texas,Corsicana,23945,3756,4099,4792,1657,795,15099
Texas,Cottonwood,140,11,36,38,14,7,106
Texas,Cottonwood Shores,1414,149,359,227,89,49,873
Texas,Cotulla,3963,896,707,300,261,138,2302
Texas,Country Acres,133,0,32,27,0,0,59
Texas,Coupland,207,21,62,28,20,7,138
Texas,Cove,451,23,108,139,39,15,324
Texas,Covington,267,32,80,61,5,2,180
Texas,Coyanosa,211,134,39,0,0,0,173
Texas,Coyote Flats,404,51,150,85,40,12,338
Texas,Daisetta,738,118,220,120,30,18,506
Texas,Dalhart,8254,1053,1452,1537,788,195,5025
Texas,Dallas,1260688,205349,175321,181029,151840,91304,804843
Texas,Santa Cruz,136,60,16,29,0,31,136
Texas,Santa Fe,12700,698,3236,3587,761,345,8627
Texas,Santa Maria,822,216,88,123,15,0,442
Texas,Santa Monica,90,8,43,23,0,0,74
Texas,Santa Rosa,2893,708,459,208,41,0,1416
Texas,Santa Rosa,237,103,67,5,0,0,175
Texas,Santel,0,0,0,0,0,0,0
Texas,San Ygnacio,461,139,50,106,10,36,341
Texas,Sarita,425,103,92,46,16,0,257
Texas,Savannah,4557,64,453,1110,834,278,2739
Texas,Savoy,642,83,143,214,39,14,493
Texas,Scenic Oaks,5468,114,379,763,1305,933,3494
Texas,Schertz,36535,1741,6049,8287,4704,2849,23630
Texas,Schulenburg,2892,578,687,397,237,66,1965
Texas,Scissors,3234,1161,300,83,13,10,1567
Texas,Scotland,555,46,132,86,40,9,313
Texas,Scottsville,341,49,100,37,24,5,215
Texas,Scurry,654,56,140,155,95,8,454
Texas,Seabrook,12774,275,1096,3011,2589,1361,8332
Texas,Seadrift,1534,223,406,208,60,4,901
Texas,Seagoville,15558,2926,3794,2821,664,306,10511
Texas,Santa Clara,723,61,133,183,87,34,498
Texas,Santa Anna,47,23,11,0,0,0,34
Texas,Santa Anna,1357,209,402,243,54,20,928
Texas,Sansom Park,4796,1052,1263,486,130,73,3004
Texas,Dalworthington Gardens,2119,99,165,469,441,366,1540
Texas,Damon,549,109,84,109,23,0,325
Texas,Danbury,1463,118,287,358,99,44,906
Texas,Darrouzett,389,37,112,68,47,7,271
Texas,Dawson,801,127,162,146,71,27,533
Texas,Dayton,7413,732,1844,1486,245,203,4510
Texas,Dayton Lakes,182,28,32,28,12,5,105
Texas,Dean,543,41,144,118,65,7,375
Texas,Decatur,6301,627,1248,1252,715,205,4047
Texas,DeCordova,2763,27,434,741,751,304,2257
Texas,Concepcion,39,18,21,0,0,0,39
Texas,Deer Park,33313,2858,5194,8882,3011,1251,21196
Texas,De Leon,2221,460,502,409,103,62,1536
Texas,Dell City,321,109,34,66,5,11,225
Texas,Del Mar Heights,230,5,49,0,0,0,54
Texas,San Leanna,599,7,120,185,79,82,473
Texas,San Leon,5299,904,1286,1142,437,152,3921
Texas,San Marcos,54712,3423,5922,7165,5211,2158,23879
Texas,San Patricio,448,56,115,126,18,4,319
Texas,San Pedro,473,98,95,39,48,10,290
Texas,San Perlita,664,154,100,57,31,1,343
Texas,San Saba,3020,615,590,549,157,60,1971
Texas,De Kalb,1665,167,455,344,151,32,1149
Texas,Como,770,98,148,123,18,8,395
Texas,Commerce,8558,873,1133,995,630,521,4152
Texas,Comfort,3091,498,538,406,213,82,1737
Texas,Keller,43107,979,3366,7445,10800,5331,27921
Texas,Kemah,2125,113,286,497,400,130,1426
Texas,Kemp,1522,207,317,231,71,34,860
Texas,Kempner,1326,100,336,415,72,29,952
Texas,Kendleton,296,17,78,90,18,11,214
Texas,Kenedy,3410,805,543,566,158,25,2097
Texas,Kenefick,485,55,140,109,21,2,327
Texas,Kennard,348,35,105,76,25,2,243
Texas,Kennedale,7273,854,1405,1632,908,345,5144
Texas,Kerens,1651,230,372,337,79,41,1059
Texas,Kermit,6057,1124,1147,990,314,59,3634
Texas,Kerrville,22687,2298,4599,4920,2693,1586,16096
Texas,Kilgore,14442,1257,2491,3349,1251,583,8931
Texas,Killeen,136378,6536,21093,35394,10627,4342,77992
Texas,Kingsbury,799,120,240,102,135,9,606
Texas,Kingsland,6756,762,1458,1552,571,199,4542
Texas,Kingsville,26285,3837,2894,3614,2428,1252,14025
Texas,Kirby,8332,996,1931,1861,410,120,5318
Texas,Kirbyville,2409,318,672,372,52,11,1425
Texas,Kirvin,117,15,20,33,2,0,70
Texas,Knippa,788,180,133,89,43,34,479
Texas,Keene,6091,618,985,1179,522,145,3449
Texas,K-Bar Ranch,701,51,187,111,13,0,362
Texas,Kaufman,6947,979,1455,1325,431,100,4290
Texas,Katy,15796,1586,2355,2692,2380,969,9982
Texas,Jacksonville,14743,2345,2580,1922,704,396,7947
Texas,Jamaica Beach,1008,10,216,332,228,77,863
Texas,Jardin de San Julian,27,11,0,0,0,0,11
Texas,Jarrell,927,79,190,227,84,24,604
Texas,Jasper,7684,884,1878,1020,313,145,4240
Texas,Jayton,614,111,107,108,78,38,442
Texas,Jefferson,2305,195,793,468,194,92,1742
Texas,Jersey Village,7849,315,1376,2001,1386,916,5994
Texas,Jewett,1318,211,328,173,56,22,790
Texas,J.F. Villareal,37,37,0,0,0,0,37
Texas,Knollwood,394,33,75,162,37,16,323
Texas,Joaquin,913,88,211,212,22,32,565
Texas,Jolly,162,12,61,40,11,10,134
Texas,Jones Creek,2506,278,634,574,114,10,1610
Texas,Jonestown,1945,132,304,520,344,147,1447
Texas,Josephine,809,70,199,125,75,26,495
Texas,Joshua,5966,659,1243,1372,483,81,3838
Texas,Jourdanton,4120,614,981,794,71,81,2541
Texas,Juarez,294,221,41,0,0,0,262
Texas,Junction,2643,393,603,572,178,98,1844
Texas,Justin,3351,235,569,867,405,188,2264
Texas,Karnes City,3216,594,677,501,249,56,2077
Texas,Johnson City,1738,127,356,379,199,65,1126
Texas,Seagraves,2606,505,392,420,108,6,1431
Texas,Knox City,1179,134,240,217,101,29,721
Texas,Kountze,2037,291,558,317,82,54,1302
Texas,Olton,1852,396,409,289,75,25,1194
Texas,Olney,3215,409,846,501,143,125,2024
Texas,Olmos Park,1990,37,67,144,525,613,1386
Texas,Olmito and Olmito,275,125,11,0,0,0,136
Texas,Olmito,948,347,55,145,47,34,628
Texas,Olivia Lopez de Gutierrez,0,0,0,0,0,0,0
Texas,Olivarez,3800,602,474,289,117,17,1499
Texas,Old River-Winfree,1894,176,489,304,67,115,1151
Texas,Oilton,362,77,89,73,6,0,245
Texas,Oglesby,590,100,144,103,36,4,387
Texas,O'Donnell,982,234,173,152,33,8,600
Texas,Odessa,111330,15784,17920,21274,8512,3393,66883
Texas,Baytown,74897,11168,11715,16013,4830,1852,45578
Texas,Bayside,417,42,97,133,43,11,326
Texas,Bayou Vista,1861,91,406,592,405,168,1662
Texas,Bay City,17499,2581,3869,2879,1311,429,11069
Texas,Batesville,1122,395,151,93,18,0,657
Texas,Bastrop,7669,881,1479,1849,679,325,5213
Texas,Bartonville,2101,101,268,395,357,210,1331
Texas,Barton Creek,3373,36,153,373,1117,994,2673
Texas,Combine,2091,368,417,413,169,106,1473
Texas,Omaha,931,68,227,228,109,27,659
Texas,Onalaska,1719,309,435,350,104,27,1225
Texas,Opdyke West,112,3,23,22,3,1,52
Texas,Orange,18945,1559,4632,3906,1599,750,12446
Texas,Kress,623,96,167,107,30,21,421
Texas,Krugerville,1555,64,267,384,279,107,1101
Texas,Krum,4625,245,676,1084,564,200,2769
Texas,Kurten,341,21,76,87,29,14,227
Texas,Kyle,32078,2523,4100,6666,4275,1289,18853
Texas,La Blanca,2421,619,385,234,108,58,1404
Texas,La Carla,179,48,4,0,0,0,52
Texas,La Casita,0,0,0,0,0,0,0
Texas,La Chuparosa,0,0,0,0,0,0,0
Texas,Lackland AFB,7714,36,162,770,487,99,1554
Texas,Kosse,378,77,125,76,0,3,281
Texas,La Coma,25,8,8,0,0,0,16
Texas,Lacy-Lakeview,6561,835,910,1862,172,150,3929
Texas,Ladonia,537,57,118,88,39,9,311
Texas,La Escondida,23,4,0,4,0,0,8
Texas,La Esperanza,30,30,0,0,0,0,30
Texas,La Feria,7325,1239,1214,1559,390,78,4480
Texas,La Feria North,86,50,36,0,0,0,86
Texas,Lago,126,42,84,0,0,0,126
Texas,Lago Vista,134,28,0,13,6,5,52
Texas,Orason,106,13,8,19,16,26,82
Texas,Orange Grove,1422,193,318,186,128,67,892
Texas,LaCoste,1299,157,302,321,86,16,882
Texas,Wharton,8733,1736,1769,1470,366,174,5515
Texas,Orchard,322,66,90,39,8,8,211
Texas,Overton,2426,248,611,488,183,79,1609
Texas,Shady Hollow,5187,89,414,1014,1540,784,3841
Texas,Shady Shores,2776,51,353,719,552,238,1913
Texas,Shallowater,2529,168,468,480,288,136,1540
Texas,Shamrock,1861,254,424,431,195,47,1351
Texas,Shavano Park,3326,57,213,378,826,955,2429
Texas,Sheldon,1615,458,154,268,37,16,933
Texas,Shenandoah,2523,59,399,691,550,313,2012
Texas,Shepherd,2887,427,707,440,83,46,1703
Texas,Sherman,39569,3830,7519,8804,2928,1905,24986
Texas,Sherwood Shores,1087,139,343,291,86,33,892
Texas,Shiner,2088,247,546,333,177,31,1334
Texas,Shoreacres,1767,48,286,506,191,93,1124
Texas,Sienna Plantation,15720,300,1038,2490,3987,1702,9517
Texas,Sierra Blanca,453,69,88,116,47,8,328
Texas,Siesta Acres,2260,706,347,250,27,0,1330
Texas,Siesta Shores,1457,473,174,98,5,0,750
Texas,Silsbee,6687,702,1638,1509,549,225,4623
Texas,Silverton,722,129,131,144,36,26,466
Texas,Simonton,786,44,155,187,114,37,537
Texas,Sinton,5701,1257,1097,798,230,161,3543
Texas,Skellytown,475,39,116,114,42,16,327
Texas,Shadybrook,1585,149,329,412,162,133,1185
Texas,Skidmore,934,235,179,200,22,10,646
Texas,Seymour,2484,216,549,640,237,70,1712
Texas,Seven Oaks,175,19,16,51,1,2,89
Texas,La Presa,330,79,37,14,8,0,138
Texas,La Pryor,1568,357,152,254,46,15,824
Texas,La Puerta,391,176,15,41,28,0,260
Texas,Laredo,248855,45866,33249,32979,16651,7317,136062
Texas,Laredo Ranchettes,58,21,0,0,0,0,21
Texas,Laredo Ranchettes West,0,0,0,0,0,0,0
Texas,La Rosita,106,9,42,0,13,0,64
Texas,Lasana,67,24,0,4,12,8,48
Texas,Lasara,994,279,140,73,31,3,526
Texas,Las Haciendas,0,0,0,0,0,0,0
Texas,Las Lomas,3743,1181,397,76,0,0,1654
Texas,Las Lomitas,312,93,31,10,0,0,134
Texas,Las Palmas,17,0,0,17,0,0,17
Texas,Las Palmas II,1765,392,215,149,44,33,833
Texas,Las Pilas,0,0,0,0,0,0,0
Texas,Las Quintas Fronterizas,2251,350,372,311,71,0,1104
Texas,Latexo,337,32,92,58,18,2,202
Texas,La Tina Ranch,730,153,136,131,0,0,420
Texas,Laughlin AFB,2163,0,28,175,304,197,704
Texas,Laureles,5087,1244,549,439,146,95,2473
Texas,Seth Ward,1838,480,292,285,35,0,1092
Texas,Seven Points,1360,269,411,165,51,15,911
Texas,Slaton,6097,1175,1523,900,453,166,4217
Texas,Smiley,578,110,167,72,20,16,385
Texas,Zuehl,468,96,152,63,47,11,369
Texas,Windthorst,318,47,114,36,42,9,248
Texas,Windom,177,12,57,24,24,3,120
Texas,Windcrest,5648,269,1473,1594,703,691,4730
Texas,Wimberley,2625,171,470,652,478,208,1979
Texas,Wilson,518,153,111,71,18,5,358
Texas,Wilmer,3826,875,514,632,133,12,2166
Texas,Wills Point,3518,478,788,587,191,104,2148
Texas,Willow Park,4478,108,530,859,1076,334,2907
Texas,Willis,6127,1154,1096,774,324,14,3362
Texas,Wildwood,711,21,101,264,103,58,547
Texas,Wild Peach Village,2367,138,587,645,80,64,1514
Texas,Wickett,452,47,119,121,11,0,298
Texas,Wichita Falls,104926,9536,20048,20361,9981,4958,64884
Texas,Whitney,2349,227,584,529,73,35,1448
Texas,Whitewright,1868,237,383,359,173,50,1202
Texas,White Settlement,16733,2377,4069,3796,717,312,11271
Texas,Whitesboro,3842,415,787,981,236,115,2534
Texas,White Oak,6409,291,1290,1441,487,399,3908
Texas,Whitehouse,7994,261,1264,2031,901,299,4756
Texas,Whiteface,404,43,65,92,38,13,251
Texas,White Deer,930,60,130,287,92,43,612
Texas,Winfield,487,97,118,53,13,4,285
Texas,Wink,1001,69,195,223,91,12,590
Texas,Winnie,3238,653,954,434,187,10,2238
Texas,Winnsboro,3273,329,702,597,154,81,1863
Texas,Zavalla,771,121,187,102,25,0,435
Texas,Zarate,26,0,26,0,0,0,26
Texas,Zapata Ranch,200,5,6,50,42,0,103
Texas,Zapata,4222,1209,737,563,241,105,2855
Texas,Yorktown,2053,432,445,320,136,30,1363
Texas,Yoakum,5483,1075,1186,783,274,56,3374
Texas,Yantis,571,65,208,78,26,12,389
Texas,Wylie,44461,1975,6479,9461,7206,2132,27253
Texas,Wyldwood,3912,0,900,963,522,290,2675
Texas,Wortham,1044,146,206,189,46,23,610
Texas,La Porte,34746,2774,7389,9057,2678,1075,22973
Texas,Woodway,8667,264,1037,2006,1848,1219,6374
Texas,Woodson,272,21,70,47,8,14,160
Texas,Woodsboro,1500,170,455,292,57,40,1014
Texas,Woodloch,213,14,43,69,10,6,142
Texas,Woodcreek,1288,49,126,367,359,212,1113
Texas,Woodbranch,1431,180,331,331,150,18,1010
Texas,Wolfforth,3996,290,482,662,448,273,2155
Texas,Wolfe City,1636,185,393,315,125,41,1059
Texas,Wixon Valley,257,20,41,53,35,21,170
Texas,Winters,2551,529,504,353,118,69,1573
Texas,Winona,893,94,235,180,25,21,555
Texas,Woodville,2738,221,671,626,188,63,1769
Texas,La Paloma Ranchettes,497,52,86,68,0,0,206
Texas,La Paloma-Lost Creek,637,107,111,128,2,4,352
Texas,La Paloma Addition,101,37,31,0,0,0,68
Texas,Palo Pinto,216,31,76,43,8,3,161
Texas,Pampa,18216,2376,3623,3990,1193,519,11701
Texas,Panhandle,2549,81,361,614,296,245,1597
Texas,Panorama Village,2013,71,346,645,363,216,1641
Texas,Pantego,2475,150,411,473,489,235,1758
Texas,Paradise,415,38,114,91,27,21,291
Texas,Paris,24903,2597,5648,5746,1509,812,16312
Texas,Parker,4118,193,287,592,944,560,2576
Texas,Big Thicket Lake Estates,659,145,122,140,50,0,457
Texas,Pasadena,153036,26031,27404,24812,8978,4127,91352
Texas,Pattison,586,103,132,127,51,16,429
Texas,Patton Village,1925,430,461,204,29,0,1124
Texas,Pawnee,168,56,37,36,0,0,129
Texas,Payne Springs,626,84,204,149,28,11,476
Texas,Pearland,101725,4527,11467,19173,18592,11546,65305
Texas,Pearsall,9651,2031,1877,1281,369,77,5635
Texas,Pecan Acres,5437,254,1037,894,706,372,3263
Texas,Pecan Gap,231,16,75,63,14,11,179
Texas,Pecan Grove,16399,357,2296,3896,3410,1623,11582
Texas,Pecan Hill,763,49,223,176,75,17,540
Texas,Pecan Plantation,5755,466,793,1997,914,769,4939
Texas,Paloma Creek South,5141,127,336,1554,786,423,3226
Texas,Paloma Creek,3780,104,297,1008,606,69,2084
Texas,Palo Blanco,170,27,44,22,0,0,93
Texas,Palmview South,5476,1332,989,614,254,96,3285
Texas,Ovilla,3616,127,523,826,746,210,2432
Texas,Owl Ranch,126,87,0,0,0,0,87
Texas,Oyster Creek,1088,203,289,138,42,4,676
Texas,Ozona,3101,712,590,556,108,101,2067
Texas,Pablo Pena,0,0,0,0,0,0,0
Texas,Paducah,1219,240,290,216,80,23,849
Texas,Paint Rock,357,74,72,27,34,0,207
Texas,Paisano Park,81,28,0,53,0,0,81
Texas,Palacios,4659,889,992,763,268,158,3070
Texas,Palestine,18488,2096,4042,3387,1150,781,11456
Texas,Pecos,9074,1931,1408,1480,525,197,5541
Texas,Palisades,286,25,59,117,19,7,227
Texas,Palmhurst,2642,327,208,398,343,224,1500
Texas,Sealy,6222,815,1090,1225,424,161,3715
Texas,Sebastian,1676,513,387,101,22,20,1043
Texas,Seco Mines,477,72,69,73,9,30,253
Texas,Seguin,27095,3940,5754,4753,1760,966,17173
Texas,Selma,7743,426,1011,1620,1103,734,4894
Texas,Seminole,7018,1329,1257,1016,498,166,4266
Texas,Serenada,1399,1,224,295,454,119,1093
Texas,Palm Valley,1720,93,167,500,334,242,1336
Texas,Palmview,5626,1565,783,518,262,68,3196
Texas,Palmer,2302,248,488,421,74,22,1253
Texas,Ore City,981,77,210,235,67,27,616
Texas,Pelican Bay,1867,224,574,245,50,4,1097
Texas,Penelope,204,43,45,38,8,0,134
Texas,Lake Meredith Estates,146,73,62,11,0,0,146
Texas,Lakeport,1097,108,217,338,79,39,781
Texas,Lakeshore Gardens-Hidden Acres,845,128,216,207,31,0,582
Texas,Lakeside town (San Patricio County),294,36,80,49,34,7,206
Texas,Lakeside town (Tarrant County),1592,107,306,484,268,108,1273
Texas,Lakeside City,1036,42,176,293,171,51,733
Texas,Lake Tanglewood,694,10,96,218,161,92,577
Texas,Lakeview,89,21,26,15,13,0,75
Texas,Lake View,127,15,0,90,22,0,127
Texas,Lakeway,13212,100,1011,2315,3970,2101,9497
Texas,Lakewood Village,584,15,79,176,114,32,416
Texas,Lake Worth,4718,648,1446,950,163,93,3300
Texas,La Loma de Falcon,115,42,12,11,0,0,65
Texas,Lamar,1040,29,425,323,91,94,962
Texas,La Marque,15230,1657,3183,3632,1019,445,9936
Texas,Lamesa,9343,1470,2378,1326,559,191,5924
Texas,La Minita,127,31,22,27,17,0,97
Texas,Lampasas,7096,799,1526,1388,727,260,4700
Texas,Lancaster,38152,3163,6649,8982,2898,1062,22754
Texas,Lantana,8585,141,534,1432,2256,833,5196
Texas,La Paloma,2704,920,194,312,49,0,1475
Texas,Lake Medina Shores,896,213,268,127,32,30,670
Texas,Lake Kiowa,2522,87,478,711,494,388,2158
Texas,Lake Jackson,27352,1290,3757,7381,3809,1822,18059
Texas,Lakehills,4900,279,1113,1375,737,252,3756
Texas,Penitas,4551,1206,544,616,119,39,2524
Texas,Perezville,4680,1052,991,638,143,127,2951
Texas,Perrin,415,57,148,92,26,14,337
Texas,Perryton,9358,1474,1652,1567,483,205,5381
Texas,Petersburg,1137,250,255,154,64,27,750
Texas,Lago Vista,6443,432,877,1771,1573,434,5087
Texas,La Grange,4666,797,954,677,164,170,2762
Texas,La Grulla,1319,427,231,185,24,0,867
Texas,Laguna Heights,3240,1051,342,144,98,0,1635
Texas,Laguna Park,1446,193,427,429,108,24,1181
Texas,Pena,185,56,19,0,0,0,75
Texas,Laguna Seca,383,34,28,77,14,0,153
Texas,La Homa,13406,3735,1265,1018,371,118,6507
Texas,La Joya,4183,1267,473,403,105,100,2348
Texas,Lake Bridgeport,422,54,112,110,24,21,321
Texas,Lake Brownwood,1264,120,444,277,24,17,882
Texas,Lake Bryan,2262,476,353,315,82,7,1233
Texas,Lake Cherokee,2665,162,680,713,455,115,2125
Texas,Lake City,442,58,73,157,15,6,309
Texas,Lake Colorado City,518,35,126,143,94,12,410
Texas,Lake Dallas,7465,226,1583,1730,1117,482,5138
Texas,Lake Dunlap,2688,199,782,403,194,38,1616
Texas,Laguna Vista,3211,240,609,619,518,357,2343
Texas,Big Wells,737,218,134,123,0,4,479
Texas,Lolita,589,28,154,162,56,0,400
Texas,Bishop Hills,285,12,27,59,33,38,169
Texas,Bullard,2677,145,364,556,401,136,1602
Texas,Buffalo Springs,375,23,92,113,64,23,315
Texas,Buffalo Gap,408,40,127,104,55,0,326
Texas,Buffalo,2129,280,383,400,131,26,1220
Texas,Buena Vista,144,58,0,0,0,0,58
Texas,Buda,10655,317,1418,2425,1901,614,6675
Texas,Buckholts,471,94,96,31,8,10,239
Texas,Buchanan Lake Village,722,127,254,198,43,20,642
Texas,Buchanan Dam,1145,139,363,351,181,50,1084
Texas,Bryson,536,55,151,52,11,0,269
Texas,Bryan,79411,10253,12489,11820,7427,5512,47501
Texas,Brushy Creek,21254,377,1971,3819,4998,2369,13534
Texas,Bulverde,4761,125,1111,1088,608,394,3326
Texas,Bruni,261,32,50,54,55,0,191
Texas,Bruceville-Eddy,1616,127,360,341,69,13,910
Texas,Brownwood,19021,1892,4396,3280,1557,638,11763
Texas,Brownsville,181487,37019,23137,24896,13292,4791,103135
Texas,Brownsboro,1039,81,180,176,64,35,536
Texas,Brownfield,9688,1915,1868,1578,553,166,6080
Texas,Browndell,189,47,63,14,13,2,139
Texas,Brookside Village,1532,139,282,407,135,44,1007
Texas,Brookshire,4879,1047,1082,416,129,85,2759
Texas,Bronte,860,125,226,199,93,30,673
Texas,Broaddus,194,30,50,18,6,5,109
Texas,Bristol,275,33,103,96,33,10,275
Texas,Bridgeport,6192,1100,1314,1120,412,79,4025
Texas,Brundage,0,0,0,0,0,0,0
Texas,Buna,2600,360,746,591,91,25,1813
Texas,Bunker Hill Village,3842,42,164,324,1024,1021,2575
Texas,Burkburnett,10960,797,2649,2650,915,449,7460
Texas,Canyon Creek,1438,196,364,271,144,0,975
Texas,Canyon,14248,733,1060,2603,2028,1096,7520
Texas,Canutillo,6110,1210,1082,686,328,154,3460
Texas,Cantu Addition,428,37,64,101,9,0,211
Texas,Canton,3578,438,972,776,144,209,2539
Texas,Caney City,212,48,73,35,19,5,180
Texas,Canadian,2999,401,501,503,306,88,1799
Texas,Camp Wood,910,218,121,195,60,37,631
Texas,Camp Swift,6461,1082,1502,1329,294,117,4324
Texas,Campo Verde,183,73,8,0,0,0,81
Texas,Campbell,515,42,150,96,39,13,340
Texas,Cameron Park,6972,2446,663,447,71,42,3669
Texas,Cameron,5448,869,1200,1052,333,70,3524
Texas,Camargito,433,162,23,16,0,0,201
Texas,Calvert,1327,154,313,169,60,14,710
Texas,Callisburg,345,6,94,80,25,8,213
Texas,Callender Lake,1201,91,430,363,92,92,1068
Texas,Caldwell,4214,660,1022,715,299,171,2867
Texas,Caddo Mills,1772,92,415,359,108,66,1040
Texas,Cactus,3210,984,232,217,59,0,1492
Texas,Bynum,191,31,45,39,8,1,124
Texas,Byers,506,18,156,85,39,19,317
Texas,Butterfield,83,34,0,14,0,0,48
Texas,Burton,393,16,70,81,87,18,272
Texas,Burnet,6104,711,1388,1007,536,137,3779
Texas,Burleson,40652,1960,7263,9948,4286,1661,25118
Texas,Burke,703,113,189,147,32,9,490
Texas,Bridge City,7907,504,1843,1837,498,228,4910
Texas,Briaroaks,548,19,120,112,91,35,377
Texas,Briarcliff,1565,20,183,503,324,171,1201
Texas,Talco,558,94,113,64,31,1,303
Texas,Stanton,2738,383,613,424,141,67,1628
Texas,Stamford,3004,443,821,474,289,57,2084
Texas,Stagecoach,596,20,187,155,54,24,440
Texas,Stafford,18097,1829,2478,3597,3035,1546,12485
Texas,Spur,1157,285,212,241,46,32,816
Texas,Spring Valley Village,4031,33,185,325,1263,921,2727
Texas,Springtown,2741,192,579,805,223,52,1851
Texas,Springlake,111,15,31,30,0,0,76
Texas,Spring Gardens,627,49,158,76,12,21,316
Texas,Spring,56369,3409,11178,13219,5336,2215,35357
Texas,Odem,2671,568,481,487,93,111,1740
Texas,O'Brien,116,35,22,21,6,2,86
Texas,Oakwood,515,61,179,137,26,15,418
Texas,Oak Valley,444,49,135,102,28,17,331
Texas,Oak Trail Shores,2880,719,564,543,83,21,1930
Texas,Oak Ridge North,3127,40,525,737,598,256,2156
Texas,Oak Ridge town (Kaufman County),454,39,106,141,19,15,320
Texas,Oak Ridge town (Cooke County),126,18,36,28,3,1,86
Texas,Oak Point,3107,97,547,767,649,200,2260
Texas,Oak Leaf,1467,89,223,339,233,100,984
Texas,Oak Island,282,97,72,43,0,0,212
Texas,Oakhurst,481,48,111,0,105,49,313
Texas,Oak Grove,862,50,182,183,104,21,540
Texas,Novice,80,24,10,7,6,4,51
Texas,North San Pedro,589,144,132,100,9,0,385
Texas,Northridge,0,0,0,0,0,0,0
Texas,North Richland Hills,66950,3543,10687,16977,9845,3582,44634
Texas,Staples,289,17,67,73,18,21,196
Texas,Canyon Lake,22759,1356,4799,6011,3473,1827,17466
Texas,Star Harbor,436,16,44,115,105,54,334
Texas,Sterling City,1026,163,242,179,40,12,636
Texas,Tahoka,2605,250,609,453,211,105,1628
Texas,Taft Southwest,1301,399,147,171,8,0,725
Texas,Taft,3063,507,683,555,104,76,1925
Texas,Sweetwater,10794,1620,2335,2321,445,147,6868
Texas,Sweeny,3738,169,947,741,199,37,2093
Texas,Surfside Beach,588,28,105,204,64,28,429
Texas,Sun Valley,153,18,26,2,0,54,100
Texas,Sunset Valley,821,5,49,105,170,207,536
Texas,Sunset Acres,0,0,0,0,0,0,0
Texas,Sunset CDP (Starr County),30,18,3,3,0,0,24
Texas,Sunset CDP (Montague County),255,8,126,45,7,0,186
Texas,Sunrise Beach Village,747,35,131,228,168,78,640
Texas,Sunray,2071,355,401,452,111,16,1335
Texas,Sunnyvale,5677,217,416,1066,1003,935,3637
Texas,Sundown,1312,121,174,285,92,51,723
Texas,Sulphur Springs,15780,1971,3837,2800,992,551,10151
Texas,Sullivan City,4125,1289,525,339,107,26,2286
Texas,Sugar Land,84268,4157,6884,14587,18687,13269,57584
Texas,Sudan,978,145,148,196,64,47,600
Texas,Study Butte,252,40,36,49,21,5,151
Texas,Streetman,255,51,46,39,11,7,154
Texas,Strawn,533,113,141,127,15,17,413
Texas,Stratford,2145,359,388,335,169,64,1315
Texas,Stowell,1504,117,572,150,19,18,876
Texas,Stonewall,445,40,98,76,100,17,331
Texas,Stockdale,1530,192,362,322,89,16,981
Texas,Stinnett,1498,174,329,370,65,26,964
Texas,Stephenville,19074,1089,2235,3037,1920,986,9267
Texas,North Pearsall,963,210,188,134,17,0,549
Texas,Cape Royale,575,16,129,149,132,149,575
Texas,Carlsbad,655,76,188,40,16,9,329
Texas,Emory,1017,127,256,239,46,16,684
Texas,Emhouse,108,8,47,19,8,3,85
Texas,Emerald Bay,1006,44,91,414,226,76,851
Texas,El Socio,137,33,18,19,0,0,70
Texas,Elsa,6444,1487,1342,578,36,90,3533
Texas,El Refugio,377,134,36,18,4,0,192
Texas,El Rancho Vela,224,73,25,23,16,0,137
Texas,El Quiote,208,82,8,0,12,0,102
Texas,El Paso,676325,90646,99605,126612,65890,30055,412808
Texas,E. Lopez,75,0,9,40,7,0,56
Texas,Elmo,792,118,251,77,51,15,512
Texas,El Mesquite,0,0,0,0,0,0,0
Texas,Encantada-Ranchito-El Calaboz,1756,725,194,134,63,15,1131
Texas,Elmendorf,1234,210,348,240,57,15,870
Texas,El Lago,2754,95,253,635,719,288,1990
Texas,Robstown,11616,2285,2091,1764,266,246,6652
Texas,Robinson,11214,597,2192,2840,1132,604,7365
Texas,Robert Lee,1071,116,294,224,76,79,789
Texas,Roaring Springs,311,42,68,54,33,3,200
Texas,Roanoke,6770,418,1021,1736,1084,407,4666
Texas,Riviera,760,163,130,106,25,4,428
Texas,Riverside,600,91,193,95,35,8,422
Texas,River Oaks,7641,1255,1830,1118,349,84,4636
Texas,Rivereno,0,0,0,0,0,0,0
Texas,Rising Star,1047,172,235,172,52,24,655
Texas,Rio Vista,1174,125,220,253,56,9,663
Texas,Elm Creek,2840,483,372,408,108,0,1371
Texas,Enchanted Oaks,370,24,74,102,66,46,312
Texas,Encinal,904,240,207,75,48,1,571
Texas,Encino,53,19,8,13,0,0,40
Texas,Falman,125,15,10,37,12,13,87
Texas,Falls City,581,83,136,105,88,20,432
Texas,Falfurrias,4512,759,1119,561,242,96,2777
Texas,Falcon Village,45,6,25,14,0,0,45
Texas,Falcon Mesa,663,143,112,104,18,6,383
Texas,Falcon Lake Estates,1620,108,219,312,4,71,714
Texas,Falcon Heights,30,16,0,14,0,0,30
Texas,Falconaire,115,46,0,18,0,0,64
Texas,Fairview,8109,91,624,1324,2990,997,6026
Texas,Fair Oaks Ranch,7315,35,755,1308,1686,1365,5149
Texas,Fairfield,2897,249,614,765,208,86,1922
Texas,Fairchilds,817,104,201,159,32,21,517
Texas,Fabrica,851,314,104,20,17,0,455
Texas,Fabens,7846,2071,1118,803,150,32,4174
Texas,Everman,6279,859,1691,1093,245,30,3918
Texas,Evergreen,10,10,0,0,0,0,10
Texas,Evant,423,56,62,114,20,5,257
Texas,Evadale,1553,132,544,317,7,7,1007
Texas,Eustace,1089,116,203,229,73,31,652
Texas,Alvin,25224,2690,4539,5965,1966,697,15857
Texas,Eureka,359,20,91,82,40,17,250
Texas,Euless,53220,3482,7880,12620,8660,3199,35841
Texas,Eugenio Saenz,39,8,17,0,0,0,25
Texas,Hubbard,1640,137,386,394,72,61,1050
Texas,Estelline,76,19,13,30,4,0,66
Texas,Escobares,1690,656,196,143,50,17,1062
Texas,Ennis,18758,2850,3285,3651,944,502,11232
Texas,Rio Hondo,2005,424,389,383,73,93,1362
Texas,Rio Grande City,14154,3235,1986,1559,887,375,8042
Texas,Rio Bravo,4860,1417,588,342,140,19,2506
Texas,Riesel,1028,57,228,232,67,25,609
Texas,Rangerville,52,33,8,11,0,0,52
Texas,Ranger,3238,391,727,469,65,28,1680
Texas,Randolph AFB,1120,7,23,153,158,157,498
Texas,Rancho Viejo,231,45,88,22,0,0,155
Texas,Rancho Viejo,2277,89,279,283,451,454,1556
Texas,Ranchos Penitas West,819,152,128,35,27,0,342
Texas,Rancho Chico,572,193,75,32,0,0,300
Texas,Rancho Banquete,602,23,154,233,13,0,423
Texas,Rancho Alegre,1612,551,301,97,16,0,965
Texas,Ranchitos Las Lomas,127,50,12,8,0,0,70
Texas,Ranchitos East,353,121,33,22,0,0,176
Texas,Ranchitos del Norte,0,0,0,0,0,0,0
Texas,Ranchette Estates,80,30,0,0,0,0,30
Texas,Ramos,235,75,13,8,8,0,104
Texas,Ramirez-Perez,41,0,22,0,0,0,22
Texas,Ramireno,76,0,16,14,0,0,30
Texas,Ralls,1946,438,382,307,88,18,1233
Texas,Rafael Pena,0,0,0,0,0,0,0
Texas,Radar Base,610,312,63,121,10,0,506
Texas,Quitman,2019,190,505,561,171,36,1463
Texas,Quitaque,478,105,59,83,50,4,301
Texas,Quintana,44,15,15,8,0,0,38
Texas,Carrollton,127279,12490,17327,23938,22306,8946,85007
Texas,Carrizo Springs,5740,952,1170,919,303,225,3569
Texas,Carrizo Hill,1046,220,124,103,32,0,479
Texas,Carmine,211,37,40,51,27,23,178
Texas,Carl's Corner,155,33,34,26,1,24,118
Texas,Rankin,811,151,223,159,16,14,563
Texas,Carbon,396,61,69,60,7,3,200
Texas,Ransom Canyon,1319,28,145,281,309,187,950
Texas,Ravenna,184,24,66,50,6,8,154
Texas,Richwood,3686,231,561,873,292,177,2134
Texas,Richmond,11895,2692,2144,1631,812,309,7588
Texas,Richland Springs,295,17,49,114,7,0,187
Texas,Richland Hills,7992,975,1503,2218,796,185,5677
Texas,Richland,222,44,56,49,14,8,171
Texas,Richardson,106123,5613,10860,17948,23310,13996,71727
Texas,Rice,989,107,193,199,49,0,548
Texas,Ricardo,693,24,299,148,81,0,552
Texas,Rhome,1572,121,358,384,126,24,1013
Texas,Retreat,389,43,95,108,17,12,275
Texas,Reno city (Parker and Tarrant Counties),2597,228,562,597,146,70,1603
Texas,Reno city (Lamar County),3245,235,485,824,366,215,2125
Texas,Rendon,14114,992,2706,3043,1602,847,9190
Texas,Relampago,44,30,14,0,0,0,44
Texas,Reklaw,397,50,119,44,29,14,256
Texas,Reid Hope King,889,225,97,18,44,0,384
Texas,Regino Ramirez,102,12,18,6,0,0,36
Texas,Refugio,2846,421,611,659,103,67,1861
Texas,Redwood,4044,1004,998,373,83,29,2487
Texas,Redwater,1124,43,377,209,53,24,706
Texas,Red Oak,11360,1098,1845,2635,900,457,6935
Texas,Red Lick,1044,31,177,289,98,81,676
Texas,Redland,1594,167,416,355,29,15,982
Texas,Redford,89,6,0,10,11,0,27
Texas,Redfield,516,92,29,61,45,13,240
Texas,Realitos,413,113,125,0,0,0,238
Texas,Raymondville,11191,2949,2654,1337,291,122,7353
Texas,Ratamosa,257,60,0,0,0,0,60
Texas,Fannett,1742,106,538,287,195,81,1207
Texas,Northlake,2655,42,353,521,581,152,1649
Texas,North Cleveland,168,24,45,54,2,0,125
Texas,Devers,416,88,57,94,20,3,262
Texas,Devine,4529,652,803,1103,216,106,2880
Texas,Deweyville,1075,48,419,257,35,15,774
Texas,D'Hanis,899,117,220,168,104,14,623
Texas,Diboll,5370,1041,1105,1061,204,47,3458
Texas,Dickens,192,33,80,41,9,5,168
Texas,Dickinson,19355,2314,3222,4073,1804,1059,12472
Texas,Dilley,4090,767,915,513,67,2,2264
Texas,Dimmitt,4354,725,875,595,258,120,2573
Texas,DISH,259,36,73,51,24,11,195
Texas,Dodd City,375,34,97,54,25,12,222
Texas,Dodson,94,36,13,8,1,4,62
Texas,Detroit,767,67,198,190,44,7,506
Texas,Doffing,5629,1558,576,466,72,30,2702
Texas,Donna,16292,3710,2589,2113,848,198,9458
Texas,Doolittle,3746,1074,263,353,79,31,1800
Texas,Dorchester,101,5,27,22,9,0,63
Texas,Double Oak,3013,61,218,592,746,343,1960
Texas,Douglassville,150,24,30,29,17,9,109
Texas,Doyle,507,0,168,121,104,43,436
Texas,Driftwood,107,9,29,11,58,0,107
Texas,Dripping Springs,2415,282,453,375,303,156,1569
Texas,Driscoll,697,182,114,91,17,19,423
Texas,Dublin,3671,537,778,491,323,46,2175
Texas,Dumas,14997,2855,2484,2328,893,250,8810
Texas,Duncanville,39567,4262,6477,8451,4338,2011,25539
Texas,Domino,102,4,19,30,11,0,64
Texas,DeSoto,51478,3274,7442,13272,7025,3488,34501
Texas,Deport,495,56,151,126,19,6,358
Texas,Denver City,4673,802,910,626,267,83,2688
Texas,Murillo,7374,1464,851,810,622,114,3861
Texas,Alice Acres,340,108,44,21,28,20,221
Texas,Alice,19425,3157,4119,3197,1016,527,12016
Texas,Alfred,108,51,0,0,0,0,51
Texas,Aledo,2999,108,330,587,485,165,1675
Texas,Aldine,15310,4217,2358,1026,131,205,7937
Texas,Albany,2203,177,486,445,329,40,1477
Texas,Alba,861,82,282,94,29,2,489
Texas,Alamo Heights,7593,111,292,1108,1931,1849,5291
Texas,Alamo,18943,4306,3271,2761,856,377,11571
Texas,Airport Road Addition,111,0,15,7,29,11,62
Texas,Airport Heights,102,25,12,16,0,0,53
Texas,Aguilares,44,11,8,8,0,0,27
Texas,Agua Dulce,832,113,166,173,56,9,517
Texas,Agua Dulce,2926,742,499,177,55,0,1473
Texas,Adrian,183,35,25,35,21,20,136
Texas,Addison,15087,689,1624,3029,3987,2233,11562
Texas,Ackerly,183,58,25,9,1,1,94
Texas,Abram,1910,762,214,148,29,19,1172
Texas,Abilene,122226,12218,22037,23376,11385,5237,74253
Texas,Abernathy,3290,537,697,560,176,123,2093
Texas,Abbott,390,19,73,90,43,24,249
Texas,Delmita,108,40,43,2,0,0,85
Texas,Del Rio,36119,7380,6218,4692,2797,728,21815
Texas,Del Sol,309,81,0,40,38,0,159
Texas,Denison,22846,2192,5263,5158,1901,973,15487
Texas,Denton,125734,7987,14442,23173,16053,9774,71429
Texas,Eagle Lake,3612,547,787,626,182,79,2221
Texas,Eagle Pass,27956,5525,3693,4584,1731,741,16274
Texas,Early,2804,202,716,551,306,75,1850
Texas,Earth,832,207,143,126,92,2,570
Texas,Elkhart,1386,206,319,318,44,37,924
Texas,Smithville,3967,480,780,709,384,181,2534
Texas,Smyer,634,49,96,145,49,13,352
Texas,Snook,482,64,144,89,17,8,322
Texas,Snyder,11484,1354,1963,2424,681,431,6853
Texas,Socorro,32877,8293,4805,4390,843,291,18622
Texas,Solis,396,67,50,25,77,16,235
Texas,Somerset,1474,228,421,257,53,13,972
Texas,Somerville,1629,203,358,295,112,31,999
Texas,Sonora,3024,496,509,489,273,100,1867
Texas,Sour Lake,1751,130,588,405,58,20,1201
Texas,South Alamo,3868,1175,326,155,0,0,1656
Texas,South Fork Estates,136,15,34,17,15,0,81
Texas,South Houston,17430,4338,3038,1528,504,190,9598
Texas,Southlake,28361,303,1491,4035,7417,4709,17955
Texas,South La Paloma,326,53,0,133,0,0,186
Texas,Southmayd,1019,130,212,229,46,10,627
Texas,South Mountain,403,57,125,78,45,13,318
Texas,South Padre Island,2888,295,482,696,583,376,2432
Texas,South Point,1363,319,354,116,0,0,789
Texas,Southside Place,1762,10,92,100,349,562,1113
Texas,South Toledo Bend,388,11,114,163,30,17,335
Texas,Spade,101,6,19,22,9,0,56
Texas,Sparks,3980,1336,477,378,0,0,2191
Texas,Spearman,3387,554,705,626,307,84,2276
Texas,Splendora,1635,299,334,313,113,9,1068
Texas,Spofford,95,24,2,29,0,3,58
Texas,El Indio,209,125,24,33,0,0,182
Texas,Murchison,518,50,127,125,42,17,361
Texas,Elias-Fela Solis,29,29,0,0,0,0,29
Texas,Electra,2737,312,857,619,182,70,2040
Texas,East Alto Bonito,978,361,153,26,13,0,553
Texas,East Bernard,2779,394,477,540,259,141,1811
Texas,Eastland,3881,542,1113,791,411,82,2939
Texas,East Mountain,985,109,265,224,54,25,677
Texas,Easton,501,94,128,100,27,6,355
Texas,East Tawakoni,868,135,218,233,43,34,663
Texas,Ector,778,94,166,170,38,15,483
Texas,Edcouch,3244,1036,364,429,141,9,1979
Texas,Eden,2485,930,599,341,81,79,2030
Texas,Edgecliff Village,2934,161,626,699,305,210,2001
Texas,Edgewater Estates,85,41,10,0,0,0,51
Texas,Edgewood,1392,207,366,267,100,29,969
Texas,Edinburg,80924,9916,9602,11967,9236,3823,44544
Texas,Edmonson,109,7,35,15,1,2,60
Texas,Edna,5661,952,1213,965,392,64,3586
Texas,Edom,347,46,49,63,41,14,213
Texas,Edroy,307,41,34,43,0,0,118
Texas,Eidson Road,9983,2738,1246,1127,203,27,5341
Texas,Elbert,52,0,0,18,3,2,23
Texas,El Brazil,36,36,0,0,0,0,36
Texas,El Camino Angosto,272,42,91,46,24,0,203
Texas,El Campo,11545,2022,2192,1861,615,343,7033
Texas,El Castillo,368,116,48,50,0,0,214
Texas,El Cenizo,567,185,13,33,21,0,252
Texas,El Cenizo,3307,921,281,238,30,3,1473
Texas,El Chaparral,212,64,15,6,20,0,105
Texas,Eldorado,1897,351,316,296,146,66,1175
Texas,Elgin,8249,1063,1365,1645,479,209,4761
Texas,North Escobares,245,127,0,0,0,0,127
Texas,Muniz,1645,504,231,68,0,0,803
Texas,Mullin,136,28,40,15,0,2,85
Texas,Nesbitt,174,4,96,42,15,14,171
Texas,Needville,3025,312,724,694,291,58,2079
Texas,Nederland,17063,668,3923,4534,1724,733,11582
Texas,Nazareth,281,4,77,68,26,4,179
Texas,Navasota,7281,1468,1446,1154,379,203,4650
Texas,Navarro,267,12,75,81,1,1,170
Texas,Natalia,1398,291,351,201,27,0,870
Texas,Nassau Bay,4085,158,171,1126,815,628,2898
Texas,Nash,3083,124,787,702,164,39,1816
Texas,Narciso Pena,0,0,0,0,0,0,0
Texas,Naples,1443,154,407,297,91,37,986
Texas,Nacogdoches,33774,2417,3934,4954,2797,2195,16297
Texas,Netos,17,17,0,0,0,0,17
Texas,Myrtle Springs,473,137,77,102,81,20,417
Texas,Mustang,15,5,1,0,0,0,6
Texas,Murphy,19691,692,1717,2786,4867,1762,11824
Texas,Alvarado,3868,633,766,960,204,35,2598
Texas,Alton,15092,3509,2112,1577,419,145,7762
Texas,Alto Bonito Heights,116,104,0,0,0,0,104
Texas,Alto,1279,128,285,275,51,20,759
Texas,Alpine,6000,560,887,1182,816,685,4130
Texas,Alma,448,112,73,72,27,13,297
Texas,Allen,92502,2513,7219,17220,19608,10799,57359
Texas,Melvin,181,43,39,40,11,2,135
Texas,Memphis,2217,434,340,424,97,75,1370
Texas,Menard,1628,315,347,352,61,20,1095
Texas,Mustang Ridge,1232,176,292,178,34,43,723
Texas,Nevada,1043,56,281,194,91,50,672
Texas,Newark,1108,165,220,233,62,17,697
Texas,New Berlin,538,25,130,145,48,56,404
Texas,North Alamo,4095,995,553,598,46,98,2290
Texas,Normanna,101,13,53,10,5,5,86
Texas,Normangee,576,77,151,94,11,44,377
Texas,Nordheim,250,40,63,47,29,3,182
Texas,Noonday,719,68,151,234,75,31,559
Texas,Nome,448,42,118,79,81,21,341
Texas,Nolanville,4533,456,490,973,315,232,2466
Texas,Nocona Hills,738,95,152,256,113,53,669
Texas,Nocona,2984,549,723,511,166,20,1969
Texas,Nixon,2529,592,417,240,20,55,1324
Texas,Nina,274,51,25,0,0,0,76
Texas,Niederwald,607,67,168,118,30,9,392
Texas,Neylandville,111,5,14,54,6,1,80
Texas,New Waverly,1335,125,319,245,48,55,792
Texas,Newton,2227,232,614,444,95,57,1442
Texas,New Territory,15494,993,1334,1910,3402,2136,9775
Texas,New Summerfield,1351,327,303,124,14,6,774
Texas,New London,1182,169,316,247,31,37,800
Texas,New Hope,775,65,201,175,103,44,588
Texas,New Home,386,67,73,49,30,2,221
Texas,New Falcon,223,58,60,0,7,0,125
Texas,New Fairview,1010,135,269,228,27,21,680
Texas,New Deal,875,122,204,137,40,3,506
Texas,New Chapel Hill,657,60,152,182,44,17,455
Texas,Newcastle,485,89,126,105,30,2,352
Texas,New Braunfels,64076,4622,10922,13563,8914,3145,41166
Texas,New Boston,4730,487,1424,1035,272,90,3308
Texas,Mentone,37,14,4,19,0,0,37
Texas,Mercedes,16425,3520,2402,1877,944,302,9045
Texas,Meridian,1714,273,332,337,27,31,1000
Texas,Merkel,2617,361,681,557,140,64,1803
Texas,Mobile City,291,100,50,33,2,0,185
Texas,Monahans,7349,1023,1552,1324,414,168,4481
Texas,Montague,308,45,115,64,12,2,238
Texas,Mont Belvieu,4585,211,819,1203,245,349,2827
Texas,Monte Alto,1836,424,260,206,74,18,982
Texas,Montgomery,750,24,127,180,92,19,442
Texas,Moody,1628,206,334,405,66,35,1046
Texas,Moore,404,197,47,19,16,15,294
Texas,Moore Station,251,57,68,20,7,10,162
Texas,Moraida,194,56,0,67,0,0,123
Texas,Morales-Sanchez,46,16,0,30,0,0,46
Texas,Moran,347,48,108,89,3,3,251
Texas,Morgan,615,127,99,51,11,4,292
Texas,Morgan Farm,348,76,175,23,7,8,289
Texas,Morgan's Point,322,10,52,67,34,46,209
Texas,Morgan's Point Resort,4223,292,1029,724,586,248,2879
Texas,Morning Glory,423,47,109,57,20,0,233
Texas,Morse,206,27,41,34,8,7,117
Texas,Morton,1841,469,339,186,59,53,1106
Texas,Moulton,930,252,220,101,30,16,619
Texas,Mountain City,771,9,118,139,130,97,493
Texas,Mount Calm,265,34,54,61,34,6,189
Texas,Mount Enterprise,436,79,137,53,22,15,306
Texas,Mount Pleasant,16007,3335,2296,2438,798,387,9254
Texas,Mount Vernon,2752,336,474,660,240,116,1826
Texas,Muenster,1584,69,373,295,244,47,1028
Texas,Muleshoe,5300,1054,1077,759,144,107,3141
Texas,Mobeetie,156,10,30,50,14,1,105
Texas,Munday,1388,218,335,246,77,11,887
Texas,Missouri City,70538,3240,8249,14506,13513,7478,46986
Texas,Mission,81573,12831,11051,10943,7353,3538,45716
Texas,Mertens,140,12,40,38,7,2,99
Texas,Mertzon,811,91,227,152,54,17,541
Texas,Mesquite,143584,16781,25671,29269,10592,4712,87025
Texas,Mesquite,650,340,6,0,23,0,369
Texas,Mexia,7453,1020,1569,1336,593,142,4660
Texas,Miami,613,17,137,132,92,31,409
Texas,Midland,123820,13050,17856,25726,14355,5811,76798
Texas,Midlothian,20679,1012,3431,5160,2509,946,13058
Texas,Midway,343,36,56,50,32,7,181
Texas,Midway North,5050,1492,584,325,180,0,2581
Texas,Midway South,2732,561,271,334,18,0,1184
Texas,Miguel Barrera,260,105,7,0,0,0,112
Texas,Mikes,879,261,60,17,18,0,356
Texas,Mila Doce,6225,1784,604,356,55,54,2853
Texas,Milam,1374,100,310,498,72,69,1049
Texas,Milano,447,49,122,61,11,12,255
Texas,Mildred,511,66,169,93,28,9,365
Texas,Miles,1086,190,240,165,43,30,668
Texas,Milford,673,98,187,155,10,4,454
Texas,Miller's Cove,190,59,5,4,0,0,68
Texas,Millican,265,25,82,48,29,2,186
Texas,Millsap,454,49,104,111,19,5,288
Texas,Mineola,4540,546,892,955,306,159,2858
Texas,Mineral Wells,16159,2504,4003,2567,721,266,10061
Texas,Mingus,304,40,105,71,13,0,229
Texas,Mi Ranchito Estate,106,106,0,0,0,0,106
Texas,Mirando City,382,75,43,26,11,0,155
Texas,Mission Bend,36723,4515,5224,7218,4132,1784,22873
Texas,Bishop,3169,534,643,608,225,59,2069
Texas,Farmers Branch,31052,3588,4860,5553,4831,2076,20908
Texas,Farwell,1748,283,354,314,118,62,1131
Texas,Wellman,301,43,50,42,47,17,199
Texas,Wellington,2306,359,515,441,150,52,1517
Texas,Welch,214,33,25,36,28,7,129
Texas,Weir,472,74,84,80,59,5,302
Texas,Weinert,216,22,55,24,32,16,149
Texas,Weimar,2282,261,620,319,197,151,1548
Texas,Webster,10993,1191,1384,2686,1412,552,7225
Texas,Webberville,661,152,161,90,23,13,439
Texas,Weatherford,27234,1877,4432,6633,2826,1779,17547
Texas,Waxahachie,31756,2473,5639,6574,3117,1502,19305
Texas,Watauga,24179,1848,4566,6113,2149,746,15422
Texas,Waskom,1992,272,717,324,90,51,1454
Texas,Wells,881,139,201,129,71,11,551
Texas,Warren City,356,29,76,99,24,6,234
Texas,Walnut Springs,823,154,167,95,42,13,471
Texas,Wallis,1173,110,392,252,64,24,842
Texas,Waller,2237,263,465,461,135,62,1386
Texas,Wake Village,5479,285,1123,1212,334,225,3179
Texas,Waelder,1175,441,153,90,13,25,722
Texas,Waco,129193,14909,19816,21560,9937,5503,71725
Texas,Von Ormy,1169,156,293,139,44,21,653
Texas,Volente,677,6,64,121,216,72,479
Texas,Vinton,1460,257,182,226,34,17,716
Texas,Villa Verde,561,249,138,12,0,0,399
Texas,Villarreal,440,44,105,110,0,0,259
Texas,Villa Pancho,698,237,24,82,62,0,405
Texas,Warren,640,20,175,184,8,32,419
Texas,Wells Branch,12014,648,2139,2560,2228,1119,8694
Texas,Weslaco,38666,7815,5927,5695,2752,1213,23402
Texas,West,2802,310,590,665,239,61,1865
Texas,Plainview,21666,3249,4001,3255,1216,905,12626
Texas,Plano,275645,12094,23392,48665,62845,39693,186689
Texas,Pleak,1498,204,324,206,83,25,842
Texas,Pleasant Hill,528,154,65,92,29,0,340
Texas,Pleasanton,9473,1394,2464,1425,660,428,6371
Texas,Pleasant Valley,369,44,101,68,41,14,268
Texas,Plum Grove,471,84,131,92,2,4,313
Texas,Point,769,124,256,108,31,12,531
Texas,Point Blank,869,100,228,167,67,55,617
Texas,Point Comfort,689,53,157,199,58,22,489
Texas,Point Venture,809,20,122,259,182,89,672
Texas,Ponder,1534,109,312,366,110,55,952
Texas,Port Aransas,3772,79,681,1091,579,454,2884
Texas,Westover Hills,636,0,21,41,220,176,458
Texas,West Orange,3452,487,1105,756,136,99,2583
Texas,Weston Lakes,2548,32,235,539,817,408,2031
Texas,Weston,321,11,91,66,39,3,210
Texas,West Odessa,23742,4502,4528,4012,607,204,13853
Texas,Westminster,719,169,137,147,50,0,503
Texas,West Livingston,8168,1672,2335,1795,204,153,6159
Texas,West Lake Hills,3262,5,174,203,1238,809,2429
Texas,Westlake,1091,22,61,139,234,236,692
Texas,Western Lake,1230,201,199,323,41,0,764
Texas,Westdale,409,50,132,89,0,44,315
Texas,West Columbia,3919,352,951,966,210,50,2529
Texas,Westbrook,212,24,74,30,10,4,142
Texas,West Alto Bonito,1108,286,127,21,11,0,445
Texas,Villa del Sol,106,14,60,7,0,0,81
Texas,Vidor,10887,763,3642,2232,461,265,7363
Texas,Victoria Vera,108,40,45,0,0,0,85
Texas,Victoria,65303,7738,12454,13179,5473,2463,41307
Texas,Gordon,450,38,111,89,54,23,315
Texas,Goodrich,260,32,67,57,2,0,158
Texas,Goodlow,209,17,88,46,4,1,156
Texas,Gonzales,7370,1419,1470,1020,366,130,4405
Texas,Golinda,500,20,108,161,30,6,325
Texas,Goliad,2111,236,378,463,204,38,1319
Texas,Goldthwaite,2142,273,369,527,182,82,1433
Texas,Goldsmith,208,11,43,91,14,4,163
Texas,Godley,1237,112,237,247,91,11,698
Texas,Glidden,443,25,127,52,16,18,238
Texas,Glen Rose,2523,323,388,598,331,161,1801
Texas,Glenn Heights,11795,878,1969,2661,975,581,7064
Texas,Gladewater,6451,754,1173,1495,461,116,3999
Texas,Girard,31,6,15,4,0,0,25
Texas,Gilmer,5088,633,1093,958,389,225,3298
Texas,Giddings,4957,763,835,843,410,137,2988
Texas,Gholson,851,81,232,287,54,12,666
Texas,Geronimo,1432,208,463,191,79,0,941
Texas,George West,2538,410,497,456,109,22,1494
Texas,Georgetown,56102,3107,8409,11516,10953,7169,41154
Texas,Gatesville,15826,3152,4351,3851,760,228,12342
Texas,Garza-Salinas II,753,124,162,41,0,6,333
Texas,Gary City,305,33,89,49,10,7,188
Texas,Garrison,897,127,223,205,38,9,602
Texas,Garrett,845,197,155,97,13,11,473
Texas,Garland,234213,34243,36231,43190,22370,8584,144618
Texas,Port Arthur,54864,9576,11828,9005,2722,953,34084
Texas,Goree,258,43,74,40,16,3,176
Texas,Plains,1629,320,204,246,132,71,973
Texas,Gorman,901,158,246,173,41,0,618
Texas,Graham,8837,1233,1885,1591,721,287,5717
Texas,Vernon,10887,1683,2144,2245,816,226,7114
Texas,Venus,3126,496,767,732,189,67,2251
Texas,Vega,797,90,114,199,138,33,574
Texas,Van Vleck,2039,235,409,438,76,32,1190
Texas,Van Horn,2175,537,427,262,103,40,1369
Texas,Vanderbilt,480,43,107,72,56,13,291
Texas,Van Alstyne,3165,138,751,751,201,170,2011
Texas,Van,2654,242,523,563,279,71,1678
Texas,Val Verde Park,2736,658,620,391,56,0,1725
Texas,Valley View,978,110,157,203,90,27,587
Texas,Valley Mills,1466,127,318,360,57,27,889
Texas,Valle Vista,354,66,0,49,20,0,135
Texas,Valle Verde,0,0,0,0,0,0,0
Texas,Valle Hermoso,0,0,0,0,0,0,0
Texas,Valentine,100,21,20,14,17,9,81
Texas,Uvalde Estates,2150,685,420,267,78,0,1450
Texas,Uvalde,16220,2883,2060,3250,926,334,9453
Texas,Utopia,227,49,10,67,11,0,137
Texas,University Park,24101,55,451,1602,5871,4815,12794
Texas,Universal City,19466,1133,2903,5201,2230,1286,12753
Texas,Union Valley,343,26,93,89,42,15,265
Texas,Granger,1583,233,431,339,129,15,1147
Texas,Grandview,1444,186,318,341,68,36,949
Texas,Grand Saline,3108,639,773,389,125,25,1951
Texas,Grand Prairie,183500,22482,29842,33349,18894,7338,111905
Texas,Grandfalls,331,56,101,17,21,2,197
Texas,Granbury,8750,687,1758,2329,918,556,6248
Texas,Graford,711,73,202,130,11,0,416
Texas,Porter Heights,1619,293,445,304,115,0,1157
Texas,Placedo,851,167,122,142,4,12,447
Texas,Piney Point Village,3270,19,158,222,957,1006,2362
Texas,Brazoria,3049,210,667,793,112,52,1834
Texas,Brazos Bend,335,14,56,85,95,34,284
Texas,Brazos Country,771,27,123,165,150,81,546
Texas,Breckenridge,5596,805,1182,807,494,177,3465
Texas,Bremond,956,166,274,193,61,9,703
Texas,La Vernia,1387,150,310,308,97,35,900
Texas,La Victoria,91,0,36,26,8,0,70
Texas,La Villa,2509,627,339,310,66,0,1342
Texas,Lavon,2507,77,350,560,387,103,1477
Texas,La Ward,190,31,24,51,5,3,114
Texas,Lawn,326,31,90,70,13,6,210
Texas,League City,91665,2816,11055,19997,17005,8497,59370
Texas,Brady,5509,986,1169,1123,304,146,3728
Texas,Leakey,637,72,130,100,68,25,395
Texas,Leary,690,66,195,145,55,14,475
Texas,Lefors,374,35,116,85,28,8,272
Texas,Leming,680,140,175,38,40,19,412
Texas,Leona,167,7,49,18,25,4,103
Texas,Leonard,2171,230,473,407,113,61,1284
Texas,Leon Valley,10846,618,1670,2942,1682,878,7790
Texas,Leroy,381,32,83,114,22,9,260
Texas,Levelland,13823,1774,2168,2864,858,368,8032
Texas,Lewisville,101151,8251,15181,21228,15189,5561,65410
Texas,Lexington,1301,108,349,239,93,37,826
Texas,Liberty,8817,1577,1581,1948,570,341,6017
Texas,Liberty City,2177,167,481,683,114,55,1500
Texas,Leander,32051,1769,4095,7144,4339,1903,19250
Texas,Brackettville,2060,587,444,307,53,14,1405
Texas,Boys Ranch,374,0,17,15,34,9,75
Texas,Boyd,1295,122,284,351,61,44,862
Texas,Bixby,624,118,100,81,0,0,299
Texas,Blackwell,383,41,90,70,39,23,263
Texas,Blanco,2309,252,432,441,231,105,1461
Texas,Blanket,384,37,116,86,14,2,255
Texas,Blessing,994,178,307,0,0,0,485
Texas,Bloomburg,390,57,108,59,9,5,238
Texas,Blooming Grove,963,63,208,234,47,8,560
Texas,Bloomington,1984,454,536,418,11,30,1449
Texas,Blossom,1253,175,303,306,76,19,879
Texas,Blue Berry Hill,581,228,60,48,0,0,336
Texas,Blue Mound,3348,749,731,476,74,27,2057
Texas,Blue Ridge,1138,109,291,272,22,8,702
Texas,Bluetown,287,125,20,4,0,0,149
Texas,Blum,462,87,118,52,19,7,283
Texas,Boerne,12272,803,1675,2430,2290,705,7903
Texas,Bogata,1191,302,261,183,103,10,859
Texas,Boling,959,190,300,214,7,45,756
Texas,Bolivar Peninsula,2196,204,447,486,330,197,1664
Texas,Bonanza Hills,121,0,16,22,0,15,53
Texas,Bonham,10044,1775,2399,1854,608,363,6999
Texas,Bonney,303,17,74,50,13,4,158
Texas,Booker,1483,183,357,241,88,46,915
Texas,Borger,13041,1503,2286,3031,817,376,8013
Texas,Botines,15,0,7,0,8,0,15
Texas,Bovina,1825,479,245,230,43,15,1012
Texas,Bowie,5172,571,1240,1174,282,121,3388
Texas,Box Canyon,25,13,9,3,0,0,25
Texas,Liberty Hill,1242,112,254,228,124,16,734
Texas,Lincoln Park,278,48,66,72,13,8,207
Texas,Lindale,5332,478,930,1245,723,272,3648
Texas,Linden,2256,276,632,435,135,80,1558
Texas,Lorena,1896,122,248,457,195,73,1095
Texas,Lorenzo,1160,221,224,214,25,17,701
Texas,Los Altos,109,31,0,0,0,0,31
Texas,Los Alvarez,374,171,21,11,0,0,203
Texas,Los Angeles,157,55,0,0,0,0,55
Texas,Los Arcos,60,16,8,0,0,0,24
Texas,Los Arrieros,40,2,33,3,0,0,38
Texas,Los Barreras,184,27,20,12,29,18,106
Texas,Los Centenarios,0,0,0,0,0,0,0
Texas,Los Corralitos,64,64,0,0,0,0,64
Texas,Los Ebanos CDP (Hidalgo County),197,121,0,38,0,23,182
Texas,Los Ebanos CDP (Starr County),356,125,27,64,5,0,221
Texas,Brenham,16257,1652,3081,3163,1239,712,9847
Texas,Briar,4221,441,998,1420,413,112,3384
Texas,Petrolia,686,83,235,137,13,3,471
Texas,Petronila,172,27,7,57,12,5,108
Texas,Pettus,557,83,109,122,7,0,321
Texas,Pflugerville,53847,2469,7246,12242,9003,3933,34893
Texas,Pharr,74273,15316,10336,9458,3773,1382,40265
Texas,Pilot Point,4011,761,684,926,279,117,2767
Texas,Pine Forest,605,50,226,108,25,7,416
Texas,Pine Harbor,690,144,230,151,0,34,559
Texas,Pinehurst,5011,626,1234,797,307,125,3089
Texas,Pinehurst,1933,176,426,572,162,29,1365
Texas,Pine Island,1416,290,300,190,68,60,908
Texas,Pineland,942,63,206,165,34,6,474
Texas,Pinewood Estates,1787,11,209,445,317,163,1145
Texas,Loraine,561,124,146,68,24,3,365
Texas,Pittsburg,4545,726,946,595,208,117,2592
Texas,Lopezville,4217,1212,472,348,354,86,2472
Texas,Loop,332,100,29,29,13,22,193
Texas,Lindsay,1103,26,155,279,187,51,698
Texas,Lindsay,351,100,58,21,0,0,179
Texas,Linn,562,146,71,81,34,22,354
Texas,Lipan,509,25,113,93,42,7,280
Texas,Lipscomb,29,0,14,10,0,2,26
Texas,Little Elm,32581,2017,4156,7331,4987,1637,20128
Texas,Littlefield,6263,909,1230,976,321,247,3683
Texas,Little River-Academy,1919,197,432,438,105,62,1234
Texas,Live Oak,14649,826,2649,3631,1924,1021,10051
Texas,Liverpool,375,42,97,115,14,6,274
Texas,Livingston,5219,603,1234,1094,388,273,3592
Texas,Llano,3313,469,621,767,339,214,2410
Texas,Llano Grande,3019,851,513,190,191,89,1834
Texas,Lockhart,13091,1757,3572,2241,779,346,8695
Texas,Lockney,1835,327,283,398,109,39,1156
Texas,Log Cabin,572,117,211,100,28,2,458
Texas,Loma Grande,20,9,11,0,0,0,20
Texas,Loma Linda,60,0,0,38,0,0,38
Texas,Loma Linda East CDP (Jim Wells County),302,0,98,31,24,0,153
Texas,Loma Linda East CDP (Starr County),0,0,0,0,0,0,0
Texas,Loma Linda West,163,64,8,0,0,0,72
Texas,Loma Vista,252,166,38,15,0,0,219
Texas,Lometa,1010,141,182,175,27,10,535
Texas,Lone Oak,579,42,161,95,56,18,372
Texas,Lone Star,1557,207,401,278,70,55,1011
Texas,Longoria,0,0,0,0,0,0,0
Texas,Longview,82112,8664,14356,18600,7426,3514,52560
Texas,Lope?o,0,0,0,0,0,0,0
Texas,Farmersville,3424,512,949,608,315,60,2444
Texas,Port Isabel,5033,1158,1070,727,304,125,3384
Texas,Port Lavaca,12315,1672,2406,2411,901,433,7823
Texas,Fulshear,3228,104,269,442,744,415,1974
Texas,Fruitvale,582,78,165,86,8,6,343
Texas,Frost,639,114,107,138,43,16,418
Texas,Fronton Ranchettes,155,17,5,11,0,12,45
Texas,Fronton,154,82,13,0,0,0,95
Texas,Fritch,2982,127,708,794,281,88,1998
Texas,Frisco,137797,3502,9670,21333,33969,16147,84621
Texas,Friona,4018,868,847,296,207,79,2297
Texas,Friendswood,37602,1241,4022,7597,8395,3748,25003
Texas,Fresno,21877,2156,2491,3545,2366,1306,11864
Texas,Freer,2775,467,649,478,81,1,1676
Texas,Freeport,12118,2258,2189,1758,410,87,6702
Texas,Fulton,1319,159,362,367,124,26,1038
Texas,Fredericksburg,10826,852,2112,2208,2003,978,8153
Texas,Franklin,1882,185,478,322,108,33,1126
Texas,Fowlerton,165,0,26,27,0,0,53
Texas,Four Points,0,0,0,0,0,0,0
Texas,Four Corners,13626,1566,1496,2594,1817,632,8105
Texas,Fort Worth,796614,93716,120493,140162,89292,43754,487417
Texas,Fort Stockton,8441,1501,1911,1451,376,171,5410
Texas,Fort Hood,30739,351,2981,6226,1203,352,11113
Texas,Tolar,996,7,265,210,107,19,608
Texas,Todd Mission,49,5,22,13,0,2,42
Texas,Toco,94,17,39,18,0,0,74
Texas,Tivoli,603,132,99,119,19,3,372
Texas,Tira,263,49,67,57,21,3,197
Texas,Frankston,1017,114,239,172,96,62,683
Texas,Gail,326,7,58,63,36,43,207
Texas,Gainesville,16119,2109,3747,2919,1162,332,10269
Texas,Galena Park,11126,2456,1939,1558,318,73,6344
Texas,Marquez,278,18,73,46,8,13,158
Texas,Marshall,23743,3184,4899,4057,2224,741,15105
Texas,Mart,2050,198,564,358,131,53,1304
Texas,Martindale,1341,213,318,136,119,77,863
Texas,Martinez,0,0,0,0,0,0,0
Texas,Mason,1873,330,482,287,132,114,1345
Texas,Matador,541,64,88,166,35,9,362
Texas,Matagorda,335,17,100,103,59,3,282
Texas,Mathis,4989,1393,614,680,127,68,2882
Texas,Maud,1027,31,260,235,57,20,603
Texas,Mauriceville,3132,286,836,629,273,54,2078
Texas,Maypearl,703,26,165,153,63,11,418
Texas,Meadow,801,93,156,173,43,12,477
Texas,Meadowlakes,2051,16,292,392,574,264,1538
Texas,Meadows Place,4730,195,620,953,1215,404,3387
Texas,Medina,4921,1484,676,215,40,13,2428
Texas,Megargel,224,42,70,73,1,0,186
Texas,Melissa,6214,124,683,1264,842,410,3323
Texas,Garfield,1535,309,293,267,138,19,1026
Texas,Garden Ridge,3637,30,306,494,1011,740,2581
Texas,Gardendale,1399,16,327,383,132,20,878
Texas,Garden City,292,35,43,66,49,8,201
Texas,Garciasville,55,11,11,0,0,0,22
Texas,Garceno,592,155,20,18,70,9,272
Texas,Ganado,1796,386,393,263,78,13,1133
Texas,Galveston,48971,6041,8188,9562,5218,4304,33313
Texas,Gallatin,349,49,101,55,27,6,238
Texas,Tioga,1035,83,273,257,62,15,690
Texas,Marlin,5804,1263,1249,902,252,117,3783
Texas,Timpson,1385,257,258,302,41,21,879
Texas,Timbercreek Canyon,408,10,68,94,102,43,317
Texas,Taylor,16276,2141,4022,2737,943,569,10412
Texas,Tatum,960,82,234,188,61,13,578
Texas,Tanquecitos South Acres II,0,0,0,0,0,0,0
Texas,Tanquecitos South Acres,471,142,10,0,13,24,189
Texas,Talty,1652,113,262,446,175,90,1086
Texas,Fort Hancock,1623,594,225,95,40,9,963
Texas,Fort Davis,1112,275,131,187,138,78,809
Texas,Fort Clark Springs,1012,94,224,287,172,21,798
Texas,Fort Bliss,9321,104,714,1673,733,329,3553
Texas,Forsan,216,16,25,68,15,6,130
Texas,Forney,16793,572,2688,3922,1909,983,10074
Texas,Forest Hill,12709,2338,2273,2144,501,258,7514
Texas,Taylor Lake Village,3638,64,370,552,1144,388,2518
Texas,Follett,577,71,128,104,52,16,371
Texas,Flower Mound,68654,1291,5140,11736,18042,7709,43918
Texas,Flowella,69,13,25,7,0,6,51
Texas,Floresville,6985,1152,1879,1225,331,137,4724
Texas,Florence,870,143,187,159,33,31,553
Texas,Flor del Rio,139,74,13,0,0,0,87
Texas,Flatonia,1565,490,319,233,54,27,1123
Texas,Fifth Street,1943,824,201,0,29,0,1054
Texas,Ferris,2489,445,438,364,121,49,1417
Texas,Fernando Salinas,11,6,5,0,0,0,11
Texas,Faysville,608,89,72,133,14,12,320
Texas,Fayetteville,251,14,84,76,29,6,209
Texas,Fate,8414,387,831,1739,1731,535,5223
Texas,Floydada,2916,580,591,384,172,69,1796
Texas,Taylor Landing,227,4,33,78,36,30,181
Texas,Teague,3546,387,632,1004,218,62,2303
Texas,Tehuacana,256,28,69,60,27,10,194
Texas,Tilden,365,46,59,55,33,36,229
Texas,Tiki Island,873,30,151,273,230,115,799
Texas,Tierra Verde,296,21,55,57,18,0,151
Texas,Tierra Grande,165,10,10,71,16,26,133
Texas,Tierra Dorada,8,8,0,0,0,0,8
Texas,Tierra Bonita,112,26,0,23,0,0,49
Texas,Thunderbird Bay,634,76,172,215,75,10,548
Texas,Throckmorton,738,127,178,152,100,18,575
Texas,Three Rivers,1596,249,372,333,92,11,1057
Texas,Thrall,656,110,185,94,50,16,455
Texas,Thorntonville,495,105,111,98,22,3,339
Texas,Thornton,404,66,116,95,8,8,293
Texas,Thorndale,1414,262,266,210,111,47,896
Texas,Thompsonville,0,0,0,0,0,0,0
Texas,Thompsons,163,22,36,34,14,12,118
Texas,The Woodlands,105713,1992,7939,16576,26656,15511,68674
Texas,The Hills,2550,3,159,420,883,291,1756
Texas,The Colony,39736,1549,6194,10033,6202,2368,26346
Texas,Texline,490,61,85,159,21,12,338
Texas,Texhoma,275,17,115,52,41,4,229
Texas,Texas City,46266,5412,9326,11576,2641,1227,30182
Texas,Texarkana,37088,3029,7494,7515,3934,2056,24028
Texas,Terrell Hills,5123,93,168,566,1366,1277,3470
Texas,Terrell,16355,2464,3328,3074,987,514,10367
Texas,Terlingua,145,3,35,18,67,8,131
Texas,Tenaha,1454,302,268,180,32,32,814
Texas,Temple,69938,5538,14356,14136,7291,4511,45832
Texas,Timberwood Park,26219,634,2752,4919,5168,2979,16452
Texas,Portland,15638,983,2555,3764,1590,793,9685
Texas,Howe,2635,242,565,527,173,87,1594
Texas,Los Fresnos,6280,1289,748,650,437,108,3232
Texas,Turkey,367,46,65,95,23,2,231
Texas,Tulsita,45,13,32,0,0,0,45
Texas,Tulia,4872,787,1154,785,250,148,3124
Texas,Tuleta,274,24,91,64,36,0,215
Texas,Troy,1755,203,379,388,107,31,1108
Texas,Troup,1661,215,445,277,132,36,1105
Texas,Trophy Club,10187,117,759,1581,2896,1320,6673
Texas,Trinity,2748,608,1001,389,70,14,2082
Texas,Trinidad,838,85,275,147,28,13,548
Texas,Trenton,775,122,170,195,43,13,543
Texas,Trent,291,26,57,89,22,3,197
Texas,Travis Ranch,3021,246,315,568,455,243,1827
Texas,Tradewinds,131,49,45,13,0,0,107
Texas,Toyah,164,26,36,14,8,0,84
Texas,Tornillo,1367,354,157,162,15,9,697
Texas,Tool,2438,388,646,485,179,91,1789
Texas,Tom Bean,1004,52,200,270,39,36,597
Texas,Tomball,11186,788,2277,1997,1341,635,7038
Texas,Powell,79,18,11,15,6,1,51
Texas,Los Fresnos,61,0,8,15,0,0,23
Texas,Los Huisaches,27,0,0,0,0,18,18
Texas,Los Indios,1222,306,245,145,12,21,729
Texas,Los Lobos,0,0,0,0,0,0,0
Texas,Tuscola,769,35,187,162,59,23,466
Texas,Tye,1153,188,301,178,43,13,723
Texas,Tyler,100806,10333,13659,20798,11627,6484,62901
Texas,Tynan,269,61,61,49,10,0,181
Texas,Prairie View,6064,111,135,148,68,113,575
Texas,Premont,2686,613,577,437,51,19,1697
Texas,Presidio,4139,1626,400,174,195,275,2670
Texas,Preston,1713,288,456,495,191,37,1467
Texas,Primera,4247,568,654,655,438,60,2375
Texas,Princeton,7942,726,1492,1753,811,193,4975
Texas,Progreso,5789,1779,742,649,118,87,3375
Texas,Progreso Lakes,352,59,66,82,41,13,261
Texas,Prosper,13939,247,1414,2669,2670,1210,8210
Texas,Providence Village,5160,19,634,1036,1077,245,3011
Texas,Pueblo East,0,0,0,0,0,0,0
Texas,Los Minerales,33,24,0,5,0,0,29
Texas,Pueblo Nuevo,795,185,57,51,0,0,293
Texas,Pyote,130,24,12,40,5,0,81
Texas,Quail,18,2,9,4,0,0,15
Texas,Quail Creek,1653,107,402,406,266,23,1204
Texas,Quanah,2568,319,675,494,219,79,1786
Texas,Queen City,1863,177,544,334,51,18,1124
Texas,Quemado,169,116,17,0,9,0,142
Texas,Quesada,0,0,0,0,0,0,0
Texas,Quinlan,1631,288,434,256,62,6,1046
Texas,Union Grove,348,34,92,85,10,4,225
Texas,Uncertain,94,12,40,26,14,2,94
Texas,Uhland,1214,208,215,171,39,12,645
Texas,Putnam,65,5,11,17,8,0,41
Texas,Los Nopalitos,94,15,8,0,0,0,23
Texas,Lost Creek,4570,0,40,425,1354,1174,2993
Texas,Los Veteranos I,0,0,0,0,0,0,0
Texas,Malakoff,2982,504,629,398,155,95,1781
Texas,Malone,290,22,79,68,4,4,177
Texas,Manchaca,1427,46,273,200,556,51,1126
Texas,Manor,6435,844,804,1221,614,82,3565
Texas,Mansfield,61559,2182,7715,12929,11471,4569,38866
Texas,Manuel Garcia,310,55,38,0,13,0,106
Texas,Manuel Garcia II,232,131,0,32,0,0,163
Texas,Manvel,6690,557,1143,1768,531,348,4347
Texas,Marathon,546,83,124,91,101,42,441
Texas,Marble Falls,6170,706,1127,1446,637,280,4196
Texas,Marfa,1921,220,269,264,315,241,1309
Texas,Magnolia,1566,158,305,347,107,69,986
Texas,Marietta,109,21,38,11,11,3,84
Texas,Markham,1280,222,256,184,100,26,788
Texas,Powderly,835,59,219,206,91,80,655
Texas,Pottsboro,2411,75,361,733,233,126,1528
Texas,Potosi,3113,159,473,705,420,177,1934
Texas,Poth,2114,270,429,360,157,76,1292
Texas,Poteet,3359,685,754,434,16,5,1894
Texas,Post Oak Bend City,992,133,176,265,113,33,720
Texas,Post,5218,1842,1034,803,192,153,4024
Texas,Port O'Connor,923,89,169,196,125,43,622
Texas,Port Neches,12826,590,2785,3425,1590,566,8956
Texas,Port Mansfield,70,0,13,27,25,5,70
Texas,Marion,1051,129,243,190,75,17,654
Texas,Prado Verde,262,30,12,70,21,39,172
Texas,Madisonville,4518,770,1116,803,263,66,3018
Texas,McLendon-Chisholm,1655,41,274,377,300,165,1157
Texas,Los Veteranos II,65,22,22,0,0,0,44
Texas,Los Ybanez,11,1,7,3,0,0,11
Texas,Lott,851,128,179,168,49,6,530
Texas,Louise,599,60,193,149,40,35,477
Texas,Lovelady,579,31,130,131,23,9,324
Texas,Lowry Crossing,1747,61,356,485,293,75,1270
Texas,Lozano,593,125,0,94,61,0,280
Texas,Lubbock,240719,20247,34205,43696,24793,14796,137737
Texas,Lucas,6241,136,623,1147,1574,606,4086
Texas,Lueders,141,22,37,50,4,0,113
Texas,Lufkin,36015,5154,5722,7107,2844,1765,22592
Texas,McQueeney,2480,216,686,599,209,119,1829
Texas,Luling,5624,1091,1171,920,677,100,3959
Texas,Lyford,2601,530,537,285,119,31,1502
Texas,Lytle,2934,480,803,567,231,48,2129
Texas,Mabank,3327,356,813,459,154,148,1930
Texas,McAllen,136993,22005,16314,21527,16421,6756,83023
Texas,McCamey,1870,228,417,273,44,30,992
Texas,McDade,913,146,200,122,72,18,558
Texas,Macdona,285,57,139,69,0,6,271
Texas,McGregor,5042,555,1187,833,166,192,2933
Texas,McKinney,150064,7221,15662,28210,28267,13639,92999
Texas,McKinney Acres,1086,268,195,97,34,0,594
Texas,McLean,942,101,214,226,34,8,583
Texas,Lumberton,12216,881,2668,2985,1109,466,8109
Texas,Poynor,208,17,71,49,19,0,156
Utah,Apple Valley,996,49,174,275,96,42,636
Utah,Alpine,9986,137,510,2096,1533,954,5230
Utah,Alta,391,0,75,53,40,40,208
Utah,Altamont,211,8,47,39,19,9,122
Utah,Alton,128,0,10,33,9,8,60
Utah,Amalga,568,44,90,96,46,19,295
Utah,American Fork,27799,943,2728,6167,3407,1531,14776
Utah,Aneth,446,81,77,57,31,0,246
Utah,Annabella,862,25,119,214,68,42,468
Utah,Antimony,118,11,33,42,10,7,103
Utah,Ballard,812,102,205,134,36,6,483
Utah,Aurora,938,15,236,262,52,30,595
Utah,Avon,293,3,76,49,26,57,211
Utah,Elk Ridge,2856,11,221,603,392,188,1415
Utah,Beaver,3051,108,645,643,239,92,1727
Utah,Tremonton,7999,760,1083,1800,516,179,4338
Utah,Trenton,473,23,96,121,31,10,281
Utah,Tropic,655,24,122,144,73,29,392
Utah,Tselakai Dezza,155,21,77,21,0,0,119
Utah,Uintah,1427,24,278,329,184,63,878
Utah,Vernal,10321,846,2338,1957,664,345,6150
Utah,Vernon,266,10,65,54,14,3,146
Utah,Veyo,492,35,133,144,58,0,370
Utah,Vineyard,901,41,47,248,152,84,572
Utah,Virgin,503,47,112,124,37,14,334
Utah,Torrey,222,12,41,68,40,9,170
Utah,Wales,273,13,48,69,17,3,150
Utah,Wanship,497,9,99,76,61,5,250
Utah,Washington,22080,953,3571,5636,2460,1226,13846
Utah,Washington Terrace,9119,427,2037,2098,746,334,5642
Utah,Wellington,1694,126,321,538,75,58,1118
Utah,Wellsville,3593,114,544,716,400,188,1962
Utah,Wendover,1273,318,168,99,45,17,647
Utah,West Bountiful,5394,97,847,1322,727,263,3256
Utah,West Haven,11323,465,1800,2366,1152,442,6225
Utah,West Jordan,109549,5874,17191,24976,10785,4107,62933
Utah,West Mountain,950,8,66,307,100,71,552
Utah,Wallsburg,368,12,102,100,31,7,252
Utah,Toquerville,1838,88,243,465,317,93,1206
Utah,Tooele,32454,1522,6469,7270,2932,876,19069
Utah,Timber Lakes,410,39,38,170,102,37,386
Utah,South Salt Lake,24501,2953,3327,5131,2600,1155,15166
Utah,South Weber,6568,264,837,1424,828,315,3668
Utah,South Willard,1992,59,361,408,167,69,1064
Utah,Spanish Fork,36916,1648,4176,7530,3547,1649,18550
Utah,Spanish Valley,276,4,73,70,57,0,204
Utah,Spring City,916,62,140,243,85,68,598
Utah,Springdale,444,18,60,174,96,58,406
Utah,Spring Glen,1217,42,210,521,97,34,904
Utah,Spring Lake,383,0,68,54,28,1,151
Utah,Springville,31178,1197,2731,5950,4040,1837,15755
Utah,Stansbury Park,8752,50,1144,1856,1085,406,4541
Utah,Sterling,226,3,36,78,19,14,150
Utah,Stockton,721,36,226,209,22,3,496
Utah,Summit,142,0,45,18,14,11,88
Utah,Summit Park,8025,214,366,1219,1875,1550,5224
Utah,Sunset,5163,348,1199,1130,350,30,3057
Utah,Sutherland,296,0,97,32,41,22,192
Utah,Syracuse,25977,340,2743,5350,3410,1667,13510
Utah,Tabiona,128,8,46,29,2,2,87
Utah,Taylorsville,60383,4209,10226,15395,5908,2281,38019
Utah,Teasdale,132,0,31,25,35,0,91
Utah,Thatcher,665,29,79,100,117,43,368
Utah,Thompson Springs,85,0,22,19,0,0,41
Utah,West Point,9932,112,1431,2505,1142,203,5393
Utah,West Valley City,133660,17600,25433,24480,7456,2387,77356
Utah,West Wood,738,18,109,173,78,78,456
Utah,White City,5497,281,929,1580,639,219,3648
Utah,Independence,185,2,22,52,12,13,101
Utah,Hyrum,7820,359,1161,1458,746,192,3916
Utah,Hyde Park,4170,57,425,800,589,352,2223
Utah,Hurricane,14694,601,2848,3954,1283,712,9398
Utah,Huntsville,804,16,131,180,129,60,516
Utah,Huntington,2044,188,392,574,104,19,1277
Utah,Hoytsville,761,96,113,242,42,13,506
Utah,Howell,237,11,91,57,8,1,168
Utah,Hooper,7873,260,1321,2101,658,369,4709
Utah,Honeyville,1350,12,319,326,108,54,819
Utah,Holladay,30748,587,3211,6427,6761,4259,21245
Utah,Holden,375,6,38,132,51,6,233
Utah,Hinckley,638,55,115,176,46,12,404
Utah,Hildale,2926,242,312,231,33,9,827
Utah,Highland,17030,87,755,2434,3008,1706,7990
Utah,Hideout,691,127,113,104,58,44,446
Utah,Herriman,26721,271,2664,5848,2609,1152,12544
Utah,Henrieville,244,21,62,62,12,3,160
Utah,Henefer,667,23,121,193,53,20,410
Utah,Helper,2169,164,373,612,179,41,1369
Utah,Heber,13001,669,1495,2707,1225,723,6819
Utah,Hatch,175,25,34,46,25,4,134
Utah,Harrisville,5942,252,1150,1394,656,102,3554
Utah,Ivins,7406,315,1214,2198,887,575,5189
Utah,South Ogden,16805,620,2784,4296,1970,1087,10757
Utah,Jensen,197,0,26,31,19,0,76
Utah,Junction,262,52,86,39,2,0,179
Utah,White Mesa,276,25,91,8,0,0,124
Utah,Whiterocks,108,23,21,0,17,0,61
Utah,Willard,1737,57,392,432,141,77,1099
Utah,Wolf Creek,800,53,103,221,184,128,689
Utah,Woodland,163,0,55,63,16,10,144
Utah,Woodland Hills,1389,19,101,303,224,158,805
Utah,Woodruff,294,5,108,61,3,7,184
Utah,Leeds,890,23,180,252,101,85,641
Utah,Leamington,254,9,24,81,37,14,165
Utah,Layton,71007,2271,8473,16826,9144,3545,40259
Utah,La Verkin,4156,215,770,1138,317,97,2537
Utah,La Sal,267,61,18,149,0,5,233
Utah,Laketown,242,4,22,70,38,11,145
Utah,Lake Shore,723,17,116,232,72,10,447
Utah,Koosharem,284,15,33,76,18,13,155
Utah,Kingston,270,31,45,54,12,32,174
Utah,Kenilworth,123,13,16,63,8,23,123
Utah,Kearns,36530,4677,6951,6750,1805,447,20630
Utah,Kaysville,29213,310,2564,5414,4874,2297,15459
Utah,Kanosh,410,27,97,113,29,11,277
Utah,Kanarraville,290,12,53,103,29,15,212
Utah,Kanab,4410,88,904,1226,531,340,3089
Utah,Kamas,2148,227,431,398,145,34,1235
Utah,Joseph,350,56,84,90,12,6,248
Utah,South Jordan,59662,1142,5855,13376,9417,4986,34776
Utah,Snyderville,6252,216,393,974,1723,885,4191
Utah,Snowville,117,9,39,20,5,1,74
Utah,Orem,91697,4080,7658,18659,11679,5425,47501
Utah,Palmyra,387,4,60,138,61,14,277
Utah,Panguitch,1789,84,394,485,125,37,1125
Utah,Paradise,1134,37,146,230,124,75,612
Utah,Paragonah,543,17,140,163,55,18,393
Utah,Park City,7963,461,567,1287,1989,1448,5752
Utah,Parowan,2858,82,659,741,210,129,1821
Utah,Payson,19313,1089,2567,4111,1623,596,9986
Utah,Peoa,130,0,54,31,23,22,130
Utah,Perry,4566,68,602,978,606,340,2594
Utah,Peter,431,0,57,142,67,39,305
Utah,Pine Valley,150,0,44,41,26,0,111
Utah,Plain City,6028,130,927,1518,645,248,3468
Utah,Pleasant Grove,35771,939,3349,6943,4663,2038,17932
Utah,Pleasant View,8647,270,1103,1755,1321,635,5084
Utah,Plymouth,362,35,110,85,16,1,247
Utah,Portage,287,8,83,69,20,3,183
Utah,Price,8505,677,1284,2105,578,272,4916
Utah,Providence,7043,112,655,1271,1093,730,3861
Utah,Provo,115345,4567,6662,17510,12965,6268,47972
Utah,Randlett,184,25,51,29,0,0,105
Utah,Randolph,535,22,167,103,27,8,327
Utah,Redmond,710,43,191,141,33,29,437
Utah,Orderville,782,44,158,224,39,24,489
Utah,Richfield,7570,374,1334,1840,532,275,4355
Utah,Orangeville,1597,56,302,437,74,29,898
Utah,Oljato-Monument Valley,1151,74,326,161,34,31,626
Utah,Montezuma Creek,350,64,82,44,7,0,197
Utah,Monticello,2517,140,442,534,202,167,1485
Utah,Morgan,3855,44,576,814,543,228,2205
Utah,Moroni,1543,217,234,255,101,29,836
Utah,Mountain Green,2981,12,310,598,513,166,1599
Utah,Mount Pleasant,3251,197,595,648,246,160,1846
Utah,Murray,48460,2492,7161,13018,6311,3278,32260
Utah,Myton,512,85,131,81,10,13,320
Utah,Naples,2352,138,487,525,112,46,1308
Utah,Navajo Mountain,521,65,68,79,11,8,231
Utah,Neola,419,24,91,82,11,0,208
Utah,Nephi,5463,318,984,1355,365,112,3134
Utah,Newcastle,299,0,0,98,89,0,187
Utah,New Harmony,192,8,34,73,20,15,150
Utah,Newton,831,30,167,188,87,37,509
Utah,Nibley,6060,127,474,1174,661,376,2812
Utah,North Logan,9380,269,693,1369,1464,948,4743
Utah,North Ogden,18006,432,2862,4294,2350,1032,10970
Utah,North Salt Lake,18046,872,2178,3290,2981,1610,10931
Utah,Oak City,662,25,86,188,92,18,409
Utah,Oakley,1412,64,276,300,136,92,868
Utah,Oasis,0,0,0,0,0,0,0
Utah,Ogden,84273,9084,15075,17529,6452,3207,51347
Utah,Ophir,18,1,5,10,2,0,18
Utah,Hanksville,118,10,33,32,1,0,76
Utah,Richmond,2526,48,559,492,262,112,1473
Utah,River Heights,1973,33,227,397,343,182,1182
Utah,Mexican Hat,0,0,0,0,0,0,0
Utah,Mendon,1121,3,154,227,165,49,598
Utah,Meadow,298,10,67,65,22,20,184
Utah,Mayfield,416,8,74,118,58,27,285
Utah,Marysvale,468,82,167,91,33,15,388
Utah,Marriott-Slaterville,1819,80,337,484,110,61,1072
Utah,Marion,711,15,102,242,71,7,437
Utah,Mapleton,8788,140,676,1904,1260,665,4645
Utah,Mantua,674,19,128,158,103,60,468
Utah,Manti,3301,154,407,893,313,173,1940
Utah,Manila,128,7,36,32,10,1,86
Utah,Magna,27451,2917,5497,5818,1251,338,15821
Utah,Maeser,4260,237,626,1015,298,132,2308
Utah,Lynndyl,104,2,22,32,12,3,71
Utah,Lyman,358,4,35,130,36,5,210
Utah,Logan,49400,2521,4289,7406,5566,2632,22414
Utah,Loa,472,32,89,125,32,8,286
Utah,Lindon,10552,253,746,2219,1477,765,5460
Utah,Liberty,1881,26,427,373,165,98,1089
Utah,Lewiston,2048,85,381,412,217,63,1158
Utah,Levan,738,43,264,124,45,5,481
Utah,Lehi,54079,847,4457,10531,7694,2781,26310
Utah,Smithfield,10413,278,1402,2059,1213,535,5487
Utah,Midvale,30844,2487,5274,7176,3449,1494,19880
Utah,Riverdale,8610,449,1610,2095,821,300,5275
Utah,Midway,4261,124,576,1163,519,326,2708
Utah,Millcreek,60119,2447,7506,13145,11461,6775,41334
Utah,Riverside,829,35,101,241,53,20,450
Utah,Riverton,40912,1024,4587,10462,5240,2037,23350
Utah,Rockville,395,24,62,120,59,30,295
Utah,Rocky Ridge,1168,37,127,120,37,1,322
Utah,Roosevelt,6555,383,1177,1176,487,163,3386
Utah,Roy,37670,2093,6907,8965,3457,1019,22441
Utah,Rush Valley,564,56,140,162,38,22,418
Utah,St. George,76915,3881,10939,19134,8171,5349,47474
Utah,Salem,7015,134,823,1463,800,450,3670
Utah,Salina,2503,208,614,659,90,63,1634
Utah,Salt Lake City,190679,15648,21609,33182,30460,22943,123842
Utah,Samak,146,4,30,14,62,0,110
Utah,Sandy,91533,2487,11326,21214,14962,7766,57755
Utah,Santa Clara,6550,138,590,1554,902,542,3726
Utah,Santaquin,10054,455,1247,1797,805,296,4600
Utah,Saratoga Springs,22532,350,1377,4071,3321,1179,10298
Utah,Scipio,408,23,117,113,44,4,301
Utah,Scofield,34,6,4,9,9,0,28
Utah,Sigurd,561,45,147,115,14,3,324
Utah,Silver Summit,3768,78,183,564,893,658,2376
Utah,Moab,5175,358,1015,1362,635,197,3567
Utah,Minersville,863,35,223,207,56,16,537
Utah,Millville,2080,64,301,325,264,172,1126
Utah,Milford,1516,88,379,216,128,57,868
Utah,Monroe,2603,163,508,644,223,130,1668
Utah,Halls Crossing,0,0,0,0,0,0,0
Utah,Gunnison,3256,363,796,949,165,121,2394
Utah,Coalville,1502,120,332,286,113,45,896
Utah,Copperton,648,43,218,193,0,10,464
Utah,Corinne,865,51,198,167,72,13,501
Utah,Cornish,359,29,79,66,22,8,204
Utah,Cottonwood Heights,34234,712,4101,7350,7157,3683,23003
Utah,Cove,406,0,83,82,53,44,262
Utah,Dammeron Valley,484,0,187,142,54,101,484
Utah,Daniel,1072,47,264,280,128,40,759
Utah,Delta,3466,227,475,808,368,132,2010
Utah,Deseret,309,26,88,32,70,0,216
Utah,Deweyville,353,28,94,74,39,9,244
Utah,Draper,45469,860,4845,9967,7000,4410,27082
Utah,Duchesne,2051,186,395,371,115,33,1100
Utah,Dugway,597,29,148,121,48,21,367
Utah,Dutch John,143,0,21,60,14,0,95
Utah,Eagle Mountain,25037,500,1856,5362,2833,660,11211
Utah,East Carbon-Sunnyside,1480,156,340,445,32,8,981
Utah,Escalante,797,79,176,189,79,62,585
Utah,Erda,2181,78,378,487,220,65,1228
Utah,Ephraim,6598,293,419,1042,398,297,2449
Utah,Enterprise,1691,45,212,381,106,83,827
Utah,Enterprise,683,0,24,155,56,74,309
Utah,Enoch,6075,121,865,1497,303,257,3043
Utah,Clinton,21036,814,3048,5265,1901,803,11831
Utah,Emigration Canyon,1838,5,117,278,248,607,1255
Utah,Elwood,1209,26,192,301,143,53,715
Utah,Elsinore,799,42,187,241,64,6,540
Utah,Elmo,368,28,113,100,8,4,253
Utah,Elberta,223,40,24,33,27,5,129
Utah,Eden,627,16,47,123,86,98,370
Utah,Echo,99,0,20,26,0,0,46
Utah,Emery,335,27,84,94,23,2,230
Utah,Eureka,658,18,185,198,32,12,445
Utah,Cleveland,557,11,93,163,28,12,307
Utah,Clear Creek,0,0,0,0,0,0,0
Utah,Benjamin,1545,46,291,293,184,34,848
Utah,Benson,1190,57,250,358,149,64,878
Utah,Beryl Junction,0,0,0,0,0,0,0
Utah,Bicknell,352,13,64,78,58,33,246
Utah,Big Water,555,26,143,187,26,30,412
Utah,Blanding,3564,59,346,813,297,196,1711
Utah,Bluebell,149,13,61,26,23,0,123
Utah,Bluff,358,24,23,38,109,146,340
Utah,Bluffdale,9008,135,1286,1879,1005,281,4586
Utah,Bonanza,0,0,0,0,0,0,0
Utah,Boulder,130,0,23,45,35,19,122
Utah,Bountiful,43221,1289,4876,10238,7234,3598,27235
Utah,Brian Head,60,5,5,9,5,10,34
Utah,Brigham City,18397,846,3783,3974,1594,646,10843
Utah,Bryce Canyon City,158,8,25,9,11,0,53
Utah,Cache,0,0,0,0,0,0,0
Utah,Cannonville,231,9,52,36,21,21,139
Utah,Clawson,171,4,51,51,2,0,108
Utah,Clarkston,633,26,147,109,65,20,367
Utah,Circleville,635,43,201,129,73,8,454
Utah,Charleston,614,21,80,195,69,53,418
Utah,Central Valley,627,32,108,171,42,51,404
Utah,Central,742,19,183,226,94,18,540
Utah,Clearfield,30299,1258,5243,6562,2612,697,16372
Utah,Centerville,16387,267,1833,3754,2927,1585,10366
Utah,Cedar Hills,10165,45,449,1704,1650,961,4809
Utah,Cedar Fort,423,39,99,97,18,18,271
Utah,Cedar City,29429,1319,3227,5485,3334,1750,15115
Utah,Castle Valley,310,24,46,91,84,41,286
Utah,Castle Dale,1758,51,377,468,121,54,1071
Utah,Carbonville,1558,132,260,475,127,9,1003
Utah,Centerfield,1134,114,204,311,69,3,701
Utah,Halchita,521,58,85,51,9,0,203
Utah,Mona,1464,61,296,277,139,36,809
Utah,Fairview,1819,76,362,403,124,36,1001
Utah,Bear River City,843,35,169,240,80,19,543
Utah,Woods Cross,10686,161,1503,2727,1324,390,6105
Utah,Fairfield,135,5,34,41,6,3,89
Utah,Farmington,21223,218,1438,4731,3512,2009,11908
Utah,Farr West,6270,253,1096,1749,587,188,3873
Utah,Fayette,328,8,28,79,34,8,157
Utah,Ferron,1634,94,320,482,101,24,1021
Utah,Fielding,417,27,94,107,23,7,258
Utah,Flaming Gorge,90,0,30,12,9,3,54
Utah,Fort Duchesne,784,166,139,56,17,29,407
Utah,Fountain Green,989,59,218,237,81,18,613
Utah,Francis,1217,40,200,318,136,36,730
Utah,Fillmore,2849,273,589,558,141,80,1641
Utah,Fruit Heights,5625,53,398,1195,1097,543,3286
Utah,Green River,1106,110,238,166,90,9,613
Utah,Grantsville,9609,299,1683,2021,845,409,5257
Utah,Fremont,127,0,25,38,0,0,63
Utah,Goshen,916,103,166,195,41,6,511
Utah,Glenwood,555,32,82,118,47,40,319
Utah,Granite,1414,62,142,247,439,196,1086
Utah,Genola,1467,119,251,298,118,33,819
Utah,Garland,2491,110,497,556,167,52,1382
Utah,Garden City,683,4,107,204,70,17,402
Utah,Garden,161,0,72,47,0,0,119
Utah,Glendale,284,7,45,102,22,15,191
Vermont,Concord,277,29,137,17,12,0,195
Vermont,East Burke,111,0,13,8,32,12,65
Vermont,Coventry,98,6,29,10,16,0,61
Vermont,Danville,326,20,95,55,44,60,274
Vermont,Derby Center,555,85,158,90,35,27,395
Vermont,Derby Line,814,39,182,172,108,57,558
Vermont,Dorset,311,0,31,79,124,60,294
Vermont,Perkinsville,191,5,53,28,20,14,120
Vermont,East Barre,996,9,332,122,145,95,703
Vermont,East Middlebury,279,0,87,32,84,19,222
Vermont,Windsor,2194,149,565,300,309,127,1450
Vermont,Enosburg Falls,1341,212,390,262,105,57,1026
Vermont,Essex Junction,9709,199,1453,2049,1780,1109,6590
Vermont,Fairfax,703,32,142,147,37,224,582
Vermont,Fair Haven,2238,188,527,462,238,149,1564
Vermont,Fairlee,294,0,74,48,36,26,184
Vermont,Glover,292,56,90,70,30,4,250
Vermont,Worcester,94,10,7,19,23,4,63
Vermont,Orleans,835,96,194,147,51,19,507
Vermont,Chester,775,28,403,129,28,77,665
Vermont,East Montpelier,63,0,17,32,0,14,63
Vermont,Chelsea,319,65,69,48,29,39,250
Vermont,Bennington,8865,783,2111,1660,1341,494,6389
Vermont,Castleton,1203,13,64,28,107,33,245
Vermont,Albany,195,12,60,20,21,2,115
Vermont,Alburgh,489,38,164,73,35,9,319
Vermont,Arlington,1287,77,262,318,177,141,975
Vermont,Ascutney,393,52,234,74,15,0,375
Vermont,Barnet,187,3,76,25,22,9,135
Vermont,Barre,8885,663,2217,1785,1155,403,6223
Vermont,Barton,567,109,169,110,36,13,437
Vermont,Beecher Falls,160,42,50,28,6,3,129
Vermont,Bellows Falls,2985,225,886,592,242,110,2055
Vermont,Cavendish,240,17,51,71,40,36,215
Vermont,Old Bennington,155,0,10,16,39,48,113
Vermont,Bethel,649,40,187,89,80,43,439
Vermont,Bradford,895,77,212,179,98,42,608
Vermont,Brandon,1617,129,348,236,190,197,1100
Vermont,Brattleboro,7259,598,1397,1313,877,966,5151
Vermont,Bristol,1831,44,453,418,177,249,1341
Vermont,Burlington,42570,2511,4090,4722,6822,4733,22878
Vermont,Cabot,202,13,43,37,10,26,129
Vermont,Cambridge,188,11,32,46,52,13,154
Vermont,Canaan,322,33,122,72,6,2,235
Vermont,Benson,309,17,105,56,23,17,218
Vermont,Norwich,1058,18,10,46,360,330,764
Vermont,North Westminster,243,35,72,35,19,2,163
Vermont,North Troy,635,111,173,86,19,21,410
Vermont,South Shaftsbury,540,31,180,76,76,16,379
Vermont,South Royalton,727,0,116,41,225,219,601
Vermont,South Burlington,18536,657,2413,3305,4541,2903,13819
Vermont,South Barre,1457,74,480,246,159,65,1024
Vermont,Shelburne,690,36,117,164,129,47,493
Vermont,Saxtons River,562,39,51,93,115,70,368
Vermont,Springfield,3700,192,1078,816,238,108,2432
Vermont,St. Johnsbury,6122,523,1355,1264,776,537,4455
Vermont,Rutland,16091,1197,3986,3113,2024,1282,11602
Vermont,Rochester,304,10,82,48,48,19,207
Vermont,Richmond,630,38,178,24,153,41,434
Vermont,Richford,1338,250,491,184,62,22,1009
Vermont,Readsboro,272,61,80,45,22,7,215
Vermont,Randolph,2214,241,565,319,324,238,1687
Vermont,St. Albans,6864,332,1585,1486,953,323,4679
Vermont,Stowe,434,26,31,102,217,58,434
Vermont,Swanton,2558,262,875,480,173,50,1840
Vermont,Troy,134,26,48,34,24,0,132
Vermont,Wilmington,442,7,58,130,61,15,271
Vermont,Williamstown,1161,92,349,222,56,76,795
Vermont,Wilder,1562,30,259,235,374,189,1087
Vermont,White River Junction,2267,218,511,499,215,178,1621
Vermont,West Rutland,2075,193,653,363,190,72,1471
Vermont,Westminster,279,13,93,47,34,34,221
Vermont,West Burke,332,33,90,56,31,13,223
Vermont,West Brattleboro,2559,233,690,356,360,210,1849
Vermont,Wells River,386,55,93,80,35,12,275
Vermont,Wells,354,31,84,94,25,19,253
Vermont,Websterville,432,28,179,103,9,0,319
Vermont,Waterbury,1815,64,259,362,427,192,1304
Vermont,Wallingford,717,41,194,97,144,51,527
Vermont,Waitsfield,192,0,13,55,49,28,145
Vermont,Vergennes,2629,158,605,558,439,149,1909
Vermont,Quechee,645,0,67,110,141,86,404
Vermont,Winooski,7223,703,1244,1118,1090,535,4690
Vermont,Putney,395,38,90,47,86,79,340
Vermont,Woodstock,1064,25,108,187,245,237,802
Vermont,Marshfield,293,13,59,48,36,17,173
Vermont,Middlebury,6885,220,922,664,695,846,3347
Vermont,Milton,1926,157,511,424,253,56,1401
Vermont,Montpelier,7712,305,1089,1092,1547,1571,5604
Vermont,Morrisville,2401,238,637,575,350,149,1949
Vermont,Newbury,313,20,95,48,55,44,262
Vermont,Manchester Center,2238,108,483,390,281,143,1405
Vermont,Newfane,65,0,18,6,11,18,53
Vermont,Newport Center,288,40,46,84,40,0,210
Vermont,North Bennington,1795,91,186,232,199,131,839
Vermont,Northfield,2181,133,566,325,203,147,1374
Vermont,North Hartland,172,0,90,27,0,9,126
Vermont,North Springfield,549,106,149,195,35,0,485
Vermont,Pittsford,539,70,123,157,97,8,455
Vermont,Newport,4493,506,1211,776,362,216,3071
Vermont,Manchester,777,48,70,93,229,131,571
Vermont,Lyndonville,1178,51,355,190,64,39,699
Vermont,Ludlow,944,83,221,189,151,82,726
Vermont,Graniteville,595,28,282,87,26,53,476
Vermont,Greensboro,103,4,14,18,38,27,101
Vermont,Greensboro Bend,232,17,81,23,20,16,157
Vermont,Groton,432,33,117,96,31,16,293
Vermont,Hardwick,1478,170,348,291,109,122,1040
Vermont,Hartland,395,0,69,103,49,86,307
Vermont,Hinesburg,963,2,53,168,346,106,675
Vermont,Hyde Park,506,9,95,100,79,55,338
Vermont,Irasburg,171,17,44,34,18,36,149
Vermont,Island Pond,701,109,236,100,55,16,516
Vermont,Jacksonville,238,5,75,49,12,30,171
Vermont,Jeffersonville,936,27,212,203,116,19,577
Vermont,Jericho,1352,31,97,273,333,165,899
Vermont,Johnson,1418,131,205,152,88,56,632
Vermont,Lowell,116,20,44,23,2,1,90
Vermont,Proctorsville,510,56,111,113,83,20,383
Vermont,Poultney,1518,71,277,189,75,101,713
Vermont,Plainfield,278,5,88,54,22,41,210
Village of Islands village; Florida,Islamorad,6386,231,1400,1747,1139,688,5205
Virginia,Yogaville,179,6,16,48,43,66,179
Virginia,Heathsville,53,0,0,10,7,25,42
Virginia,Haysi,452,128,118,73,25,6,350
Virginia,Haymarket,1915,81,156,386,384,175,1182
Virginia,Hayfield,4610,70,311,505,999,992,2877
Virginia,Harriston,1050,243,281,206,12,0,742
Virginia,Harrisonburg,51388,3892,6474,5325,5020,3716,24427
Virginia,Harborton,131,0,0,0,0,106,106
Virginia,Hanover,237,52,14,43,64,8,181
Virginia,Hampton,137081,9112,24568,35381,13369,7503,89933
Virginia,Hampden-Sydney,1704,30,42,13,35,191,311
Virginia,Hamilton,463,37,83,76,65,86,347
Virginia,Bon Air,17128,998,1926,3364,3223,2188,11699
Virginia,Bobtown,444,0,37,177,16,112,342
Virginia,Blue Ridge Shores,791,33,257,129,89,70,578
Virginia,Henry Fork,1374,95,235,402,17,25,774
Virginia,Herndon,24384,2578,3020,2873,4508,3471,16450
Virginia,Highland Springs,16955,1818,3949,3289,1237,604,10897
Virginia,Chatmoss,1475,104,278,406,116,143,1047
Virginia,Castlewood,1875,282,517,386,62,28,1275
Virginia,Catlett,297,37,207,30,0,11,285
Virginia,Cats Bridge,262,63,81,40,6,0,190
Virginia,Cave Spring,25554,561,3327,5649,5795,3449,18781
Virginia,Cedar Bluff,1148,163,249,338,34,34,818
Virginia,Central Garage,1156,181,343,150,100,88,862
Virginia,Centreville,73660,2649,7526,10638,16606,10906,48325
Virginia,Chamberlayne,6190,443,936,1290,1213,817,4699
Virginia,Chantilly,23864,1452,2138,3691,4665,3688,15634
Virginia,Charles City,213,41,64,35,6,17,163
Virginia,Charlotte Court House,736,72,134,143,44,36,429
Virginia,Charlottesville,45084,2725,6173,5061,6475,7369,27803
Virginia,Chase City,2312,388,568,353,93,69,1471
Virginia,Chase Crossing,539,121,177,10,8,7,323
Virginia,Chatham,1059,118,187,234,113,170,822
Virginia,Blue Ridge,2640,147,738,425,465,195,1970
Virginia,Bluefield,5350,615,1071,1375,546,255,3862
Virginia,Bloxom,414,80,92,67,15,14,268
Virginia,Bland,588,16,178,155,46,0,395
Virginia,Riverview,504,161,117,132,0,14,424
Virginia,Riverdale,1483,202,412,279,125,16,1034
Virginia,Rivanna,1795,26,113,108,671,510,1428
Virginia,Riner,713,77,48,122,119,122,488
Virginia,Ridgeway,850,113,186,198,60,31,588
Virginia,Richmond,213735,24087,32987,34528,31303,20335,143240
Virginia,Cheriton,462,99,159,107,16,8,389
Virginia,Richlands,5630,928,1344,1077,347,195,3891
Virginia,Reston,60112,1960,4390,8103,15790,13317,43560
Virginia,Remington,619,57,167,101,45,20,390
Virginia,Ravensworth,2563,293,303,544,402,373,1915
Virginia,Raven,2018,662,341,298,58,0,1359
Virginia,Radford,17057,746,1587,2196,1456,1039,7024
Virginia,Quinby,206,30,89,18,30,0,167
Virginia,Rich Creek,797,76,251,169,35,16,547
Virginia,Bealeton,4666,243,936,864,520,233,2796
Virginia,Bedford,6522,781,1589,1224,638,263,4495
Virginia,Belle Haven,441,35,99,122,21,28,305
Virginia,Blairs,834,136,202,193,21,39,591
Virginia,Blackstone,3553,537,896,608,332,191,2564
Virginia,Blacksburg,43530,641,1408,2279,4512,5996,14836
Virginia,Big Stone Gap,5508,1216,1159,1034,422,211,4042
Virginia,Big Island,261,28,92,53,28,15,216
Virginia,Bethel Manor,3996,42,235,969,303,116,1665
Virginia,Berryville,4267,547,690,794,509,386,2926
Virginia,Bensley,6228,1552,1297,914,151,35,3949
Virginia,Benns Church,585,128,178,153,8,0,467
Virginia,Belview,1236,42,385,57,87,71,642
Virginia,Belspring,201,57,77,24,19,0,177
Virginia,Belmont Estates,1388,31,199,222,325,268,1045
Virginia,Belmont,6360,82,354,648,1460,1311,3855
Virginia,Bellwood,5772,954,1423,855,310,144,3686
Virginia,Belle Haven,6721,335,525,736,1616,1561,4773
Virginia,Cascades,12194,236,661,1964,3082,2453,8396
Virginia,Carrsville,269,56,94,48,27,10,235
Virginia,Carrollton,5383,342,813,1198,815,558,3726
Virginia,Captains Cove,1082,100,290,148,229,51,818
Virginia,Fairlawn,2402,144,504,541,339,316,1844
Virginia,Fair Oaks,33268,693,2157,4880,8551,6861,23142
Virginia,Courtland,2065,248,452,355,160,88,1303
Virginia,County Center,2513,82,282,545,501,291,1701
Virginia,Countryside,10301,229,1027,2098,2626,1134,7114
Virginia,Concord,1543,309,321,297,92,56,1075
Virginia,Fair Lakes,7721,203,667,1201,1826,1767,5664
Virginia,Columbia,62,2,10,9,10,0,31
Virginia,Colonial Beach,3556,579,1140,515,347,219,2800
Virginia,Collinsville,7507,1151,1624,1676,680,358,5489
Virginia,Coeburn,2377,387,483,439,98,77,1484
Virginia,Cluster Springs,903,59,340,163,40,14,616
Virginia,Cloverdale,3415,100,615,779,540,238,2272
Virginia,Clover,450,91,121,119,8,0,339
Virginia,Colonial Heights,17515,1457,4245,3739,1651,967,12059
Virginia,Fairfax Station,11290,217,836,1168,2465,3294,7980
Virginia,Fairfax,23402,1246,2507,3691,5142,3907,16493
Virginia,Exmore,1510,401,397,234,37,32,1101
Virginia,Staunton,24193,2196,5312,4286,3226,2155,17175
Virginia,Stephens City,1905,172,402,432,175,128,1309
Virginia,Sterling,28883,3633,4617,4190,4222,2106,18768
Virginia,Stone Ridge,9578,149,408,1430,2550,1411,5948
Virginia,Stony Creek,160,15,30,34,18,19,116
Virginia,Strasburg,6506,435,1787,1360,545,323,4450
Virginia,Stuart,1613,283,290,450,93,52,1168
Virginia,Stuarts Draft,9005,504,2845,1567,830,426,6172
Virginia,Sudley,17009,1847,2646,3351,1811,948,10603
Virginia,Suffolk,86184,7124,16125,18759,9368,5695,57071
Virginia,Crimora,1913,151,705,352,71,54,1333
Virginia,Crewe,2746,320,488,479,237,90,1614
Virginia,Craigsville,1164,256,351,164,27,19,817
Virginia,Covington,5736,666,1729,1212,239,130,3976
Virginia,Ewing,280,20,46,64,21,0,151
Virginia,Clintwood,1423,215,299,360,136,96,1106
Virginia,Quantico Base,6560,39,306,995,605,192,2137
Virginia,Clinchport,74,19,31,3,0,0,53
Virginia,Clifton Forge,3839,502,979,877,230,165,2753
Virginia,Buckhall,17066,662,2124,2995,2956,2015,10752
Virginia,Buckingham Courthouse,209,0,39,41,24,49,153
Virginia,Buena Vista,6666,745,1663,1023,451,224,4106
Virginia,Bull Run,14781,1730,2476,2672,1804,881,9563
Virginia,Bull Run Mountain Estates,1380,46,198,317,290,104,955
Virginia,Burke,42205,1522,3612,5571,9490,8279,28474
Virginia,Buchanan,1098,132,319,193,73,80,797
Virginia,Burke Centre,17982,811,1337,2547,4153,3291,12139
Virginia,Callaghan,183,13,47,75,34,4,173
Virginia,Calverton,196,36,56,46,33,25,196
Virginia,Camptown,609,140,204,89,8,0,441
Virginia,Cana,1310,292,127,331,130,25,905
Virginia,Cape Charles,912,117,154,180,176,116,743
Virginia,Yorkshire,9244,1482,1635,1401,749,388,5655
Virginia,Burkeville,400,53,127,62,47,7,296
Virginia,Brookneal,1184,175,364,269,77,15,900
Virginia,Brodnax,278,60,78,39,7,11,195
Virginia,Broadway,3765,474,577,801,306,263,2421
Virginia,Boones Mill,158,29,31,41,25,4,130
Virginia,Boston,336,37,107,63,15,9,231
Virginia,Boswell's Corner,1399,197,393,179,130,32,931
Virginia,Bowling Green,1266,135,366,269,144,45,959
Virginia,Boyce,775,63,123,150,142,45,523
Virginia,Boydton,350,31,66,55,66,31,249
Virginia,Boykins,762,102,140,175,44,24,485
Virginia,Bracey,1357,104,210,582,127,44,1067
Virginia,Brambleton,15537,124,707,1507,4426,2832,9596
Virginia,Branchville,145,12,49,20,3,2,86
Virginia,Brandermill,13721,383,1650,2918,2905,1857,9713
Virginia,Bridgewater,5844,312,1176,734,741,538,3501
Virginia,Brightwood,1703,163,561,291,51,12,1078
Virginia,Bristol,17524,2172,4055,3259,1991,898,12375
Virginia,Broadlands,13436,134,363,1239,3159,2757,7652
Virginia,Clinchco,336,74,87,55,8,5,229
Virginia,Quantico,469,52,136,70,63,40,361
Virginia,Purcellville,8658,247,757,1323,1707,965,4999
Virginia,Pungoteague,251,6,117,43,6,0,172
Virginia,Allisonia,140,9,38,44,0,0,91
Virginia,Alexandria,149315,9646,13818,20508,33951,35893,113816
Virginia,Alberta,296,36,89,49,24,20,218
Virginia,Adwolf,1418,155,451,379,120,31,1136
Virginia,Accomac,468,55,98,83,44,34,314
Virginia,Abingdon,8143,903,1553,1650,1099,802,6007
Virginia,Altavista,3464,509,973,536,334,161,2513
Virginia,Cherry Hill,18089,1105,2423,3631,2392,1386,10937
Virginia,Chester,21927,1580,4331,4760,2278,1418,14367
Virginia,Chester Gap,800,53,214,84,95,121,567
Virginia,Chilhowie,1839,212,619,305,109,73,1318
Virginia,Chincoteague,2930,299,798,604,278,352,2331
Virginia,Christiansburg,21623,1028,3368,4372,3913,2484,15165
Virginia,Churchville,68,0,52,0,16,0,68
Virginia,Chesapeake,230601,13550,40278,53229,28571,16494,152122
Virginia,Amelia Court House,483,186,147,34,77,4,448
Virginia,Amherst,2323,368,439,442,315,118,1682
Virginia,Annandale,42893,4650,5441,6785,7669,5357,29902
Virginia,Bassett,1113,249,238,218,71,14,790
Virginia,Baskerville,47,6,14,0,11,0,31
Virginia,Bailey's Crossroads,26075,3863,3840,2843,4045,3044,17635
Virginia,Augusta Springs,339,113,126,38,0,0,277
Virginia,Atlantic,1111,115,244,167,282,17,825
Virginia,Atkins,1009,162,449,158,12,20,801
Virginia,Ashland,7298,661,1432,1132,500,444,4169
Virginia,Ashburn,48954,1133,3511,7442,10769,7987,30842
Virginia,Arrington,767,119,128,113,13,56,429
Virginia,Arlington,223945,10987,13982,20709,58068,64713,168459
Virginia,Arcola,229,52,0,10,75,50,187
Virginia,Aquia Harbour,6975,198,688,1669,1175,1072,4802
Virginia,Appomattox,2124,302,521,344,154,83,1404
Virginia,Apple Mountain Lake,1459,52,282,409,128,52,923
Virginia,Appalachia,1871,271,337,360,113,62,1143
Virginia,Claremont,281,55,87,45,11,22,220
Virginia,Basye,685,28,123,243,121,63,578
Virginia,Clarksville,1213,73,234,265,180,107,859
Virginia,Cleveland,198,43,67,20,5,6,141
Virginia,Forest,10292,297,1551,1890,1890,1327,6955
Virginia,Floyd,558,63,106,99,75,56,399
Virginia,Floris,8357,35,356,801,1784,2568,5544
Virginia,Flint Hill,171,0,32,107,7,6,152
Virginia,Fishersville,7911,503,1544,1506,1100,668,5321
Virginia,Fincastle,374,39,87,76,45,29,276
Virginia,Fort Belvoir,8209,41,534,1761,891,601,3828
Virginia,Fieldale,770,128,163,110,33,28,462
Virginia,Farmville,8355,370,1296,774,610,555,3605
Virginia,Fancy Gap,190,0,22,88,18,16,144
Virginia,Falmouth,4630,70,813,724,710,283,2600
Virginia,Falls Church,13308,209,683,1035,3123,4027,9077
Virginia,Fairview Beach,413,0,197,81,50,32,360
Virginia,Fairview,141,47,77,17,0,0,141
Virginia,Ferrum,1996,151,79,157,92,64,543
Virginia,Fort Chiswell,1024,121,247,238,95,83,784
Virginia,Fort Hunt,17273,268,633,1654,4096,5089,11740
Virginia,Fort Lee,4747,44,367,1027,439,182,2059
Virginia,Clifton,257,0,10,48,62,64,184
Virginia,Glade Spring,1575,140,341,367,170,76,1094
Virginia,George Mason,10065,241,538,511,1124,1106,3520
Virginia,Gate City,2370,363,465,585,164,62,1639
Virginia,Gasburg,504,97,166,118,34,25,440
Virginia,Gargatha,519,105,177,45,56,0,383
Virginia,Galax,6876,1385,1686,1358,411,169,5009
Virginia,Gainesville,12950,295,1229,2283,2894,1618,8319
Virginia,Front Royal,14846,1880,3608,2872,1147,530,10037
Virginia,Fries,513,84,133,140,48,9,414
Virginia,Free Union,358,10,17,144,46,53,270
Virginia,Fredericksburg,27395,1449,4325,4291,3409,2589,16063
Virginia,Franklin Farm,19776,250,958,1813,4779,4903,12703
Virginia,Franklin,8457,1128,1418,1660,919,576,5701
Virginia,Franconia,19698,839,2311,2723,4298,4152,14323
Virginia,Claypool Hill,1625,213,310,467,114,65,1169
Virginia,Stanleytown,1280,163,255,432,62,77,989
Virginia,Bayside,85,55,30,0,0,0,85
Virginia,New Kent,283,0,93,107,0,0,200
Virginia,Grundy,891,103,97,119,114,118,551
Virginia,Groveton,16373,2278,1846,2355,2292,1818,10589
Virginia,Grottoes,2714,286,897,401,138,28,1750
Virginia,Gretna,1283,236,319,265,61,53,934
Virginia,Greenville,1287,106,538,213,17,0,874
Virginia,Greenbush,151,22,65,7,17,8,119
Virginia,Gwynn,695,30,173,151,29,103,486
Virginia,Greenbriar,8060,128,897,1414,1715,1426,5580
Virginia,Great Falls,15764,109,627,1259,3663,4916,10574
Virginia,Gratton,920,117,215,153,131,36,652
Virginia,Goshen,381,76,129,56,8,9,278
Virginia,Gordonsville,1564,285,328,359,88,82,1142
Virginia,Goochland,777,26,35,131,324,86,602
Virginia,Gloucester Point,9199,567,2192,2281,955,544,6539
Virginia,Greenbackville,139,0,0,0,72,67,139
Virginia,Halifax,1335,136,369,270,136,124,1035
Virginia,Hallwood,320,38,96,49,8,9,200
Virginia,Pennington Gap,1804,608,433,206,103,26,1376
Virginia,Pulaski,8958,1280,2364,1939,581,357,6521
Virginia,Prince George,1944,214,664,325,75,32,1310
Virginia,Prices Fork,1407,91,218,214,294,93,910
Virginia,Powhatan,185,13,36,81,30,25,185
Virginia,Pound,948,145,188,208,74,51,666
Virginia,Potomac Mills,5768,604,1101,915,678,566,3864
Virginia,Portsmouth,96135,10401,18305,21524,8423,4743,63396
Virginia,Port Royal,99,9,27,10,7,3,56
Virginia,Poquoson,12077,538,2272,2482,1887,1238,8417
Virginia,Pocahontas,365,44,110,86,15,8,263
Virginia,Plum Creek,1646,170,569,310,112,0,1161
Virginia,Piney Mountain,1564,94,361,214,98,201,968
Virginia,Pimmit Hills,6646,586,875,619,1324,1238,4642
Virginia,Phenix,285,17,73,45,16,20,171
Virginia,Petersburg,32123,4866,7483,6168,2018,1485,22020
Virginia,Gloucester Courthouse,2732,152,600,805,323,92,1972
Virginia,Newington Forest,12280,353,1545,2008,2474,2040,8420
Virginia,Glenvar,978,223,360,193,37,0,813
Virginia,Glen Allen,15007,575,2689,3180,2513,1534,10491
Virginia,Oak Level,745,144,211,176,27,8,566
Virginia,Oak Hall,370,0,150,62,0,0,212
Virginia,Oak Grove,1727,191,242,129,402,216,1180
Virginia,Nottoway Court House,97,8,18,23,0,0,49
Virginia,Norton,4007,479,518,1146,382,141,2666
Virginia,North Springfield,6825,705,1064,1258,1154,650,4831
Virginia,Oakton,36739,1564,2362,3873,8145,9906,25850
Virginia,North Shore,2951,206,533,818,761,327,2645
Virginia,Nokesville,1901,114,349,406,170,230,1269
Virginia,Nickelsville,430,56,121,87,19,11,294
Virginia,Newsoms,350,67,93,74,22,25,281
Virginia,New River,497,67,256,86,36,17,462
Virginia,Newport News,181323,12637,32382,42323,17245,10395,114982
Virginia,New Market,2336,513,573,323,217,168,1794
Virginia,Norfolk,245452,19413,40050,50637,23236,15736,149072
Virginia,Occoquan,932,7,94,174,238,205,718
Virginia,Onancock,1214,207,260,202,178,142,989
Virginia,Onley,501,27,118,110,59,36,350
Virginia,Glasgow,1362,238,418,179,70,23,928
Virginia,Penhook,784,50,91,174,206,140,661
Virginia,Pembroke,1328,149,390,258,69,32,898
Virginia,Pearisburg,2727,254,725,548,273,143,1943
Virginia,Patrick Springs,1695,234,440,439,136,113,1362
Virginia,Pastoria,1028,263,291,21,48,0,623
Virginia,Passapatanzy,1204,38,175,334,162,72,781
Virginia,Parrott,528,110,142,18,42,17,329
Virginia,Parksley,756,56,202,145,74,59,536
Virginia,Pantops,3647,217,366,661,866,702,2812
Virginia,Pamplin City,175,25,52,22,8,10,117
Virginia,Palmyra,143,0,48,32,12,0,92
Virginia,Painter,251,29,54,48,14,11,156
Virginia,Orange,4854,747,1087,834,364,212,3244
Virginia,Opal,649,26,81,184,124,33,448
Virginia,Glen Lyn,152,10,36,44,0,0,90
Virginia,Stanley,1697,326,642,204,50,29,1251
Virginia,Capron,89,9,23,25,8,7,72
Virginia,Stafford Courthouse,4295,501,787,673,310,315,2586
Virginia,Round Hill,541,18,47,80,131,64,340
Virginia,Rose Hill CDP (Lee County),878,218,229,135,19,12,613
Virginia,Rose Hill CDP (Fairfax County),20142,1208,2413,3251,3647,3256,13775
Virginia,Rocky Mount,4794,976,1173,956,339,226,3670
Virginia,Rockwood,8634,524,1403,1872,1262,1060,6121
Virginia,Roanoke,98736,10706,20833,20871,10188,6024,68622
Virginia,Crosspointe,6197,101,277,796,1070,1677,3921
Virginia,Crozet,6601,325,739,905,1036,1285,4290
Virginia,Culpeper,17167,1814,3198,2860,1581,688,10141
Virginia,Cumberland,216,115,37,6,23,10,191
Virginia,Dahlgren,3049,173,539,629,312,290,1943
Virginia,Dahlgren Center,573,6,26,142,62,31,267
Virginia,Dale City,72130,5952,13396,14074,7281,3713,44416
Virginia,Daleville,2872,107,621,705,380,163,1976
Virginia,Damascus,759,159,113,188,76,16,552
Virginia,Dante,632,77,207,60,27,7,378
Virginia,Danville,42450,6227,8206,9560,3303,1913,29209
Virginia,Dayton,1654,134,348,313,278,104,1177
Virginia,Stanardsville,363,30,96,59,25,18,228
Virginia,Deerfield,101,16,37,33,0,0,86
Virginia,Deltaville,1032,52,299,152,172,119,794
Virginia,Ruckersville,984,161,107,192,173,43,676
Virginia,Rural Retreat,1559,175,366,343,147,89,1120
Virginia,Rushmere,786,188,103,192,76,59,618
Virginia,Rustburg,1039,181,330,201,79,40,831
Virginia,Mineral,636,81,137,126,18,28,390
Virginia,Midland,210,23,48,44,26,9,150
Virginia,Middletown,1537,111,261,345,185,42,944
Virginia,Middleburg,689,29,93,145,171,82,520
Virginia,Middlebrook,256,23,69,47,0,0,139
Virginia,Metompkin,498,111,131,82,35,0,359
Virginia,Merrimac,1890,325,334,355,266,170,1450
Virginia,Merrifield,16412,630,777,1825,4252,4193,11677
Virginia,Scottsburg,120,6,38,43,6,3,96
Virginia,Scotland,135,0,54,13,24,33,124
Virginia,Dendron,328,29,126,59,21,13,248
Virginia,Schuyler,101,31,47,9,0,0,87
Virginia,Savageville,63,0,19,34,0,10,63
Virginia,Savage Town,90,0,32,0,0,0,32
Virginia,Sanford,169,22,81,21,0,0,124
Virginia,Sandy Level,406,136,132,103,0,0,371
Virginia,Sandston,7317,856,1765,1505,505,169,4800
Virginia,Saluda,629,140,219,92,16,12,479
Virginia,Saltville,2343,328,496,528,121,98,1571
Virginia,Salem,25165,1681,5034,5373,2890,1910,16888
Virginia,St. Paul,1080,164,181,250,181,38,814
Virginia,St. Charles,113,25,23,18,0,0,66
Virginia,Saxis,198,58,72,26,12,1,169
Virginia,Modest Town,118,51,33,34,0,0,118
Virginia,Dillwyn,486,66,154,48,20,5,293
Virginia,Drakes Branch,698,98,124,125,36,28,411
Virginia,Max Meadows,221,43,115,63,0,0,221
Virginia,Maurertown,881,126,185,153,72,47,583
Virginia,Matoaca,2132,175,699,518,112,40,1544
Virginia,Mathews,589,34,223,131,43,37,468
Virginia,Massanutten,2213,69,326,396,375,417,1583
Virginia,Massanetta Springs,5015,205,379,890,1069,924,3467
Virginia,Mason Neck,1983,65,218,293,387,479,1442
Virginia,Marumsco,38847,5449,7171,6318,3528,1982,24448
Virginia,Martinsville,13624,2087,2822,2912,956,736,9513
Virginia,Marshall,1864,99,483,275,202,49,1108
Virginia,Marion,5919,804,1535,1335,508,317,4499
Virginia,Mappsville,501,35,235,0,0,0,270
Virginia,Mappsburg,46,0,7,13,11,0,31
Virginia,Mantua,7531,353,798,877,1440,1918,5386
Virginia,Manchester,10378,721,1712,2366,1843,733,7375
Virginia,Manassas Park,15625,1755,2579,2770,1876,922,9902
Virginia,Manassas,40743,4772,6722,6877,4543,2892,25806
Virginia,Makemie Park,264,9,143,12,0,0,164
Virginia,Madison Heights,10355,1308,2583,2197,867,404,7359
Virginia,Madison,182,40,47,28,20,2,137
Virginia,McNair,20022,941,940,2072,5205,4337,13495
Virginia,Meadowbrook,19027,2030,3561,4391,1875,766,12623
Virginia,Meadow View,1090,181,202,224,136,81,824
Virginia,Mechanicsville,37210,1983,7101,8060,5716,2666,25526
Virginia,Melfa,439,52,138,95,21,13,319
Virginia,Dranesville,11895,117,662,1438,2968,2532,7717
Virginia,Draper,291,15,75,74,79,0,243
Virginia,Dryden,1268,93,253,337,114,66,863
Virginia,Dublin,2665,336,636,690,157,73,1892
Virginia,Duffield,115,19,16,34,6,6,81
Virginia,Dulles Town Center,4971,218,612,689,1174,666,3359
Virginia,Dumbarton,8701,857,1687,1921,736,385,5586
Virginia,Dumfries,5158,738,907,897,289,161,2992
Virginia,Dungannon,443,87,91,56,17,27,278
Virginia,Dunn Loring,9393,332,500,963,2325,2318,6438
Virginia,Dooms,1247,179,377,166,91,13,826
Virginia,East Highland Park,14733,1249,3568,3613,1276,604,10310
Virginia,Eastville,175,10,33,37,40,12,132
Virginia,Ebony,109,0,48,8,23,0,79
Virginia,Edinburg,1279,154,340,179,96,62,831
Virginia,Elkton,2779,353,752,513,250,96,1964
Virginia,Elliston,1210,171,512,88,0,0,771
Virginia,Emory,1189,26,73,53,114,119,385
Virginia,Emporia,5672,995,1281,943,412,299,3930
Virginia,Enon,3973,213,877,937,399,215,2641
Virginia,Esmont,521,44,129,58,18,38,287
Virginia,Ettrick,5696,272,951,730,199,128,2280
Virginia,East Lexington,1171,156,248,168,131,119,822
Virginia,Montclair,19896,441,1952,3739,3932,3512,13576
Virginia,Monterey,156,20,36,31,23,15,125
Virginia,Hillsboro,84,1,6,13,24,15,59
Virginia,Mount Crawford,431,29,131,64,62,34,320
Virginia,Mountain Road,1430,306,229,263,11,109,918
Virginia,Motley,992,124,300,248,63,0,735
Virginia,Moorefield Station,1096,13,40,164,323,69,609
Virginia,Montvale,556,97,212,146,8,18,481
Virginia,Montross,440,55,109,59,58,24,305
Virginia,Montrose,7880,961,1920,1467,398,179,4925
Virginia,Lovingston,380,69,106,38,41,0,254
Virginia,Lovettsville,2022,90,307,300,364,145,1206
Virginia,Louisa,2204,276,490,361,164,100,1391
Virginia,Loudoun Valley Estates,5659,58,237,265,1578,1378,3516
Virginia,Lorton,19722,666,2315,3785,3161,2665,12592
Virginia,Long Branch,7560,377,716,886,1501,1833,5313
Virginia,Loch Lomond,4149,685,932,621,254,63,2555
Virginia,Linton Hall,40567,739,3142,7048,7256,4948,23133
Virginia,Lincolnia,23802,2493,2661,3300,4470,3221,16145
Virginia,Lexington,7071,450,406,407,505,481,2249
Virginia,Leesburg,47872,3099,5059,7132,9444,5454,30188
Virginia,Lee Mont,265,67,16,38,12,56,189
Virginia,Lebanon,3388,466,796,744,298,178,2482
Virginia,Laymantown,2510,149,603,615,270,160,1797
Virginia,Mount Hermon,3981,347,711,1064,518,326,2966
Virginia,Mount Jackson,2253,421,541,293,110,58,1423
Virginia,Mount Sidney,412,37,120,40,83,14,294
Virginia,Mount Vernon,12639,809,1010,1679,2557,2626,8681
Virginia,Wytheville,8154,1358,2059,1610,760,486,6273
Virginia,Yorktown,130,0,6,23,61,15,105
Virginia,Scottsville,546,82,127,92,48,49,398
Virginia,Sedley,537,39,48,243,5,22,357
Virginia,Selma,339,87,85,84,23,19,298
Virginia,Seven Corners,8801,1613,1292,1156,1204,1102,6367
Virginia,Seven Mile Ford,696,102,138,128,48,0,416
Virginia,Shawneeland,1345,124,443,370,118,28,1083
Virginia,Shawsville,1274,137,306,174,100,102,819
Virginia,Shenandoah,2412,410,768,382,100,29,1689
Virginia,Lawrenceville,1419,153,185,179,111,59,687
Virginia,Shenandoah Farms,3930,350,1003,766,565,104,2788
Virginia,New Hope,972,111,201,106,115,123,656
Virginia,New Church,211,30,65,34,34,0,163
Virginia,New Castle,166,11,25,49,20,7,112
Virginia,New Baltimore,9192,392,1133,1650,1826,1167,6168
Virginia,Nelsonia,367,43,217,62,0,0,322
Virginia,Nellysford,1139,70,202,160,224,315,971
Virginia,Neabsco,16073,781,1792,2957,2646,2063,10239
Virginia,Nathalie,146,0,62,15,0,15,92
Virginia,Nassawadox,631,134,212,79,49,26,500
Virginia,Narrows,2166,187,615,522,123,42,1489
Virginia,Newington,13470,473,1088,2475,2618,2203,8857
Virginia,Laurel Park,883,107,97,362,80,0,646
Virginia,Laurel Hill,7569,198,712,1109,1813,1307,5139
Virginia,Laurel,16618,1232,3047,4014,2321,802,11416
Virginia,Jarratt,628,64,168,144,47,11,434
Virginia,Ivy,927,0,39,67,170,345,621
Virginia,Ivor,407,41,140,102,22,3,308
Virginia,Ivanhoe,379,164,80,22,0,14,280
Virginia,Irvington,490,13,85,143,94,109,444
Virginia,Iron Gate,354,39,110,78,33,7,267
Virginia,Innsbrook,7699,119,841,1243,1601,1223,5027
Virginia,Independent Hill,8583,353,989,1359,1497,1283,5481
Virginia,Independence,1211,221,352,260,28,10,871
Virginia,Idylwood,18514,1442,1738,2033,3818,3887,12918
Virginia,Jolivue,1255,133,267,292,92,21,805
Virginia,Hybla Valley,16106,2823,1983,2159,1790,1554,10309
Virginia,Huntington,12718,829,1177,1766,3040,3058,9870
Virginia,Hot Springs,526,59,205,70,1,36,371
Virginia,Horse Pasture,1857,238,609,456,78,43,1424
Virginia,Horntown,431,70,109,37,43,0,259
Virginia,Hopewell,22279,2825,5677,4487,1201,629,14819
Virginia,Honaker,1576,225,407,411,47,9,1099
Virginia,Hollymead,8352,560,577,1332,1578,1479,5526
Virginia,Hollins,14654,1292,3054,3131,2157,643,10277
Virginia,Hiwassee,188,9,98,7,0,27,141
Virginia,Hillsville,2701,407,572,584,221,109,1893
Virginia,Hurt,1412,137,339,327,142,48,993
Virginia,McMullin,329,74,102,74,10,0,260
Virginia,Jonesville,1263,146,248,390,81,86,951
Virginia,Kenbridge,1233,172,237,233,127,31,800
Virginia,Lansdowne,11707,330,776,1671,2729,2455,7961
Virginia,Lancaster,167,10,40,26,21,0,97
Virginia,Lake Wilderness,2570,91,500,588,321,133,1633
Virginia,Lakeside,13039,1469,2163,2663,1895,829,9019
Virginia,Lake Ridge,43963,1848,4380,9142,7819,5608,28797
Virginia,Lake of the Woods,7926,324,1381,2038,1376,852,5971
Virginia,Lake Monticello,9629,188,1527,2082,1764,1404,6965
Virginia,Lake Land'Or,3865,183,848,762,411,213,2417
Virginia,Lake Holiday,2302,64,149,622,493,266,1594
Virginia,Lake Caroline,2154,40,529,479,360,168,1576
Virginia,Keller,170,12,66,31,2,7,118
Virginia,Lake Barcroft,9833,543,920,1351,1990,2146,6950
Virginia,La Crosse,741,151,187,138,21,14,511
Virginia,King William,119,40,37,26,0,0,103
Virginia,Kingstowne,15935,286,1005,2062,4508,3669,11530
Virginia,Kings Park West,13702,458,743,1888,3117,2612,8818
Virginia,Kings Park,4564,92,497,556,926,798,2869
Virginia,King George,5299,315,972,974,548,425,3234
Virginia,King and Queen Court House,132,0,40,41,9,0,90
Virginia,Kilmarnock,1443,121,538,335,144,44,1182
Virginia,Keysville,1067,139,194,223,45,29,630
Virginia,Keokee,286,100,69,72,0,10,251
Virginia,Lafayette,450,53,105,104,29,0,291
Virginia,McLean,47784,607,1693,3391,10085,17042,32818
Virginia,Deep Creek,55,0,31,0,0,9,40
Virginia,Woodlawn CDP (Carroll County),2266,173,588,548,251,45,1605
Virginia,Warm Springs,58,0,0,42,0,0,42
Virginia,Warrenton,9843,499,1855,2016,1272,1130,6772
Virginia,Warsaw,1287,199,290,243,180,55,967
Virginia,Washington,136,8,26,37,28,28,127
Virginia,Wattsville,1195,181,383,230,126,20,940
Virginia,Waverly,1570,281,418,252,72,23,1046
Virginia,Waynesboro,21150,2196,5604,4074,1709,972,14555
Virginia,Weber City,1389,267,408,282,57,50,1064
Virginia,West Falls Church,29489,3679,3971,4075,4938,3973,20636
Virginia,Westlake Corner,1058,97,203,298,157,155,910
Virginia,West Point,3336,201,884,670,440,162,2357
Virginia,West Springfield,22897,678,2217,3488,4736,4570,15689
Virginia,Weyers Cave,2754,211,428,570,345,177,1731
Virginia,White Stone,479,43,152,98,20,44,357
Virginia,Whitesville,346,75,125,33,0,0,233
Virginia,Williamsburg,14754,600,1122,1714,1957,1830,7223
Virginia,Winchester,27168,2832,5438,4582,2745,2320,17917
Virginia,Lynchburg,78158,5120,10946,13137,8669,5763,43635
Virginia,Luray,4843,812,1313,686,361,249,3421
Virginia,Lunenburg,180,6,59,50,0,0,115
Virginia,Wyndham,10040,183,517,1144,2528,1910,6282
Virginia,Woodstock,5181,609,1017,1104,481,140,3351
Virginia,Woodlawn CDP (Fairfax County),22466,4076,3627,3460,2072,1242,14477
Virginia,Warfield,87,21,39,15,7,0,82
Virginia,Low Moor,122,48,33,20,11,0,112
Virginia,Woodburn,8883,622,877,1110,1888,1718,6215
Virginia,Woodbridge,4448,263,637,925,704,624,3153
Virginia,Wolf Trap,16631,310,486,1169,4106,5004,11075
Virginia,Wise,3185,341,655,751,326,193,2266
Virginia,Wintergreen,377,160,0,0,0,159,319
Virginia,Windsor,2642,331,720,516,213,56,1836
Virginia,Woodlake,6945,112,636,861,1865,1075,4549
Virginia,Lyndhurst,1681,195,543,144,184,71,1137
Virginia,Wakefield,13082,344,733,1727,2671,3170,8645
Virginia,Virginia Beach,448290,19884,66707,110664,66094,34834,298183
Virginia,Surry,235,32,53,30,25,15,155
Virginia,Sussex,145,20,43,26,23,1,113
Virginia,Tangier,491,121,205,46,24,7,403
Virginia,Tappahannock,2223,361,515,364,204,86,1530
Virginia,Tasley,237,11,76,43,10,12,152
Virginia,Tazewell,4522,562,1103,814,369,266,3114
Virginia,Temperanceville,449,28,195,53,51,0,327
Virginia,Templeton,488,111,108,80,13,21,333
Virginia,The Plains,187,25,7,35,42,13,122
Virginia,Thynedale,72,13,27,10,0,0,50
Virginia,Timberlake,12440,1141,2640,2552,1309,566,8208
Virginia,Timberville,2576,334,705,381,182,89,1691
Virginia,Toms Brook,337,38,94,69,9,2,212
Virginia,Triangle,8901,592,1565,1517,1179,664,5517
Virginia,Troutdale,149,28,52,25,2,7,114
Virginia,Troutville,551,43,166,146,37,27,419
Virginia,Tuckahoe,47316,2294,5795,8043,10240,6815,33187
Virginia,Virgilina,135,20,31,41,10,7,109
Virginia,Vinton,8162,767,1999,1611,956,233,5566
Virginia,Villa Heights,458,66,131,170,13,0,380
Virginia,Vienna,16341,602,1159,1904,3514,3754,10933
Virginia,Victoria,1809,327,440,412,116,42,1337
Virginia,Verona,3434,489,1024,569,253,130,2465
Virginia,Wachapreague,201,24,84,38,13,17,176
Virginia,Vansant,389,51,134,82,74,0,341
Virginia,University of Virginia,8902,101,189,200,678,759,1927
Virginia,University Center,4341,472,604,676,824,477,3053
Virginia,Union Level,101,37,50,14,0,0,101
Virginia,Union Hall,1365,114,250,366,173,194,1097
Virginia,Tysons Corner,22437,434,1379,2535,5948,6385,16681
Virginia,Twin Lakes,1744,135,321,337,283,76,1152
Virginia,Urbanna,556,78,137,148,71,41,475
Virginia,McKenney,401,88,97,64,17,12,278
Virginia,Wakefield,850,100,172,155,48,21,496
Virginia,South Riding,27441,616,1686,3049,6905,4373,16629
Virginia,Springfield,30444,3177,4460,4993,5067,3228,20925
Virginia,Spotsylvania Courthouse,4382,296,768,944,397,232,2637
Virginia,Sperryville,259,17,69,69,0,47,202
Virginia,Southside Chesconessex,159,25,55,0,0,0,80
Virginia,South Run,6500,98,347,522,1547,1767,4281
Virginia,South Hill,4566,612,921,1115,357,340,3345
Virginia,Southern Gateway,2900,178,505,622,339,131,1775
Virginia,South Boston,8037,925,1790,1515,811,288,5329
Virginia,Southampton Meadows,398,144,79,67,0,0,290
Virginia,Snowville,185,0,32,20,10,52,114
Virginia,Smithfield,8233,605,1456,1760,1105,752,5678
Virginia,Skyland Estates,713,35,173,136,97,57,498
Virginia,Shipman,412,28,89,70,48,14,249
Virginia,Sherando,746,68,95,228,173,20,584
Virginia,Short Pump,26902,374,1471,2957,7047,5434,17283
Virginia,Shenandoah Retreat,578,56,96,147,62,56,417
Virginia,Lowes Island,11396,315,619,1141,2855,2464,7394
Virginia,Sugar Grove,549,183,97,66,29,23,398
Virginia,Sugarland Run,12527,936,1845,1997,2165,991,7934
Virginia,Springville,1647,128,562,318,120,0,1128
Virginia,Shenandoah Shores,906,72,215,157,61,12,517
Washington,Bryant,1815,50,642,574,117,44,1427
Washington,Bryn Mawr-Skyway,16473,1804,2953,3452,2041,949,11199
Washington,Camano,15500,587,3093,4616,2354,1041,11691
Washington,Burlington,8509,757,1961,2152,457,319,5646
Washington,Burley,1735,91,319,508,157,78,1153
Washington,Buckley,4475,525,905,1048,261,182,2921
Washington,Burbank,3114,128,637,884,305,112,2066
Washington,Bunk Foss,3522,194,616,847,499,212,2368
Washington,Buena,1691,546,25,54,5,0,630
Washington,Bucoda,622,77,134,207,18,12,448
Washington,Brush Prairie,2708,70,642,830,206,121,1869
Washington,Burien,49785,5569,8702,11155,5522,2379,33327
Washington,Browns Point,1260,10,193,321,247,132,903
Washington,Krupp,45,4,20,13,2,0,39
Washington,Forks,3693,259,1016,872,207,52,2406
Washington,Fort Lewis,13163,86,1054,2838,743,216,4937
Washington,Four Lakes,221,5,60,41,73,0,179
Washington,Camas,20890,710,2504,4553,3506,2193,13466
Washington,Fox Island,3731,33,341,827,866,549,2616
Washington,Frederickson,19949,1012,3874,5877,1526,585,12874
Washington,Freeland,1803,145,370,516,241,157,1429
Washington,Friday Harbor,2162,148,430,530,246,223,1577
Washington,Garfield,496,26,110,197,51,26,410
Washington,Garrett,1508,127,286,319,230,105,1067
Washington,Geneva,2544,47,256,677,516,276,1772
Washington,George,648,231,36,51,7,1,326
Washington,Gig Harbor,7918,231,988,1864,1516,1256,5855
Washington,Fords Prairie,1815,197,355,665,43,62,1322
Washington,Canterwood,3408,29,428,949,661,414,2481
Washington,Cathlamet,612,43,116,166,33,29,387
Washington,Carbonado,547,35,141,154,25,4,359
Washington,Clear Lake CDP (Pierce County),1114,184,334,196,61,72,847
Washington,Clayton,346,25,96,103,0,0,224
Washington,Clarkston Heights-Vineland,6590,306,1467,1859,742,425,4799
Washington,Clarkston,7330,779,1463,2182,473,90,4987
Washington,Clallam Bay,378,26,78,89,56,20,269
Washington,Chinook,341,0,72,179,0,11,262
Washington,Chico,2157,38,311,619,343,340,1651
Washington,Chewelah,2592,192,664,690,194,79,1819
Washington,Cherry Grove,647,4,43,287,33,74,441
Washington,Cheney,11171,226,691,1701,1112,563,4293
Washington,Chelan Falls,186,22,91,73,0,0,186
Washington,Chelan,3974,405,1265,583,473,285,3011
Washington,Canyon Creek,3045,179,631,981,171,48,2010
Washington,Chehalis,7314,633,1106,1973,602,375,4689
Washington,Central Park,2652,136,758,787,234,57,1972
Washington,Centralia,16683,2072,3155,4211,930,589,10957
Washington,Centerville,167,10,40,57,2,3,112
Washington,Cavalero,4950,154,785,1325,700,218,3182
Washington,Glacier,73,0,32,27,14,0,73
Washington,Cathcart,2553,58,377,727,507,112,1781
Washington,Castle Rock,2334,191,514,635,175,74,1589
Washington,Cashmere,3146,314,712,555,300,197,2078
Washington,Cascade Valley,2280,229,585,539,99,87,1539
Washington,Carson,2361,119,662,577,136,34,1528
Washington,Carnation,1733,161,279,368,215,102,1125
Washington,Carlsborg,675,0,241,298,40,96,675
Washington,Chain Lake,4660,159,769,1045,648,225,2846
Washington,Gleed,2948,393,657,613,207,137,2007
Washington,Grapeview,1156,89,175,435,115,84,898
Washington,Gold Bar,2193,220,557,439,124,40,1380
Washington,Hockinson,4985,205,702,1256,696,288,3147
Washington,Hobart,6362,208,1099,1700,1056,461,4524
Washington,High Bridge,3152,52,449,876,619,227,2223
Washington,Herron Island,81,0,26,41,0,14,81
Washington,Hazel Dell,20155,1574,3444,5610,2372,695,13695
Washington,Hatton,74,15,25,12,1,1,54
Washington,Hat Island,0,0,0,0,0,0,0
Washington,Hartline,119,3,22,52,11,2,90
Washington,Harrington,327,20,107,54,39,19,239
Washington,Harrah,680,146,110,80,22,13,371
Washington,Hansville,3617,65,465,1187,617,423,2757
Washington,Hamilton,230,58,41,67,3,11,180
Washington,Hogans Corner,161,44,29,12,0,0,85
Washington,Clear Lake CDP (Skagit County),1061,71,244,356,93,33,797
Washington,Green Bluff,992,79,85,171,215,43,593
Washington,Grays River,474,42,134,112,33,8,329
Washington,Grayland,489,32,224,126,31,43,456
Washington,Kent,124292,11589,21028,27744,13613,5504,79478
Washington,Ketron Island,0,0,0,0,0,0,0
Washington,Kettle Falls,1437,88,474,300,146,51,1059
Washington,Key Center,3811,257,537,1161,499,182,2636
Washington,Keyport,488,0,69,197,107,25,398
Washington,Kingston,1963,27,319,572,407,109,1434
Washington,Kirkland,84721,2256,7370,16945,22387,12517,61475
Washington,Kittitas,1387,130,406,266,128,38,968
Washington,Klahanie,11586,177,627,1567,3306,2083,7760
Washington,Greenwater,109,0,0,44,16,0,60
Washington,Glenwood,186,8,66,42,19,3,138
Washington,Home,1702,76,273,445,245,84,1123
Washington,Hoquiam,8479,845,1685,2442,395,300,5667
Washington,Goldendale,3437,175,631,886,417,85,2194
Washington,Gorst,484,104,159,65,70,20,418
Washington,Graham,24976,866,5272,6610,1985,1007,15740
Washington,Grand Coulee,897,78,258,236,59,31,662
Washington,Grand Mound,3329,269,635,743,175,46,1868
Washington,Grandview,11083,2499,1465,1515,356,152,5987
Washington,Granger,3404,783,313,354,62,44,1556
Washington,Granite Falls,3451,185,815,825,291,129,2245
Washington,Klickitat,448,13,116,193,7,2,331
Washington,Kendall,126,0,45,55,0,0,100
Washington,Kelso,11837,1277,2759,2800,327,362,7525
Washington,Keller,228,33,49,47,5,3,137
Washington,Hoodsport,880,277,194,173,50,0,694
Washington,Kayak Point,2068,66,345,534,199,181,1325
Washington,Kalama,2498,124,593,664,255,111,1747
Washington,Kahlotus,224,25,36,67,18,4,150
Washington,Junction City,9,0,9,0,0,0,9
Washington,Jamestown,427,30,27,177,48,17,299
Washington,Issaquah,33682,486,2352,6335,8244,6011,23428
Washington,Ione,342,25,93,108,33,9,268
Washington,Indianola,3486,83,586,939,555,285,2448
Washington,Index,178,9,32,49,50,1,141
Washington,Inchelium,494,64,76,133,22,6,301
Washington,Ilwaco,1021,30,219,312,74,60,695
Washington,Hunts Point,508,6,19,63,196,78,362
Washington,Humptulips,251,14,47,116,0,0,177
Washington,Kapowsin,285,8,90,80,13,0,191
Washington,Clearview,3682,258,647,859,669,185,2618
Washington,Des Moines,30715,3169,5512,7760,3434,1623,21498
Washington,Cliffdell,138,1,1,61,35,13,111
Washington,Everson,2553,349,447,541,124,73,1534
Washington,Everett,105685,8422,19111,28123,10962,4404,71022
Washington,Esperance,3811,208,825,716,789,250,2788
Washington,Eschbach,260,0,22,110,9,14,155
Washington,Erlands Point-Kitsap Lake,3065,147,568,842,405,68,2030
Washington,Ephrata,7948,800,1614,1495,888,218,5015
Washington,Fairchild AFB,2947,36,102,662,334,107,1241
Washington,Enumclaw,11494,1025,2414,2825,911,392,7567
Washington,Enetai,1919,109,355,607,296,120,1487
Washington,Endicott,239,14,57,57,23,9,160
Washington,Elmer City,307,22,78,65,26,13,204
Washington,Elma,3035,119,672,842,113,38,1784
Washington,Ellensburg,18637,761,1537,2850,2296,1073,8517
Washington,Elk Plain,14252,827,3439,3674,966,404,9310
Washington,Entiat,1190,91,288,350,82,49,860
Washington,Electric City,1094,59,276,363,85,30,813
Washington,Fairfield,464,18,119,160,51,8,356
Washington,Fairwood CDP (Spokane County),8262,43,1182,2258,1031,780,5294
Washington,McKenna,970,28,375,125,24,16,568
Washington,McMillin,1399,79,324,425,115,198,1141
Washington,Malden,168,20,39,65,6,2,132
Washington,Malo,0,0,0,0,0,0,0
Washington,Fircrest,6612,169,756,1750,1119,684,4478
Washington,Finley,5958,775,1290,1424,276,101,3866
Washington,Fairwood CDP (King County),20032,781,2281,4852,4189,1820,13923
Washington,Fife Heights,2009,69,427,426,239,128,1289
Washington,Fern Prairie,2108,208,396,561,155,113,1433
Washington,Ferndale,12355,967,2097,3107,1403,575,8149
Washington,Felida,7744,114,659,1843,1475,1142,5233
Washington,Federal Way,92859,6130,16515,23302,10097,4628,60672
Washington,Farmington,104,4,27,20,13,4,68
Washington,Fall City,1729,43,395,424,302,153,1317
Washington,Fife,9477,662,1873,2123,877,399,5934
Washington,Machias,1168,69,319,249,63,72,772
Washington,Elbe,0,0,0,0,0,0,0
Washington,Edison,162,26,34,23,0,19,102
Washington,Dixie,268,27,55,66,12,12,172
Washington,Curlew Lake,560,64,145,160,38,28,435
Washington,Cusick,106,15,28,46,5,1,95
Washington,Custer,423,43,198,105,0,0,346
Washington,Dallesport,1365,63,436,440,90,15,1044
Washington,Danville,32,0,0,28,2,0,30
Washington,Dollars Corner,1101,25,222,286,154,152,839
Washington,Darrington,1497,140,282,451,39,43,955
Washington,Davenport,1610,73,339,449,162,74,1097
Washington,Dayton,2852,215,499,793,327,153,1987
Washington,Deep River,182,13,51,75,12,8,159
Washington,Deer Park,3784,206,846,1116,274,57,2499
Washington,Deming,420,101,16,43,99,0,259
Washington,Desert Aire,2131,411,249,227,108,26,1021
Washington,Dash Point,830,16,151,235,148,134,684
Washington,Edmonds,40689,1316,5243,9748,9815,4967,31089
Washington,Donald,0,0,0,0,0,0,0
Washington,DuPont,9054,99,615,2021,1751,984,5470
Washington,Covington,18689,930,3432,4374,2613,1005,12354
Washington,Cowiche,1007,333,114,24,31,0,502
Washington,Creston,273,29,79,59,24,8,199
Washington,Crocker,1385,102,260,334,73,108,877
Washington,Curlew,117,21,25,38,9,0,93
Washington,Edgewood,9600,327,2350,2422,1164,686,6949
Washington,Duluth,1550,103,295,437,183,60,1078
Washington,Eatonville,2830,124,678,739,234,74,1849
Washington,East Renton Highlands,11092,566,2028,2415,1940,899,7848
Washington,East Port Orchard,5109,266,964,1439,252,240,3161
Washington,Easton,374,25,168,77,21,0,291
Washington,Eastmont,21274,1006,2990,5487,3709,1211,14403
Washington,East Cathlamet,490,37,51,255,32,10,385
Washington,Duvall,7373,140,664,1564,1599,442,4409
Washington,East Wenatchee,13473,1585,2281,3078,1162,414,8520
Washington,Cle Elum,2544,153,458,588,345,76,1620
Washington,McCleary,1965,122,328,606,78,65,1199
Washington,Mabton,2329,658,332,153,33,0,1176
Washington,Coupeville,2141,94,367,582,287,284,1614
Washington,Fobes Hill,2824,99,529,753,495,178,2054
Washington,Five Corners,19662,1236,3714,5070,1409,619,12048
Washington,La Center,3066,90,463,829,367,182,1931
Washington,Lacey,44825,1913,6550,11692,6278,3453,29886
Washington,La Conner,748,9,177,294,100,45,625
Washington,Country Homes,5573,139,492,1151,525,225,2532
Washington,LaCrosse,265,19,68,78,47,10,222
Washington,Lake Bosworth,554,31,153,200,7,8,399
Washington,Lake Cassidy,3666,197,718,1007,355,221,2498
Washington,Lake Cavanaugh,125,10,10,81,8,8,117
Washington,Lake Forest Park,13059,342,1154,2804,3183,2222,9705
Washington,Lake Goodwin,3577,174,833,981,394,162,2544
Washington,Lake Holm,3416,50,567,867,762,253,2499
Washington,La Grande,102,9,0,37,37,19,102
Washington,Disautel,27,14,13,0,0,0,27
Washington,Coulee Dam,1290,74,218,436,115,59,902
Washington,Cottage Lake,23703,294,1909,4375,5872,3630,16080
Washington,Clinton,766,36,92,266,163,78,635
Washington,Clover Creek,6792,404,1684,1805,466,321,4680
Washington,Clyde Hill,3150,58,90,346,864,708,2066
Washington,Cohassett Beach,641,20,224,73,35,0,352
Washington,Colfax,2842,148,400,806,370,224,1948
Washington,College Place,8957,564,846,2360,908,782,5460
Washington,Coulee City,634,51,229,122,51,28,481
Washington,Colton,435,6,99,141,49,50,345
Washington,Conconully,172,18,57,69,7,8,159
Washington,Concrete,739,80,184,174,55,15,508
Washington,Connell,5359,706,987,1477,80,87,3337
Washington,Conway,10,0,0,0,5,5,10
Washington,Copalis Beach,370,118,56,182,0,0,356
Washington,Cosmopolis,1547,78,437,501,97,34,1147
Washington,Colville,4692,399,1033,1133,421,183,3169
Washington,McChord AFB,3288,36,214,728,313,0,1291
Washington,Lakeland North,12380,678,2351,3519,1582,516,8646
Washington,Lake McMurray,132,24,58,32,0,9,123
Washington,Lind,488,13,118,102,39,31,303
Washington,Lochsloy,2593,118,772,601,244,108,1843
Washington,Lofall,2081,82,307,756,295,133,1573
Washington,Long Beach,1434,114,344,488,116,107,1169
Washington,Longbranch,3023,234,649,902,261,166,2212
Washington,Longview,36619,3450,7492,10721,2490,1695,25848
Washington,Liberty Lake,8269,288,957,1774,1539,870,5428
Washington,Longview Heights,3403,179,516,1073,397,268,2433
Washington,Loon Lake,766,36,143,292,33,61,565
Washington,Lower Elochoman,130,0,8,95,21,0,124
Washington,Lyle,578,77,102,120,37,20,356
Washington,Lyman,591,35,150,201,24,8,418
Washington,Lynden,12886,832,2089,3313,1652,760,8646
Washington,Lynnwood,36491,2980,6242,9098,5354,1902,25576
Washington,Loomis,85,0,38,38,9,0,85
Washington,Lakeland South,13460,533,2379,3589,1630,593,8724
Washington,Lewisville,1732,64,418,456,202,43,1183
Washington,Leavenworth,2227,152,471,378,352,311,1664
Washington,Lake Marcel-Stillwater,1269,73,95,331,180,208,887
Washington,Lake Morton-Berrydale,9921,607,1773,2616,1623,567,7186
Washington,Lake Roesiger,772,83,178,134,141,27,563
Washington,Lake Shore,6957,301,1004,1932,1177,554,4968
Washington,Lake Stevens,29774,1757,5109,7519,3166,1367,18918
Washington,Lake Stickney,8930,658,1509,2334,1019,292,5812
Washington,Lebam,133,13,23,38,34,0,108
Washington,Lake Tapps,12710,332,2129,2846,2203,958,8468
Washington,Lakewood,59122,4762,10829,16584,5293,2656,40124
Washington,Lamont,84,4,25,24,6,0,59
Washington,Langley,1287,32,197,307,270,174,980
Washington,Larch Way,3834,326,366,839,754,172,2457
Washington,Latah,160,11,26,34,14,5,90
Washington,Laurier,0,0,0,0,0,0,0
Washington,Lakeview,892,214,102,325,27,15,683
Washington,Lake Ketchum,948,146,112,388,69,51,766
Washington,Kenmore,21575,865,2093,4385,4806,2712,14861
Washington,Tukwila,19757,2243,4019,3949,2024,750,12985
Washington,Winlock,1513,129,309,332,55,50,875
Washington,Winthrop,364,16,89,97,34,30,266
Washington,Wishram,364,30,108,95,22,11,266
Washington,Wollochet,5930,96,646,1356,1157,1101,4356
Washington,Woodinville,11373,224,1123,2261,2612,1621,7841
Washington,Woodland,5589,549,696,1317,312,168,3042
Washington,Woods Creek,5652,368,1131,1392,706,261,3858
Washington,Woodway,1337,12,105,175,320,266,878
Washington,Yacolt,1819,96,484,313,81,26,1000
Washington,Yakima,93261,15421,15245,17247,5653,4197,57763
Washington,Yarrow Point,1172,3,41,108,396,261,809
Washington,Yelm,7701,306,1163,1762,672,221,4124
Washington,Zillah,3100,433,630,542,208,129,1942
Washington,Alderton,3314,253,609,933,259,124,2178
Washington,Alder,64,0,7,0,5,27,39
Washington,Albion,585,37,117,150,79,21,404
Washington,Airway Heights,6449,495,1680,2272,331,50,4828
Washington,Ahtanum,3359,447,627,740,194,70,2078
Washington,Addy,139,0,38,57,0,0,95
Washington,Wilson Creek,185,19,39,46,9,25,138
Washington,Willapa,233,22,48,71,18,19,178
Washington,Wilkeson,406,28,109,120,25,12,294
Washington,Wilderness Rim,1476,86,275,515,253,139,1268
Washington,Nooksack,1807,118,342,425,96,24,1005
Washington,Normandy Park,6568,201,555,1449,1550,1000,4755
Washington,North Bend,6305,226,748,1450,1266,456,4146
Washington,Warm Beach,2397,77,571,674,351,133,1806
Washington,Washougal,14777,731,2412,4212,1667,678,9700
Washington,Washtucna,279,17,68,100,14,7,206
Washington,Waterville,1869,100,442,389,146,34,1111
Washington,Wauna,4451,137,873,1146,707,360,3223
Washington,Waverly,80,2,20,24,5,1,52
Washington,Acme,156,44,0,0,0,0,44
Washington,Wenatchee,32950,3858,5912,6052,3230,1736,20788
Washington,West Pasco,2223,90,622,583,218,215,1728
Washington,Westport,1965,107,528,608,162,42,1447
Washington,West Richland,13048,554,1774,3190,1948,813,8279
Washington,West Side Highway,5812,316,1354,1434,361,132,3597
Washington,Whidbey Island Station,1938,10,73,310,151,0,544
Washington,White Center,14728,2172,2761,3155,1236,533,9857
Washington,White Salmon,2212,242,258,530,395,126,1551
Washington,White Swan,652,83,94,88,5,0,270
Washington,Wilbur,682,41,271,146,63,14,535
Washington,West Clarkston-Highland,5470,419,1222,1543,554,161,3899
Washington,Nisqually Indian Community,644,101,147,121,28,14,411
Washington,Aberdeen Gardens,261,19,84,70,24,17,214
Washington,North Fort Lewis,3682,44,310,818,234,26,1432
Washington,Othello,7624,1418,965,1099,293,196,3971
Washington,Otis Orchards-East Farms,6792,260,1584,1836,623,241,4544
Washington,Outlook,305,126,0,0,6,0,132
Washington,Oyehut,13,0,13,0,0,0,13
Washington,Pacific,6954,643,1414,1737,557,151,4502
Washington,Pacific Beach,216,0,72,61,55,14,202
Washington,Packwood,212,0,125,57,30,0,212
Washington,Palouse,1071,12,159,263,171,117,722
Washington,Parker,125,27,26,17,11,0,81
Washington,Parkland,36318,3103,8061,7683,2102,812,21761
Washington,Parkwood,7294,304,1148,2047,678,462,4639
Washington,Pasco,67391,10513,10141,10759,4088,1978,37479
Washington,Pateros,678,106,96,125,24,21,372
Washington,Peaceful Valley,3654,455,956,943,87,32,2473
Washington,Pe Ell,553,38,155,163,29,5,390
Washington,Picnic Point,9094,329,1134,2472,1751,579,6265
Washington,Pine Grove,136,0,49,21,30,0,100
Washington,Point Roberts,1270,58,257,306,207,147,975
Washington,Pomeroy,1279,57,329,347,169,42,944
Washington,Oso,231,20,56,19,23,42,160
Washington,Orting,7078,447,1497,1644,518,210,4316
Washington,Oroville,1863,268,474,445,69,37,1293
Washington,Orient,73,0,46,24,0,0,70
Washington,North Lynnwood,18829,1070,2280,4930,3051,999,12330
Washington,North Marysville,137,0,77,48,0,0,125
Washington,North Omak,773,53,80,193,84,9,419
Washington,Northport,334,34,87,86,35,3,245
Washington,North Puyallup,1758,154,645,490,104,30,1423
Washington,North Sultan,201,0,41,61,36,9,147
Washington,Northwest Stanwood,82,12,31,19,0,0,62
Washington,North Yelm,2700,206,752,647,76,43,1724
Washington,Oakesdale,543,19,114,160,67,26,386
Washington,Aberdeen,16429,1601,3320,4200,963,562,10646
Washington,Oak Harbor,22331,1013,3536,6153,2379,724,13805
Washington,Ocean City,156,38,43,41,0,0,122
Washington,Ocean Park,1315,127,325,394,257,62,1165
Washington,Ocean Shores,5637,319,1356,2219,589,313,4796
Washington,Odessa,744,68,188,237,94,36,623
Washington,Okanogan,2594,298,691,469,204,90,1752
Washington,Olympia,48941,2282,6158,11342,8607,5839,34228
Washington,Omak,4812,446,1149,1076,312,178,3161
Washington,Onalaska,977,71,165,313,12,66,627
Washington,Orchards,21299,1527,3544,5205,1415,551,12242
Washington,Oakville,725,71,172,222,21,17,503
Washington,Nile,89,10,60,19,0,0,89
Washington,Newport,2263,227,462,572,151,113,1525
Washington,Newcastle,10994,90,970,1775,2641,2043,7519
Washington,Benton City,3156,326,581,778,227,56,1968
Washington,Bethel,3906,256,775,1174,309,200,2714
Washington,Bickleton,61,4,10,14,11,6,45
Washington,Big Lake,1934,122,286,500,375,194,1477
Washington,Bingen,914,192,141,126,85,52,596
Washington,Birch Bay,8404,469,1348,2301,1345,811,6274
Washington,Tumwater,18478,815,2482,5067,2442,1931,12737
Washington,Ames Lake,1358,23,186,200,412,152,973
Washington,Amboy,1878,61,447,506,31,24,1069
Washington,Amanda Park,154,22,38,19,13,2,94
Washington,Altoona,66,0,3,38,25,0,66
Washington,Almira,263,23,59,88,8,11,189
Washington,Allyn,2144,105,341,641,403,222,1712
Washington,Algona,3107,328,757,673,117,26,1901
Washington,Alger,141,24,45,47,0,0,116
Washington,Alderwood Manor,9337,504,1690,2332,1252,571,6349
Washington,Mercer Island,24120,374,966,2579,7083,6137,17139
Washington,Mesa,352,78,72,37,13,2,202
Washington,Metaline,206,0,61,65,9,14,149
Washington,Bellingham,82944,3661,9312,16628,13113,7210,49924
Washington,Bell Hill,954,0,160,290,294,169,913
Washington,Bellevue,134630,4452,10777,20677,35819,25856,97581
Washington,Belfair,3298,463,466,1015,120,55,2119
Washington,Anacortes,16048,657,2646,4275,2793,1706,12077
Washington,Anderson Island,1053,28,222,383,178,154,965
Washington,Arlington,18578,1148,3910,5082,1355,563,12058
Washington,Arlington Heights,2725,169,663,640,297,75,1844
Washington,Artondale,13376,321,1587,3168,2467,1623,9166
Washington,Ashford,296,45,113,125,13,0,296
Washington,Asotin,1360,54,240,404,136,59,893
Washington,Auburn,74527,5942,14386,16456,7696,3252,47732
Washington,Bainbridge Island,23343,270,1510,3555,6320,5348,17003
Washington,Metaline Falls,136,38,24,33,16,8,119
Washington,Bangor Base,6392,44,518,1416,353,80,2411
Washington,Barberton,6201,308,897,1497,923,434,4059
Washington,Baring,164,11,48,76,13,0,148
Washington,Barney's Junction,179,24,51,70,0,0,145
Washington,Barstow,69,3,11,15,10,9,48
Washington,Basin City,1373,416,101,79,0,0,596
Washington,Battle Ground,18576,1105,2860,4710,1611,656,10942
Washington,Bay Center,202,18,30,90,38,13,189
Washington,Bay View,826,17,94,163,258,111,643
Washington,Beaux Arts Village,333,0,3,20,101,83,207
Washington,Banks Lake South,200,6,61,37,17,0,121
Washington,Methow,49,0,23,26,0,0,49
Washington,Midland,8349,938,2003,1634,620,142,5337
Washington,Mill Creek,19028,424,2012,4515,4155,2419,13525
Washington,Blaine,4905,264,955,1087,565,430,3301
Washington,Blyn,30,0,24,2,0,1,27
Washington,Bonney Lake,18516,808,3312,4654,1715,1021,11510
Washington,Bothell,41207,1723,4924,8851,9159,4003,28660
Washington,Bothell East,9307,257,579,1802,1852,1281,5771
Washington,Bothell West,19088,605,2530,4033,3890,1869,12927
Washington,Boulevard Park,3815,597,693,936,319,109,2654
Washington,Boyds,91,19,23,18,0,0,60
Washington,Brady,604,45,151,175,75,12,458
Washington,Black Diamond,4291,242,902,1101,444,254,2943
Washington,Bremerton,39017,1687,6581,11923,3657,1546,25394
Washington,Bridgeport,2285,552,387,290,40,6,1275
Washington,Brier,6443,265,827,1775,1151,524,4542
Washington,Brinnon,705,60,179,274,67,54,634
Washington,Medina,3120,10,117,233,946,693,1999
Washington,Medical Lake,4924,319,968,1085,402,237,3011
Washington,Neah Bay,945,92,199,205,37,26,559
Washington,Neilton,361,80,59,87,26,3,255
Washington,Nespelem,173,5,47,51,3,0,106
Washington,Nespelem Community,230,26,79,50,6,5,166
Washington,Brewster,2624,688,281,251,149,69,1438
Washington,Port Angeles,19200,1135,4028,5585,1565,1255,13568
Washington,Navy Yard City,2622,193,390,874,91,128,1676
Washington,Napavine,1748,136,466,487,88,12,1189
Washington,Mill Creek East,17967,465,1812,3654,3994,2142,12067
Washington,Millwood,1686,89,341,539,129,86,1184
Washington,Milton,7219,260,1580,1976,760,382,4958
Washington,Mineral,188,55,56,57,0,20,188
Washington,Minnehaha,9548,445,1578,3199,1094,294,6610
Washington,Mirrormont,3763,21,366,836,1017,534,2774
Washington,Moclips,0,0,0,0,0,0,0
Washington,Monroe,17734,1840,3184,4368,1538,749,11679
Washington,Monroe North,1584,54,201,418,189,101,963
Washington,Naselle,342,12,114,96,22,4,248
Washington,Montesano,3894,180,617,1205,497,205,2704
Washington,Moses Lake,21579,2096,3492,4455,1408,1145,12596
Washington,Moses Lake North,4057,467,690,734,76,39,2006
Washington,Mossyrock,789,126,243,147,20,6,542
Washington,Mountlake Terrace,20521,1319,3637,5674,2750,1332,14712
Washington,Mount Vernon,32957,4084,5136,6695,3061,1404,20380
Washington,Mount Vista,7995,225,1067,2034,1377,934,5637
Washington,Moxee,3702,292,741,739,128,84,1984
Washington,Mukilteo,20818,423,2330,4404,4681,2480,14318
Washington,Naches,881,76,217,194,50,18,555
Washington,Morton,1296,89,372,282,32,64,839
Washington,Port Angeles East,3406,293,723,1043,220,204,2483
Washington,North Bonneville,1317,60,218,439,107,108,932
Washington,Port Gamble Tribal Community,898,58,192,239,107,10,606
Washington,Sumas,1563,180,300,300,85,56,921
Washington,Summit,7467,504,1685,2050,924,392,5555
Washington,Summit View,7014,231,1352,1863,598,202,4246
Washington,Summitview,1501,54,164,310,176,100,804
Washington,Sumner,9584,530,2251,2271,840,258,6150
Washington,Sunday Lake,838,0,80,317,139,0,536
Washington,Sunnyside,16204,3998,2084,1256,356,470,8164
Washington,Sunnyslope,3452,166,597,760,543,366,2432
Washington,Suquamish,4220,204,730,1168,606,323,3031
Washington,Porter,233,16,10,111,24,0,161
Washington,Sultan,4744,282,960,1373,337,118,3070
Washington,Tacoma,203481,16999,38389,46262,23335,12635,137620
Washington,Tampico,427,60,143,66,0,0,269
Washington,Tanglewilde,6110,604,936,1839,436,426,4241
Washington,Tanner,1048,14,81,156,219,181,651
Washington,Tekoa,824,60,216,216,56,36,584
Washington,Tenino,1915,104,418,513,93,103,1231
Washington,Terrace Heights,6952,606,1266,1828,710,474,4884
Washington,Thorp,351,56,54,77,43,11,241
Washington,Three Lakes,2902,139,589,880,497,223,2328
Washington,Tieton,1391,282,282,196,44,12,816
Washington,Tokeland,240,2,70,90,32,0,194
Washington,Taholah,844,91,138,178,35,20,462
Washington,Toledo,605,37,124,187,26,13,387
Washington,Sudden Valley,6815,45,919,1818,1570,612,4964
Washington,Steptoe,184,13,62,61,9,8,153
Washington,Snohomish,9437,506,1647,2748,1059,522,6482
Washington,Snoqualmie,12115,235,681,2144,3258,1327,7645
Washington,Snoqualmie Pass,249,10,60,50,70,19,209
Washington,Soap Lake,1766,282,341,476,93,34,1226
Washington,South Bend,1703,261,286,477,101,46,1171
Washington,South Cle Elum,552,32,193,123,32,14,394
Washington,South Creek,2140,245,860,633,77,64,1879
Washington,South Hill,55592,1951,9916,13742,5753,2802,34164
Washington,South Prairie,292,23,105,72,19,4,223
Washington,South Wenatchee,1728,317,395,188,14,23,937
Washington,Stevenson,1402,142,258,366,160,80,1006
Washington,Southworth,2393,77,498,787,235,180,1777
Washington,Spangle,186,23,56,45,24,4,152
Washington,Spokane,210695,11817,36033,52252,24682,15735,140519
Washington,Spokane Valley,92286,5009,18214,26614,9893,3689,63419
Washington,Sprague,589,31,140,208,24,13,416
Washington,Springdale,304,35,63,72,10,0,180
Washington,Stansberry Lake,2312,160,400,708,72,118,1458
Washington,Stanwood,6560,327,940,1774,733,302,4076
Washington,Starbuck,90,5,33,31,17,0,86
Washington,Startup,696,172,167,62,57,0,458
Washington,Steilacoom,6118,147,826,1607,991,708,4279
Washington,Spanaway,29214,2295,6675,7377,1612,639,18598
Washington,Skykomish,130,9,36,56,12,7,120
Washington,Tonasket,1053,134,265,246,88,35,768
Washington,Torboy,126,0,0,79,12,0,91
Washington,Twisp,976,71,215,225,139,71,721
Washington,Twin Lakes,103,0,39,33,15,0,87
Washington,Mattawa,4516,1509,300,93,66,20,1988
Washington,Marysville,63760,4214,12048,17568,5331,2231,41392
Washington,Maryhill,0,0,0,0,0,0,0
Washington,Martha Lake,17163,815,2093,4242,2940,1164,11254
Washington,Marrowstone,1242,25,129,292,289,173,908
Washington,Markham,126,20,21,26,23,25,115
Washington,Marietta-Alderwood,4704,309,564,1297,554,373,3097
Washington,Marcus,163,19,63,36,11,2,131
Washington,Union,345,9,131,128,60,17,345
Washington,Marblemount,63,0,0,39,7,0,46
Washington,Maple Valley,24682,401,3283,6142,4180,1597,15603
Washington,Maple Heights-Lake Desire,3416,213,478,677,915,191,2474
Washington,Maple Falls,14,0,14,0,0,0,14
Washington,Manson,1284,246,223,290,110,67,936
Washington,Mansfield,291,11,74,96,46,14,241
Washington,Manchester,5094,283,864,1418,770,259,3594
Washington,Maltby,11220,327,1851,2416,2165,961,7720
Washington,Malott,649,206,88,39,0,0,333
Washington,Malone,551,43,135,106,37,19,340
Washington,Kennewick,76918,6426,12847,17988,6688,3529,47478
Washington,Maplewood,4961,170,714,1162,834,738,3618
Washington,Toppenish,9006,2390,942,839,205,104,4480
Washington,Union Gap,6042,1363,1131,898,141,47,3580
Washington,Uniontown,418,2,78,138,52,29,299
Washington,Touchet,436,37,92,129,18,6,282
Washington,Town and Country,5481,152,913,1516,642,287,3510
Washington,Tracyton,6205,265,1045,1868,660,225,4063
Washington,Trout Lake,640,19,98,164,113,64,458
Washington,Warden,2735,658,335,323,83,14,1413
Washington,Wapato,5075,1474,724,367,35,52,2652
Washington,Walnut Grove,9732,547,1668,2900,1097,599,6811
Washington,Wallula,302,46,45,17,0,0,108
Washington,Waller,7998,424,1900,2137,988,364,5813
Washington,Walla Walla East,1767,13,226,513,240,242,1234
Washington,Union Hill-Novelty Hill,21510,245,1284,3470,5552,4509,15060
Washington,Walla Walla,31957,2563,5229,7991,3102,1680,20565
Washington,Verlot,115,13,51,10,13,0,87
Washington,Venersborg,3823,138,746,887,660,226,2657
Washington,Vaughn,527,23,148,145,86,33,435
Washington,Vashon,10189,403,1207,1973,2290,2148,8021
Washington,Vantage,27,18,0,9,0,0,27
Washington,Vancouver,168050,11629,29620,42587,19192,10305,113333
Washington,Valley,163,32,14,66,0,0,112
Washington,Vader,674,66,124,223,16,7,436
Washington,Upper Elochoman,51,10,22,0,0,8,40
Washington,University Place,31991,1015,4431,8146,4756,2546,20894
Washington,Waitsburg,1128,51,235,297,131,55,769
Washington,Skokomish,691,90,125,125,28,11,379
Washington,Swede Heaven,829,22,287,217,58,10,594
Washington,Sisco Heights,2829,151,616,829,384,57,2037
Washington,Rockford,367,7,81,137,26,11,262
Washington,Rock Island,856,210,192,138,11,0,551
Washington,Rockport,78,10,35,23,10,0,78
Washington,Rocky Point,1592,49,231,716,137,93,1226
Washington,Ronald,200,14,79,15,0,56,164
Washington,Roosevelt,148,50,18,9,4,0,81
Washington,Rosalia,635,28,152,155,72,29,436
Washington,Rosburg,429,18,91,126,34,24,293
Washington,Puget Island,798,3,268,256,58,32,617
Washington,Rosedale,4620,293,708,1245,752,419,3417
Washington,Rochester,2249,13,453,696,455,14,1631
Washington,Roslyn,911,51,193,183,111,48,586
Washington,Royal City,1695,563,147,79,24,28,841
Washington,Ruston,915,18,121,257,134,170,700
Washington,Ryderwood,281,16,110,144,11,0,281
Washington,St. John,597,26,138,188,83,25,460
Washington,Salmon Creek,21301,1099,2912,5653,2827,1987,14478
Washington,Sammamish,50163,582,1936,6001,14080,8941,31540
Washington,Prosser,5819,657,854,1279,452,343,3585
Washington,Prescott,377,62,63,71,22,0,218
Washington,Prairie Ridge,12495,848,3065,3205,677,264,8059
Washington,Prairie Heights,4306,295,868,1061,397,103,2724
Washington,Roy,634,42,89,191,58,41,421
Washington,May Creek,661,34,124,177,118,63,516
Washington,Mead,7363,346,1299,1960,1157,438,5200
Washington,Meadowdale,2806,125,387,804,494,185,1995
Washington,River Road,383,35,70,136,27,14,282
Washington,Riverbend,2121,32,325,585,326,164,1432
Washington,Ritzville,1603,90,356,471,177,92,1186
Washington,Ridgefield,5693,124,888,1710,567,305,3594
Washington,Richland,52291,1599,6425,11033,9167,6488,34712
Washington,Republic,1154,97,237,386,78,57,855
Washington,Renton,97234,7392,15608,21719,16191,6783,67693
Washington,Riverside,402,55,93,106,9,13,276
Washington,Redmond,57959,1918,3428,9159,14517,12023,41045
Washington,Reardan,675,21,141,190,56,25,433
Washington,Raymond,2800,341,740,572,193,29,1875
Washington,Ravensdale,1162,60,272,301,117,58,808
Washington,Rainier,2219,162,472,540,196,76,1446
Washington,Raft Island,305,8,19,71,83,100,281
Washington,Quincy,7163,1708,822,913,310,105,3858
Washington,Qui-nai-elt Village,69,3,6,13,13,0,35
Washington,Skamokawa Valley,377,43,68,145,38,0,294
Washington,Quilcene,437,19,127,145,34,42,367
Washington,Queets,175,22,37,29,0,3,91
Washington,Puyallup,38720,2067,8115,9472,4521,2288,26463
Washington,Purdy,1074,32,74,371,256,94,827
Washington,Pullman,31502,262,1107,2496,3503,4059,11427
Washington,Meadow Glade,2649,72,351,630,376,301,1730
Washington,Poulsbo,9588,431,1512,2197,1387,797,6324
Washington,Port Townsend,9208,323,1498,2219,2013,1447,7500
Washington,Port Orchard,13004,613,1956,3709,1376,721,8375
Washington,SeaTac,27859,3285,5805,6300,2407,1124,18921
Washington,Santiago,19,2,6,5,2,0,15
Washington,Satsop,621,59,143,194,45,37,478
Washington,Seabeck,1306,150,190,384,225,140,1089
Washington,Seattle,653017,31738,52530,112717,167762,114980,479727
Washington,Sedro-Woolley,10673,588,2406,3054,644,327,7019
Washington,Sekiu,53,0,0,0,0,35,35
Washington,Selah,7531,575,1048,1698,904,553,4778
Washington,Port Ludlow,2382,42,255,842,498,401,2038
Washington,Shadow Lake,2714,39,595,741,504,144,2023
Washington,Shelton,9810,1249,1771,2401,594,246,6261
Washington,Shoreline,54774,3689,6387,13430,11083,6047,40636
Washington,Silvana,80,0,0,80,0,0,80
Washington,Silverdale,20053,508,3009,5545,2783,1234,13079
Washington,Silver Firs,22153,628,2100,4915,4435,1779,13857
Washington,Port Hadlock-Irondale,3552,334,1103,904,253,71,2665
Washington,Sequim,6695,380,1527,1984,869,384,5144
West Virginia,Glen Ferris,123,104,19,0,0,0,123
West Virginia,Glen Fork,586,89,226,64,47,0,426
West Virginia,Glen Jean,340,43,144,42,13,0,242
West Virginia,Glenville,1812,112,205,215,136,128,796
West Virginia,Grant Town,587,59,208,103,29,20,419
West Virginia,Grafton,5173,563,1787,918,336,110,3714
West Virginia,Grantsville,581,108,174,76,39,21,418
West Virginia,Glen Dale,1537,63,396,336,208,198,1201
West Virginia,Glen White,474,126,133,37,72,40,408
West Virginia,Enterprise,840,95,313,158,67,27,660
West Virginia,Gilbert Creek,1170,331,332,167,21,19,870
West Virginia,Gilbert,373,44,88,67,31,17,247
West Virginia,Fairlea,1817,262,583,398,38,35,1316
West Virginia,Fairmont,18773,1428,4342,3356,1932,929,11987
West Virginia,Fairview,354,54,119,53,10,1,237
West Virginia,Falling Spring,169,8,46,47,11,13,125
West Virginia,Falling Waters,1109,120,207,234,118,50,729
West Virginia,Falls View,152,18,17,65,0,0,100
West Virginia,Farmington,399,22,125,71,11,9,238
West Virginia,Fayetteville,2914,170,588,644,451,286,2139
West Virginia,Fenwick,130,0,75,10,6,0,91
West Virginia,Flatwoods,312,48,79,49,7,0,183
West Virginia,Flemington,366,50,108,73,11,3,245
West Virginia,Follansbee,2934,285,966,622,251,178,2302
West Virginia,Fort Ashby,1454,61,614,434,71,38,1218
West Virginia,Fort Gay,808,122,278,102,17,11,530
West Virginia,Frank,81,0,33,17,0,0,50
West Virginia,Franklin,726,112,268,74,64,72,590
West Virginia,Friendly,77,0,41,31,0,0,72
West Virginia,Gallipolis Ferry,996,113,402,186,38,4,743
West Virginia,Galloway,122,20,45,48,9,0,122
West Virginia,Gary,722,100,275,127,58,11,571
West Virginia,Gassaway,913,136,276,155,75,45,687
West Virginia,Gauley Bridge,723,117,174,110,37,6,444
West Virginia,Ghent,555,0,107,139,179,0,425
West Virginia,Glasgow,740,114,257,146,52,18,587
West Virginia,Ellenboro,454,61,137,89,25,16,328
West Virginia,Culloden,3549,217,825,767,281,227,2317
West Virginia,Elkins,7244,560,1938,936,821,761,5016
West Virginia,Williamson,3077,470,666,582,196,343,2257
West Virginia,Wiley Ford,790,96,283,148,28,6,561
West Virginia,Whitmer,55,0,9,0,0,0,9
West Virginia,Whitesville,548,82,225,62,7,9,385
West Virginia,White Sulphur Springs,2538,311,808,494,125,65,1803
West Virginia,White Hall,640,26,131,165,72,42,436
West Virginia,Wheeling,27894,1999,6771,5551,3791,2226,20338
West Virginia,Beckley,17375,1687,3907,3566,2006,1010,12176
West Virginia,Beaver,1086,383,258,188,119,17,965
West Virginia,Beards Fork,115,52,29,25,0,0,106
West Virginia,Bayard,403,59,208,17,7,3,294
West Virginia,Bath (Berkeley Springs),580,77,167,88,49,63,444
West Virginia,Bartow,47,11,36,0,0,0,47
West Virginia,Bartley,250,34,138,23,0,0,195
West Virginia,Barrackville,1324,123,348,281,147,40,939
West Virginia,Barboursville,4078,512,904,782,399,245,2842
West Virginia,Bancroft,914,62,506,75,71,8,722
West Virginia,Accoville,749,136,167,102,24,20,449
West Virginia,Addison (Webster Springs),1015,150,285,192,62,53,742
West Virginia,Albright,327,52,127,28,1,2,210
West Virginia,Alderson,1221,79,288,341,102,58,868
West Virginia,Alum Creek,1902,208,477,640,189,13,1527
West Virginia,Amherstdale,205,29,61,43,4,0,137
West Virginia,Williamstown,2931,133,590,750,338,349,2160
West Virginia,Anawalt,191,46,59,19,5,8,137
West Virginia,Ansted,1583,210,495,244,129,53,1131
West Virginia,Apple Grove,175,41,49,23,7,6,126
West Virginia,Arbovale,197,21,68,14,28,25,156
West Virginia,Athens,1086,15,79,115,68,100,377
West Virginia,Auburn,128,31,44,19,0,3,97
West Virginia,Aurora,296,36,94,48,0,0,178
West Virginia,Anmoore,608,63,147,167,12,0,389
West Virginia,Elkview,1377,184,560,129,129,37,1039
West Virginia,Windsor Heights,437,35,137,85,37,0,294
West Virginia,Wolf Summit,124,25,80,19,0,0,124
West Virginia,Elk Garden,120,30,64,3,2,0,99
West Virginia,Elizabeth,839,91,217,145,41,29,523
West Virginia,Eleanor,1807,67,509,431,232,94,1333
West Virginia,Eccles,118,0,28,51,21,18,118
West Virginia,East Dailey,434,22,159,81,0,0,262
West Virginia,East Bank,729,88,282,98,59,20,547
West Virginia,Durbin,224,30,79,34,0,7,150
West Virginia,Dunbar,7798,524,2223,1883,707,584,5921
West Virginia,Despard,1560,159,455,281,39,11,945
West Virginia,Delbarton,547,71,116,135,18,4,344
West Virginia,Deep Water,271,22,127,28,0,0,177
West Virginia,Davy,249,81,62,22,15,2,182
West Virginia,Davis,683,57,273,128,33,32,523
West Virginia,Danville,688,123,246,117,25,6,517
West Virginia,Daniels,2301,237,741,564,134,44,1720
West Virginia,Dailey,101,0,89,0,12,0,101
West Virginia,Cucumber,57,20,23,0,0,0,43
West Virginia,Womelsdorf (Coalton),298,36,125,28,22,18,229
West Virginia,Worthington,140,15,44,50,3,0,112
West Virginia,Beech Bottom,618,60,227,108,31,4,430
West Virginia,Belington,2080,295,660,322,76,39,1392
West Virginia,Belle,1247,33,360,285,89,42,809
West Virginia,Belmont,1031,78,336,205,68,44,731
West Virginia,Winfield,2256,72,509,512,283,220,1596
West Virginia,Belva,95,6,70,10,9,0,95
West Virginia,Bergoo,64,5,29,22,8,0,64
West Virginia,Granville,1966,205,644,393,98,7,1347
West Virginia,Craigsville,1779,229,637,308,118,0,1292
West Virginia,Cross Lanes,10567,464,2515,1658,1468,765,6870
West Virginia,Crum,175,48,24,47,0,14,133
West Virginia,Crumpler,155,20,70,7,18,20,135
West Virginia,Benwood,1363,86,418,389,44,33,970
West Virginia,Great Cacapon,284,48,56,86,17,3,210
West Virginia,New Richmond,289,72,115,22,0,0,209
West Virginia,Dixie,135,0,54,33,6,5,98
West Virginia,Thurmond,7,0,0,3,2,2,7
West Virginia,Thomas,638,79,316,83,33,9,520
West Virginia,Terra Alta,1591,170,502,263,59,27,1021
West Virginia,Teays Valley,13848,508,2579,2717,2147,1571,9522
West Virginia,Sylvester,133,8,47,23,7,6,91
West Virginia,Switzer,864,183,153,247,50,24,657
West Virginia,Tioga,10,10,0,0,0,0,10
West Virginia,Crab Orchard,2475,193,636,554,240,100,1723
West Virginia,Covel,174,21,64,0,0,0,85
West Virginia,Corinne,200,14,73,16,0,0,103
West Virginia,Comfort,328,34,77,31,17,5,164
West Virginia,Coal Fork,1061,162,349,177,29,42,759
West Virginia,Coal City,1596,192,698,318,78,0,1286
West Virginia,Clendenin,1033,144,317,198,80,68,807
West Virginia,Cowen,527,106,159,63,10,3,341
West Virginia,Tornado,1280,26,401,242,144,83,896
West Virginia,Triadelphia,640,28,273,108,29,8,446
West Virginia,Tunnelton,290,36,104,41,5,4,190
West Virginia,Wayne,1884,356,549,254,24,58,1241
West Virginia,Waverly,215,32,36,114,5,10,197
West Virginia,Washington,1296,8,331,331,199,64,933
West Virginia,Wardensville,221,44,69,28,7,7,155
West Virginia,War,811,171,322,61,6,25,585
West Virginia,Wallace,479,10,144,27,39,11,231
West Virginia,Vivian,75,26,10,16,0,0,52
West Virginia,Vienna,10623,471,2253,2573,1414,750,7461
West Virginia,Verdunville,763,163,249,172,65,49,698
West Virginia,Van,98,13,23,38,0,13,87
West Virginia,Valley Head,295,45,182,44,11,0,282
West Virginia,Valley Grove,312,28,111,49,23,1,212
West Virginia,Valley Bend,519,36,186,78,29,0,329
West Virginia,Union,548,45,144,101,25,27,342
West Virginia,Twilight,165,0,70,10,0,0,80
West Virginia,Clearview,516,15,137,114,46,61,373
West Virginia,Weirton,19432,1479,5673,4325,2110,938,14525
West Virginia,Clay,607,123,179,64,29,31,426
West Virginia,Chester,2526,202,957,611,82,44,1896
West Virginia,Smithfield,139,31,36,4,8,0,79
West Virginia,Smithers,981,84,329,181,33,19,646
West Virginia,Sistersville,1366,156,411,226,75,48,916
West Virginia,Sissonville,4655,314,1469,842,484,231,3340
West Virginia,Shrewsbury,752,168,245,132,57,0,602
West Virginia,Shinnston,2565,231,731,484,224,131,1801
West Virginia,Sophia,1356,265,394,180,53,26,918
West Virginia,Shepherdstown,1587,52,65,115,132,76,440
West Virginia,Shady Spring,3060,165,703,455,398,331,2052
West Virginia,Scarbro,648,119,225,80,8,0,432
West Virginia,Sarah Ann,276,61,72,18,0,0,151
West Virginia,Sand Fork,182,6,35,30,15,9,95
West Virginia,Salt Rock,713,102,335,103,14,39,593
West Virginia,Salem,1671,147,387,261,90,76,961
West Virginia,Shannondale,3305,226,695,859,299,150,2229
West Virginia,South Charleston,13276,807,3164,2768,1965,1144,9848
West Virginia,Spelter,470,25,219,56,16,0,316
West Virginia,Spencer,2014,368,564,343,111,93,1479
West Virginia,Chesapeake,1544,189,586,282,73,21,1151
West Virginia,Chelyan,889,98,392,105,38,0,633
West Virginia,Cheat Lake,9219,200,1204,1391,1474,1751,6020
West Virginia,Chauncey,331,27,110,22,54,0,213
West Virginia,Chattaroy,598,67,226,113,13,35,454
West Virginia,Charlton Heights,382,37,152,77,8,0,274
West Virginia,Charles Town,5587,607,1079,992,702,376,3756
West Virginia,Charleston,50566,2897,9456,9175,7367,6815,35710
West Virginia,Sutton,1231,102,362,259,107,80,910
West Virginia,Summersville,3531,394,1011,807,320,268,2800
West Virginia,Stonewood,1909,197,663,351,148,48,1407
West Virginia,Stollings,442,43,132,118,11,0,304
West Virginia,Star City,2050,136,362,301,354,193,1346
West Virginia,Stanaford,1726,184,436,381,138,48,1187
West Virginia,Springfield,389,60,146,81,0,0,287
West Virginia,Clarksburg,16347,1448,4336,3612,1679,629,11704
West Virginia,Welch,3021,544,1213,543,144,83,2527
West Virginia,Wellsburg,2746,215,749,640,207,182,1993
West Virginia,West Hamlin,875,179,285,122,6,3,595
West Virginia,Monaville,166,45,67,14,0,0,126
West Virginia,Monongah,1020,104,297,230,79,17,727
West Virginia,Montcalm,559,110,170,94,8,8,390
West Virginia,Montgomery,1801,186,322,225,166,111,1010
West Virginia,Montrose,165,20,64,26,17,3,130
West Virginia,Moorefield,2814,458,984,397,199,82,2120
West Virginia,Mitchell Heights,381,14,69,96,63,43,285
West Virginia,Morgantown,30164,932,2973,3475,3817,3539,14736
West Virginia,Moundsville,8888,771,3024,1840,639,235,6509
West Virginia,Mount Carbon,346,23,51,123,52,8,257
West Virginia,Mount Gay-Shamrock,1349,217,464,281,77,14,1053
West Virginia,Mount Hope,1271,96,314,294,79,22,805
West Virginia,Mullens,1993,119,498,380,199,105,1301
West Virginia,Neibert,128,35,67,26,0,0,128
West Virginia,Green Bank,223,0,43,7,46,29,125
West Virginia,Mineralwells,1582,127,474,401,146,25,1173
West Virginia,Minden,413,187,78,46,0,0,311
West Virginia,Milton,2557,257,877,464,204,115,1917
West Virginia,Man,991,151,240,205,63,46,705
West Virginia,Mannington,2036,172,644,365,111,47,1339
West Virginia,Marlinton,1002,142,305,185,87,50,769
West Virginia,Marmet,1570,196,539,287,125,18,1165
West Virginia,Martinsburg,17564,2113,4074,3074,1136,885,11282
West Virginia,Mason,966,102,389,162,35,16,704
West Virginia,Masontown,602,48,183,136,42,13,422
West Virginia,Matewan,516,114,141,68,23,2,348
West Virginia,Matheny,379,145,137,53,15,0,350
West Virginia,Matoaka,212,32,95,24,4,0,155
West Virginia,Maybeury,149,28,36,32,8,11,115
West Virginia,Meadow Bridge,384,68,100,41,11,10,230
West Virginia,Middlebourne,875,104,282,128,37,75,626
West Virginia,Middleway,519,29,237,37,82,0,385
West Virginia,Mill Creek,745,107,313,67,20,10,517
West Virginia,Nettie,757,0,401,201,0,36,638
West Virginia,Newburg,401,40,175,59,19,5,298
West Virginia,New Cumberland,1165,206,403,169,46,37,861
West Virginia,Newell,1317,195,493,183,73,0,944
West Virginia,Pea Ridge,6323,304,1171,1230,899,855,4459
West Virginia,Pennsboro,1184,155,418,225,41,30,869
West Virginia,Pentress,197,15,35,44,0,23,117
West Virginia,Petersburg,2450,309,863,424,116,103,1815
West Virginia,Peterstown,473,58,137,84,58,9,346
West Virginia,Philippi,3192,468,585,396,205,242,1896
West Virginia,Pickens,33,7,26,0,0,0,33
West Virginia,Piedmont,839,150,362,99,23,0,634
West Virginia,Pinch,2876,216,675,454,370,372,2087
West Virginia,Pine Grove,658,86,200,89,19,16,410
West Virginia,Westover,4145,277,1162,741,434,447,3061
West Virginia,Weston,4096,398,1338,573,329,179,2817
West Virginia,West Milford,772,50,211,163,37,50,511
West Virginia,West Logan,573,56,163,119,40,27,405
West Virginia,West Liberty,1781,30,125,152,74,45,426
West Virginia,Pax,151,15,64,25,3,0,107
West Virginia,St. Marys,1725,126,516,412,148,84,1286
West Virginia,Paw Paw,504,88,122,96,4,0,310
West Virginia,Parkersburg,31133,2655,9034,6721,2258,1209,21877
West Virginia,New Haven,1456,149,450,333,107,25,1064
West Virginia,New Martinsville,5295,506,1476,1194,317,213,3706
West Virginia,West Union,1163,151,340,230,33,14,768
West Virginia,Nitro,6711,463,1919,1558,551,422,4913
West Virginia,Northfork,320,56,124,42,9,1,232
West Virginia,North Hills,867,13,73,170,203,129,588
West Virginia,Nutter Fort,1625,86,392,372,168,99,1117
West Virginia,Oak Hill,8249,1071,2210,1515,679,300,5775
West Virginia,Oakvale,174,28,69,24,26,0,147
West Virginia,Oceana,1172,239,366,200,37,11,853
West Virginia,Omar,447,67,184,132,0,0,383
West Virginia,Paden City,2773,325,979,547,118,39,2008
West Virginia,Page,161,24,49,37,0,0,110
West Virginia,Pageton,88,39,39,0,0,0,78
West Virginia,Parcoal,43,18,20,0,0,0,38
West Virginia,Parsons,1526,174,499,221,35,113,1042
West Virginia,St. George,63,5,38,10,10,0,63
West Virginia,Shenandoah Junction,516,72,173,114,0,0,359
West Virginia,Rupert,902,141,338,91,16,36,622
West Virginia,Hilltop,686,180,263,61,20,9,533
West Virginia,Hillsboro,262,38,62,53,17,0,170
West Virginia,Hico,174,34,15,79,13,15,156
West Virginia,Hepzibah,703,58,283,110,14,35,500
West Virginia,Henlawson,244,44,103,30,0,0,177
West Virginia,Hendricks,243,39,112,34,14,0,199
West Virginia,Henderson,170,50,38,23,8,2,121
West Virginia,Hinton,2589,376,833,469,164,155,1997
West Virginia,Helvetia,31,0,7,8,16,0,31
West Virginia,Hedgesville,283,14,60,86,21,8,189
West Virginia,Harts,627,77,232,151,13,25,498
West Virginia,Hartford City,612,70,224,143,15,2,454
West Virginia,Harrisville,2423,279,805,388,129,142,1743
West Virginia,Harpers Ferry,200,11,23,43,43,41,161
West Virginia,Harman,106,21,37,12,0,7,77
West Virginia,Handley,301,32,87,43,8,6,176
West Virginia,Helen,114,64,50,0,0,0,114
West Virginia,Hamlin,1643,167,391,351,113,103,1125
West Virginia,Holden,644,93,113,197,46,0,449
West Virginia,Hooverson Heights,2834,240,931,568,221,64,2024
West Virginia,Point Pleasant,4307,322,1444,863,407,97,3133
West Virginia,St. Albans,10882,686,2968,2704,1252,553,8163
West Virginia,Pleasant Valley,3180,112,1046,529,452,245,2384
West Virginia,Piney View,911,56,370,169,84,31,710
West Virginia,Pineville,685,75,165,191,27,46,504
West Virginia,Chapmanville,1297,147,444,209,58,45,903
West Virginia,Ceredo,1471,181,399,322,126,83,1111
West Virginia,Hometown,530,54,253,14,67,0,388
West Virginia,Century,185,18,94,26,0,0,138
West Virginia,Cassville,1150,19,582,100,100,0,801
West Virginia,Cass,47,14,33,0,0,0,47
West Virginia,Carpendale,789,62,272,169,50,40,593
West Virginia,Carolina,355,42,107,87,52,0,288
West Virginia,Capon Bridge,373,36,160,35,16,4,251
West Virginia,Huntersville,146,15,68,29,5,0,117
West Virginia,Hundred,262,42,86,56,5,22,211
West Virginia,Cedar Grove,838,168,211,129,39,10,557
West Virginia,Hambleton,254,48,94,24,15,0,181
West Virginia,Gypsy,317,124,51,17,23,48,263
West Virginia,Greenview,486,87,87,137,4,0,315
West Virginia,Boomer,923,74,289,219,8,31,621
West Virginia,Bolt,598,12,209,141,18,0,380
West Virginia,Bolivar,1236,89,233,291,200,117,930
West Virginia,Boaz,1306,91,272,389,135,86,973
West Virginia,Bluewell,2535,533,672,348,173,43,1769
West Virginia,Bluefield,10431,1057,2467,2188,1190,463,7365
West Virginia,Blennerhassett,2769,217,823,624,209,160,2033
West Virginia,Bowden,0,0,0,0,0,0,0
West Virginia,Blacksville,163,12,69,8,7,6,102
West Virginia,Big Sandy,185,33,60,80,0,0,173
West Virginia,Big Creek,367,29,125,76,31,0,261
West Virginia,Big Chimney,301,53,94,83,30,41,301
West Virginia,Beverly,656,89,141,68,36,28,362
West Virginia,Bethlehem,2589,117,555,534,445,196,1847
West Virginia,Bethany,1137,13,61,65,53,77,269
West Virginia,Berwind,578,46,135,56,0,13,250
West Virginia,Birch River,62,0,19,0,0,0,19
West Virginia,Bradley,1810,167,499,290,188,13,1157
West Virginia,Bradshaw,293,65,106,14,4,2,191
West Virginia,Bramwell,293,39,85,58,28,11,221
West Virginia,Green Spring,252,27,103,38,0,12,180
West Virginia,Cameron,969,125,366,105,42,21,659
West Virginia,Camden-on-Gauley,196,32,69,17,11,5,134
West Virginia,Cairo,405,64,120,61,4,7,256
West Virginia,Burnsville,511,62,166,96,5,20,349
West Virginia,Burlington,243,35,38,31,7,19,130
West Virginia,Buffalo,1331,117,493,165,71,25,871
West Virginia,Bud,440,107,182,73,0,17,379
West Virginia,Buckhannon,5650,409,1193,657,411,410,3080
West Virginia,Brush Fork,1137,129,243,145,160,11,688
West Virginia,Bruno,1102,250,195,198,17,0,660
West Virginia,Bruceton Mills,54,2,28,5,0,2,37
West Virginia,Brookhaven,5384,394,1128,741,797,554,3614
West Virginia,Bridgeport,8338,295,1556,1560,1730,912,6053
West Virginia,Brenton,207,66,40,44,22,0,172
West Virginia,Brandywine,119,45,62,8,0,0,115
West Virginia,Brandonville,140,2,47,14,19,7,89
West Virginia,Powellton,610,87,159,124,12,0,382
West Virginia,Pratt,527,20,129,120,43,50,362
West Virginia,Poca,1071,71,316,247,83,62,779
West Virginia,Prince,100,0,27,0,12,0,39
West Virginia,Lumberport,1022,93,297,210,43,24,667
West Virginia,Lubeck,1308,69,418,311,124,69,991
West Virginia,Lost Creek,481,45,125,88,44,33,335
West Virginia,Logan,1818,301,475,479,55,39,1349
West Virginia,Littleton,123,0,20,0,13,0,33
West Virginia,Lewisburg,3948,197,702,610,908,589,3006
West Virginia,Lester,334,47,110,52,13,2,224
West Virginia,Mabscott,1387,96,401,257,95,114,963
West Virginia,Lesage,1358,186,402,250,108,87,1033
West Virginia,Lavalette,1159,120,257,217,137,65,796
West Virginia,Lashmeet,436,40,199,14,41,0,294
West Virginia,Kopperston,495,63,152,137,0,20,372
West Virginia,Kistler,507,70,201,86,27,0,384
West Virginia,Kingwood,2955,300,687,559,363,130,2039
West Virginia,Kincaid,392,76,54,15,0,8,153
West Virginia,Prichard,267,67,135,48,8,9,267
West Virginia,Leon,128,15,67,5,2,1,90
West Virginia,MacArthur,1559,197,519,221,159,47,1143
West Virginia,McConnell,615,38,124,120,44,38,364
West Virginia,McMechen,1702,154,611,303,102,35,1205
West Virginia,Rowlesburg,749,126,296,70,19,33,544
West Virginia,Rossmore,596,144,169,115,0,0,428
West Virginia,Ronceverte,1582,161,580,295,123,65,1224
West Virginia,Romney,2221,343,601,327,128,136,1535
West Virginia,Roderfield,51,13,12,15,0,0,40
West Virginia,Robinette,703,51,261,104,0,7,423
West Virginia,Rivesville,1025,51,250,137,111,63,612
West Virginia,Ripley,3258,387,690,677,355,140,2249
West Virginia,Ridgeley,612,97,248,100,19,16,480
West Virginia,Richwood,2180,259,748,273,153,54,1487
West Virginia,Rhodell,212,47,53,17,5,1,123
West Virginia,Reedy,149,9,53,28,12,2,104
West Virginia,Reedsville,508,55,164,88,25,10,342
West Virginia,Red Jacket,685,142,203,74,53,12,484
West Virginia,Reader,359,76,104,74,33,0,287
West Virginia,Mallory,1306,343,333,252,93,18,1039
West Virginia,Madison,2993,151,874,665,195,234,2119
West Virginia,Kimball,105,14,38,5,14,12,83
West Virginia,Keystone,176,21,68,37,0,0,126
West Virginia,Kimberly,261,14,132,51,0,0,197
West Virginia,Kermit,294,45,100,59,11,25,240
West Virginia,Idamay,204,0,42,108,0,0,150
West Virginia,Iaeger,241,81,60,18,0,0,159
West Virginia,Keyser,5320,277,1593,850,305,213,3238
West Virginia,Hurricane,6388,389,1430,1376,563,574,4332
West Virginia,Huntington,48944,4017,8751,9377,5117,4294,31556
West Virginia,Raysal,498,159,52,37,0,0,248
West Virginia,Ravenswood,3853,179,1202,632,230,311,2554
West Virginia,Inwood,2351,153,861,407,87,85,1593
West Virginia,Ranson corpor,4713,377,1291,737,487,238,3130
West Virginia,Rainelle,1452,256,519,236,65,17,1093
West Virginia,Racine,235,20,93,57,0,24,194
West Virginia,Rachel,234,17,96,21,49,0,183
West Virginia,Quinwood,209,38,72,50,4,1,165
West Virginia,Pullman,190,34,36,57,0,0,127
West Virginia,Prosperity,1624,193,503,341,179,50,1266
West Virginia,Princeton,6082,979,1266,1218,435,285,4183
West Virginia,Rand,1315,173,308,258,54,0,793
West Virginia,Itmann,302,11,147,37,0,0,195
West Virginia,Huttonsville,260,33,75,36,3,13,160
West Virginia,Kenova,3127,417,972,789,101,13,2292
West Virginia,Justice,427,127,121,40,0,0,288
West Virginia,Junior,471,99,143,58,5,1,306
West Virginia,Jefferson,800,179,210,133,27,5,554
West Virginia,Jane Lew,365,25,132,59,16,16,248
West Virginia,Jacksonburg,106,10,74,9,0,0,93
Wisconsin,Arpin,319,44,102,56,13,2,217
Wisconsin,Avoca,595,51,217,140,23,4,435
Wisconsin,Augusta,1468,127,406,328,73,52,986
Wisconsin,Auburndale,626,63,167,93,66,27,416
Wisconsin,Athens,1016,111,336,158,76,39,720
Wisconsin,Ashwaubenon,17082,726,3523,4071,2301,1041,11662
Wisconsin,Angelica,87,13,25,21,4,4,67
Wisconsin,Aniwa,243,18,80,59,6,5,168
Wisconsin,Babcock,72,11,29,16,2,0,58
Wisconsin,Appleton,73118,3658,13522,15245,10471,4840,47736
Wisconsin,Arcadia,2947,398,759,372,173,81,1783
Wisconsin,Arena,820,52,214,171,68,33,538
Wisconsin,Argonne,176,8,52,30,6,6,102
Wisconsin,Ashippun,216,10,57,54,20,10,151
Wisconsin,Ashland,8116,294,1699,1919,1012,677,5601
Wisconsin,Argyle,785,36,296,158,45,27,562
Wisconsin,Arkansaw,179,14,56,37,10,0,117
Wisconsin,Arkdale,145,11,46,48,7,6,118
Wisconsin,Arlington,860,17,205,209,91,39,561
Wisconsin,Antigo,8001,662,2181,1880,628,220,5571
Wisconsin,Bagley,478,55,201,83,8,7,354
Wisconsin,Cataract,139,54,16,32,2,9,113
Wisconsin,Baldwin,3964,220,878,1245,243,121,2707
Wisconsin,Dalton,222,16,59,49,22,4,150
Wisconsin,Dallas,368,40,124,87,14,4,269
Wisconsin,Dale,473,7,133,99,54,16,309
Wisconsin,Curtiss,319,72,59,28,2,1,162
Wisconsin,Cumberland,2434,156,705,463,255,141,1720
Wisconsin,Cudahy,18347,1462,4225,4335,2192,619,12833
Wisconsin,Cuba City,1917,81,444,486,285,82,1378
Wisconsin,Cross Plains,3834,141,681,805,664,281,2572
Wisconsin,Crivitz,1035,96,305,287,28,34,750
Wisconsin,Crandon,1914,193,533,395,108,55,1284
Wisconsin,Couderay,75,3,26,16,14,3,62
Wisconsin,Cottage Grove,6639,278,854,1280,1097,608,4117
Wisconsin,Cornucopia,93,6,22,44,10,9,91
Wisconsin,Cornell,1481,163,319,339,158,34,1013
Wisconsin,Coon Valley,689,39,195,143,83,52,512
Wisconsin,Conrath,133,24,44,11,9,1,89
Wisconsin,Como,2416,148,516,563,196,198,1621
Wisconsin,Combined Locks,3444,135,829,1046,424,36,2470
Wisconsin,Columbus,4999,171,1052,1166,836,291,3516
Wisconsin,Boaz,113,13,38,27,2,3,83
Wisconsin,Bohners Lake,2110,208,548,480,220,75,1531
Wisconsin,Bonduel,1409,65,405,287,86,32,875
Wisconsin,Boscobel,3194,401,867,651,224,144,2287
Wisconsin,Boulder Junction,123,1,39,38,30,2,110
Wisconsin,Bowler,416,32,124,51,21,5,233
Wisconsin,Coloma,392,33,126,86,27,6,278
Wisconsin,Collins,180,6,81,41,0,8,136
Wisconsin,Danbury,219,7,81,41,4,0,133
Wisconsin,Dane,1171,60,228,244,153,25,710
Wisconsin,Darien,1708,182,434,286,88,83,1073
Wisconsin,Darlington,2338,231,626,474,183,99,1613
Wisconsin,Eagle River,1644,90,409,368,155,62,1084
Wisconsin,Eagle Lake,1229,67,264,286,187,90,894
Wisconsin,Eagle,1777,32,381,432,286,81,1212
Wisconsin,Dyckesville,484,9,114,59,128,73,383
Wisconsin,Durand,1742,109,614,325,150,77,1275
Wisconsin,Dunbar,121,3,24,24,8,5,64
Wisconsin,Drummond,163,30,37,40,21,6,134
Wisconsin,Dresser,859,57,235,219,50,17,578
Wisconsin,Doylestown,265,21,111,51,11,2,196
Wisconsin,Downsville,130,0,31,27,31,0,89
Wisconsin,Downing,326,14,106,43,39,3,205
Wisconsin,Dousman,2412,116,657,555,267,148,1743
Wisconsin,Dorchester,977,102,302,131,32,12,579
Wisconsin,Colfax,1154,78,262,296,62,46,744
Wisconsin,Dodgeville,4678,213,1167,1207,471,143,3201
Wisconsin,Dickeyville,1176,45,402,232,103,17,799
Wisconsin,Diaperville,40,2,9,10,2,2,25
Wisconsin,Diamond Bluff,160,6,59,52,8,9,134
Wisconsin,De Soto,275,14,73,85,12,5,189
Wisconsin,De Pere,24366,770,3899,5215,3731,1635,15250
Wisconsin,Denmark,2080,161,636,361,196,48,1402
Wisconsin,Dellwood,598,49,210,148,22,20,449
Wisconsin,Delavan Lake,2352,129,383,595,427,140,1674
Wisconsin,Delavan,8439,1162,1962,1629,569,292,5614
Wisconsin,Delafield,7168,131,893,1355,1571,945,4895
Wisconsin,DeForest,9347,203,1530,2453,1338,650,6174
Wisconsin,Deer Park,235,18,86,57,11,0,172
Wisconsin,Deerfield,2631,60,457,615,452,118,1702
Wisconsin,Dodge,124,9,38,34,8,0,89
Wisconsin,Eastman,413,24,125,70,19,14,252
Wisconsin,Coleman,729,40,184,205,53,10,492
Wisconsin,Cochrane,442,11,167,97,40,7,322
Wisconsin,Brooklyn,1428,37,257,380,197,62,933
Wisconsin,Brown Deer,12101,544,2214,2900,2025,1103,8786
Wisconsin,Browns Lake,2318,62,618,562,256,66,1564
Wisconsin,Brownsville,615,28,179,87,92,19,405
Wisconsin,Browntown,292,18,103,53,19,9,202
Wisconsin,Bruce,797,70,260,114,37,13,494
Wisconsin,Brule,239,9,65,63,25,8,170
Wisconsin,Buffalo City,1035,21,353,274,91,38,777
Wisconsin,Burlington,10548,471,2392,2771,913,435,6982
Wisconsin,Burnett,240,19,70,51,8,5,153
Wisconsin,Butler,1763,105,543,418,301,60,1427
Wisconsin,Butte des Morts,832,4,135,296,96,45,576
Wisconsin,Butternut,385,30,103,107,18,9,267
Wisconsin,Cable,215,20,20,65,23,17,145
Wisconsin,Cadott,1407,124,390,254,97,39,904
Wisconsin,Caledonia,24659,1086,5313,6094,3290,2053,17836
Wisconsin,Cambria,716,55,170,142,50,18,435
Wisconsin,Cambridge,1298,36,206,290,250,142,924
Wisconsin,Cameron,1974,100,518,514,120,50,1302
Wisconsin,Campbellsport,2007,137,577,380,165,124,1383
Wisconsin,Camp Douglas,580,38,176,139,38,3,394
Wisconsin,Camp Lake,4003,354,762,930,266,184,2496
Wisconsin,Caroline,227,20,67,30,15,10,142
Wisconsin,Cascade,675,54,209,166,44,3,476
Wisconsin,Casco,559,47,161,82,60,14,364
Wisconsin,Cashton,992,84,388,178,63,34,747
Wisconsin,Cassville,854,43,288,162,83,42,618
Wisconsin,Brookfield,38000,784,4236,6560,9442,5968,26990
Wisconsin,Brokaw,229,9,64,68,27,12,180
Wisconsin,Brodhead,3323,196,986,782,220,113,2297
Wisconsin,Bristol,4928,287,1252,1217,475,287,3518
Wisconsin,Cobb,532,10,135,143,49,14,351
Wisconsin,Clyman,473,43,164,108,33,1,349
Wisconsin,Clintonville,4504,428,1312,1035,280,93,3148
Wisconsin,Clinton,2123,180,568,431,202,65,1446
Wisconsin,Cleveland,1626,102,314,298,208,100,1022
Wisconsin,Clear Lake,803,39,333,186,33,14,605
Wisconsin,Clayton,615,46,164,91,28,9,338
Wisconsin,Clam Lake,32,1,11,13,3,2,30
Wisconsin,Chippewa Falls,13868,677,3821,3124,1457,511,9590
Wisconsin,Chilton,3944,277,1217,782,377,61,2714
Wisconsin,Chili,278,21,41,34,39,12,147
Wisconsin,Chief Lake,601,50,173,127,39,15,404
Wisconsin,Chetek,2345,210,652,579,141,109,1691
Wisconsin,Colby,1851,260,536,344,78,20,1238
Wisconsin,Chenequa,527,5,52,90,187,93,427
Wisconsin,Chaseburg,275,7,80,95,33,4,219
Wisconsin,Chain O' Lakes,1070,25,230,288,291,111,945
Wisconsin,Centuria,1035,100,226,171,38,15,550
Wisconsin,Cedar Grove,2165,59,555,461,157,138,1370
Wisconsin,Cedarburg,11508,249,1535,1800,2961,1304,7849
Wisconsin,Cecil,611,38,209,141,58,30,476
Wisconsin,Cazenovia,407,51,129,92,12,5,289
Wisconsin,Catawba,102,9,35,30,8,1,83
Wisconsin,Boyceville,996,126,253,216,35,28,658
Wisconsin,Boyd,565,51,139,156,34,21,401
Wisconsin,Brandon,960,68,231,199,79,17,594
Wisconsin,Brice Prairie,1924,52,438,521,191,135,1337
Wisconsin,Brillion,3175,121,890,597,299,88,1995
Wisconsin,Chelsea,109,16,33,25,3,0,77
Wisconsin,Baileys Harbor,276,0,70,90,59,27,246
Wisconsin,East Troy,4304,204,846,919,490,207,2666
Wisconsin,Eden,761,52,223,189,44,20,528
Wisconsin,Galesville,1495,111,346,330,200,61,1048
Wisconsin,Friesland,357,39,88,65,30,4,226
Wisconsin,Friendship,696,86,248,134,51,14,533
Wisconsin,French Island,4397,196,1046,1350,634,264,3490
Wisconsin,Fremont,675,40,184,173,58,16,471
Wisconsin,Fredonia,2115,98,589,522,165,77,1451
Wisconsin,Frederic,985,81,322,175,51,25,654
Wisconsin,Franks Field,141,19,27,39,4,1,90
Wisconsin,Franklin,36103,2038,6419,8155,6215,3009,25836
Wisconsin,Francis Creek,519,16,181,128,43,24,392
Wisconsin,Fox Point,6709,79,287,778,1896,1705,4745
Wisconsin,Fox Lake,1545,133,476,314,128,27,1078
Wisconsin,Fountain City,853,40,198,197,120,48,603
Wisconsin,Fort Atkinson,12447,861,2966,2554,1341,633,8355
Wisconsin,Forestville,505,31,182,88,18,13,332
Wisconsin,Forest Junction,665,43,151,171,70,3,438
Wisconsin,Footville,646,104,227,100,53,13,497
Wisconsin,Fontana-on-Geneva Lake,1406,26,175,279,395,239,1114
Wisconsin,Fond du Lac,43060,2614,10606,9316,4740,2192,29468
Wisconsin,Florence,502,50,159,121,33,0,363
Wisconsin,Fitchburg,26616,1625,3464,4713,4907,3456,18165
Wisconsin,Ferryville,158,23,31,61,11,10,136
Wisconsin,Fenwood,149,8,56,26,9,1,100
Wisconsin,Fennimore,2465,83,569,689,199,103,1643
Wisconsin,Fall River,1601,52,316,381,219,71,1039
Wisconsin,Fall Creek,1321,76,244,377,145,46,888
Wisconsin,Fairwater,366,38,110,85,20,8,261
Wisconsin,Gays Mills,501,22,123,124,26,18,313
Wisconsin,Genoa City,3035,144,656,646,245,131,1822
Wisconsin,Germantown,19830,881,3180,4226,3841,1549,13677
Wisconsin,Gibbsville,507,4,209,80,56,4,353
Wisconsin,Hager City,261,7,107,34,25,6,179
Wisconsin,Gresham,446,33,98,151,25,5,312
Wisconsin,Greenwood,1093,86,333,218,60,58,755
Wisconsin,Green Valley,160,0,58,19,0,0,77
Wisconsin,Greenleaf,821,87,220,112,16,4,439
Wisconsin,Green Lake,955,42,224,224,144,90,724
Wisconsin,Greenfield,37113,2417,9461,8425,5426,2492,28221
Wisconsin,Greendale,14294,385,2772,3334,2600,1402,10493
Wisconsin,Greenbush,153,8,35,30,13,2,88
Wisconsin,Green Bay,104847,9007,22090,20264,11781,4171,67313
Wisconsin,Gratiot,189,10,76,32,17,3,138
Wisconsin,Grantsburg,1251,113,356,323,59,58,909
Wisconsin,Granton,377,23,113,75,15,9,235
Wisconsin,Fairchild,524,89,167,62,18,0,336
Wisconsin,Grand View,161,14,36,42,6,3,101
Wisconsin,Grafton,11535,307,1863,2507,2269,969,7915
Wisconsin,Gotham,221,0,48,97,16,3,164
Wisconsin,Gordon,180,29,40,61,15,3,148
Wisconsin,Goodman,277,28,87,70,18,4,207
Wisconsin,Glidden,416,33,143,72,30,0,278
Wisconsin,Glenwood City,1267,94,377,232,93,51,847
Wisconsin,Glen Haven,78,10,38,7,1,2,58
Wisconsin,Glen Flora,79,2,10,32,9,0,53
Wisconsin,Glendale,12914,533,1627,2526,2875,1803,9364
Wisconsin,Glenbeulah,455,23,144,89,49,24,329
Wisconsin,Gilmanton,145,25,64,12,4,4,109
Wisconsin,Gilman,388,24,143,70,43,17,297
Wisconsin,Gillett,1340,155,451,289,64,29,988
Wisconsin,Grand Marsh,88,11,40,14,6,0,71
Wisconsin,Eau Claire,67385,2342,10316,14307,8432,4502,39899
Wisconsin,Exeland,219,13,63,32,8,0,116
Wisconsin,Eureka,402,144,67,45,18,4,278
Wisconsin,Big Falls,71,21,27,22,0,1,71
Wisconsin,Birch Hill,266,15,53,42,8,2,120
Wisconsin,Birchwood,466,36,132,110,41,15,334
Wisconsin,Birnamwood,874,78,290,180,18,20,586
Wisconsin,Biron,895,76,294,181,76,24,651
Wisconsin,Black Creek,1349,45,359,312,105,24,845
Wisconsin,Black Earth,1396,50,393,318,177,59,997
Wisconsin,Black River Falls,3574,234,1089,922,244,157,2646
Wisconsin,Blair,1310,132,339,256,95,31,853
Wisconsin,Blanchardville,809,43,245,173,45,26,532
Wisconsin,Bloomer,3536,206,988,796,268,169,2427
Wisconsin,Bloomfield,4666,305,1202,943,401,185,3036
Wisconsin,Bloomington,809,25,251,196,47,7,526
Wisconsin,Blue Mounds,829,29,192,203,114,52,590
Wisconsin,Blue River,442,39,148,99,26,14,326
Wisconsin,Bluffview,595,45,157,109,14,3,328
Wisconsin,Elk Mound,1062,64,243,218,88,21,634
Wisconsin,Elkhorn,9998,511,2036,2305,999,624,6475
Wisconsin,Elkhart Lake,1051,34,218,242,168,108,770
Wisconsin,Eleva,761,46,229,200,51,15,541
Wisconsin,Elderon,161,16,66,21,11,1,115
Wisconsin,Elcho,284,21,87,113,17,11,249
Wisconsin,Eland,237,30,77,33,16,0,156
Wisconsin,Egg Harbor,283,1,21,66,83,50,221
Wisconsin,Edmund,175,4,59,41,12,0,116
Wisconsin,Edgerton,5484,275,1196,1445,705,187,3808
Wisconsin,Edgar,1605,83,444,339,114,19,999
Wisconsin,Big Bend,1285,45,328,358,159,57,947
Wisconsin,Berlin,5454,618,1735,899,287,204,3743
Wisconsin,Benton,1030,70,232,294,71,36,703
Wisconsin,Beloit,36858,4312,8309,6263,2094,1491,22469
Wisconsin,Ettrick,647,33,199,128,47,14,421
Wisconsin,Ephraim,269,7,30,66,95,30,228
Wisconsin,Endeavor,459,34,152,104,23,8,321
Wisconsin,Emerald,155,25,35,21,8,6,95
Wisconsin,Embarrass,601,37,199,145,30,7,418
Wisconsin,Elroy,1414,163,447,265,49,26,950
Wisconsin,Elmwood Park,448,23,79,118,79,38,337
Wisconsin,Elmwood,865,47,319,166,56,13,601
Wisconsin,Elm Grove,6037,94,452,531,1788,1404,4269
Wisconsin,Ellsworth,3227,203,843,804,207,106,2163
Wisconsin,Ellison Bay,213,4,65,34,57,20,180
Wisconsin,Balsam Lake,781,69,249,203,63,27,611
Wisconsin,Bancroft,565,82,140,74,33,6,335
Wisconsin,Evansville,5143,163,921,1391,588,229,3292
Wisconsin,Bangor,1435,88,352,333,136,54,963
Wisconsin,Barneveld,1276,37,204,325,200,44,810
Wisconsin,Barron,3366,445,835,709,169,40,2198
Wisconsin,Barronett,102,12,55,12,0,0,79
Wisconsin,Bay City,471,39,183,56,24,2,304
Wisconsin,Bayfield,544,10,57,173,119,69,428
Wisconsin,Bayside,4490,73,338,554,1279,970,3214
Wisconsin,Bear Creek,424,93,108,78,6,8,293
Wisconsin,Beaver Dam,16400,1352,4411,3528,1359,823,11473
Wisconsin,Belgium,2067,117,385,485,281,38,1306
Wisconsin,Bell Center,127,17,43,25,12,6,103
Wisconsin,Belleville,2643,51,538,685,303,85,1662
Wisconsin,Bellevue,15048,1144,3088,3392,2201,532,10357
Wisconsin,Belmont,1007,47,328,226,79,18,698
Wisconsin,Baraboo,12071,1145,3007,2469,1260,438,8319
Wisconsin,Genoa,241,19,57,74,18,3,171
Wisconsin,Livingston,656,31,190,144,50,17,432
Wisconsin,Amherst,1220,83,254,238,104,30,709
Wisconsin,Sauk City,3461,87,822,840,421,187,2357
Wisconsin,Sandy Hook,465,4,119,146,43,17,329
Wisconsin,St. Peter,1401,71,342,398,173,81,1065
Wisconsin,St. Nazianz,638,57,198,130,60,7,452
Wisconsin,St. Joseph,431,12,113,83,64,41,313
Wisconsin,St. Francis,9549,1004,2115,2238,1444,679,7480
Wisconsin,St. Croix Falls,2082,127,539,519,239,195,1619
Wisconsin,St. Cloud,494,20,202,124,29,16,391
Wisconsin,Rudolph,471,31,174,91,47,4,347
Wisconsin,Rothschild,5287,187,1229,1305,719,221,3661
Wisconsin,Rosholt,426,9,165,53,42,7,276
Wisconsin,Rosendale,934,31,302,176,95,48,652
Wisconsin,Rome,750,32,227,206,47,21,533
Wisconsin,Rock Springs,386,25,111,66,21,8,231
Wisconsin,Rockland,661,19,168,198,26,4,415
Wisconsin,Rockdale,202,6,37,50,28,15,136
Wisconsin,Rochester,3706,301,1120,679,431,227,2758
Wisconsin,Roberts,1645,64,321,461,174,66,1086
Wisconsin,River Hills,1472,11,76,162,402,399,1050
Wisconsin,River Falls,15103,307,1444,2820,1904,1036,7511
Wisconsin,Ripon,7690,512,1833,1347,767,380,4839
Wisconsin,Rio,1102,53,265,281,106,26,731
Wisconsin,Ridgeway,591,58,180,114,49,9,410
Wisconsin,Ridgeland,230,13,67,74,3,5,162
Wisconsin,Richland Center,5094,329,1115,1243,396,286,3369
Wisconsin,Richfield,11410,342,1943,2933,2150,844,8212
Wisconsin,Rice Lake,8355,509,2416,1885,620,439,5869
Wisconsin,Saukville,4484,196,960,994,451,335,2936
Wisconsin,Saxon,64,8,27,14,2,5,56
Wisconsin,Sayner,131,8,25,63,5,0,101
Wisconsin,Scandinavia,358,16,119,75,28,10,248
Wisconsin,Spooner,2625,172,793,518,204,138,1825
Wisconsin,Spencer,2030,153,580,436,122,64,1355
Wisconsin,Sparta,9638,748,2519,2255,907,311,6740
Wisconsin,South Wayne,447,66,128,68,21,2,285
Wisconsin,South Milwaukee,21229,1461,5250,5154,1989,872,14726
Wisconsin,Somerset,2671,112,521,552,256,90,1531
Wisconsin,Solon Springs,575,39,149,183,50,37,458
Wisconsin,Soldiers Grove,592,91,195,107,23,13,429
Wisconsin,Sobieski,499,40,81,145,43,31,340
Wisconsin,Slinger,5148,204,1121,1116,723,282,3446
Wisconsin,Sister Bay,734,23,196,192,168,68,647
Wisconsin,Siren,806,60,236,177,53,28,554
Wisconsin,Silver Lake,2270,96,476,522,275,119,1488
Wisconsin,Rib Mountain,5714,123,1066,1108,968,616,3881
Wisconsin,Shullsburg,1115,113,371,217,111,37,849
Wisconsin,Shorewood,13284,277,913,2018,3081,3241,9530
Wisconsin,Shiocton,892,55,285,179,40,24,583
Wisconsin,Sherwood,2810,13,516,506,586,280,1901
Wisconsin,Shell Lake,1375,101,383,322,180,69,1055
Wisconsin,Sheldon,215,31,67,29,13,1,141
Wisconsin,Sheboygan Falls,7803,450,1971,1777,1016,341,5555
Wisconsin,Sheboygan,48853,3998,12673,9630,4373,1849,32523
Wisconsin,Amherst Junction,403,9,88,83,48,16,244
Wisconsin,Sharon,1632,143,414,306,98,39,1000
Wisconsin,Seymour,3450,215,747,735,298,150,2145
Wisconsin,Seymour,1579,73,373,435,134,92,1107
Wisconsin,Sextonville,366,26,114,94,7,0,241
Wisconsin,Schofield,2104,109,803,429,127,45,1513
Wisconsin,Shorewood Hills,1839,14,92,114,239,833,1292
Wisconsin,Springbrook,91,7,34,21,0,6,68
Wisconsin,Rib Lake,1061,107,280,183,73,49,692
Wisconsin,Rewey,308,13,73,78,19,13,196
Wisconsin,Plymouth,8427,510,1871,1919,1338,489,6127
Wisconsin,Plum City,586,33,182,145,26,4,390
Wisconsin,Plover,12255,536,2497,2387,1934,656,8010
Wisconsin,Pleasant Prairie,20217,1000,3913,4283,3021,1786,14003
Wisconsin,Platteville,11740,194,1262,1502,786,812,4556
Wisconsin,Plainfield,1057,139,261,184,29,6,619
Wisconsin,Plain,830,30,237,177,94,22,560
Wisconsin,Pittsville,883,87,234,184,53,15,573
Wisconsin,Pine River,103,7,38,22,0,0,67
Wisconsin,Pigeon Falls,357,45,127,60,40,18,290
Wisconsin,Phillips,1446,107,429,316,158,38,1048
Wisconsin,Pewaukee,8252,143,1583,1999,1461,790,5976
Wisconsin,Pewaukee,13784,246,1923,2636,3243,1703,9751
Wisconsin,Peshtigo,3458,263,948,844,357,133,2545
Wisconsin,Pepin,818,57,269,220,70,27,643
Wisconsin,Pence,126,2,51,34,12,1,100
Wisconsin,Pembine,185,0,67,26,5,0,98
Wisconsin,Pella,182,7,75,45,14,13,154
Wisconsin,Patch Grove,129,8,34,38,9,1,90
Wisconsin,Park Ridge,595,12,90,103,108,97,410
Wisconsin,Park Falls,2216,232,566,575,209,73,1655
Wisconsin,Pardeeville,2196,82,556,632,186,66,1522
Wisconsin,Palmyra,1640,135,536,378,109,45,1203
Wisconsin,Paddock Lake,3005,173,772,723,314,122,2104
Wisconsin,Packwaukee,268,42,50,53,7,0,152
Wisconsin,Oxford,577,53,207,115,23,5,403
Wisconsin,Owen,917,66,262,203,79,28,638
Wisconsin,Polonia,568,10,178,94,50,24,356
Wisconsin,Poplar,590,31,138,132,106,21,428
Wisconsin,Portage,10232,736,2667,2632,792,258,7085
Wisconsin,Port Edwards,1660,70,391,448,173,122,1204
Wisconsin,Reserve,448,77,93,91,17,3,281
Wisconsin,Reeseville,663,70,196,131,28,11,436
Wisconsin,Reedsville,1088,57,306,261,73,20,717
Wisconsin,Reedsburg,9468,573,2318,2042,790,435,6158
Wisconsin,Redgranite,2110,351,738,470,149,55,1763
Wisconsin,Readstown,442,60,144,67,29,15,315
Wisconsin,Random Lake,1550,74,371,381,180,64,1070
Wisconsin,Randolph,1711,147,531,340,103,17,1138
Wisconsin,Radisson,134,9,61,18,13,1,102
Wisconsin,Racine,78127,9314,14766,16184,5863,2612,48739
Wisconsin,Pulcifer,156,17,52,27,18,6,120
Wisconsin,Pulaski,3531,97,966,788,371,155,2377
Wisconsin,Princeton,1191,88,371,276,81,21,837
Wisconsin,Rhinelander,7583,534,1823,1771,719,402,5249
Wisconsin,Prescott,4212,131,973,1152,371,193,2820
Wisconsin,Prairie Farm,485,41,155,108,34,8,346
Wisconsin,Prairie du Sac,4168,91,1064,885,662,213,2915
Wisconsin,Prairie du Chien,5809,417,1873,1315,429,201,4235
Wisconsin,Poy Sippi,282,40,85,60,10,10,205
Wisconsin,Poynette,2636,97,540,766,315,81,1799
Wisconsin,Powers Lake,1150,88,272,282,188,51,881
Wisconsin,Pound,504,45,164,71,32,6,318
Wisconsin,Potter Lake,1092,35,272,386,100,88,881
Wisconsin,Potter,303,20,76,63,21,11,191
Wisconsin,Potosi,709,54,204,139,85,21,503
Wisconsin,Post Lake,359,28,129,90,34,22,303
Wisconsin,Port Wing,137,13,29,40,18,17,117
Wisconsin,Port Washington,11481,393,2189,2460,1900,1022,7964
Wisconsin,Prentice,640,58,219,124,44,13,458
Wisconsin,Springfield,236,37,60,66,0,0,163
Wisconsin,Spring Green,1709,105,346,387,249,111,1198
Wisconsin,Spring Valley,1414,63,294,342,188,59,946
Wisconsin,Whitefish Bay,14122,172,815,1401,3975,2955,9318
Wisconsin,Wheeler,337,60,87,68,5,4,224
Wisconsin,Weyerhaeuser,252,17,87,64,16,7,191
Wisconsin,Weyauwega,1696,171,571,285,77,18,1122
Wisconsin,West Salem,4936,144,1169,1118,675,268,3374
Wisconsin,Weston,14956,870,3644,3116,1671,853,10154
Wisconsin,West Milwaukee,4222,579,875,863,379,124,2820
Wisconsin,Westfield,1328,98,359,198,75,42,772
Wisconsin,Westby,2147,144,534,486,254,86,1504
Wisconsin,Westboro,210,23,57,48,9,8,145
Wisconsin,West Bend,31611,1501,6771,7475,4282,1578,21607
Wisconsin,West Baraboo,1747,159,315,327,161,83,1045
Wisconsin,West Allis,60677,4383,14856,14386,7852,2346,43823
Wisconsin,Webster,623,76,148,142,39,4,409
Wisconsin,Wauzeka,777,25,193,195,34,23,470
Wisconsin,Wauwatosa,47126,1164,5327,8289,11996,7288,34064
Wisconsin,Wautoma,1960,223,514,396,77,51,1261
Wisconsin,Wausaukee,479,63,197,81,24,4,369
Wisconsin,Wausau,39210,2915,8556,8222,4488,2495,26676
Wisconsin,Waupun,11355,1262,3437,2451,717,314,8181
Wisconsin,Waupaca,6006,314,1861,1295,495,175,4140
Wisconsin,Waunakee,12846,154,1427,2379,2622,1482,8064
Wisconsin,Waumandee,55,6,23,10,3,4,46
Wisconsin,Waukesha,71324,3404,11402,15466,11497,4966,46735
Wisconsin,Waukau,312,9,95,106,19,11,240
Wisconsin,Waubeka,813,13,146,219,113,43,534
Wisconsin,Watertown,23878,1651,5557,5075,2249,1167,15699
Wisconsin,Whitehall,1676,154,428,359,142,61,1144
Wisconsin,White Lake,333,39,106,68,8,10,231
Wisconsin,Whitelaw,692,40,238,160,50,18,506
Wisconsin,Whitewater,14866,474,1021,1725,934,797,4951
Wisconsin,Zoar,161,6,31,36,0,0,73
Wisconsin,Yuba,63,6,27,22,3,0,58
Wisconsin,Wyocena,694,77,231,186,32,24,550
Wisconsin,Wyeville,149,12,50,25,9,4,100
Wisconsin,Wrightstown,3205,175,553,707,418,165,2018
Wisconsin,Woodville,1195,87,305,242,133,26,793
Wisconsin,Woodruff,709,78,280,164,27,25,574
Wisconsin,Woodman,109,10,36,31,2,0,79
Wisconsin,Woodford,75,4,31,15,0,0,50
Wisconsin,Wonewoc,850,76,305,175,33,17,606
Wisconsin,Wittenberg,1029,69,395,122,53,48,687
Wisconsin,Withee,512,55,142,127,10,11,345
Wisconsin,Wisconsin Rapids,18104,913,5099,4666,1461,546,12685
Wisconsin,Waterloo,3345,338,1034,630,232,95,2329
Wisconsin,Wisconsin Dells,2255,184,552,527,169,114,1546
Wisconsin,Winter,288,26,98,68,19,11,222
Wisconsin,Winneconne,2487,76,624,550,339,111,1700
Wisconsin,Windsor,3876,124,629,925,706,442,2826
Wisconsin,Wind Point,1749,19,199,317,472,373,1380
Wisconsin,Wind Lake,5384,194,1064,1373,831,318,3780
Wisconsin,Winchester,619,18,178,197,74,38,505
Wisconsin,Wilton,578,23,164,128,27,10,352
Wisconsin,Wilson,266,3,90,88,11,2,194
Wisconsin,Wilmot,225,10,113,41,17,12,193
Wisconsin,Williams Bay,2593,121,446,460,496,407,1930
Wisconsin,Wild Rose,800,84,274,168,53,21,600
Wisconsin,Whittlesey,131,11,45,37,7,0,100
Wisconsin,Whiting,1664,166,474,357,236,67,1300
Wisconsin,Wiota,111,4,42,33,9,2,90
Wisconsin,Waterford,5348,278,1222,1133,516,257,3406
Wisconsin,Washburn,2094,83,389,492,401,206,1571
Wisconsin,Warrens,435,34,125,84,27,24,294
Wisconsin,Theresa,1175,101,365,305,67,25,863
Wisconsin,Tennyson,347,20,112,71,35,9,247
Wisconsin,Taylor,487,22,159,88,13,2,284
Wisconsin,Taycheedah,844,92,336,139,78,26,671
Wisconsin,Tainter Lake,2764,81,679,705,420,211,2096
Wisconsin,Sussex,10680,262,1881,2091,1902,627,6763
Wisconsin,Suring,344,49,147,68,16,9,289
Wisconsin,Superior,700,42,185,193,85,20,525
Wisconsin,Superior,26817,1139,5972,6841,2711,1362,18025
Wisconsin,Sun Prairie,31174,788,4056,6605,5742,3117,20308
Wisconsin,Summit Lake,148,18,35,28,4,8,93
Wisconsin,Summit,4738,123,727,848,981,544,3223
Wisconsin,Sullivan,693,45,184,159,65,20,473
Wisconsin,Thiensville,3203,82,500,617,652,433,2284
Wisconsin,Suamico,11787,336,2787,2310,1840,784,8057
Wisconsin,Sturgeon Bay,9043,594,2170,2269,1315,521,6869
Wisconsin,Strum,999,80,257,256,68,30,691
Wisconsin,Stratford,1726,57,488,345,130,71,1091
Wisconsin,Stoughton,12976,706,2077,2878,2203,950,8814
Wisconsin,Stone Lake,176,8,48,29,16,8,109
Wisconsin,Stoddard,824,40,208,204,92,32,576
Wisconsin,Stockholm,78,5,10,23,14,13,65
Wisconsin,Stockbridge,765,30,256,157,105,25,573
Wisconsin,Stevens Point,26769,949,3928,4354,3174,1999,14404
Wisconsin,Steuben,109,3,35,27,5,0,70
Wisconsin,Stetsonville,605,40,182,128,24,17,391
Wisconsin,Star Prairie,617,19,162,127,57,19,384
Wisconsin,Stanley,3608,403,1220,968,128,34,2753
Wisconsin,Sturtevant,6983,615,1821,1684,646,232,4998
Wisconsin,Osseo,1581,87,383,377,144,106,1097
Wisconsin,Thornton,100,3,33,21,3,0,60
Wisconsin,Three Lakes,437,37,111,110,84,61,403
Wisconsin,Walworth,2824,182,600,594,357,116,1849
Wisconsin,Wales,2573,28,421,490,481,360,1780
Wisconsin,Waldo,542,33,147,138,46,10,374
Wisconsin,Wabeno,456,58,110,134,13,0,315
Wisconsin,Viroqua,4363,248,1364,863,461,240,3176
Wisconsin,Viola,770,32,263,127,38,43,503
Wisconsin,Vesper,636,30,185,154,27,16,412
Wisconsin,Verona,11723,117,1373,2054,2489,1767,7800
Wisconsin,Van Dyne,258,6,112,27,40,9,194
Wisconsin,Valders,1041,70,278,231,55,11,645
Wisconsin,Unity,337,40,126,58,13,2,239
Wisconsin,Union Grove,4891,262,1024,1476,397,161,3320
Wisconsin,Union Center,172,23,71,30,1,4,129
Wisconsin,Thorp,1631,172,481,321,73,57,1104
Wisconsin,Two Rivers,11500,793,3480,2585,1207,353,8418
Wisconsin,Tustin,114,6,42,36,12,4,100
Wisconsin,Turtle Lake,350,7,64,122,42,21,256
Wisconsin,Turtle Lake,1115,63,391,226,42,19,741
Wisconsin,Tunnel City,186,5,53,42,12,0,112
Wisconsin,Trempealeau,1717,99,352,444,176,109,1180
Wisconsin,Trego,141,8,47,32,14,12,113
Wisconsin,Townsend,81,6,19,24,6,0,55
Wisconsin,Tony,89,13,40,23,6,0,82
Wisconsin,Tomahawk,3309,350,832,885,288,100,2455
Wisconsin,Tomah,9326,567,2485,2143,937,201,6333
Wisconsin,Tilleda,72,2,23,13,2,0,40
Wisconsin,Tigerton,923,74,281,176,56,14,601
Wisconsin,Tichigan,5524,288,1213,1170,890,341,3902
Wisconsin,Twin Lakes,6031,252,1300,1569,594,293,4008
Wisconsin,Oshkosh,66582,4432,14152,12688,7329,2786,41387
Wisconsin,Shawano,9181,601,2454,2195,738,437,6425
Wisconsin,Orfordville,1422,75,324,342,128,48,917
Wisconsin,La Crosse,51993,2220,7529,10138,5628,3347,28862
Wisconsin,Lac La Belle,301,2,23,66,88,39,218
Wisconsin,Lac du Flambeau,1739,195,314,387,135,48,1079
Wisconsin,Kronenwetter,7406,236,1509,1494,1310,247,4796
Wisconsin,Krakow,346,27,143,62,29,7,268
Wisconsin,Kohler,2389,27,226,326,618,371,1568
Wisconsin,Knowlton,138,0,64,9,14,4,91
Wisconsin,Knapp,427,47,172,83,25,2,329
Wisconsin,Kingston,303,27,84,69,15,3,198
Wisconsin,King,1587,152,694,289,244,65,1444
Wisconsin,Kimberly,6646,260,1658,1384,987,258,4547
Wisconsin,Kieler,484,21,193,93,33,15,355
Wisconsin,Kiel,3739,151,1123,945,267,62,2548
Wisconsin,Kewaunee,2912,78,1010,690,302,144,2224
Wisconsin,Kewaskum,4043,376,864,964,348,158,2710
Wisconsin,Keshena,1364,77,260,208,40,12,597
Wisconsin,Kenosha,99897,7244,20567,21050,9875,4672,63408
Wisconsin,Kennan,128,14,49,27,11,0,101
Wisconsin,Kendall,515,46,199,100,22,8,375
Wisconsin,Kellnersville,413,29,131,107,25,9,301
Wisconsin,Kekoskee,170,12,65,46,10,2,135
Wisconsin,Kaukauna,15720,686,4191,3278,1710,585,10450
Wisconsin,Juneau,2741,283,711,651,162,29,1836
Wisconsin,Junction City,384,23,128,77,33,7,268
Wisconsin,Jump River,44,9,17,9,0,0,35
Wisconsin,Juda,361,17,118,99,3,0,237
Wisconsin,Johnson Creek,2855,129,494,712,457,168,1960
Wisconsin,Ladysmith,3278,258,924,589,286,142,2199
Wisconsin,La Farge,640,63,271,91,51,36,512
Wisconsin,Lake Arrowhead,810,30,216,234,185,83,748
Wisconsin,Lake Camelot,897,24,354,294,100,24,796
Wisconsin,Linden,509,37,127,137,16,5,322
Wisconsin,Lime Ridge,203,63,58,31,9,0,161
Wisconsin,Lily Lake,518,47,137,107,0,1,292
Wisconsin,Lewis,97,17,45,12,2,2,78
Wisconsin,Leopolis,67,4,27,5,6,4,46
Wisconsin,Lena,534,43,185,114,25,6,373
Wisconsin,Legend Lake,1272,76,321,332,105,76,910
Wisconsin,Lebanon,389,19,46,120,38,3,226
Wisconsin,La Valle,409,43,160,46,23,3,275
Wisconsin,Lauderdale Lakes,1061,29,222,258,207,83,799
Wisconsin,Laona,415,27,178,53,13,11,282
Wisconsin,Lannon,1108,75,290,288,121,46,820
Wisconsin,Lancaster,3811,156,1118,771,349,277,2671
Wisconsin,Jim Falls,232,19,113,41,7,0,180
Wisconsin,Lakewood,308,17,97,53,39,31,237
Wisconsin,Lake Wisconsin,4443,79,772,1310,738,383,3282
Wisconsin,Lake Wazeecha,2622,19,675,740,380,124,1938
Wisconsin,Lake Tomahawk,197,13,62,60,23,2,160
Wisconsin,Lake Sherwood,348,35,93,64,40,63,295
Wisconsin,Lake Ripley,1670,73,423,464,283,113,1356
Wisconsin,Lake Nebagamon,1173,43,203,296,243,91,876
Wisconsin,Lake Mills,5776,231,1074,1372,1010,278,3965
Wisconsin,Lake Lorraine,282,40,131,27,18,11,227
Wisconsin,Lake Koshkonong,1201,114,278,322,145,80,939
Wisconsin,Lake Ivanhoe,626,18,155,147,30,15,365
Wisconsin,Lake Hallie,6562,244,1350,1633,922,227,4376
Wisconsin,Lake Geneva,7714,674,1630,1470,923,621,5318
Wisconsin,Lake Delton,2952,184,821,675,403,210,2293
Wisconsin,Lake Wissota,3131,86,769,864,285,226,2230
Wisconsin,Little Chute,10641,423,2835,2446,1172,449,7325
Wisconsin,Jefferson,7965,541,2376,1527,715,243,5402
Wisconsin,Jackson,6808,353,1346,1813,959,240,4711
Wisconsin,Hayward,2101,185,442,452,188,118,1385
Wisconsin,Hawkins,345,15,139,84,21,2,261
Wisconsin,Haugen,361,22,82,117,22,7,250
Wisconsin,Osceola,2524,126,535,619,248,102,1630
Wisconsin,Hatfield,191,14,90,15,7,6,132
Wisconsin,Hartland,9187,327,1477,2070,1418,839,6131
Wisconsin,Hartford,14271,588,3042,3413,1762,636,9441
Wisconsin,Harrison,7386,84,894,1364,1571,574,4487
Wisconsin,Hanover,183,0,82,10,37,6,135
Wisconsin,Hancock,344,49,107,70,17,4,247
Wisconsin,Hammond,2015,51,392,467,208,79,1197
Wisconsin,Hales Corners,7756,377,1387,1621,1489,665,5539
Wisconsin,Abbotsford,2179,326,638,334,123,46,1467
Wisconsin,Abrams,401,26,145,83,26,14,294
Wisconsin,Adams,1660,207,508,319,136,27,1197
Wisconsin,Adell,459,13,160,116,33,12,334
Wisconsin,Albany,1268,90,382,255,74,14,815
Wisconsin,Algoma,3131,255,997,645,256,66,2219
Wisconsin,Allenton,950,48,239,270,109,0,666
Wisconsin,Allouez,13947,848,2564,2810,2664,1205,10091
Wisconsin,Alma,678,40,232,184,64,38,558
Wisconsin,Alma Center,514,38,125,87,53,7,310
Wisconsin,Almena,684,76,218,145,32,6,477
Wisconsin,Almond,510,48,130,93,26,14,311
Wisconsin,Altoona,7053,244,1247,1649,823,752,4715
Wisconsin,Amberg,164,17,72,30,6,2,127
Wisconsin,Amery,2865,290,744,665,304,208,2211
Wisconsin,Hazel Green,1105,50,299,222,116,42,729
Wisconsin,Hebron,162,5,84,26,20,3,138
Wisconsin,Helenville,190,12,58,65,14,5,154
Wisconsin,Herbster,97,1,12,33,26,16,88
Wisconsin,Ixonia,1710,41,378,446,200,68,1133
Wisconsin,Ironton,269,16,82,61,5,0,164
Wisconsin,Iron River,719,47,193,182,36,24,482
Wisconsin,Iron Ridge,986,45,313,263,49,15,685
Wisconsin,Iron Belt,211,0,69,65,20,2,156
Wisconsin,Iola,1344,88,360,296,166,36,946
Wisconsin,Ingram,81,7,21,13,9,0,50
Wisconsin,Independence,1624,196,453,293,86,37,1065
Wisconsin,Hustler,177,16,45,44,13,8,126
Wisconsin,Hustisford,1212,63,306,269,83,25,746
Wisconsin,Hurley,1560,143,428,437,124,71,1203
Wisconsin,Humbird,201,24,81,40,0,3,148
Wisconsin,Hudson,13194,241,2138,2713,2741,1329,9162
Wisconsin,Janesville,63799,3877,16092,14022,6047,3148,43186
Wisconsin,Howards Grove,3238,41,839,760,412,168,2220
Wisconsin,Houlton,352,47,109,93,20,55,324
Wisconsin,Hortonville,2708,90,576,672,354,90,1782
Wisconsin,Horicon,3644,306,969,763,276,76,2390
Wisconsin,Holmen,9432,194,2050,2568,1056,436,6304
Wisconsin,Hollandale,291,12,93,70,26,2,203
Wisconsin,Holcombe,149,25,42,24,22,0,113
Wisconsin,Hobart,7356,289,1354,1270,1114,656,4683
Wisconsin,Hixton,423,17,147,119,18,6,307
Wisconsin,Hingham,1004,23,206,251,141,30,651
Wisconsin,Hillsboro,1396,93,406,337,106,61,1003
Wisconsin,Hilbert,1108,122,336,162,84,17,721
Wisconsin,Highland,919,60,258,170,79,24,591
Wisconsin,Hewitt,840,31,209,188,91,71,590
Wisconsin,Howard,18668,795,4196,4032,2530,861,12414
Wisconsin,Little Round Lake,1287,89,248,290,23,0,650
Wisconsin,Hatley,518,28,184,125,43,12,392
Wisconsin,Oconto,4492,299,1402,958,380,120,3159
Wisconsin,New Glarus,2128,112,515,480,314,122,1543
Wisconsin,Newburg,1190,62,330,328,139,14,873
Wisconsin,New Berlin,39774,1358,6999,9373,8258,3744,29732
Wisconsin,New Auburn,543,42,164,103,51,5,365
Wisconsin,Newald,128,21,52,33,1,0,107
Wisconsin,Neosho,610,39,167,146,31,14,397
Wisconsin,Neopit,851,46,267,61,57,29,460
Wisconsin,Nelsonville,118,6,25,29,21,6,87
Wisconsin,Nelson,324,20,111,61,32,12,236
Wisconsin,Nekoosa,2450,115,738,505,117,76,1551
Wisconsin,Neillsville,2270,192,694,475,233,62,1656
Wisconsin,Neenah,25781,1039,5600,5302,3785,1591,17317
Wisconsin,Necedah,958,91,261,160,50,25,587
Wisconsin,Navarino,157,6,65,33,10,2,116
Wisconsin,Nashotah,1452,10,170,292,368,180,1020
Wisconsin,Muskego,24529,647,5268,5638,3809,1605,16967
Wisconsin,Muscoda,1452,133,418,326,84,28,989
Wisconsin,Mukwonago,7485,222,1839,1657,876,626,5220
Wisconsin,Mount Sterling,202,13,57,65,4,10,149
Wisconsin,Mount Pleasant,26196,1336,4967,6238,3908,2424,18873
Wisconsin,Mount Horeb,7349,156,1289,1493,1358,570,4866
Wisconsin,Mount Hope,164,8,47,35,8,4,102
Wisconsin,Mount Calvary,532,28,157,109,43,38,375
Wisconsin,Mountain,330,52,117,67,5,10,251
Wisconsin,Mosinee,4021,159,1216,756,473,184,2788
Wisconsin,Montreal,739,31,193,177,98,34,533
Wisconsin,Monticello,1182,41,351,325,80,48,845
Wisconsin,New Holstein,3219,398,769,890,295,111,2463
Wisconsin,New Lisbon,2316,259,691,663,108,51,1772
Wisconsin,New London,7129,538,2147,1239,620,183,4727
Wisconsin,New Odanah,502,45,145,90,21,0,301
Wisconsin,Little Sturgeon,156,6,66,41,28,10,151
Wisconsin,Oregon,9769,155,1392,2127,1427,1026,6127
Wisconsin,Oostburg,2927,87,715,659,375,166,2002
Wisconsin,Ontario,503,51,126,100,18,6,301
Wisconsin,Onalaska,18255,548,3001,4576,2689,1690,12504
Wisconsin,Omro,3543,252,842,656,301,167,2218
Wisconsin,Oliver,359,31,104,69,23,13,240
Wisconsin,Okauchee Lake,4516,61,612,971,1118,431,3193
Wisconsin,Ogema,221,50,56,22,10,0,138
Wisconsin,Ogdensburg,219,21,71,38,11,2,143
Wisconsin,Odanah,7,0,1,5,0,0,6
Wisconsin,Oconto Falls,2859,211,871,643,145,175,2045
Wisconsin,Oconomowoc Lake,619,12,82,106,158,92,450
Wisconsin,Montfort,691,30,186,172,44,23,455
Wisconsin,Oconomowoc,16111,498,2576,3078,3070,1739,10961
Wisconsin,Oakdale,272,20,100,60,16,5,201
Wisconsin,Oak Creek,34974,1511,7456,7965,4952,2223,24107
Wisconsin,Norwalk,656,113,155,67,14,5,354
Wisconsin,North Prairie,2281,56,433,550,349,141,1529
Wisconsin,Northport,518,38,188,109,39,8,382
Wisconsin,North Hudson,3807,78,721,685,708,293,2485
Wisconsin,North Freedom,616,76,169,132,32,19,428
Wisconsin,North Fond du Lac,5003,418,1256,1164,363,85,3286
Wisconsin,North Bay,263,3,28,32,66,54,183
Wisconsin,Nichols,226,34,87,15,0,1,137
Wisconsin,Niagara,1584,72,447,389,140,11,1059
Wisconsin,New Richmond,8599,405,1480,2163,926,288,5262
Wisconsin,New Post,262,23,83,70,8,30,214
Wisconsin,Oakfield,1060,77,283,260,105,41,766
Wisconsin,Montello,1436,105,455,371,134,21,1086
Wisconsin,Neshkoro,385,35,148,72,18,10,283
Wisconsin,Monona,7835,247,1147,1780,1660,1131,5965
Wisconsin,Marshfield,18410,1306,4243,3857,2058,1339,12803
Wisconsin,Marshall,3920,259,942,985,241,109,2536
Wisconsin,Marquette,133,16,46,38,6,1,107
Wisconsin,Markesan,1585,185,495,233,126,37,1076
Wisconsin,Marion,1155,77,414,220,84,15,810
Wisconsin,Marinette,10863,514,3229,2695,771,354,7563
Wisconsin,Maribel,396,17,151,66,27,3,264
Wisconsin,Marengo,110,8,30,17,0,0,55
Wisconsin,Marathon City,1412,73,524,249,151,50,1047
Wisconsin,Maple Bluff,1478,4,67,184,410,429,1094
Wisconsin,Manitowoc,33301,2754,8682,6851,3600,1291,23178
Wisconsin,Manawa,1332,107,435,300,100,14,956
Wisconsin,Maiden Rock,104,0,25,10,13,7,55
Wisconsin,Mason,76,4,23,23,2,0,52
Wisconsin,Madison,243122,7809,22622,37069,46258,36437,150195
Wisconsin,Lynxville,147,14,48,42,5,2,111
Wisconsin,Lyndon Station,651,48,187,117,19,19,390
Wisconsin,Luxemburg,2559,104,560,610,218,29,1521
Wisconsin,Luck,1067,59,353,243,108,44,807
Wisconsin,Lublin,100,14,38,12,7,1,72
Wisconsin,Monroe,10807,706,2986,2243,1011,523,7469
Wisconsin,Lowell,313,32,119,63,14,7,235
Wisconsin,Long Lake,26,2,14,10,0,0,26
Wisconsin,Lone Rock,881,62,380,117,39,15,613
Wisconsin,Lomira,2246,208,580,499,153,78,1518
Wisconsin,Lohrville,390,33,165,75,13,2,288
Wisconsin,Loganville,269,22,71,77,16,5,191
Wisconsin,Lodi,3047,163,547,621,444,194,1969
Wisconsin,McFarland,8092,122,1167,1494,1581,1203,5567
Wisconsin,Mattoon,509,95,117,76,20,8,316
Wisconsin,Loyal,1206,94,410,245,52,23,824
Wisconsin,Mayville,5060,529,1337,978,458,98,3400
Wisconsin,Mauston,4435,564,1316,973,320,106,3279
Wisconsin,Mondovi,2693,213,745,493,182,112,1745
Wisconsin,Mole Lake,541,68,105,134,8,2,317
Wisconsin,Mishicot,1466,98,423,342,129,63,1055
Wisconsin,Minong,400,26,142,79,28,4,279
Wisconsin,Mineral Point,2547,105,533,574,304,254,1770
Wisconsin,Milwaukee,599498,65087,107928,106488,55975,28861,364339
Wisconsin,Milton,5572,297,1233,1362,579,266,3737
Wisconsin,Milltown,1103,53,336,239,56,22,706
Wisconsin,Millston,129,18,39,27,12,4,100
Wisconsin,Milladore,269,20,81,64,15,1,181
Wisconsin,Middle Village,237,15,77,44,11,4,151
Wisconsin,Middleton,18478,508,1979,3131,4152,3149,12919
Wisconsin,Merton,3492,43,297,571,806,343,2060
Wisconsin,Minocqua,288,19,90,79,31,51,270
Wisconsin,Merrillan,648,107,179,133,25,11,455
Wisconsin,Medford,4338,261,1414,838,377,119,3009
Wisconsin,Merrimac,506,36,152,122,50,31,391
Wisconsin,Mellen,699,67,203,183,39,15,507
Wisconsin,Melvina,57,5,21,6,3,5,40
Wisconsin,Menasha,17546,932,4227,3900,1739,721,11519
Wisconsin,Melrose,620,40,159,124,43,16,382
Wisconsin,Menomonie,16210,555,2103,2328,1342,1080,7408
Wisconsin,Mequon,23494,223,2553,3537,6685,3920,16918
Wisconsin,Mercer,620,23,184,166,42,24,439
Wisconsin,Merrill,9419,756,2715,2076,633,241,6421
Wisconsin,Menomonee Falls,35884,1243,6864,7167,6883,3479,25636
Wisconsin,Mazomanie,1716,81,429,401,187,79,1177
Wyoming,South Greeley,4478,429,1004,1155,272,37,2897
Wyoming,Smoot,278,0,0,61,16,0,77
Wyoming,Saratoga,1851,119,507,419,137,152,1334
Wyoming,Sleepy Hollow,1245,31,254,295,200,16,796
Wyoming,Slater,83,0,37,0,46,0,83
Wyoming,Sinclair,371,13,78,126,52,6,275
Wyoming,Shoshoni,530,42,200,112,41,18,413
Wyoming,South Park,1681,11,45,276,569,195,1096
Wyoming,Sheridan,17775,717,3419,4368,2387,1194,12085
Wyoming,Shell,69,0,21,39,9,0,69
Wyoming,Robertson,139,0,0,62,31,0,93
Wyoming,Rolling Hills,487,26,89,106,28,22,271
Wyoming,Rock Springs,23869,1583,5004,5380,2116,967,15050
Wyoming,Rock River,219,2,66,90,14,6,178
Wyoming,Riverton,10915,754,2296,3038,999,268,7355
Wyoming,Riverside,57,0,21,14,8,10,53
Wyoming,Reliance,587,74,177,94,6,84,435
Wyoming,Red Butte,574,0,119,140,154,31,444
Wyoming,Star Valley Ranch,1342,115,256,271,215,143,1000
Wyoming,Ranchettes,6138,187,867,1515,1207,736,4512
Wyoming,Rawlins,9155,700,2113,2112,731,302,5958
Wyoming,Ryan Park,0,0,0,0,0,0,0
Wyoming,Story,954,47,153,299,176,94,769
Wyoming,Veteran,35,7,0,7,0,0,14
Wyoming,Superior,265,13,58,71,7,6,155
Wyoming,Ranchester,911,21,137,292,99,26,575
Wyoming,Worland,5416,525,1109,1347,463,208,3652
Wyoming,Woods Landing-Jelm,43,0,4,28,0,0,32
Wyoming,Wilson,1645,0,82,475,603,145,1305
Wyoming,Whiting,135,0,22,70,43,0,135
Wyoming,Wheatland,3639,186,672,1107,329,260,2554
Wyoming,Westview Circle,45,0,45,0,0,0,45
Wyoming,Washam,38,0,10,0,10,0,20
Wyoming,Warren AFB,2634,33,117,423,261,143,977
Wyoming,Wamsutter,360,15,104,76,28,0,223
Wyoming,Sundance,1401,70,348,377,115,106,1016
Wyoming,Vista West,929,45,198,223,71,112,649
Wyoming,Urie,462,7,110,180,50,6,353
Wyoming,Upton,1030,59,261,313,112,45,790
Wyoming,Turnerville,134,0,39,95,0,0,134
Wyoming,Torrington,6736,434,1350,1805,596,427,4612
Wyoming,Thermopolis,2832,156,670,875,272,99,2072
Wyoming,Thayne,457,34,116,65,24,12,251
Wyoming,Teton Village,161,0,16,0,83,19,118
Wyoming,Ten Sleep,237,33,58,75,36,9,211
Wyoming,Taylor,61,0,15,36,10,0,61
Wyoming,Table Rock,0,0,0,0,0,0,0
Wyoming,Van Tassell,7,0,1,4,0,0,5
Wyoming,Ralston,339,22,24,108,50,0,204
Wyoming,Kaycee,234,16,54,44,31,0,145
Wyoming,Purple Sage,853,102,143,78,0,26,349
Wyoming,Marbleton,1385,138,284,291,93,16,822
Wyoming,Manville,46,17,13,16,0,0,46
Wyoming,Manderson,110,21,27,20,11,0,79
Wyoming,Mammoth,108,2,4,71,6,21,104
Wyoming,McKinnon,0,0,0,0,0,0,0
Wyoming,Lyman,2249,104,503,431,153,54,1245
Wyoming,Lusk,1755,128,390,516,181,36,1251
Wyoming,Lucerne,680,98,109,156,81,56,500
Wyoming,Lovell,2361,289,434,616,175,38,1552
Wyoming,Lost Springs,5,0,0,5,0,0,5
Wyoming,Meadow Acres,153,0,38,65,20,9,132
Wyoming,Lonetree,0,0,0,0,0,0,0
Wyoming,Lingle,649,26,97,223,73,3,422
Wyoming,Laramie,31879,537,2456,4713,4749,3582,16037
Wyoming,Lander,7758,255,1652,1551,1127,582,5167
Wyoming,Lance Creek,27,0,3,10,6,0,19
Wyoming,Lakeview North,48,0,25,23,0,0,48
Wyoming,La Grange,425,10,25,114,51,10,210
Wyoming,La Barge,467,44,122,99,16,2,283
Wyoming,Kirby,67,19,16,20,3,3,61
Wyoming,Kemmerer,2692,142,554,775,243,109,1823
Wyoming,Wright,2255,140,614,385,95,58,1292
Wyoming,Little America,74,0,43,0,0,0,43
Wyoming,Rafter J Ranch,1535,37,357,224,369,291,1278
Wyoming,Medicine Bow,252,9,104,41,17,10,181
Wyoming,Midwest,362,51,71,109,13,17,261
Wyoming,Powell,6408,327,1314,1680,458,283,4062
Wyoming,Powder River,0,0,0,0,0,0,0
Wyoming,Point of Rocks,81,6,5,18,20,0,49
Wyoming,Pine Haven,468,30,122,155,40,22,369
Wyoming,Pinedale,1865,27,369,432,227,82,1137
Wyoming,Pine Bluffs,1131,48,254,287,162,47,798
Wyoming,Pavillion,244,11,60,64,24,12,171
Wyoming,Parkman,194,31,44,92,13,0,180
Wyoming,Owl Creek,0,0,0,0,0,0,0
Wyoming,Osmond,295,0,67,70,7,7,151
Wyoming,Meeteetse,314,25,77,58,51,26,237
Wyoming,Osage,332,83,110,34,11,0,238
Wyoming,Opal,79,15,19,29,0,0,63
Wyoming,Oakley,0,0,0,0,0,0,0
Wyoming,North Rock Springs,2107,56,762,310,160,80,1368
Wyoming,Nordic,664,12,132,175,83,58,460
Wyoming,Newcastle,3502,354,790,966,214,85,2409
Wyoming,Mountain View,1293,19,308,248,130,28,733
Wyoming,Mountain View,103,0,28,25,6,11,70
Wyoming,Moose Wilson Road,1836,39,44,176,805,378,1442
Wyoming,Moorcroft,1094,25,229,246,41,39,580
Wyoming,Mills,3597,402,934,914,129,8,2387
Wyoming,Orin,44,0,10,24,0,0,34
Wyoming,Yoder,74,13,17,11,21,1,63
Wyoming,Cheyenne,62195,2718,10595,15871,7559,4537,41280
Wyoming,Johnstown,306,9,44,111,34,3,201
Wyoming,Bondurant,0,0,0,0,0,0,0
Wyoming,Boulder,0,0,0,0,0,0,0
Wyoming,Boulder Flats,407,23,56,118,35,16,248
Wyoming,Brookhurst,195,0,94,73,14,5,186
Wyoming,Buffalo,4614,197,1091,1141,536,287,3252
Wyoming,Burlington,257,8,38,56,30,10,142
Wyoming,Burns,266,18,62,70,15,7,172
Wyoming,Byron,620,31,172,108,27,15,353
Wyoming,Carpenter,271,0,137,44,0,0,181
Wyoming,Carter,0,0,0,0,0,0,0
Wyoming,Casper,58817,3181,10084,16644,6008,2960,38877
Wyoming,Casper Mountain,373,0,30,144,61,72,307
Wyoming,Centennial,180,0,30,72,41,5,148
Wyoming,Chugcreek,356,0,0,92,0,32,124
Wyoming,Chugwater,269,73,55,71,21,8,228
Wyoming,Clearmont,138,4,47,26,6,7,90
Wyoming,Clearview Acres,1038,114,358,146,0,0,618
Wyoming,Cody,9741,478,2025,2243,1255,802,6803
Wyoming,Cokeville,508,7,109,117,48,12,293
Wyoming,Cora,0,0,0,0,0,0,0
Wyoming,Cowley,831,22,132,204,67,26,451
Wyoming,Big Piney,530,2,132,135,39,13,321
Wyoming,Big Horn,427,0,92,93,113,42,340
Wyoming,Beulah,77,0,0,77,0,0,77
Wyoming,Bessemer Bend,166,10,24,62,24,0,120
Wyoming,Afton,1959,55,238,611,172,66,1142
Wyoming,Albany,41,6,12,10,10,3,41
Wyoming,Albin,152,18,23,42,3,0,86
Wyoming,Alcova,0,0,0,0,0,0,0
Wyoming,Alpine,771,41,222,182,139,9,593
Wyoming,Alpine Northeast,11,0,0,0,11,0,11
Wyoming,Alpine Northwest,220,0,153,67,0,0,220
Wyoming,Alta,511,0,64,153,97,49,363
Wyoming,Antelope Hills,0,0,0,0,0,0,0
Wyoming,Antelope Valley-Crestview,1529,91,376,351,217,34,1069
Wyoming,Crowheart,102,4,29,39,6,15,93
Wyoming,Arapahoe,1572,141,255,324,30,42,792
Wyoming,Arrowhead Springs,49,0,0,13,6,30,49
Wyoming,Arvada,36,0,12,8,9,1,30
Wyoming,Atlantic City,15,0,0,0,15,0,15
Wyoming,Auburn,128,0,39,31,12,23,105
Wyoming,Baggs,393,30,68,79,59,15,251
Wyoming,Bairoil,111,6,34,28,13,7,88
Wyoming,Bar Nunn,2573,117,532,700,247,98,1694
Wyoming,Basin,1392,51,309,333,198,71,962
Wyoming,Bear River,674,29,201,149,62,9,450
Wyoming,Bedford,38,0,0,31,0,0,31
Wyoming,Arlington,33,0,0,10,5,0,15
Wyoming,Daniel,308,0,159,31,23,0,213
Wyoming,Dayton,903,28,180,281,115,69,673
Wyoming,Deaver,172,20,32,43,13,2,110
Wyoming,Glendo,308,20,104,98,9,0,231
Wyoming,Glenrock,2593,113,618,683,221,97,1732
Wyoming,Granger,138,14,49,40,0,0,103
Wyoming,Green River,12604,633,2661,3232,1354,355,8235
Wyoming,Greybull,2089,227,489,433,132,53,1334
Wyoming,Grover,273,0,65,37,40,0,142
Wyoming,Guernsey,1124,71,365,288,79,22,825
Wyoming,Hanna,782,66,187,229,31,52,565
Wyoming,Hartrandt,764,73,221,193,10,0,497
Wyoming,Hartville,83,5,52,12,10,3,82
Wyoming,Gillette,31634,1840,6438,7382,2476,937,19073
Wyoming,Hawk Springs,26,5,0,21,0,0,26
Wyoming,Hill View Heights,84,0,15,42,27,0,84
Wyoming,Hoback,1274,34,129,355,339,164,1021
Wyoming,Homa Hills,281,29,50,131,0,0,210
Wyoming,Hudson,517,29,114,124,37,18,322
Wyoming,Hulett,396,59,77,101,24,4,265
Wyoming,Huntley,0,0,0,0,0,0,0
Wyoming,Hyattville,44,0,12,14,14,4,44
Wyoming,Jackson,10152,495,1893,1726,2543,774,7431
Wyoming,James Town,576,20,219,167,48,39,493
Wyoming,Jeffrey City,0,0,0,0,0,0,0
Wyoming,Hillsdale,116,0,0,57,0,0,57
Wyoming,Y-O Ranch,124,0,37,33,0,0,70
Wyoming,Garland,106,27,0,28,9,12,76
Wyoming,Frannie,134,6,29,36,15,3,89
Wyoming,Diamondville,644,16,273,164,32,14,499
Wyoming,Dixon,75,7,20,21,10,4,62
Wyoming,Douglas,6371,376,1678,1581,458,168,4261
Wyoming,Dubois,780,27,189,201,143,63,623
Wyoming,East Thermopolis,307,26,79,87,33,2,227
Wyoming,Eden,232,5,68,59,33,0,165
Wyoming,Edgerton,327,35,50,90,15,5,195
Wyoming,Elk Mountain,156,1,39,53,25,13,131
Wyoming,Encampment,455,4,135,138,53,14,344
Wyoming,Esterbrook,54,8,29,9,0,8,54
Wyoming,Freedom,416,0,30,80,31,15,156
Wyoming,Ethete,1678,102,285,474,36,3,900
Wyoming,Evanston,12213,1039,2407,2543,955,467,7411
Wyoming,Evansville,2836,255,728,723,134,45,1885
Wyoming,Fairview,387,0,40,110,15,23,188
Wyoming,Farson,425,0,56,94,76,25,251
Wyoming,Fontenelle,0,0,0,0,0,0,0
Wyoming,Fort Bridger,249,29,154,30,0,0,213
Wyoming,Fort Laramie,210,11,67,81,14,9,182
Wyoming,Fort Washakie,1861,146,300,446,68,43,1003
Wyoming,Fox Farm-College,4390,477,801,1004,216,32,2530
Wyoming,Fox Park,0,0,0,0,0,0,0
Wyoming,Etna,259,16,87,156,0,0,259
Wyoming,Kelly,36,0,0,0,0,0,0
