State,City,Population,Never Married,Married,Divorced,Separated,Widowed,Total
Alabama,Movico,170,0,89,30,25,0,144
Alabama,Pell City,13312,2355,5049,1894,261,836,10395
Alabama,Pelham,22346,4820,9805,2426,252,785,18088
Alabama,Parrish,1086,187,461,128,9,67,852
Alabama,Panola,32,11,15,0,0,6,32
Alabama,Paint Rock,208,32,68,44,0,16,160
Alabama,Ozark,14786,3184,5228,2041,320,1329,12102
Alabama,Oxford,21243,4306,9159,2150,306,1137,17058
Alabama,Owens Cross Roads,1667,348,771,119,17,134,1389
Alabama,Our Town,490,43,196,204,0,47,490
Alabama,Orrville,110,56,23,10,0,13,102
Alabama,Orange Beach,5682,942,3155,444,94,334,4969
Alabama,Pennington,218,75,58,33,6,19,191
Alabama,Opp,6665,1398,2695,711,98,494,5396
Alabama,Onycha,197,24,82,30,6,7,149
Alabama,Oneonta,6633,1034,2796,648,138,746,5362
Alabama,Ohatchee,962,92,538,109,3,63,805
Alabama,Odenville,3663,539,1601,232,218,333,2923
Alabama,Oakman,659,136,253,92,10,87,578
Alabama,Oak Hill,11,0,0,2,0,9,11
Alabama,Oak Grove,564,86,230,79,4,65,464
Alabama,Notasulga,974,308,336,73,0,92,809
Alabama,Northport,24339,6132,9365,2264,256,1539,19556
Alabama,North Johns,179,37,73,22,2,5,139
Alabama,North Courtland,710,261,144,76,29,85,595
Alabama,Opelika,28544,7813,10349,3049,503,1630,23344
Alabama,Newville,509,133,200,43,19,40,435
Alabama,Penton,236,9,125,20,0,68,222
Alabama,Boykin,67,36,0,20,5,6,67
Alabama,Phil Campbell,1149,187,369,160,14,91,821
Alabama,Phenix City,36639,10072,11313,3648,1218,2079,28330
Alabama,Petrey,42,14,16,3,0,4,37
Alabama,Peterman,120,16,79,0,14,11,120
Alabama,Perdido Beach,599,98,296,107,12,50,563
Alabama,Perdido,554,117,251,81,0,14,463
Alabama,Camden,2721,748,777,266,35,185,2011
Alabama,Calvert,394,78,0,81,0,94,253
Alabama,Calera,12593,2162,6048,918,69,343,9540
Alabama,Butler,2360,594,797,223,84,243,1941
Alabama,Bucks,50,0,50,0,0,0,50
Alabama,Bon Secour,648,40,324,207,0,39,610
Alabama,Brundidge,2189,785,581,230,82,157,1835
Alabama,Brookwood,1932,361,888,180,31,58,1518
Alabama,Brookside,1258,270,459,137,22,137,1025
Alabama,Brook Highland,7032,2215,2565,742,162,178,5862
Alabama,Bristow Cove,531,68,228,69,0,28,393
Alabama,Brilliant,908,163,353,101,20,120,757
Alabama,Brighton,2904,969,569,420,53,226,2237
Alabama,Bridgeport,2300,536,711,336,56,225,1864
Alabama,Brewton,5424,1473,1813,464,123,490,4363
Alabama,Brent,4898,1782,1563,487,191,221,4244
Alabama,Brantleyville,1111,187,321,194,0,52,754
Alabama,Brantley,971,301,261,114,34,75,785
Alabama,Broomtown,160,20,108,0,0,23,151
Alabama,New Union,1088,201,308,99,0,94,702
Alabama,Newton,1709,347,714,265,41,101,1468
Alabama,New Site,767,204,356,50,12,52,674
Alabama,Bessemer,27043,8617,6636,3262,884,2206,21605
Alabama,Berry,1392,307,599,117,30,111,1164
Alabama,Benton,49,1,31,0,0,4,36
Alabama,Belle Fontaine,539,90,114,61,59,12,336
Alabama,Bellamy,816,290,203,38,40,106,677
Alabama,Belk,289,47,127,15,5,16,210
Alabama,Belgreen,66,7,15,29,0,10,61
Alabama,Beaverton,273,27,156,26,0,20,229
Alabama,Beatrice,294,110,80,27,4,15,236
Alabama,Bear Creek,1296,290,582,137,15,61,1085
Alabama,Bayou La Batre,2634,713,836,271,41,66,1927
Alabama,Billingsley,176,40,63,13,11,13,140
Alabama,Bay Minette,8843,2627,2339,1085,164,578,6793
Alabama,Ballplay,1535,312,546,277,0,67,1202
Alabama,Bakerhill,209,37,102,15,15,9,178
Alabama,Baileyton,909,130,362,168,9,46,715
Alabama,Babbie,687,105,334,54,8,59,560
Alabama,Axis,911,174,501,92,0,44,811
Alabama,Avon,594,126,215,99,2,18,460
Alabama,Autaugaville,1119,325,411,105,21,73,935
Alabama,Auburn,58693,28686,16363,2818,637,1314,49818
Alabama,Attalla,5965,1143,2636,769,101,463,5112
Alabama,Atmore,10072,3437,2877,1296,442,682,8734
Alabama,Athens,23938,5106,9594,2370,428,1847,19345
Alabama,Banks,136,25,41,28,4,4,102
Alabama,Birmingham,212211,78713,49521,26421,6540,12966,174161
Alabama,Black,157,16,84,21,0,7,128
Alabama,Blountsville,1967,437,731,170,53,91,1482
Alabama,New Market,1410,271,608,76,0,113,1068
Alabama,New Hope,2803,494,1263,301,35,106,2199
Alabama,New Brockton,1346,324,444,157,25,68,1018
Alabama,Newbern,160,29,63,18,3,19,132
Alabama,Needham,108,11,65,10,2,9,97
Alabama,Nectar,281,52,108,42,13,19,234
Alabama,Nauvoo,171,34,71,20,4,15,144
Alabama,Natural Bridge,43,4,31,3,0,1,39
Alabama,Napier Field,414,80,176,44,8,18,326
Alabama,Nances Creek,292,35,112,31,0,39,217
Alabama,Nanafalia,64,18,24,5,0,7,54
Alabama,Myrtlewood,157,35,71,20,4,15,145
Alabama,Muscle Shoals,13492,2783,5904,1404,199,643,10933
Alabama,Munford,1443,350,469,180,58,83,1140
Alabama,Mulga,922,197,297,110,28,84,716
Alabama,Eufaula,12809,3205,4456,1357,212,888,10118
Alabama,Mount Vernon,1482,420,424,141,55,194,1234
Alabama,Mount Olive CDP (Jefferson County),4100,606,2192,310,0,147,3255
Alabama,Mount Olive CDP (Coosa County),300,83,116,18,0,5,222
Alabama,Mountain Brook,20518,2730,10944,977,57,590,15298
Alabama,Bon Air,103,10,30,20,3,5,68
Alabama,Boligee,640,211,94,33,7,49,394
Alabama,Boaz,9673,2208,3368,940,99,690,7305
Alabama,Blue Springs,99,26,58,5,0,6,95
Alabama,Blue Ridge,1461,335,731,55,7,83,1211
Alabama,Pickensville,661,184,204,85,25,59,557
Alabama,Piedmont,4767,764,1900,438,192,457,3751
Alabama,Pike Road,7178,1059,3895,376,20,191,5541
Alabama,Pinckard,460,104,186,72,5,23,390
Alabama,St. Stephens,580,100,202,150,0,54,506
Alabama,St. Florian,418,73,245,29,0,29,376
Alabama,Rutledge,342,53,150,42,3,44,292
Alabama,Russellville,9824,2288,3043,1067,121,854,7373
Alabama,Rosa,385,113,182,22,2,27,346
Alabama,Rogersville,1099,166,378,115,9,153,821
Alabama,Rockville,34,17,11,6,0,0,34
Alabama,Rock Mills,648,140,327,24,0,42,533
Alabama,Rockford,620,141,161,115,40,73,530
Alabama,Rock Creek,1336,247,620,213,0,41,1121
Alabama,Robertsdale,5656,1243,2445,493,105,305,4591
Alabama,Saks,10826,2002,4405,1224,239,779,8649
Alabama,Roanoke,6013,1238,2128,799,144,567,4876
Alabama,Riverside,2296,338,1121,257,45,149,1910
Alabama,River Falls,721,156,223,111,25,76,591
Alabama,Ridgeville,117,39,32,19,4,15,109
Alabama,Repton,130,30,45,11,7,9,102
Alabama,Rehobeth,1602,283,761,111,19,58,1232
Alabama,Reform,2012,568,522,277,21,192,1580
Alabama,Reeltown,425,67,238,68,0,38,411
Alabama,Reece City,793,117,359,105,16,45,642
Alabama,Redstone Arsenal,1657,756,513,61,0,8,1338
Alabama,Red Level,364,68,168,42,8,25,311
Alabama,Redland,4331,499,2481,233,67,108,3388
Alabama,Riverview,138,21,62,12,5,17,117
Alabama,Samson,2103,572,563,250,85,172,1642
Alabama,Sand Rock,590,97,354,33,16,27,527
Alabama,Sanford,212,46,89,38,3,6,182
Alabama,South Vinemont,545,154,153,67,8,66,448
Alabama,Southside,8514,1659,4383,460,15,421,6938
Alabama,Somerville,691,119,339,89,3,32,582
Alabama,Snead,765,105,397,63,7,86,658
Alabama,Smoke Rise,2443,475,1217,122,0,69,1883
Alabama,Smiths Station,5165,784,2202,586,144,156,3872
Alabama,Slocomb,1880,440,676,248,46,190,1600
Alabama,Skyline,1048,196,475,121,21,68,881
Alabama,Sipsey,473,102,186,53,30,40,411
Alabama,Sims Chapel,163,28,68,7,0,8,111
Alabama,Silverhill,654,60,343,65,24,56,548
Alabama,Silas,680,202,180,100,9,27,518
Alabama,Shorter,436,88,160,47,21,42,358
Alabama,Shoal Creek,1481,178,816,71,0,85,1150
Alabama,Shiloh,350,52,141,56,15,17,281
Alabama,Shelby,1364,240,633,127,38,52,1090
Alabama,Sheffield,9074,2419,3041,1252,228,707,7647
Alabama,Semmes,3583,592,1423,334,82,235,2666
Alabama,Selmont-West Selmont,2574,1060,364,211,121,139,1895
Alabama,Selma,19987,7256,4068,1974,695,1563,15556
Alabama,Section,811,146,330,91,19,63,649
Alabama,Scottsboro,14775,2952,6333,1503,216,1260,12264
Alabama,Satsuma,6152,777,3097,714,18,293,4899
Alabama,Sardis City,1654,359,829,118,9,116,1431
Alabama,Saraland,13715,2823,6006,1257,209,1033,11328
Alabama,Red Bay,3143,617,1044,475,66,339,2541
Alabama,Ashville,2342,490,831,175,143,137,1776
Alabama,Ray,480,127,230,38,54,16,465
Alabama,Rainsville,4992,899,2397,468,30,308,4102
Alabama,Dothan,67708,16595,24335,7937,1643,3753,54263
Alabama,Double Springs,1180,241,402,174,32,139,988
Alabama,Douglas,1024,222,339,101,37,40,739
Alabama,Dozier,307,110,88,50,2,19,269
Alabama,Dunnavant,984,184,438,61,32,51,766
Alabama,Dutton,331,59,135,40,1,22,257
Alabama,East Brewton,2508,663,840,295,34,191,2023
Alabama,East Point,151,19,132,0,0,0,151
Alabama,Eclectic,912,169,353,106,12,64,704
Alabama,Edgewater,905,248,211,115,9,44,627
Alabama,Edwardsville,137,18,75,10,0,7,110
Alabama,Dora,2295,484,858,291,64,110,1807
Alabama,Egypt,1254,303,619,56,0,26,1004
Alabama,Elberta,1506,304,579,205,64,78,1230
Alabama,Eldridge,204,36,87,14,7,8,152
Alabama,Elkmont,430,48,196,54,12,35,345
Alabama,Pleasant Groves,560,132,243,20,10,37,442
Alabama,Pleasant Grove,10270,2514,4400,1074,74,410,8472
Alabama,Pisgah,717,149,262,102,17,54,584
Alabama,Pinson,7448,1386,3465,847,52,465,6215
Alabama,Pine Ridge,235,27,68,41,3,12,151
Alabama,Pine Level,4552,843,2180,403,31,157,3614
Alabama,Pine Hill,929,260,276,49,36,50,671
Alabama,Pine Apple,138,16,42,29,21,10,118
Alabama,Elba,3919,1216,1143,452,138,297,3246
Alabama,Dodge City,714,92,372,53,13,35,565
Alabama,Detroit,215,44,112,18,6,13,193
Alabama,Demopolis,7249,1795,2221,774,162,598,5550
Alabama,Rainbow City,9608,1613,4102,1107,245,547,7614
Alabama,Ragland,1802,326,704,162,21,176,1389
Alabama,Putnam,100,29,51,9,7,4,100
Alabama,Providence,268,26,142,28,8,19,223
Alabama,Prichard,22439,7779,4697,2195,1074,1741,17486
Alabama,Priceville,2943,473,1312,250,63,170,2268
Alabama,Prattville,34706,7115,14332,3606,506,1697,27256
Alabama,Powell,1037,291,354,119,22,90,876
Alabama,Pollard,236,42,73,23,3,7,148
Alabama,Point Clear,2495,240,997,263,42,303,1845
Alabama,Crossville,2312,433,920,188,30,234,1805
Alabama,Cuba,509,52,285,39,27,27,430
Alabama,Cullman,15014,2734,6259,2107,214,1054,12368
Alabama,Cullomburg,117,28,44,18,0,0,90
Alabama,Cusseta,151,40,50,17,0,20,127
Alabama,Dadeville,3181,780,1183,330,152,313,2758
Alabama,Daleville,5188,1118,2038,534,159,210,4059
Alabama,Daphne,23559,5018,9457,2731,536,1128,18870
Alabama,Dauphin Island,1319,188,718,141,4,49,1100
Alabama,Daviston,271,45,131,29,11,25,241
Alabama,Dayton,25,2,8,1,4,0,15
Alabama,Deatsville,1218,167,599,86,15,20,887
Alabama,Decatur,55598,12329,20437,6402,1896,3445,44509
Alabama,Deer Park,203,49,106,0,10,17,182
Alabama,Delta,259,34,134,51,0,15,234
Alabama,Ranburne,441,56,205,49,0,51,361
Alabama,Ashland,2667,462,980,365,114,230,2151
Alabama,Ashford,2316,547,946,188,44,146,1871
Alabama,Arley,476,87,218,53,11,48,417
Alabama,Hanceville,3195,726,974,436,78,424,2638
Alabama,Hammondville,587,85,291,76,0,23,475
Alabama,Hamilton,6814,1240,2952,620,160,363,5335
Alabama,Haleyville,4068,668,1401,739,52,346,3206
Alabama,Haleburg,96,11,66,6,0,4,87
Alabama,Hackneyville,381,48,240,34,0,26,348
Alabama,Hackleburg,1444,263,644,161,47,105,1220
Alabama,Gu-Win,126,16,65,14,1,8,104
Alabama,Gurley,691,162,209,140,10,59,580
Alabama,Guntersville,8326,1665,3386,1076,126,696,6949
Alabama,Gulf Shores,10703,2026,5010,1285,140,651,9112
Alabama,Harpersville,1711,350,581,219,37,104,1291
Alabama,Gulfcrest,207,0,133,0,0,0,133
Alabama,Grove Hill,1716,502,581,157,42,59,1341
Alabama,Elmore,1671,485,511,105,46,112,1259
Alabama,Emelle,38,9,25,1,0,3,38
Alabama,Emerald Mountain,2895,325,1520,197,0,26,2068
Alabama,Enterprise,27785,6285,10778,2761,491,1717,22032
Alabama,Epes,137,26,73,13,0,9,121
Alabama,Grimes,570,122,210,74,19,24,449
Alabama,Greenville,7912,2265,2203,908,165,599,6140
Alabama,Greensboro,2485,866,625,195,80,216,1982
Alabama,Graysville,2149,414,836,238,26,265,1779
Alabama,Grayson Valley,5160,1080,1954,884,152,213,4283
Alabama,Guin,2351,456,938,393,63,171,2021
Alabama,Hartford,2645,533,909,277,120,288,2127
Alabama,Hartselle,14455,2675,6532,1459,121,734,11521
Alabama,Harvest,5226,1198,2062,405,190,126,3981
Alabama,Hoover,83547,16343,38782,6357,740,3629,65851
Alabama,Homewood,25535,8382,8963,1893,168,725,20131
Alabama,Holtville,4263,678,2021,322,56,177,3254
Alabama,Holt,3652,1276,933,301,109,206,2825
Alabama,Hollywood,971,152,414,208,8,89,871
Alabama,Holly Pond,1084,219,503,72,32,44,870
Alabama,Hollis Crossroads,714,149,233,117,0,43,542
Alabama,Hollins,930,89,356,72,10,82,609
Alabama,Hokes Bluff,4314,902,1936,503,0,288,3629
Alabama,Hodges,308,84,110,49,2,19,264
Alabama,Hobson City,998,280,282,121,40,42,765
Alabama,Hobson,77,0,20,29,0,28,77
Alabama,Hissop,772,353,153,94,0,97,697
Alabama,Hillsboro,562,108,252,53,15,49,477
Alabama,Highland Lakes,4864,567,2797,217,0,153,3734
Alabama,Highland Lake,393,38,244,35,4,23,344
Alabama,Henagar,2253,371,931,397,59,133,1891
Alabama,Helena,17589,2902,8110,1436,130,423,13001
Alabama,Heflin,3504,703,1164,585,129,283,2864
Alabama,Heath,338,64,119,55,10,12,260
Alabama,Headland,4685,825,1839,530,129,259,3582
Alabama,Hazel Green,3266,722,1477,260,19,222,2700
Alabama,Hayneville,984,457,163,74,33,71,798
Alabama,Hayden,1186,210,554,109,27,88,988
Alabama,Hatton,144,0,98,28,0,7,133
Alabama,Grant,956,143,467,65,16,47,738
Alabama,Horn Hill,254,28,138,26,2,14,208
Alabama,Grand Bay,3501,683,1564,381,27,182,2837
Alabama,Goshen,356,60,123,26,15,41,265
Alabama,Fort Rucker,4895,1087,1916,179,42,0,3224
Alabama,Fort Payne,14112,3147,5477,1432,254,848,11158
Alabama,Fort Deposit,1482,438,384,134,48,53,1057
Alabama,Forkland,767,229,175,36,35,59,534
Alabama,Forestdale,9716,2457,3598,1125,290,526,7996
Alabama,Foley,16345,3259,6806,2003,350,1375,13793
Alabama,Florence,39855,11327,14075,4534,688,2919,33543
Alabama,Florala,1863,344,732,223,51,163,1513
Alabama,Flomaton,1670,475,562,170,31,97,1335
Alabama,Five Points,181,72,49,32,0,19,172
Alabama,Fitzpatrick,84,0,51,13,0,20,84
Alabama,Franklin,243,57,99,17,17,7,197
Alabama,Fayetteville,1257,218,584,74,33,67,976
Alabama,Faunsdale,53,17,19,2,0,15,53
Alabama,Falkville,1226,176,394,186,55,240,1051
Alabama,Fairview,483,76,244,27,12,32,391
Alabama,Fairhope,17309,2954,7699,1677,211,1291,13832
Alabama,Fairford,85,0,75,10,0,0,85
Alabama,Fairfield,10987,3613,2481,1418,507,930,8949
Alabama,Excel,1019,194,450,106,7,40,797
Alabama,Evergreen,3842,1239,981,298,79,387,2984
Alabama,Eva,552,90,256,61,13,35,455
Alabama,Eutaw,2834,809,680,409,184,292,2374
Alabama,Eunola,421,30,285,26,0,28,369
Alabama,Fayette,4523,891,1511,579,153,370,3504
Alabama,Fredonia,385,27,223,43,9,0,302
Alabama,Frisco City,1272,351,318,175,71,123,1038
Alabama,Fruitdale,209,56,49,35,0,0,140
Alabama,Gordonville,278,85,39,62,25,27,238
Alabama,Gordon,275,102,78,34,2,25,241
Alabama,Gordo,1680,398,547,215,37,135,1332
Alabama,Goodwater,1537,540,413,168,45,139,1305
Alabama,Good Hope,2232,246,1105,173,31,53,1608
Alabama,Goldville,43,3,21,0,0,7,31
Alabama,Glenwood,228,37,131,2,3,13,186
Alabama,Glencoe,5139,818,2661,565,14,393,4451
Alabama,Glen Allen,513,99,214,68,0,57,438
Alabama,Gilbertown,191,37,79,23,0,9,148
Alabama,Geraldine,883,115,400,72,27,42,656
Alabama,Georgiana,1710,578,365,191,50,215,1399
Alabama,Geneva,4469,726,1426,567,134,483,3336
Alabama,Geiger,262,41,93,23,11,12,180
Alabama,Gaylesville,187,31,103,10,2,17,163
Alabama,Gardendale,13763,2540,6689,1241,119,1057,11646
Alabama,Garden City,374,44,165,59,9,38,315
Alabama,Gantt,180,31,89,19,2,18,159
Alabama,Gallant,742,188,380,23,60,31,682
Alabama,Gainesville,171,38,37,35,4,15,129
Alabama,Gadsden,36455,9783,11359,4616,972,2861,29591
Alabama,Fyffe,1358,239,593,137,26,81,1076
Alabama,Fultondale,8733,2158,3885,690,47,547,7327
Alabama,Fulton,211,46,79,4,5,30,164
Alabama,Fruithurst,266,35,140,35,3,13,226
Alabama,Graham,332,87,162,0,0,0,249
Alabama,Spanish Fort,7578,1525,3611,636,14,379,6165
Alabama,Hueytown,15894,3304,6057,1630,274,1320,12585
Alabama,Huntsville,185594,53563,65772,20675,3465,9345,152820
Alabama,Margaret,4487,692,1672,460,63,42,2929
Alabama,Marbury,1419,256,613,165,27,78,1139
Alabama,Maplesville,815,177,239,158,22,39,635
Alabama,Malvern,1816,338,828,235,43,63,1507
Alabama,Malcolm,168,30,52,0,0,9,91
Alabama,Magnolia Springs,752,85,490,36,11,44,666
Alabama,Madrid,355,47,158,32,7,38,282
Alabama,Madison,45590,10264,21089,3258,319,1257,36187
Alabama,McMullen,5,0,0,3,0,2,5
Alabama,McKenzie,551,149,172,58,13,53,445
Alabama,McIntosh,422,113,155,26,14,17,325
Alabama,Marion,3551,1565,711,411,77,199,2963
Alabama,Macedonia,165,13,74,4,4,39,134
Alabama,Lynn,563,91,242,75,19,56,483
Alabama,Luverne,2825,705,922,385,20,264,2296
Alabama,Loxley,1886,416,682,219,16,97,1430
Alabama,Lowndesboro,118,8,76,7,0,6,97
Alabama,Louisville,440,133,201,38,6,28,406
Alabama,Lookout Mountain,1152,277,580,91,13,92,1053
Alabama,Locust Fork,1441,351,609,130,19,79,1188
Alabama,Lockhart,443,83,163,60,4,31,341
Alabama,Loachapoka,217,61,64,13,20,10,168
Alabama,Livingston,3466,1974,736,211,20,130,3071
Alabama,Littleville,1029,156,516,105,23,65,865
Alabama,McDonald Chapel,530,64,128,96,39,42,369
Alabama,Maytown,359,67,175,36,2,30,310
Alabama,Meadowbrook,8752,1810,4515,486,47,386,7244
Alabama,Megargel,64,0,64,0,0,0,64
Alabama,Ariton,702,217,206,86,29,45,583
Alabama,Moundville,2183,490,821,154,79,224,1768
Alabama,Moulton,3386,657,1287,332,100,413,2789
Alabama,Mosses,1036,509,143,66,40,74,832
Alabama,Morrison Crossroads,190,9,80,62,27,0,178
Alabama,Morris,1737,266,890,139,13,88,1396
Alabama,Mooresville,78,8,48,5,0,4,65
Alabama,Moores Mill,6591,1339,2652,757,166,355,5269
Alabama,Moody,12292,2070,6052,1161,220,581,10084
Alabama,Montgomery,202967,65288,60393,20221,5036,10266,161204
Alabama,Montevallo,6549,2833,1964,523,115,325,5760
Alabama,Monroeville,6265,1834,1893,596,132,448,4903
Alabama,Mobile,194669,61001,58660,20835,5375,11880,157751
Alabama,Minor,1334,297,547,56,28,131,1059
Alabama,Millry,565,168,226,68,19,30,511
Alabama,Millport,1070,230,460,74,0,136,900
Alabama,Millerville,216,0,86,25,8,38,157
Alabama,Millbrook,14983,3400,6248,1204,250,889,11991
Alabama,Mignon,1088,149,577,64,51,20,861
Alabama,Midway,583,278,68,39,14,30,429
Alabama,Midland City,2151,498,729,199,73,116,1615
Alabama,Midfield,5284,1761,1575,497,107,260,4200
Alabama,Meridianville,6270,1233,3095,565,140,167,5200
Alabama,Mentone,390,33,188,55,2,68,346
Alabama,Memphis,38,2,24,0,2,8,36
Alabama,Lisman,613,167,138,59,27,65,456
Alabama,Huguley,2373,476,924,322,136,180,2038
Alabama,Lipscomb,2275,664,660,304,68,131,1827
Alabama,Linden,2123,464,721,201,90,276,1752
Alabama,Ardmore,1419,270,475,216,32,130,1123
Alabama,Argo,4146,562,2044,611,150,75,3442
Alabama,Lakeview,133,38,56,11,0,3,108
Alabama,La Fayette,2989,1073,709,336,67,271,2456
Alabama,Ladonia,2840,477,1046,457,35,149,2164
Alabama,Kinston,563,120,184,61,19,42,426
Alabama,Kinsey,2275,553,812,243,90,83,1781
Alabama,Kimberly,2799,514,1363,184,18,114,2193
Alabama,Killen,1177,182,588,110,15,53,948
Alabama,Kennedy,412,46,223,20,22,48,359
Alabama,Kellyton,248,40,87,37,4,22,190
Alabama,Arab,8282,1599,3460,1034,176,563,6832
Alabama,Kansas,186,46,73,17,15,10,161
Alabama,Jemison,2627,338,1029,212,136,219,1934
Alabama,Jasper,14186,2898,5645,1588,336,891,11358
Alabama,Jacksonville,12372,5256,3321,1197,171,582,10527
Alabama,Jacksons' Gap,932,212,420,93,27,38,790
Alabama,Jackson,5055,1336,1750,337,240,318,3981
Alabama,Ivalee,690,120,422,12,10,22,586
Alabama,Irondale,12398,3217,4649,1797,279,579,10521
Alabama,Indian Springs Village,2505,440,1358,192,37,155,2182
Alabama,Ider,887,169,404,70,10,89,742
Alabama,Hytop,422,53,186,50,5,28,322
Alabama,Hurtsboro,487,127,128,47,44,39,385
Alabama,Joppa,263,0,149,0,0,114,263
Alabama,Anniston,22626,6086,7027,2582,951,2109,18755
Alabama,Anderson,253,61,107,34,3,25,230
Alabama,Andalusia,9058,2158,3041,1063,216,850,7328
Alabama,Lincoln,6391,1137,2811,917,232,256,5353
Alabama,Lillian,1256,153,638,94,34,15,934
Alabama,Libertyville,146,17,84,18,0,8,127
Alabama,Lexington,667,82,328,71,10,47,538
Alabama,Level Plains,2181,473,1010,183,8,98,1772
Alabama,Lester,143,35,69,9,4,8,125
Alabama,Leroy,779,146,446,71,16,11,690
Alabama,Leighton,859,264,235,113,42,73,727
Alabama,Leesburg,1055,167,511,110,15,55,858
Alabama,Leeds,11881,2172,5265,1101,177,672,9387
Alabama,Langston,211,42,119,12,6,16,195
Alabama,Lanett,6457,1923,1618,761,236,572,5110
Alabama,Lake View,2417,560,1196,164,10,72,2002
Alabama,Abanda,52,0,0,0,0,52,52
Alabama,Abbeville,2646,596,939,308,71,320,2234
Alabama,Adamsville,4454,1180,1784,409,70,302,3745
Alabama,Addison,682,97,289,121,26,41,574
Alabama,Akron,293,123,61,26,17,38,265
Alabama,Alabaster,31905,6388,14102,2441,441,1256,24628
Alabama,Albertville,21406,4540,7783,1957,304,1410,15994
Alabama,Alexander City,14787,3474,5227,1648,258,1054,11661
Alabama,Alexandria,3912,507,2016,388,0,138,3049
Alabama,Aliceville,3727,1275,779,290,165,370,2879
Alabama,Allgood,803,162,418,57,5,20,662
Alabama,Altoona,808,159,327,90,32,68,676
Alabama,Lineville,2549,518,911,219,41,253,1942
Alabama,Spring Garden,179,40,102,0,12,0,154
Alabama,Ethelsville,99,31,34,8,5,4,82
Alabama,Castleberry,543,129,193,57,58,50,487
Alabama,Chatom,1006,251,401,119,17,137,925
Alabama,Chelsea,11386,1609,5696,817,36,182,8340
Alabama,Cherokee,850,126,371,99,9,73,678
Alabama,Chickasaw,6005,1724,1505,737,176,339,4481
Alabama,Childersburg,5105,1102,1676,741,81,322,3922
Alabama,Choccolocco,2279,227,1226,210,36,112,1811
Alabama,Chunchula,136,0,95,41,0,0,136
Alabama,Citronelle,3886,936,1737,353,53,214,3293
Alabama,Clanton,8715,1977,3487,928,99,677,7168
Alabama,Clay,9682,1977,4635,1014,130,660,8416
Alabama,Clayhatchee,441,97,209,62,2,13,383
Alabama,Clayton,2947,1353,592,476,143,168,2732
Alabama,Cleveland,1206,203,640,75,14,63,995
Alabama,Clio,856,168,326,90,46,71,701
Alabama,Coaling,1808,423,718,201,14,76,1432
Alabama,Coats Bend,1842,414,730,286,36,68,1534
Alabama,Coffeeville,383,128,134,16,10,23,311
Alabama,Coker,819,248,301,89,12,40,690
Alabama,Collinsville,2104,614,586,222,3,200,1625
Alabama,Colony,345,110,101,38,4,26,279
Alabama,Columbia,680,81,260,106,20,68,535
Alabama,Columbiana,4176,922,1498,614,161,423,3618
Alabama,Concord,2044,478,887,283,56,117,1821
Alabama,Coosada,1374,297,589,107,37,69,1099
Alabama,Cordova,2074,439,723,306,29,250,1747
Alabama,Cottondale,3702,1103,1297,394,102,145,3041
Alabama,Cottonwood,1438,288,487,179,56,99,1109
Alabama,County Line,187,19,113,20,1,25,178
Alabama,Courtland,592,138,172,55,15,54,434
Alabama,Centreville,2719,514,1095,280,31,334,2254
Alabama,Centre,3570,557,1635,301,132,374,2999
Alabama,Camp Hill,1051,394,214,134,60,50,852
Alabama,Carbon Hill,1739,333,501,358,74,140,1406
Alabama,West End-Cobb Town,3790,856,1476,427,128,231,3118
Alabama,West Jefferson,442,72,178,39,9,36,334
Alabama,Westover,1239,149,569,189,9,54,970
Alabama,West Point,626,52,373,51,14,29,519
Alabama,White Hall,832,311,160,76,38,62,647
Alabama,Whatley,0,0,0,0,0,0,0
Alabama,White Plains,908,115,459,98,0,24,696
Alabama,Wetumpka,7406,1905,2345,1135,317,564,6266
Alabama,York,2652,1104,394,279,98,272,2147
Alabama,Sterrett,575,97,269,101,32,30,529
Alabama,Steele,945,89,506,115,23,86,819
Alabama,Stapleton,1360,184,800,72,53,47,1156
Alabama,Standing Rock,48,4,36,8,0,0,48
Alabama,Spruce Pine,146,60,57,29,0,0,146
Alabama,Cowarts,2071,419,881,231,26,91,1648
Alabama,Yellow Bluff,186,103,15,11,0,18,147
Alabama,Woodstock,1766,391,727,127,40,68,1353
Alabama,Woodland,222,46,94,27,4,19,190
Alabama,Whitesboro,2139,358,922,243,24,68,1615
Alabama,Wilsonville,2163,402,862,291,25,117,1697
Alabama,Wilton,584,155,201,88,13,33,490
Alabama,Winfield,4345,1211,1712,287,100,447,3757
Alabama,Center Point,16797,5264,4716,1869,396,786,13031
Alabama,Cedar Bluff,2017,308,885,213,79,109,1594
Alabama,Catherine,20,0,20,0,0,0,20
Alabama,Carrollton,922,363,244,80,7,66,760
Alabama,Carolina,285,32,172,24,0,2,230
Alabama,Carlton,74,14,49,11,0,0,74
Alabama,Carlisle-Rockledge,2910,761,1251,177,53,120,2362
Alabama,Cardiff,30,0,15,0,2,5,22
Alabama,Woodville,763,105,291,110,22,63,591
Alabama,Creola,1842,389,866,172,42,47,1516
Alabama,Coffee Springs,264,41,117,41,3,18,220
Alabama,Tuscumbia,8537,1796,3145,1076,80,750,6847
Alabama,Tuscaloosa,94865,42522,25324,7261,1411,3987,80505
Alabama,Vernon,2202,471,922,234,62,165,1854
Alabama,Tuskegee,9218,5028,1354,714,409,517,8022
Alabama,Twin,415,75,216,44,6,25,366
Alabama,Underwood-Petersville,3425,719,1585,298,14,283,2899
Alabama,Union,269,84,59,29,29,47,248
Alabama,Union Grove,81,13,39,14,0,7,73
Alabama,Union Springs,3915,1401,633,449,337,206,3026
Alabama,Uniontown,2841,1137,418,245,104,147,2051
Alabama,Uriah,278,53,74,109,23,6,265
Alabama,West Blocton,1359,277,500,124,44,87,1032
Alabama,Weogufka,292,20,114,46,0,0,180
Alabama,Wedowee,714,110,252,145,22,87,616
Alabama,Webb,1287,227,637,151,22,74,1111
Alabama,Trussville,20351,3219,10427,1250,232,952,16080
Alabama,Weaver,3072,503,1389,381,47,217,2537
Alabama,Waterloo,143,20,61,28,2,11,122
Alabama,Warrior,3191,802,1210,383,64,278,2737
Alabama,Valley,9444,2201,3505,1210,165,503,7584
Alabama,Valley Grande,3912,741,1843,230,73,233,3120
Alabama,Valley Head,587,149,206,136,6,23,520
Alabama,Walnut Grove,910,160,324,126,28,53,691
Alabama,Vance,1302,252,633,69,2,75,1031
Alabama,Waldo,246,39,96,35,4,22,196
Alabama,Wadley,809,344,160,55,33,41,633
Alabama,Vredenburgh,154,88,35,6,14,9,152
Alabama,Vinegar Bend,214,0,141,0,0,0,141
Alabama,Vincent,2032,404,797,294,31,144,1670
Alabama,Vina,335,47,149,59,7,18,280
Alabama,Vandiver,1020,213,529,86,27,63,918
Alabama,Waverly,266,61,106,53,3,14,237
Alabama,Troy,18696,8325,5335,1216,243,748,15867
Alabama,Vestavia Hills,34116,5376,16958,2776,239,1660,27009
Alabama,Triana,578,252,122,81,24,25,504
Alabama,Springville,4174,324,2486,308,30,79,3227
Alabama,Stevenson,2194,396,876,197,91,129,1689
Alabama,Stewartville,1956,329,1013,221,33,123,1719
Alabama,Stockton,748,197,314,110,31,37,689
Alabama,Sulligent,1956,313,950,208,52,98,1621
Alabama,Sumiton,2689,409,1106,308,44,175,2042
Alabama,Summerdale,986,184,434,96,33,33,780
Alabama,Susan Moore,731,130,325,71,15,66,607
Alabama,Sweet Water,304,61,145,18,0,11,235
Alabama,Sylacauga,12749,3313,3958,1222,355,1063,9911
Alabama,Trinity,2239,281,1152,248,14,75,1770
Alabama,Sylvan Springs,1729,196,797,215,22,169,1399
Alabama,Talladega,15931,4930,4486,2085,587,1232,13320
Alabama,Talladega Springs,224,46,76,27,6,15,170
Alabama,Sylvania,2119,392,900,152,76,97,1617
Alabama,Tarrant,6278,1971,1371,1260,195,469,5266
Alabama,Taylor,2880,489,1078,311,50,71,1999
Alabama,Theodore,5942,1098,2373,689,209,272,4641
Alabama,Trafford,601,99,240,81,15,54,489
Alabama,Thomaston,268,56,131,14,14,11,226
Alabama,Thomasville,4099,949,1609,430,93,305,3386
Alabama,Toxey,182,25,81,3,0,25,134
Alabama,Town Creek,998,231,381,119,28,26,785
Alabama,Tallassee,5380,1304,1735,600,178,458,4275
Alabama,Tillmans Corner,19065,3915,7140,2184,404,1125,14768
Alabama,Thorsby,2140,366,979,176,13,168,1702
Alabama,Tibbie,24,0,0,0,11,7,18
Alabama,Tidmore Bend,1170,215,548,109,46,112,1030
Alaska,Toksook Bay,549,200,171,8,2,9,390
Alaska,Tonsina,30,0,18,0,0,12,30
Alaska,Tolsona,0,0,0,0,0,0,0
Alaska,Teller,165,75,31,2,2,12,122
Alaska,Tenakee Springs,150,19,97,7,0,6,129
Alaska,Tetlin,121,40,23,3,2,4,72
Alaska,Tok,1331,356,576,65,14,29,1040
Alaska,Thorne Bay,566,127,235,81,0,16,459
Alaska,Togiak,787,310,181,26,12,12,541
Alaska,Tazlina,358,149,107,34,4,16,310
Alaska,Mekoryuk,174,68,49,6,5,6,134
Alaska,South Naknek,63,21,18,5,4,11,59
Alaska,Tanana,277,111,79,24,6,12,232
Alaska,Mentasta Lake,157,58,27,15,18,9,127
Alaska,Mertarvik,0,0,0,0,0,0,0
Alaska,Trapper Creek,432,76,135,101,7,19,338
Alaska,Meadow Lakes,7424,1726,3053,574,201,146,5700
Alaska,Marshall,350,102,98,8,5,11,224
Alaska,Manokotak,691,248,226,18,16,21,529
Alaska,Manley Hot Springs,84,7,47,8,0,3,65
Alaska,Soldotna,4409,1184,1505,571,60,166,3486
Alaska,Mendeltna,22,0,22,0,0,0,22
Alaska,South Van Horn,581,159,143,116,0,17,435
Alaska,Stebbins,547,204,107,21,10,27,369
Alaska,Steele Creek,6272,1305,3150,680,3,91,5229
Alaska,Sterling,6054,1240,3031,418,72,310,5071
Alaska,Stevens Village,25,12,0,4,6,1,23
Alaska,Stony River,40,19,6,0,0,0,25
Alaska,Sunrise,15,9,0,0,0,6,15
Alaska,Susitna,0,0,0,0,0,0,0
Alaska,Susitna North,1404,269,654,143,21,95,1182
Alaska,Sutton-Alpine,1602,652,416,237,71,51,1427
Alaska,Takotna,49,8,16,0,4,3,31
Alaska,Talkeetna,616,159,258,56,41,21,535
Alaska,Tanacross,127,71,27,5,0,1,104
Alaska,Tanaina,9640,2311,3853,655,128,192,7139
Alaska,Tatitlek,86,42,34,1,0,0,77
Alaska,Haines,1955,460,855,252,10,68,1645
Alaska,Salcha,984,234,461,33,0,13,741
Alaska,Gulkana,115,39,51,4,0,2,96
Alaska,Evansville,16,2,4,6,0,2,14
Alaska,Eureka Roadhouse,0,0,0,0,0,0,0
Alaska,Ester,3008,1198,1026,256,115,162,2757
Alaska,Emmonak,835,339,203,24,9,29,604
Alaska,Elim,328,107,89,14,2,13,225
Alaska,Elfin Cove,24,0,16,3,0,0,19
Alaska,Ekwok,78,38,14,5,0,3,60
Alaska,Eielson AFB,2630,458,1213,90,0,0,1761
Alaska,Egegik,68,9,23,15,6,5,58
Alaska,Eek,455,133,124,3,8,23,291
Alaska,Excursion Inlet,40,23,12,5,0,0,40
Alaska,Edna Bay,0,0,0,0,0,0,0
Alaska,Eagle,89,31,41,4,4,1,81
Alaska,Dry Creek,84,35,33,0,0,4,72
Alaska,Dot Lake Village,54,24,11,9,2,2,48
Alaska,Dot Lake,0,0,0,0,0,0,0
Alaska,Diomede,43,19,4,5,0,0,28
Alaska,Metlakatla,1661,453,482,183,45,81,1244
Alaska,Dillingham,2307,619,758,229,26,101,1733
Alaska,Diamond Ridge,1140,201,527,135,12,30,905
Alaska,Deltana,2311,400,970,213,7,151,1741
Alaska,Delta Junction,1045,283,409,77,0,31,800
Alaska,Eagle Village,17,3,8,6,0,0,17
Alaska,Gustavus,496,55,308,79,0,3,445
Alaska,Fairbanks,32193,8912,10917,3247,553,970,24599
Alaska,Farmers Loop,4149,954,2048,238,0,25,3265
Alaska,Grayling,171,64,27,11,6,9,117
Alaska,Goodnews Bay,230,95,38,4,8,7,152
Alaska,Golovin,132,37,35,13,0,5,90
Alaska,Goldstream,3862,1187,1645,224,16,56,3128
Alaska,Glennallen,366,102,160,21,12,0,295
Alaska,Glacier View,249,43,134,4,0,18,199
Alaska,Gateway,5610,1191,2485,471,95,106,4348
Alaska,Game Creek,36,0,14,0,0,0,14
Alaska,Gambell,718,294,147,9,19,54,523
Alaska,Galena,554,144,206,36,6,23,415
Alaska,False Pass,37,14,11,10,0,0,35
Alaska,Gakona,205,25,91,2,0,0,118
Alaska,Fritz Creek,1910,371,940,178,22,48,1559
Alaska,Fox River,649,165,212,13,4,21,415
Alaska,Fox,558,33,473,18,0,20,544
Alaska,Four Mile Road,10,0,5,0,0,5,10
Alaska,Fort Yukon,555,191,136,37,12,42,418
Alaska,Fort Greely,391,67,157,9,0,0,233
Alaska,Flat,0,0,0,0,0,0,0
Alaska,Fishhook,5323,1173,2311,453,27,124,4088
Alaska,Ferry,6,6,0,0,0,0,6
Alaska,Farm Loop,1081,259,507,83,38,33,920
Alaska,Funny River,776,110,297,174,16,55,652
Alaska,Minto,257,141,45,14,0,5,205
Alaska,Old Harbor,249,119,54,26,7,10,216
Alaska,Moose Pass,428,81,226,48,0,0,355
Alaska,Anchorage municipal,299107,83244,112525,27972,3864,8418,236023
Alaska,Anchor Point,1951,397,895,242,18,64,1616
Alaska,Anderson,201,45,110,17,0,3,175
Alaska,Angoon,382,157,89,52,8,17,323
Alaska,Aniak,525,159,166,24,12,18,379
Alaska,Anvik,87,25,23,3,7,8,66
Alaska,Arctic Village,138,58,25,13,5,4,105
Alaska,Atka,66,14,29,15,0,4,62
Alaska,Atmautluak,258,67,71,6,16,8,168
Alaska,Atqasuk,159,80,21,4,1,13,119
Alaska,Attu Station,16,11,5,0,0,0,16
Alaska,Badger,21197,4871,8528,1638,549,425,16011
Alaska,Barrow,4293,1268,1234,285,51,97,2935
Alaska,Bear Creek,1824,554,530,292,27,30,1433
Alaska,Beaver,60,38,3,7,1,8,57
Alaska,Beluga,6,0,0,6,0,0,6
Alaska,Bethel,6370,2035,1896,550,106,169,4756
Alaska,Bettles,22,4,13,3,2,0,22
Alaska,Big Delta,539,78,310,29,0,8,425
Alaska,Big Lake,3815,651,1731,371,41,159,2953
Alaska,Birch Creek,1,1,0,0,0,0,1
Alaska,Akiak,399,136,96,11,3,10,256
Alaska,Akiachak,562,174,160,8,16,18,376
Alaska,Anaktuvuk Pass,247,117,51,8,2,6,184
Alaska,Akhiok,84,5,46,3,3,0,57
Alaska,Ambler,280,95,70,7,3,8,183
Alaska,Aleneva,59,0,17,0,0,0,17
Alaska,Port Alexander,31,8,20,0,0,0,28
Alaska,Northway Village,92,34,18,8,3,9,72
Alaska,Northway Junction,64,25,8,6,1,4,44
Alaska,Northway,131,42,56,3,0,0,101
Alaska,Port Alsworth,147,35,54,8,0,3,100
Alaska,Port Clarence,40,40,0,0,0,0,40
Alaska,Port Graham,206,84,56,9,1,7,157
Alaska,Port Heiden,81,17,42,2,1,4,66
Alaska,Port Lions,231,50,126,7,2,17,202
Alaska,Port Protection,82,11,39,32,0,0,82
Alaska,Primrose,73,15,52,0,0,6,73
Alaska,Prudhoe Bay,2724,670,1613,388,25,28,2724
Alaska,Quinhagak,661,225,169,18,30,23,465
Alaska,Rampart,7,2,0,3,0,2,7
Alaska,Red Devil,22,8,7,0,0,4,19
Alaska,Red Dog Mine,81,29,48,0,4,0,81
Alaska,Ridgeway,2195,385,1190,138,17,25,1755
Alaska,Ruby,202,66,46,12,1,13,138
Alaska,Russian Mission,410,161,90,8,14,10,283
Alaska,St. George,53,19,21,5,0,2,47
Alaska,Alatna,1,1,0,0,0,0,1
Alaska,Alcan Border,51,6,14,0,0,0,20
Alaska,Aleknagik,199,72,62,13,4,14,165
Alaska,Allakaket,77,36,22,4,2,3,67
Alaska,Nuiqsut,345,123,68,21,4,23,239
Alaska,Nulato,285,135,61,6,3,19,224
Alaska,Nunam Iqua,129,49,35,5,0,10,99
Alaska,Noatak,443,166,116,13,1,12,308
Alaska,Ninilchik,728,173,327,82,18,48,648
Alaska,Nikolski,37,11,18,3,0,2,34
Alaska,Nikolai,113,58,27,5,11,0,101
Alaska,Nikolaevsk,234,48,94,41,0,10,193
Alaska,Nikiski,4549,1083,1683,657,68,250,3741
Alaska,Nightmute,259,109,63,2,0,10,184
Alaska,Newtok,388,149,91,1,5,3,249
Alaska,New Stuyahok,609,222,157,15,4,14,412
Alaska,Newhalen,159,47,43,4,3,8,105
Alaska,New Allakaket,67,25,17,0,1,2,45
Alaska,Nenana,406,130,149,30,9,28,346
Alaska,Nelson Lagoon,42,15,16,2,3,6,42
Alaska,Nelchina,170,0,81,0,0,0,81
Alaska,Naukati Bay,32,13,0,10,0,9,32
Alaska,Napaskiak,408,118,123,5,4,22,272
Alaska,Napakiak,352,95,84,13,17,13,222
Alaska,Nanwalek,238,56,62,7,5,8,138
Alaska,Naknek,567,116,272,47,8,18,461
Alaska,Nabesna,0,0,0,0,0,0,0
Alaska,Mud Bay,167,7,136,9,0,0,152
Alaska,Mountain Village,749,268,148,19,15,34,484
Alaska,Mosquito Lake,126,44,45,28,9,0,126
Alaska,Nome,3773,1181,1133,369,68,84,2835
Alaska,Nondalton,182,77,35,4,6,10,132
Alaska,Noorvik,608,236,126,15,7,21,405
Alaska,North Pole,2265,541,908,206,39,34,1728
Alaska,Nunapitchuk,554,160,151,13,7,12,343
Alaska,Deering,144,63,27,6,3,5,104
Alaska,Oscarville,22,9,3,0,0,2,14
Alaska,Ouzinkie,230,104,67,6,1,16,194
Alaska,Palmer,6449,1778,2125,708,90,195,4896
Alaska,Paxson,38,5,19,0,0,14,38
Alaska,Pedro Bay,12,2,6,3,0,1,12
Alaska,Pelican,79,13,40,11,5,2,71
Alaska,Perryville,98,40,16,3,1,5,65
Alaska,Petersburg,3024,783,1205,322,34,110,2454
Alaska,Petersville,0,0,0,0,0,0,0
Alaska,Moose Creek,728,307,156,137,0,21,621
Alaska,Pilot Point,53,20,10,3,0,4,37
Alaska,Pitkas Point,136,52,34,0,1,7,94
Alaska,Platinum,42,4,15,2,2,1,24
Alaska,Pleasant Valley,168,20,104,0,0,0,124
Alaska,Point Baker,41,23,0,18,0,0,41
Alaska,Point Hope,562,198,127,13,5,25,368
Alaska,Point Lay,285,107,42,12,3,3,167
Alaska,Point MacKenzie,466,200,144,67,24,8,443
Alaska,Point Possession,0,0,0,0,0,0,0
Alaska,Pope-Vannoy Landing,0,0,0,0,0,0,0
Alaska,Portage Creek,0,0,0,0,0,0,0
Alaska,Adak,122,24,25,20,5,9,83
Alaska,Pilot Station,582,222,122,11,0,21,376
Alaska,Crown Point,132,64,34,5,0,0,103
Alaska,Central,58,10,27,12,0,4,53
Alaska,Craig,1231,307,495,154,20,39,1015
Alaska,Halibut Cove,23,12,11,0,0,0,23
Alaska,Happy Valley,607,175,289,57,0,27,548
Alaska,Harding-Birch Lakes,142,6,76,13,0,15,110
Alaska,Healy,1120,179,569,88,19,0,855
Alaska,Healy Lake,0,0,0,0,0,0,0
Alaska,Hobart Bay,0,0,0,0,0,0,0
Alaska,Hollis,124,13,92,0,0,0,105
Alaska,Holy Cross,214,86,44,14,9,11,164
Alaska,Homer,5324,1301,2076,585,81,216,4259
Alaska,Yakutat,597,184,195,67,6,20,472
Alaska,Hoonah,821,238,267,116,21,27,669
Alaska,Hope,50,0,46,0,0,0,46
Alaska,Houston,1977,401,760,241,42,82,1526
Alaska,Hughes,62,22,11,0,7,0,40
Alaska,Huslia,420,121,120,11,2,21,275
Alaska,Hydaburg,277,94,60,44,10,16,224
Alaska,Hyder,13,0,0,6,0,7,13
Alaska,Igiugig,49,4,17,8,1,3,33
Alaska,Iliamna,78,19,31,8,2,2,62
Alaska,Ivanof Bay,0,0,0,0,0,0,0
Alaska,Hooper Bay,1140,381,187,39,13,28,648
Alaska,Wrangell city and borough,2387,477,1056,354,36,139,2062
Alaska,Womens Bay,852,226,406,43,0,9,684
Alaska,Wiseman,11,0,7,0,0,0,7
Alaska,Tuntutuliak,466,144,116,18,11,19,308
Alaska,Tununak,294,126,66,3,4,8,207
Alaska,Twin Hills,95,27,12,5,13,6,63
Alaska,Two Rivers,238,31,97,13,36,0,177
Alaska,Tyonek,214,110,36,23,0,11,180
Alaska,Ugashik,19,1,15,3,0,0,19
Alaska,Unalakleet,710,177,258,62,19,34,550
Alaska,Unalaska,4619,1495,1630,463,147,162,3897
Alaska,Upper Kalskag,284,81,67,7,7,15,177
Alaska,Valdez,3979,1025,1407,511,124,20,3087
Alaska,Venetie,177,76,42,4,7,6,135
Alaska,Wainwright,458,162,119,11,6,16,314
Alaska,Wales,155,80,20,4,2,3,109
Alaska,Wasilla,8676,1946,2979,977,146,480,6528
Alaska,Whale Pass,16,16,0,0,0,0,16
Alaska,White Mountain,179,58,32,21,4,9,124
Alaska,Whitestone,195,77,70,35,0,0,182
Alaska,Whitestone Logging Camp,0,0,0,0,0,0,0
Alaska,Whittier,295,76,89,43,8,12,228
Alaska,Willow,2085,488,941,234,7,35,1705
Alaska,Willow Creek,8,8,0,0,0,0,8
Alaska,Juneau city and borough,32531,8872,12881,3194,612,915,26474
Alaska,Kachemak,551,138,277,53,4,18,490
Alaska,Kake,628,189,206,51,16,23,485
Alaska,Kaktovik,155,77,27,6,1,7,118
Alaska,Kotzebue,3283,1094,1045,179,30,76,2424
Alaska,Koyuk,272,91,51,14,0,6,162
Alaska,Koyukuk,80,28,11,4,4,7,54
Alaska,Kupreanof,40,4,25,0,0,0,29
Alaska,Kwethluk,824,303,162,20,28,34,547
Alaska,Kwigillingok,331,106,97,6,4,14,227
Alaska,Lake Louise,45,12,0,19,6,8,45
Alaska,Lake Minchumina,21,4,14,3,0,0,21
Alaska,Lakes,9028,1919,3992,841,42,245,7039
Alaska,Larsen Bay,61,14,26,5,2,2,49
Alaska,Lazy Mountain,1637,352,696,112,9,24,1193
Alaska,Levelock,114,34,21,13,0,4,72
Alaska,Lime Village,7,1,4,0,0,2,7
Alaska,Livengood,10,0,10,0,0,0,10
Alaska,Loring,0,0,0,0,0,0,0
Alaska,Lowell Point,141,75,66,0,0,0,141
Alaska,Lower Kalskag,317,121,76,13,7,16,233
Alaska,Lutak,13,0,0,13,0,0,13
Alaska,McCarthy,107,38,43,0,0,0,81
Alaska,McGrath,346,80,123,21,5,14,243
Alaska,McKinley Park,514,346,43,105,0,0,494
Alaska,Kotlik,643,251,120,20,29,21,441
Alaska,Tuluksak,436,118,128,1,5,12,264
Alaska,Kongiganak,408,167,108,5,7,7,294
Alaska,Kokhanok,145,74,29,6,2,2,113
Alaska,Kalifornsky,7965,1471,3526,665,77,296,6035
Alaska,Kaltag,192,82,58,7,3,8,158
Alaska,Karluk,44,21,10,6,0,0,37
Alaska,Kasaan,71,20,24,7,3,2,56
Alaska,Kasigluk,599,206,141,19,16,20,402
Alaska,Kasilof,388,79,156,10,0,7,252
Alaska,Kenai,7463,1508,2982,1038,232,246,6006
Alaska,Kenny Lake,128,12,45,34,0,0,91
Alaska,Ketchikan,8197,2290,2789,1154,151,314,6698
Alaska,Kiana,380,130,94,21,9,17,271
Alaska,King Cove,1074,258,569,68,25,40,960
Alaska,King Salmon,340,103,112,38,5,4,262
Alaska,Kipnuk,686,241,195,21,9,18,484
Alaska,Kivalina,576,228,119,18,4,13,382
Alaska,Klawock,792,217,231,105,15,71,639
Alaska,Klukwan,66,23,29,10,2,1,65
Alaska,Knik-Fairview,16017,3312,6520,1661,238,412,12143
Alaska,Knik River,765,198,317,91,4,18,628
Alaska,Kobuk,159,57,31,1,1,0,90
Alaska,Kodiak,6293,1825,2236,601,97,263,5022
Alaska,Kodiak Station,1398,170,702,22,4,13,911
Alaska,Koliganek,129,33,39,1,2,9,84
Alaska,Crooked Creek,98,42,17,4,0,4,67
Alaska,Akutan,899,292,465,82,31,18,888
Alaska,Cantwell,209,37,104,15,0,9,165
Alaska,Shaktoolik,223,77,65,9,1,10,162
Alaska,Shishmaref,573,222,92,25,5,21,365
Alaska,Shungnak,342,151,48,7,2,11,219
Alaska,Silver Springs,168,28,86,7,2,0,123
Alaska,Sitka city and borough,8943,2139,3699,965,86,333,7222
Alaska,Skagway,957,208,435,99,51,38,831
Alaska,Skwentna,42,0,29,4,0,0,33
Alaska,Slana,84,0,35,17,0,0,52
Alaska,Sleetmute,96,33,21,2,1,3,60
Alaska,Chiniak,23,0,23,0,0,0,23
Alaska,Chignik Lake,70,23,29,2,0,4,58
Alaska,Shageluk,43,17,16,0,0,4,37
Alaska,Chignik Lagoon,73,21,35,5,0,2,63
Alaska,Chicken,0,0,0,0,0,0,0
Alaska,Chickaloon,284,59,165,23,0,25,272
Alaska,Chevak,1082,522,164,16,7,38,747
Alaska,Chenega,66,21,12,4,0,8,45
Alaska,Chena Ridge,5473,1254,2625,374,37,63,4353
Alaska,Chefornak,516,189,137,13,7,5,351
Alaska,Brevig Mission,442,190,58,8,7,11,274
Alaska,Buckland,596,208,137,15,8,25,393
Alaska,Buffalo Soapstone,827,198,308,77,10,17,610
Alaska,Butte,3854,992,1616,330,35,103,3076
Alaska,Chase,23,8,0,15,0,0,23
Alaska,Chignik,70,11,40,0,0,0,51
Alaska,Seward,2710,1159,742,343,43,152,2439
Alaska,Seldovia Village,174,17,107,20,2,7,153
Alaska,Seldovia,243,47,111,42,2,15,217
Alaska,Covenant Life,105,7,81,0,0,0,88
Alaska,Cordova,2621,683,1041,397,87,39,2247
Alaska,Copper Center,405,148,111,39,10,5,313
Alaska,Cooper Landing,457,61,263,28,19,4,375
Alaska,College,14675,5602,5266,1192,127,395,12582
Alaska,Coldfoot,10,4,3,3,0,0,10
Alaska,Cold Bay,46,13,25,6,0,0,44
Alaska,Cohoe,1577,420,654,189,25,37,1325
Alaska,Coffman Cove,150,21,71,40,0,5,137
Alaska,Clark's Point,56,17,14,5,1,2,39
Alaska,Clam Gulch,182,36,95,8,0,4,143
Alaska,Circle,118,51,14,10,2,2,79
Alaska,Chuathbaluk,116,32,28,5,4,2,71
Alaska,Chitina,80,14,14,19,2,4,53
Alaska,Chistochina,59,34,7,11,0,4,56
Alaska,Chisana,0,0,0,0,0,0,0
Alaska,St. Mary's,583,180,177,23,14,28,422
Alaska,St. Michael,396,132,65,15,11,15,238
Alaska,St. Paul,576,242,122,74,10,33,481
Alaska,Salamatof,1110,387,321,177,36,30,951
Alaska,Sand Point,1188,398,434,99,18,31,980
Alaska,Savoonga,883,332,187,17,11,35,582
Alaska,Saxman,401,129,125,55,12,17,338
Alaska,Scammon Bay,488,178,97,7,6,6,294
Alaska,Selawik,794,311,126,28,3,28,496
Alaska,Alakanuk,777,272,195,6,5,26,504
Alaska,Chalkyitsik,101,34,19,2,4,3,62
Arizona,Houck,1152,623,185,43,20,55,926
Arizona,Central Heights-Midland City,3030,903,1010,508,0,253,2674
Arizona,Cornville,2708,490,1361,314,52,234,2451
Arizona,Corona de Tucson,7023,964,3774,339,0,152,5229
Arizona,Cottonwood,178,66,61,8,9,0,144
Arizona,Cottonwood,11493,2630,4238,2003,206,659,9736
Arizona,Cowlic,90,60,0,9,0,0,69
Arizona,Crozier,24,3,16,4,0,1,24
Arizona,Crystal Beach,160,14,109,22,8,7,160
Arizona,Cutter,64,16,24,13,0,0,53
Arizona,Dateland,249,67,94,19,13,12,205
Arizona,Deer Creek,204,59,69,32,0,22,182
Arizona,Jakes Corner,41,0,11,30,0,0,41
Arizona,Indian Wells,212,82,65,8,19,3,177
Arizona,Icehouse Canyon,736,123,372,68,20,24,607
Arizona,Haigler Creek,27,0,27,0,0,0,27
Arizona,Haivana Nakya,203,106,16,0,0,8,130
Arizona,Hard Rock,80,32,13,7,5,10,67
Arizona,Hayden,600,185,195,86,0,61,527
Arizona,Heber-Overgaard,2594,603,1188,286,45,110,2232
Arizona,Hunter Creek,0,0,0,0,0,0,0
Arizona,Hondah,1118,287,399,53,8,6,753
Arizona,Hotevilla-Bacavi,1091,396,269,87,34,64,850
Arizona,Cornfields,300,115,50,19,2,35,221
Arizona,Cordes Lakes,2642,454,1176,476,18,230,2354
Arizona,Copper Hill,18,0,18,0,0,0,18
Arizona,Coolidge,11973,2769,4020,1345,315,565,9014
Arizona,Chandler,250202,62276,100064,21066,3185,7598,194189
Arizona,Charco,16,11,0,0,0,5,16
Arizona,Chiawuli Tak,42,25,17,0,0,0,42
Arizona,Chilchinbito,839,381,154,13,6,23,577
Arizona,Chinle,4947,1970,823,359,37,122,3311
Arizona,Chino Valley,10961,1600,4765,1850,101,632,8948
Arizona,Chloride,182,37,59,50,6,23,175
Arizona,Christopher Creek,37,9,14,5,0,9,37
Arizona,Chuichu,221,135,37,0,6,0,178
Arizona,Cibecue,1848,666,375,115,51,58,1265
Arizona,Huachuca City,2160,415,678,340,11,112,1556
Arizona,Cibola,393,32,69,125,24,41,291
Arizona,Citrus Park,4451,742,2092,589,23,172,3618
Arizona,Clacks Canyon,113,11,83,0,0,9,103
Arizona,Clarkdale,4132,538,2325,638,71,249,3821
Arizona,Claypool,1843,303,708,275,17,76,1379
Arizona,Clay Springs,503,207,70,10,0,36,323
Arizona,Clifton,3500,794,1257,236,39,98,2424
Arizona,Colorado City,4808,1243,912,75,78,40,2348
Arizona,Comobabi,49,0,18,0,0,0,18
Arizona,Concho,238,51,60,15,0,0,126
Arizona,Congress,1255,139,766,93,20,161,1179
Arizona,Cienega Springs,1798,265,822,209,16,210,1522
Arizona,Holbrook,4993,1192,1717,607,101,149,3766
Arizona,Bylas,1834,682,345,111,18,104,1260
Arizona,Yucca,69,13,13,10,0,25,61
Arizona,Mammoth,1532,338,486,156,85,86,1151
Arizona,Maish Vaya,133,41,33,15,0,14,103
Arizona,McNeal,274,27,128,38,0,12,205
Arizona,McNary,634,226,154,41,3,12,436
Arizona,McConnico,0,0,0,0,0,0,0
Arizona,Lupton,3,3,0,0,0,0,3
Arizona,Many Farms,1667,646,388,53,17,61,1165
Arizona,Lukachukai,1803,707,459,38,44,50,1298
Arizona,Lower Santan Village,688,242,141,38,0,45,466
Arizona,Littletown,436,102,190,8,0,22,322
Arizona,Littlefield,228,25,150,0,0,0,175
Arizona,Litchfield Park,5253,903,2659,462,75,341,4440
Arizona,Linden,2536,404,1230,300,0,96,2030
Arizona,Leupp,1059,346,290,69,24,73,802
Arizona,Low Mountain,750,230,189,56,9,38,522
Arizona,Marana,38280,6141,18649,3138,315,1435,29678
Arizona,Maricopa,45748,10141,18887,3666,644,1042,34380
Arizona,Maricopa Colony,746,231,171,46,7,18,473
Arizona,Morenci,1649,359,441,370,8,0,1178
Arizona,Mojave Ranch Estates,41,12,14,10,0,0,36
Arizona,Mohave Valley,2983,703,1198,140,184,85,2310
Arizona,Moenkopi,1114,404,303,128,12,37,884
Arizona,Moccasin,55,0,55,0,0,0,55
Arizona,Miracle Valley,515,103,212,63,0,36,414
Arizona,Miami,2052,521,639,342,60,114,1676
Arizona,Mesquite Creek,508,50,315,69,1,45,480
Arizona,Mescal,1652,242,807,259,24,65,1397
Arizona,Mesa del Caballo,705,64,293,105,0,24,486
Arizona,Mesa,458860,118793,172263,46603,5513,21251,364423
Arizona,Meadview,677,102,294,200,0,81,677
Arizona,Mead Ranch,28,0,6,10,0,0,16
Arizona,Mayer,1269,288,446,256,62,118,1170
Arizona,Martinez Lake,54,0,38,5,0,0,43
Arizona,LeChee,1542,580,487,58,26,50,1201
Arizona,Youngtown,6405,1426,2027,959,68,469,4949
Arizona,Lazy Y U,648,34,263,0,64,0,361
Arizona,Lake of the Woods,4363,891,1883,416,33,164,3387
Arizona,Jerome,388,52,141,126,0,28,347
Arizona,Jeddito,311,99,88,9,8,15,219
Arizona,Morristown,97,8,62,22,0,5,97
Arizona,Hackberry,94,8,56,14,0,16,94
Arizona,Mountainaire,1219,281,471,109,0,26,887
Arizona,Munds Park,660,87,573,0,0,0,660
Arizona,Joseph City,1184,267,390,76,6,30,769
Arizona,Naco,1013,209,315,102,11,34,671
Arizona,Nelson,520,107,168,36,0,3,314
Arizona,New Kingman-Butler,11859,2644,4267,1804,322,879,9916
Arizona,New River,15289,2428,8388,1268,256,689,13029
Arizona,Nogales,20601,4975,6962,1837,475,1236,15485
Arizona,Nolic,0,0,0,0,0,0,0
Arizona,Yuma,93812,20805,39036,6490,1695,4217,72243
Arizona,Nazlini,483,158,120,26,9,31,344
Arizona,Kachina Village,2638,442,1251,382,112,41,2228
Arizona,Kaibab,147,55,19,23,3,9,109
Arizona,Kaibito,1611,577,435,52,7,52,1123
Arizona,Lake Montezuma,5970,1103,2801,1095,113,250,5362
Arizona,Lake Havasu City,53010,9411,25418,6600,612,3639,45680
Arizona,Kykotsmovi Village,843,335,202,106,0,39,682
Arizona,Ko Vaya,24,11,9,0,0,0,20
Arizona,Komatke,1458,524,209,56,5,10,804
Arizona,Kohls Ranch,103,0,97,0,0,6,103
Arizona,Kohatk,21,21,0,0,0,0,21
Arizona,Klagetoh,291,93,76,19,2,20,210
Arizona,Kino Springs,247,83,72,19,9,5,188
Arizona,Kingman,28511,5964,10103,4304,704,2191,23266
Arizona,Kearny,2312,605,823,218,0,172,1818
Arizona,Keams Canyon,203,55,80,36,0,22,193
Arizona,Kayenta,4702,1810,1268,99,51,32,3260
Arizona,Katherine,103,38,19,41,0,5,103
Arizona,Kaka,123,74,0,15,0,8,97
Arizona,La Paz Valley,469,43,216,47,0,163,469
Arizona,Gu Oidak,123,25,51,26,0,0,102
Arizona,Cameron,1199,465,289,54,38,51,897
Arizona,Greer,46,0,46,0,0,0,46
Arizona,Verde Village,12532,2154,5243,1332,91,991,9811
Arizona,Vernon,36,27,9,0,0,0,36
Arizona,Vicksburg,1043,33,465,197,0,124,819
Arizona,Village of Oak Creek (Big Park),6336,923,3705,750,49,561,5988
Arizona,Wagon Wheel,1340,88,751,60,23,149,1071
Arizona,Wahak Hotrontk,126,47,15,0,0,8,70
Arizona,Wall Lane,775,63,339,50,0,14,466
Arizona,Walnut Creek,465,0,332,39,18,22,411
Arizona,Ventana,96,73,0,10,0,0,83
Arizona,Washington Park,124,28,79,0,0,17,124
Arizona,Wellton Hills,229,46,94,13,9,24,186
Arizona,Wenden,470,100,256,32,0,31,419
Arizona,Wet Camp Village,333,147,64,6,0,0,217
Arizona,Wheatfields,821,177,300,51,21,75,624
Arizona,Whetstone,2926,586,1025,267,27,352,2257
Arizona,Whispering Pines,198,0,91,19,0,27,137
Arizona,Whitecone,930,325,220,45,14,44,648
Arizona,White Hills,379,22,225,74,0,33,354
Arizona,Wellton,2942,308,1855,302,60,190,2715
Arizona,Valle Vista,1988,280,1020,229,0,133,1662
Arizona,Valle,310,7,92,17,0,0,116
Arizona,Valentine,68,22,35,7,0,0,64
Arizona,Tonto Village,165,41,76,13,0,6,136
Arizona,Topawa,268,84,32,20,12,6,154
Arizona,Topock,14,0,0,14,0,0,14
Arizona,Top-of-the-World,217,94,69,41,0,0,204
Arizona,Toyei,0,0,0,0,0,0,0
Arizona,Truxton,191,51,54,24,0,20,149
Arizona,Tsaile,1198,623,181,43,12,24,883
Arizona,Tubac,1249,61,804,174,0,164,1203
Arizona,Tuba City,9772,3925,2360,451,131,276,7143
Arizona,Tucson,528374,179266,154721,62244,10639,24869,431739
Arizona,Tucson Estates,12079,2469,5237,1473,352,943,10474
Arizona,Tumacacori-Carmen,420,41,239,59,0,0,339
Arizona,Turkey Creek,405,106,82,36,0,11,235
Arizona,Tusayan,355,172,113,21,20,0,326
Arizona,Upper Santan Village,470,243,93,31,0,20,387
Arizona,Utting,120,14,88,0,0,0,102
Arizona,Vail,11143,1726,5645,688,78,244,8381
Arizona,Vaiva Vo,36,30,0,0,0,0,30
Arizona,Valencia West,10331,2408,3749,1019,198,261,7635
Arizona,White Mountain Lake,2241,513,859,333,26,133,1864
Arizona,Whiteriver,4766,1846,903,373,72,207,3401
Arizona,Why,184,37,71,30,14,20,172
Arizona,Wickenburg,6620,1005,2959,966,169,586,5685
Arizona,Peach Springs,1010,397,163,90,8,48,706
Arizona,Peeples Valley,523,45,258,55,4,40,402
Arizona,Peoria,163664,35516,67348,16740,1979,7859,129442
Arizona,Peridot,1687,617,405,109,20,39,1190
Arizona,Phoenix,1514208,457700,488319,149164,28143,49646,1172972
Arizona,Picacho,296,63,141,47,16,5,272
Arizona,Guadalupe,6012,1986,1441,522,100,362,4411
Arizona,Pima,2440,362,1001,200,11,107,1681
Arizona,Pimaco Two,435,8,330,28,0,69,435
Arizona,Pinal,486,100,104,55,0,33,292
Arizona,Pine,1147,107,870,88,0,55,1120
Arizona,Pinedale,588,95,231,40,0,37,403
Arizona,Pine Lake,73,16,42,15,0,0,73
Arizona,Pinetop Country Club,1635,138,1079,114,8,132,1471
Arizona,Six Shooter Canyon,985,234,355,103,20,76,788
Arizona,Snowflake,5604,974,2252,370,18,170,3784
Arizona,So-Hi,197,65,72,29,0,31,197
Arizona,Solomon,260,25,135,22,0,19,201
Arizona,Somerton,14845,3220,5682,667,239,470,10278
Arizona,Payson,15248,2032,8000,1854,238,1313,13437
Arizona,Sierra Vista Southeast,15128,2499,7610,1468,144,855,12576
Arizona,Paulden,4277,365,2182,544,139,193,3423
Arizona,Parks,1462,224,794,200,30,39,1287
Arizona,Wide Ruins,125,62,41,22,0,0,125
Arizona,Wikieup,150,24,74,24,0,10,132
Arizona,Wilhoit,912,156,468,127,9,58,818
Arizona,Willcox,3639,799,1354,458,36,220,2867
Arizona,Williams,3065,640,1329,200,22,167,2358
Arizona,Williamson,5531,767,3689,450,68,190,5164
Arizona,Willow Canyon,0,0,0,0,0,0,0
Arizona,Willow Valley,872,159,315,122,29,167,792
Arizona,Window Rock,3255,1579,722,149,51,127,2628
Arizona,Winkelman,327,144,96,17,0,42,299
Arizona,Winslow,9530,3413,2310,974,239,488,7424
Arizona,Winslow West,518,166,113,28,0,0,307
Arizona,Wintersburg,97,37,51,0,0,9,97
Arizona,Wittmann,456,133,225,17,0,0,375
Arizona,Woodruff,132,0,132,0,0,0,132
Arizona,Yarnell,543,6,310,137,6,62,521
Arizona,York,881,209,351,79,0,47,686
Arizona,Young,456,30,232,89,11,67,429
Arizona,Cactus Flats,1356,259,554,159,29,50,1051
Arizona,Patagonia,708,136,284,119,15,69,623
Arizona,Sierra Vista,44892,9576,19089,3641,672,1958,34936
Arizona,Show Low,10768,1836,4638,1124,291,660,8549
Arizona,Shonto,546,138,179,38,27,10,392
Arizona,Salome,1421,192,789,100,0,64,1145
Arizona,San Carlos,4314,1401,954,385,30,165,2935
Arizona,Sanders,606,193,117,14,18,7,349
Arizona,San Jose,728,154,188,75,8,26,451
Arizona,Burnside,543,266,85,34,6,30,421
Arizona,Bullhead City,39424,8013,15878,5315,936,3372,33514
Arizona,Buckshot,14,0,14,0,0,0,14
Arizona,Buckeye,57165,14377,21556,4638,715,1773,43059
Arizona,Bryce,72,23,18,0,0,0,41
Arizona,Brenda,429,18,359,43,0,9,429
Arizona,Bowie,366,59,207,27,8,31,332
Arizona,Bouse,711,99,337,126,10,94,666
Arizona,Bluewater,710,119,360,104,0,57,640
Arizona,Blackwater,1247,618,114,65,50,75,922
Arizona,Black Canyon City,2325,594,814,500,76,221,2205
Arizona,Bitter Springs,443,217,101,17,0,34,369
Arizona,Bisbee,5415,1108,1702,1107,92,483,4492
Arizona,Beyerville,286,113,53,18,19,0,203
Arizona,Benson,5013,819,2234,669,8,487,4217
Arizona,St. Michaels,1483,586,409,153,17,0,1165
Arizona,Beaver Valley,175,10,146,9,0,10,175
Arizona,St. Johns,633,265,120,16,0,50,451
Arizona,Parker Strip,572,27,372,75,6,76,556
Arizona,Tolleson,6806,1716,2257,565,281,377,5196
Arizona,Tombstone,1510,250,662,187,12,193,1304
Arizona,Tonalea,331,106,76,13,4,25,224
Arizona,Tonopah,19,0,19,0,0,0,19
Arizona,Tonto Basin,1394,181,668,184,23,187,1243
Arizona,North Fork,1701,413,639,153,19,16,1240
Arizona,Nutrioso,74,28,46,0,0,0,74
Arizona,Oak Springs,83,18,28,1,0,0,47
Arizona,Oatman,120,52,68,0,0,0,120
Arizona,Oljato-Monument Valley,250,88,71,0,0,12,171
Arizona,Oracle,3756,769,1862,465,126,144,3366
Arizona,Orange Grove Mobile Manor,685,158,284,6,86,28,562
Arizona,Oro Valley,41965,7709,22040,3482,468,2399,36098
Arizona,Oxbow Estates,103,20,34,26,0,12,92
Arizona,Padre Ranchitos,142,62,7,3,0,5,77
Arizona,Page,7429,2219,2718,509,44,75,5565
Arizona,Palominas,453,51,18,95,0,26,190
Arizona,Paradise Valley,13477,1661,8000,882,31,719,11293
Arizona,Parker,3068,891,1046,332,20,117,2406
Arizona,St. Johns,3512,749,1474,238,82,201,2744
Arizona,Sonoita,958,180,482,161,0,60,883
Arizona,Beaver Dam,1622,232,901,175,101,50,1459
Arizona,Bagdad,1913,321,875,85,0,13,1294
Arizona,Aguila,1066,358,569,22,0,4,953
Arizona,San Luis,30658,8478,11751,1170,616,713,22728
Arizona,San Manuel,4028,793,1365,461,67,179,2865
Arizona,San Miguel,253,116,51,23,0,10,200
Arizona,San Simon,131,10,42,35,6,10,103
Arizona,Santa Cruz,0,0,0,0,0,0,0
Arizona,San Tan Valley,87923,19003,33483,6312,878,2088,61764
Arizona,Santa Rosa,562,285,65,50,3,17,420
Arizona,Sawmill,633,295,112,25,9,34,475
Arizona,Scenic,1699,193,786,108,0,137,1224
Arizona,Scottsdale,227471,56044,100404,26184,1876,11817,196325
Arizona,Seba Dalkai,115,62,24,0,4,11,101
Arizona,Second Mesa,1296,493,245,63,81,70,952
Arizona,Sedona,10204,1847,5150,1448,254,637,9336
Arizona,Sehili,119,57,27,0,3,0,87
Arizona,Seligman,457,71,253,32,9,41,406
Arizona,Sells,2160,818,476,124,39,118,1575
Arizona,Seven Mile,831,321,160,55,31,35,602
Arizona,Shongopovi,997,459,96,94,11,48,708
Arizona,Ajo,3886,997,1287,386,79,334,3083
Arizona,Bear Flat,9,0,9,0,0,0,9
Arizona,Ak Chin,33,15,14,0,4,0,33
Arizona,Alamo Lake,4,0,4,0,0,0,4
Arizona,Aztec,2,0,0,2,0,0,2
Arizona,Avra Valley,4736,982,2050,856,71,280,4239
Arizona,Avondale,78872,22676,26120,6796,1350,1739,58681
Arizona,Avenue B and C,3798,1071,1153,361,160,183,2928
Arizona,Ash Fork,650,226,120,41,17,44,448
Arizona,Arlington,77,4,67,0,0,0,71
Arizona,Arizona Village,929,241,152,183,45,89,710
Arizona,Arizona City,8969,2412,2699,1244,165,430,6950
Arizona,Arivaca Junction,868,224,335,36,8,30,633
Arizona,Arivaca,587,46,319,139,16,42,562
Arizona,Apache Junction,36586,5892,15863,5425,575,2654,30409
Arizona,Anthem,22995,3435,11140,1725,198,521,17019
Arizona,Antares,113,17,43,30,0,20,110
Arizona,Anegam,79,40,24,7,0,3,74
Arizona,Amado,165,0,137,0,22,6,165
Arizona,Alpine,95,7,43,27,15,3,95
Arizona,Ali Molina,131,47,18,10,0,9,84
Arizona,Ali Chukson,108,65,16,0,0,17,98
Arizona,Ali Chuk,149,96,0,10,0,9,115
Arizona,Ak-Chin Village,1193,434,221,126,26,47,854
Arizona,South Komelik,73,44,0,8,0,10,62
Arizona,Picture Rocks,8666,1575,3728,1011,132,599,7045
Arizona,Springerville,1995,361,705,280,34,90,1470
Arizona,East Fork,709,220,175,59,7,88,549
Arizona,Rock House,14,0,0,0,0,14,14
Arizona,Rock Point,525,169,126,22,10,13,340
Arizona,Roosevelt,61,11,41,4,0,5,61
Arizona,Rough Rock,553,220,102,28,24,19,393
Arizona,Round Rock,882,301,212,37,18,32,600
Arizona,Round Valley,599,104,305,71,0,23,503
Arizona,Rye,88,11,59,17,0,1,88
Arizona,Sacate Village,135,62,30,0,0,0,92
Arizona,Sacaton,2667,1372,442,204,78,146,2242
Arizona,Sacaton Flats Village,422,133,138,21,0,0,292
Arizona,Saddlebrooke,9790,618,7237,768,14,782,9419
Arizona,Safford,9636,2207,3594,933,105,668,7507
Arizona,Sahuarita,25430,3825,11830,2028,224,640,18547
Arizona,St. David,1564,237,555,169,0,156,1117
Arizona,Cactus Forest,518,122,174,59,0,38,393
Arizona,Campo Bonito,18,0,0,18,0,0,18
Arizona,Camp Verde,11008,2581,4405,1346,64,933,9329
Arizona,Cane Beds,569,57,128,103,11,0,299
Arizona,Canyon Day,1310,400,383,81,3,29,896
Arizona,Carefree,3491,622,2137,291,0,365,3415
Arizona,Carrizo,208,60,31,41,0,14,146
Arizona,Casa Blanca,1623,728,225,198,25,56,1232
Arizona,Casa Grande,49796,10603,19341,5329,816,2526,38615
Arizona,Casas Adobes,68862,15355,28261,8395,765,3908,56684
Arizona,Eagar,4930,843,1666,445,183,190,3327
Arizona,Duncan,683,143,280,77,8,70,578
Arizona,Dudleyville,336,64,155,82,0,12,313
Arizona,Drysdale,223,58,71,16,0,11,156
Arizona,Tempe,169816,81365,44294,15400,1636,5036,147731
Arizona,Thatcher,4935,1365,1790,235,31,255,3676
Arizona,Theba,102,10,52,8,0,0,70
Arizona,Three Points,5033,1118,1947,746,76,324,4211
Arizona,Tolani Lake,344,104,80,12,9,27,232
Arizona,Pinetop-Lakeside,4306,763,2118,507,45,146,3579
Arizona,Pinion Pines,248,41,166,19,0,22,248
Arizona,Pinon,836,231,244,49,17,43,584
Arizona,Pirtleville,1794,581,577,112,75,68,1413
Arizona,Pisinemo,447,191,68,5,10,30,304
Arizona,South Tucson,5686,1941,1226,706,176,258,4307
Arizona,Prescott,40700,8682,17975,5828,497,3560,36542
Arizona,Catalina,7456,1712,3382,680,49,367,6190
Arizona,Prescott Valley,40258,8174,17093,4873,314,2037,32491
Arizona,Queen Creek,30143,4456,12951,1829,218,511,19965
Arizona,Queen Valley,689,18,554,38,0,79,689
Arizona,Rainbow City,1102,430,197,108,0,28,763
Arizona,Rancho Mesa Verde,619,183,191,0,62,44,480
Arizona,Red Mesa,222,87,63,17,5,12,184
Arizona,Red Rock CDP (Apache County),223,128,45,5,2,2,182
Arizona,Red Rock CDP (Pinal County),2169,529,776,207,10,14,1536
Arizona,Rillito,297,79,102,11,0,0,192
Arizona,Rincon Valley,5103,965,2529,274,0,191,3959
Arizona,Rio Rico,18760,3938,8210,1125,249,369,13891
Arizona,Rio Verde,2114,110,1773,82,0,149,2114
Arizona,Dripping Springs,103,11,66,21,0,1,99
Arizona,Quartzsite,3665,215,2425,108,166,748,3662
Arizona,Catalina Foothills,50940,10246,25881,4868,691,2901,44587
Arizona,Cave Creek,5122,823,2925,607,21,207,4583
Arizona,Cedar Creek,416,106,113,30,0,18,267
Arizona,Fort Mohave,13686,1789,6883,1516,345,1201,11734
Arizona,Fort Thomas,481,76,151,19,27,19,292
Arizona,Fortuna Foothills,27487,3302,16026,2193,320,2158,23999
Arizona,Fort Valley,1105,270,365,270,0,16,921
Arizona,Fountain Hills,23322,3929,12890,2555,113,1559,21046
Arizona,Franklin,34,4,9,9,0,0,22
Arizona,Fredonia,1688,411,695,151,0,60,1317
Arizona,Freedom Acres,57,11,34,4,0,4,53
Arizona,Gadsden,579,98,240,40,25,36,439
Arizona,Ganado,1007,341,248,52,18,47,706
Arizona,Geronimo Estates,160,0,71,0,0,0,71
Arizona,Gila Bend,1725,396,602,144,11,94,1247
Arizona,Fort Defiance,4005,1877,785,199,28,133,3022
Arizona,Gila Crossing,748,307,145,43,11,20,526
Arizona,Gisela,652,115,191,105,14,68,493
Arizona,Glendale,234844,67267,79359,23215,4435,8909,183185
Arizona,Globe,7430,1721,2797,935,229,413,6095
Arizona,Gold Canyon,9597,1047,6349,884,16,839,9135
Arizona,Golden Shores,1460,251,643,187,25,197,1303
Arizona,Golden Valley,8946,1714,4004,1314,186,815,8033
Arizona,Goodyear,72880,16155,33065,4944,529,2247,56940
Arizona,Goodyear Village,407,186,98,21,26,6,337
Arizona,Grand Canyon Village,1504,717,497,161,94,16,1485
Arizona,Grand Canyon West,0,0,0,0,0,0,0
Arizona,Greasewood,519,157,139,32,7,23,358
Arizona,Green Valley,22419,1337,14622,2288,201,3618,22066
Arizona,Gilbert,230781,47291,97122,17696,2053,4657,168819
Arizona,Tees Toh,445,158,122,30,17,31,358
Arizona,Fort Apache,135,44,53,0,0,0,97
Arizona,Flowing Springs,61,14,20,16,0,11,61
Arizona,Centennial Park,1411,421,335,17,17,0,790
Arizona,Central,406,31,209,26,0,28,294
Arizona,Drexel Heights,28233,7637,9778,2431,582,1049,21477
Arizona,Dragoon,108,19,32,35,0,22,108
Arizona,Douglas,16911,7297,3940,2197,350,658,14442
Arizona,Donovan Estates,1313,250,598,69,36,31,984
Arizona,Doney Park,5944,1186,2678,672,83,64,4683
Arizona,Dolan Springs,2050,386,916,268,41,240,1851
Arizona,Dilkon,1268,382,340,67,23,74,886
Arizona,Dewey-Humboldt,3928,561,2313,365,45,155,3439
Arizona,Desert Hills,2602,228,1435,260,53,279,2255
Arizona,Dennehotso,752,301,204,16,19,22,562
Arizona,Flowing Wells,16078,3923,5517,2668,249,867,13224
Arizona,Del Muerto,411,122,103,96,0,16,337
Arizona,East Verde Estates,232,0,89,67,0,24,180
Arizona,Ehrenberg,979,266,423,92,61,38,880
Arizona,El Capitan,131,30,65,0,0,0,95
Arizona,Elephant Head,650,113,369,32,0,48,562
Arizona,Elfrida,383,56,184,39,0,22,301
Arizona,Elgin,184,27,130,0,0,0,157
Arizona,El Mirage,33010,8272,10869,3504,436,852,23933
Arizona,Eloy,16954,7131,4323,2087,370,506,14417
Arizona,El Prado Estates,415,111,121,31,0,24,287
Arizona,First Mesa,1739,557,403,125,42,101,1228
Arizona,Flagstaff,68375,30513,19378,5494,590,1306,57281
Arizona,Florence,30770,10416,10367,5043,452,1268,27546
Arizona,East Globe,143,12,99,0,0,0,111
Arizona,Teec Nos Pos,643,309,183,29,9,10,540
Arizona,Poston,370,135,110,30,4,34,313
Arizona,Steamboat,270,91,78,12,0,12,193
Arizona,Swift Trail Junction,3323,719,1253,507,144,54,2677
Arizona,Sweet Water Village,372,238,55,0,26,20,339
Arizona,Surprise,123813,20270,56539,11899,1037,5569,95314
Arizona,Superior,2868,667,897,499,67,196,2326
Arizona,Supai,10,0,7,0,0,3,10
Arizona,Sunwest,3,0,0,0,0,3,3
Arizona,Sun Valley,280,49,138,39,44,10,280
Arizona,Tacna,706,151,323,32,18,20,544
Arizona,Sun Lakes,14378,878,9919,1112,109,2231,14249
Arizona,Sun City West,24338,1303,15665,2327,52,4991,24338
Arizona,Sun City,39111,2642,21496,5999,512,8221,38870
Arizona,Summit,5097,1232,1885,309,86,183,3695
Arizona,Summerhaven,151,0,64,0,0,0,64
Arizona,Spring Valley,1470,187,746,206,29,82,1250
Arizona,Stanfield,232,49,114,69,0,0,232
Arizona,Star Valley,2090,192,937,269,161,261,1820
Arizona,Sunizona,200,48,67,51,0,13,179
Arizona,Tanque Verde,16748,2597,9762,1126,46,888,14419
Arizona,Tat Momoli,50,19,0,0,0,31,50
Arizona,Taylor,4118,831,1658,568,71,88,3216
Arizona,Strawberry,430,145,164,30,0,91,430
Arizona,Stotonic Village,466,137,141,0,37,37,352
Arkansas,Belleville,359,69,168,30,1,8,276
Arkansas,Reader,18,0,0,8,0,10,18
Arkansas,Quitman,806,156,308,112,16,42,634
Arkansas,Sulphur Springs,1065,224,597,92,12,101,1026
Arkansas,Summit,507,90,175,95,21,59,440
Arkansas,Sunset,171,67,37,2,5,8,119
Arkansas,Sweet Home,579,185,39,153,17,63,457
Arkansas,Ben Lomond,108,13,48,11,2,23,97
Arkansas,Bauxite,546,73,193,93,6,66,431
Arkansas,Benton,32725,5998,13128,4374,451,1603,25554
Arkansas,Beaver,80,13,37,16,1,6,73
Arkansas,Beebe,7851,1779,2565,1178,207,393,6122
Arkansas,Beedeville,137,10,31,20,15,16,92
Arkansas,Bella Vista,27606,3391,16358,2242,74,1609,23674
Arkansas,Bellefonte,513,118,236,55,4,18,431
Arkansas,Bay,1973,375,875,195,11,113,1569
Arkansas,Bearden,934,175,360,88,9,29,661
Arkansas,Almyra,345,75,139,41,4,19,278
Arkansas,Warren,5852,1374,1952,618,233,534,4711
Arkansas,Tuckerman,2257,418,981,239,23,163,1824
Arkansas,Trumann,7179,1284,2574,1014,151,445,5468
Arkansas,Traskwood,401,85,128,92,5,38,348
Arkansas,Tontitown,2625,440,1401,208,24,68,2141
Arkansas,Tollette,325,94,123,40,13,23,293
Arkansas,Tinsman,37,4,26,0,0,6,36
Arkansas,Tull,631,107,304,46,5,30,492
Arkansas,Tillar,248,27,129,6,8,15,185
Arkansas,Texarkana,30127,7042,9920,3811,1135,1977,23885
Arkansas,Taylor,610,104,247,53,7,58,469
Arkansas,Swifton,687,106,315,80,24,54,579
Arkansas,Ravenden Springs,223,9,170,13,0,11,203
Arkansas,Ravenden,444,85,178,92,16,25,396
Arkansas,Ratcliff,183,30,91,19,6,18,164
Arkansas,Thornton,592,163,201,63,9,53,489
Arkansas,Tumbling Shoals,1148,261,510,111,12,58,952
Arkansas,Tupelo,179,31,81,22,3,18,155
Arkansas,Turrell,430,159,128,40,12,44,383
Arkansas,Ward,4478,931,1961,404,60,87,3443
Arkansas,Walnut Ridge,4755,826,1729,652,121,457,3785
Arkansas,Waldron,3505,650,1326,401,68,140,2585
Arkansas,Waldo,1279,343,311,155,63,104,976
Arkansas,Waldenburg,88,0,61,6,0,11,78
Arkansas,Wabbaseka,262,49,89,40,9,14,201
Arkansas,Viola,386,73,156,27,6,28,290
Arkansas,Vilonia,4214,748,1769,484,0,180,3181
Arkansas,Victoria,48,4,26,0,0,0,30
Arkansas,Vandervoort,80,6,31,5,4,4,50
Arkansas,Van Buren,22992,4107,9556,2351,248,1278,17540
Arkansas,Valley Springs,214,36,96,13,2,9,156
Arkansas,Ulm,213,48,83,18,0,23,172
Arkansas,Tyronza,1003,220,369,112,35,44,780
Arkansas,Twin Groves,385,90,143,63,12,18,326
Arkansas,Rector,2016,238,847,255,39,161,1540
Arkansas,Redfield,1598,379,638,142,18,81,1258
Arkansas,Reed,130,55,21,6,6,31,119
Arkansas,Reyno,417,79,177,59,13,22,350
Arkansas,Avoca,619,153,229,86,5,12,485
Arkansas,Bald Knob,2902,345,1202,478,92,206,2323
Arkansas,Banks,129,35,29,35,4,22,125
Arkansas,Barling,4738,653,1994,765,133,412,3957
Arkansas,Bassett,193,42,58,23,2,17,142
Arkansas,Batesville,10479,2716,4075,811,186,663,8451
Arkansas,Searcy,23782,7485,8628,1671,407,1381,19572
Arkansas,Sedgwick,147,13,71,16,6,3,109
Arkansas,Shannon Hills,3497,630,1448,506,72,91,2747
Arkansas,Sheridan,4763,857,1989,550,50,197,3643
Arkansas,Sherrill,84,7,42,1,3,5,58
Arkansas,Sherwood,30210,6853,12290,3317,488,1254,24202
Arkansas,Shirley,342,57,154,40,3,15,269
Arkansas,Sidney,181,28,104,15,0,4,151
Arkansas,Siloam Springs,15832,3577,6115,1216,183,787,11878
Arkansas,Avilla,812,87,473,123,8,0,691
Arkansas,Austin,2823,272,1499,153,17,47,1988
Arkansas,Augusta,2420,570,740,307,117,215,1949
Arkansas,Aubrey,175,68,54,11,0,24,157
Arkansas,Alma,5537,818,2473,435,166,262,4154
Arkansas,Allport,228,65,60,6,5,8,144
Arkansas,Alicia,142,31,70,7,8,6,122
Arkansas,Alexander,2809,617,848,336,58,138,1997
Arkansas,Adona,132,16,59,15,7,13,110
Arkansas,Altheimer,957,263,316,67,31,72,749
Arkansas,Altus,861,143,333,82,35,79,672
Arkansas,Smackover,1764,287,806,197,34,121,1445
Arkansas,Amagon,88,17,32,19,0,9,77
Arkansas,Anthonyville,237,36,145,24,3,11,219
Arkansas,Antoine,92,20,34,18,2,13,87
Arkansas,Arkadelphia,10721,5244,2516,654,119,703,9236
Arkansas,Arkansas City,534,149,191,50,30,34,454
Arkansas,Ashdown,4565,867,1527,554,162,412,3522
Arkansas,Ash Flat,1087,217,431,144,25,157,974
Arkansas,Atkins,3042,535,1355,253,14,259,2416
Arkansas,Amity,768,133,316,63,20,48,580
Arkansas,Smithville,98,22,48,11,0,1,82
Arkansas,South Lead Hill,117,29,47,21,1,2,100
Arkansas,Southside,2517,375,758,441,111,184,1869
Arkansas,St. Joe,151,18,68,15,1,25,127
Arkansas,St. Francis,194,23,77,31,9,2,142
Arkansas,St. Charles,294,61,138,26,8,32,265
Arkansas,Rye,156,32,37,18,13,3,103
Arkansas,Russellville,28738,8588,9686,2993,388,1197,22852
Arkansas,Russell,220,40,86,33,10,19,188
Arkansas,Rudy,94,20,29,19,3,1,72
Arkansas,St. Paul,106,18,60,13,0,1,92
Arkansas,Rosston,454,80,151,20,5,11,267
Arkansas,Rondo,257,83,48,21,24,34,210
Arkansas,Roland,548,76,315,12,0,120,523
Arkansas,Rogers,60384,12394,25440,4765,500,2547,45646
Arkansas,Roe,110,13,63,7,0,4,87
Arkansas,Rockwell,3763,513,1818,283,53,297,2964
Arkansas,Rockport,913,124,374,119,19,62,698
Arkansas,Rison,1175,323,317,84,10,165,899
Arkansas,Rose Bud,498,92,221,39,17,24,393
Arkansas,Alpena,443,80,137,51,28,31,327
Arkansas,Salem,1763,315,601,310,38,180,1444
Arkansas,Salesville,409,45,200,55,0,40,340
Arkansas,Sparkman,413,32,220,44,15,24,335
Arkansas,Springdale,75088,15663,28330,5990,1221,2452,53656
Arkansas,Springtown,90,17,37,21,0,11,86
Arkansas,Stamps,1840,572,487,250,57,143,1509
Arkansas,Star City,2362,399,891,159,53,240,1742
Arkansas,Staves,180,8,113,13,0,10,144
Arkansas,Stephens,1012,326,369,52,10,85,842
Arkansas,Salem,2621,308,1205,341,85,78,2017
Arkansas,Strawberry,409,56,140,80,0,31,307
Arkansas,Stuttgart,9195,1948,3312,1098,277,572,7207
Arkansas,Subiaco,534,240,152,47,8,31,478
Arkansas,Success,119,23,37,25,7,8,100
Arkansas,Sulphur Rock,398,63,133,75,6,23,300
Arkansas,Sulphur Springs,377,71,131,41,24,19,286
Arkansas,Scranton,198,31,62,34,17,5,149
Arkansas,Scott,29,0,23,0,0,6,29
Arkansas,Strong,426,104,136,60,0,61,361
Arkansas,Pyatt,196,44,85,13,0,4,146
Arkansas,Hensley,30,12,0,13,0,5,30
Arkansas,Prattsville,418,77,179,27,16,20,319
Arkansas,Earle,2134,781,519,192,98,102,1692
Arkansas,Dyess,397,100,138,24,7,23,292
Arkansas,Dyer,725,128,429,56,4,14,631
Arkansas,Dumas,4482,1164,1219,539,216,326,3464
Arkansas,Dover,1413,420,507,191,13,68,1199
Arkansas,Donaldson,304,73,126,37,4,13,253
Arkansas,Montrose,360,73,97,43,10,7,230
Arkansas,Moorefield,202,17,111,12,0,11,151
Arkansas,Moro,266,39,97,42,8,23,209
Arkansas,Morrilton,6746,1548,2143,886,102,560,5239
Arkansas,Morrison Bluff,55,16,17,4,1,1,39
Arkansas,Mountainburg,531,101,199,82,14,31,427
Arkansas,Mountain Home,12309,1844,5382,1705,218,1149,10298
Arkansas,Mountain Pine,816,184,284,118,6,56,648
Arkansas,Mountain View,2817,515,1000,333,66,524,2438
Arkansas,Mount Ida,1191,195,538,97,65,110,1005
Arkansas,Mount Pleasant,360,30,203,45,0,33,311
Arkansas,Mount Vernon,164,39,80,12,1,11,143
Arkansas,Mulberry,1703,249,602,259,64,147,1321
Arkansas,Murfreesboro,1639,271,519,324,26,155,1295
Arkansas,Nashville,4558,1146,1379,522,73,304,3424
Arkansas,East Camden,1070,303,336,98,12,63,812
Arkansas,East End,7248,1417,3397,570,83,276,5743
Arkansas,Edmondson,265,133,43,22,21,12,231
Arkansas,Egypt,111,14,30,27,0,4,75
Arkansas,Fordyce,4174,1053,1436,319,207,359,3374
Arkansas,Flippin,1516,282,548,218,47,114,1209
Arkansas,Fisher,342,64,150,23,8,9,254
Arkansas,Fifty-Six,204,30,80,47,1,25,183
Arkansas,Felsenthal,69,8,45,12,0,3,68
Arkansas,Fayetteville,79037,32202,24309,7538,449,2793,67291
Arkansas,Farmington,6336,834,3230,428,67,232,4791
Arkansas,Fargo,120,42,34,9,8,8,101
Arkansas,Fairfield Bay,2382,141,1212,361,18,325,2057
Arkansas,Everton,207,9,113,30,0,8,160
Arkansas,Natural Steps,372,69,236,20,18,0,343
Arkansas,Evening Shade,465,67,182,69,17,43,378
Arkansas,Eudora,2132,819,570,184,62,131,1766
Arkansas,Etowah,321,40,140,44,1,16,241
Arkansas,Enola,407,65,165,46,4,20,300
Arkansas,England,2794,588,746,296,116,296,2042
Arkansas,Emmet,584,137,192,74,6,37,446
Arkansas,Emerson,319,86,98,52,6,13,255
Arkansas,Elm Springs,2136,319,1046,146,7,136,1654
Arkansas,Elkins,2832,471,1213,297,12,144,2137
Arkansas,El Dorado,18480,4219,6089,2288,457,1389,14442
Arkansas,Elaine,722,225,186,12,6,66,495
Arkansas,Eureka Springs,2054,415,749,503,15,165,1847
Arkansas,Newark,1470,253,538,185,47,111,1134
Arkansas,New Blaine,179,7,136,0,0,9,152
Arkansas,New Edinburg,399,91,229,18,0,0,338
Arkansas,Parkdale,287,108,50,25,16,18,217
Arkansas,Parkin,907,192,328,65,50,125,760
Arkansas,Patmos,82,21,29,1,2,11,64
Arkansas,Patterson,459,117,143,68,16,31,375
Arkansas,Peach Orchard,98,11,47,14,0,14,86
Arkansas,Pea Ridge,5046,738,2571,464,0,220,3993
Arkansas,Perla,321,113,65,30,8,24,240
Arkansas,Perry,265,76,103,33,15,10,237
Arkansas,Perrytown,342,65,136,28,6,23,258
Arkansas,Perryville,1636,294,594,160,24,111,1183
Arkansas,Paris,3482,761,1076,683,42,364,2926
Arkansas,Piggott,3713,931,1176,581,0,473,3161
Arkansas,Pine Bluff,46228,15586,12123,4834,1430,2665,36638
Arkansas,Prescott,3221,629,1071,414,55,273,2442
Arkansas,Piney,4073,808,1354,896,78,368,3504
Arkansas,Plainview,553,62,303,35,5,17,422
Arkansas,Pleasant Plains,324,75,142,23,7,27,274
Arkansas,Plumerville,1052,336,373,112,11,38,870
Arkansas,Pocahontas,6516,1275,2494,990,135,487,5381
Arkansas,Pollard,208,20,120,6,4,8,158
Arkansas,Portia,591,104,206,105,12,63,490
Arkansas,Portland,427,84,206,32,2,42,366
Arkansas,Pindall,147,14,58,21,9,23,125
Arkansas,Foreman,1242,317,469,141,44,103,1074
Arkansas,Paragould,27228,4977,10936,3200,702,1654,21469
Arkansas,Palestine,688,153,279,70,8,59,569
Arkansas,Newport,7782,2316,1812,1466,330,761,6685
Arkansas,Nimmons,47,10,17,9,0,5,41
Arkansas,Norfork,545,72,296,55,17,23,463
Arkansas,Norman,329,70,116,62,0,25,273
Arkansas,Norphlet,835,142,370,88,17,26,643
Arkansas,North Crossett,2898,225,1585,252,69,162,2293
Arkansas,North Little Rock,65538,17950,19725,7849,1270,3239,50033
Arkansas,Oak Grove,425,70,168,54,24,48,364
Arkansas,Oak Grove Heights,902,147,415,91,19,31,703
Arkansas,Oakhaven,59,4,26,14,3,0,47
Arkansas,Pangburn,643,97,268,64,21,40,490
Arkansas,Oden,240,42,115,15,7,4,183
Arkansas,Oil Trough,250,51,83,29,5,21,189
Arkansas,O'Kean,194,27,94,18,5,18,162
Arkansas,Okolona,139,14,85,14,0,13,126
Arkansas,Ola,1284,295,339,238,59,175,1106
Arkansas,Omaha,198,32,63,40,5,3,143
Arkansas,Oppelo,826,112,358,108,12,47,637
Arkansas,Osceola,7424,1807,2301,871,332,372,5683
Arkansas,Oxford,636,107,276,101,0,48,532
Arkansas,Ozan,71,10,29,10,0,11,60
Arkansas,Ozark,3623,662,1241,545,157,298,2903
Arkansas,Ogden,144,30,77,1,0,19,127
Arkansas,Forrest City,14999,5217,3258,2194,690,727,12086
Arkansas,Fort Smith,87603,20865,31661,10046,2252,4463,69287
Arkansas,Fouke,783,179,287,140,1,31,638
Arkansas,Highfill,635,88,298,73,8,31,498
Arkansas,Highland,999,166,529,64,28,45,832
Arkansas,Hindsville,36,3,29,4,0,0,36
Arkansas,Holiday Island,2596,238,1350,310,0,332,2230
Arkansas,Holland,651,137,289,87,7,28,548
Arkansas,Holly Grove,677,246,114,54,40,67,521
Arkansas,Hope,10001,2342,2894,871,299,681,7087
Arkansas,Horatio,1117,220,394,112,20,55,801
Arkansas,Horseshoe Bend,2178,336,1031,256,38,321,1982
Arkansas,Horseshoe Lake,248,48,104,46,6,31,235
Arkansas,Higginson,768,101,397,66,6,17,587
Arkansas,Hot Springs,35539,8424,11665,5260,893,3042,29284
Arkansas,Houston,265,51,129,37,2,2,221
Arkansas,Hoxie,2719,615,1030,333,77,215,2270
Arkansas,Hughes,1700,594,309,165,45,130,1243
Arkansas,Humnoke,225,51,67,19,10,25,172
Arkansas,Humphrey,489,143,184,53,6,64,450
Arkansas,Hunter,99,19,52,15,0,5,91
Arkansas,Huntington,609,154,215,59,40,45,513
Arkansas,Huntsville,2348,375,864,257,29,180,1705
Arkansas,Huttig,561,101,230,53,21,51,456
Arkansas,Imboden,565,56,210,136,16,59,477
Arkansas,Hot Springs Village,13477,895,9667,1001,65,1313,12941
Arkansas,Jacksonport,134,13,68,18,0,11,110
Arkansas,Higden,137,12,72,14,0,15,113
Arkansas,Grubbs,465,76,179,60,12,32,359
Arkansas,Helena-West Helena,11546,3596,2413,1258,502,760,8529
Arkansas,Hector,517,109,225,54,0,44,432
Arkansas,Heber Springs,7187,1309,2860,1058,189,366,5782
Arkansas,Hazen,1478,193,597,168,43,179,1180
Arkansas,Haynes,188,57,45,26,5,19,152
Arkansas,Havana,244,45,113,31,4,16,209
Arkansas,Hatfield,449,76,166,64,12,36,354
Arkansas,Haskell,4323,821,1637,733,99,60,3350
Arkansas,Hartman,594,142,242,55,23,22,484
Arkansas,Hartford,498,99,220,61,5,42,427
Arkansas,Hickory Ridge,233,49,117,26,0,14,206
Arkansas,Harrison,13131,2429,4876,1856,168,931,10260
Arkansas,Harrell,320,99,120,20,5,36,280
Arkansas,Hardy,702,140,247,129,21,88,625
Arkansas,Hampton,1340,242,517,218,0,123,1100
Arkansas,Hamburg,2819,570,1076,315,94,204,2259
Arkansas,Hagarville,265,9,191,0,0,0,200
Arkansas,Hackett,833,141,287,119,43,49,639
Arkansas,Guy,761,125,364,53,3,13,558
Arkansas,Gurdon,2206,477,895,176,50,109,1707
Arkansas,Gum Springs,141,32,43,28,5,4,112
Arkansas,Guion,112,20,47,7,5,9,88
Arkansas,Harrisburg,2329,498,867,174,62,241,1842
Arkansas,Pottsville,3030,517,1371,266,36,84,2274
Arkansas,Jacksonville,28726,7438,9462,3129,700,1267,21996
Arkansas,Jennette,130,43,42,20,0,15,120
Arkansas,Gosnell,3401,601,1423,254,70,90,2438
Arkansas,Goshen,1525,169,824,44,16,44,1097
Arkansas,Glenwood,2376,438,951,320,41,179,1929
Arkansas,Gilmore,233,46,109,50,5,7,217
Arkansas,Gillham,265,32,108,25,0,18,183
Arkansas,Gillett,682,132,275,97,16,40,560
Arkansas,Gilbert,32,10,19,1,0,2,32
Arkansas,Gibson,4417,836,1800,620,91,139,3486
Arkansas,Georgetown,83,13,52,4,2,5,76
Arkansas,Gentry,3336,491,1426,340,64,190,2511
Arkansas,Gould,764,274,134,45,21,50,524
Arkansas,Gateway,406,69,169,45,6,21,310
Arkansas,Garner,179,35,85,22,0,18,160
Arkansas,Garland,321,126,59,36,23,17,261
Arkansas,Garfield,525,81,272,51,9,29,442
Arkansas,Fulton,184,36,41,43,0,23,143
Arkansas,Friendship,182,23,88,31,0,14,156
Arkansas,Fredonia (Biscoe),415,99,168,27,13,15,322
Arkansas,Franklin,197,15,115,15,4,22,171
Arkansas,Fourche,70,25,34,8,1,0,68
Arkansas,Fountain Lake,506,71,194,70,3,24,362
Arkansas,Fountain Hill,93,25,38,7,9,3,82
Arkansas,Gassville,2277,438,927,220,38,191,1814
Arkansas,Jasper,488,86,170,103,15,61,435
Arkansas,Grady,399,176,98,53,7,13,347
Arkansas,Gravette,3216,650,1280,331,51,195,2507
Arkansas,Jericho,64,24,17,3,2,12,58
Arkansas,Jerome,49,8,33,3,0,2,46
Arkansas,Johnson,3552,586,1447,354,14,87,2488
Arkansas,Joiner,514,173,98,46,35,31,383
Arkansas,Jonesboro,71576,19184,24899,7426,1328,3675,56512
Arkansas,Judsonia,2360,395,903,373,57,123,1851
Arkansas,Junction City,746,197,262,68,29,43,599
Arkansas,Keiser,600,113,209,81,9,22,434
Arkansas,Kensett,1832,381,617,222,81,110,1411
Arkansas,Keo,229,64,86,50,0,13,213
Arkansas,Grannis,600,115,284,59,10,35,503
Arkansas,Kibler,1043,194,484,112,18,83,891
Arkansas,Kirby,820,111,432,111,0,8,662
Arkansas,Knobel,236,49,107,21,3,16,196
Arkansas,Knoxville,805,144,423,58,5,20,650
Arkansas,Griffithville,156,43,48,30,2,28,151
Arkansas,Greers Ferry,857,150,424,133,0,57,764
Arkansas,Greenwood,9283,1661,3763,1115,78,232,6849
Arkansas,Greenway,208,62,60,29,0,18,169
Arkansas,Greenland,1496,202,729,120,20,68,1139
Arkansas,Green Forest,2775,614,1095,267,82,140,2198
Arkansas,Greenbrier,5090,708,2327,362,59,232,3688
Arkansas,Kingsland,439,62,153,79,20,28,342
Arkansas,Monticello,9793,3370,3362,660,161,475,8028
Arkansas,Pineville,420,68,117,20,57,45,307
Arkansas,Mansfield,1235,187,489,171,25,60,932
Arkansas,Lafe,448,70,190,48,23,41,372
Arkansas,LaGrange,60,12,24,11,0,13,60
Arkansas,Lake City,2315,355,1044,263,31,165,1858
Arkansas,Lake Hamilton,1970,173,1048,303,0,121,1645
Arkansas,Lakeview,867,103,496,110,3,72,784
Arkansas,Lake View,409,173,90,44,23,23,353
Arkansas,Lake Village,2398,605,650,347,92,197,1891
Arkansas,Lamar,1748,234,729,280,32,144,1419
Arkansas,Landmark,3171,644,1304,488,22,151,2609
Arkansas,Lavaca,2562,327,1213,175,57,106,1878
Arkansas,Leachville,1755,264,777,187,43,107,1378
Arkansas,Lead Hill,277,56,114,27,13,16,226
Arkansas,Leola,534,160,155,24,29,31,399
Arkansas,Lepanto,1955,614,546,215,41,195,1611
Arkansas,Leslie,529,115,148,86,17,28,394
Arkansas,Letona,286,43,129,29,7,3,211
Arkansas,Lewisville,1113,381,222,178,42,108,931
Arkansas,Lexa,389,105,126,16,3,25,275
Arkansas,Lincoln,2232,445,745,259,58,190,1697
Arkansas,Little Flock,2692,868,974,279,11,76,2208
Arkansas,Little Rock,196943,60980,64054,20700,4233,9035,159002
Arkansas,Zinc,69,25,18,10,2,8,63
Arkansas,Lockesburg,824,163,300,107,9,82,661
Arkansas,Yellville,1180,183,386,195,18,136,918
Arkansas,Wynne,8242,1773,2975,838,249,626,6461
Arkansas,Calico Rock,1464,409,438,282,72,101,1302
Arkansas,Cale,104,6,71,6,0,6,89
Arkansas,Caldwell,508,165,205,31,11,38,450
Arkansas,Whelen Springs,53,18,13,0,7,4,42
Arkansas,White Hall,5319,915,2399,564,90,310,4278
Arkansas,Wickes,716,190,252,59,7,35,543
Arkansas,Widener,325,108,93,16,9,18,244
Arkansas,Wiederkehr Village,39,10,22,4,0,0,36
Arkansas,Williford,49,16,12,0,0,10,38
Arkansas,Willisville,190,13,85,26,11,10,145
Arkansas,Wilmar,362,73,134,27,7,36,277
Arkansas,Wilmot,517,171,106,54,5,48,384
Arkansas,Wilson,933,203,344,65,33,59,704
Arkansas,Wilton,303,82,99,67,5,28,281
Arkansas,Winchester,211,82,62,9,4,9,166
Arkansas,Winslow,356,60,172,44,0,18,294
Arkansas,Winthrop,131,22,69,11,0,1,103
Arkansas,Woodlawn,213,20,103,25,6,6,160
Arkansas,Woodson,455,259,99,32,23,22,435
Arkansas,Wooster,959,118,447,89,8,49,711
Arkansas,Wrightsville,1204,548,285,152,57,35,1077
Arkansas,Yarborough Landing,495,105,262,48,21,33,469
Arkansas,Calion,464,108,205,75,15,15,418
Arkansas,London,995,158,411,153,38,55,815
Arkansas,Lonsdale,128,21,45,26,1,2,95
Arkansas,Maysville,108,7,68,0,0,0,75
Arkansas,Maynard,329,65,129,53,4,27,278
Arkansas,Mayflower,1975,317,903,365,48,112,1745
Arkansas,Maumelle,17695,3022,7929,1619,63,721,13354
Arkansas,Marvell,1056,340,263,101,41,103,848
Arkansas,Marshall,1657,320,680,85,9,176,1270
Arkansas,Marmaduke,1132,161,369,202,23,77,832
Arkansas,Marked Tree,2520,563,835,413,66,190,2067
Arkansas,Marion,12328,2748,4659,1030,346,437,9220
Arkansas,Marie,48,1,20,10,2,9,42
Arkansas,Marianna,3927,1227,981,452,158,196,3014
Arkansas,Hermitage,758,214,167,37,12,43,473
Arkansas,Manila,3275,406,1383,350,92,282,2513
Arkansas,Mammoth Spring,981,203,353,135,9,107,807
Arkansas,Malvern,10770,2869,3426,1646,337,714,8992
Arkansas,Magnolia,11690,3988,3699,851,178,701,9417
Arkansas,Magnet Cove,298,40,258,0,0,0,298
Arkansas,Magness,215,25,62,8,16,8,119
Arkansas,Magazine,925,139,405,101,43,52,740
Arkansas,Madison,1004,187,300,100,68,63,718
Arkansas,McRae,740,131,290,92,37,38,588
Arkansas,Melbourne,1797,278,728,213,61,243,1523
Arkansas,Lonoke,4250,879,1693,416,131,370,3489
Arkansas,Mena,5692,1001,1921,1067,92,706,4787
Arkansas,Midland,398,48,95,30,48,31,252
Arkansas,Lost Bridge Village,423,68,283,25,0,19,395
Arkansas,Louann,132,6,82,9,0,11,108
Arkansas,Lowell,8011,1103,3656,948,64,112,5883
Arkansas,Luxora,1007,276,281,54,26,56,693
Arkansas,Lynn,237,45,111,11,4,15,186
Arkansas,McAlmont,1504,546,326,235,97,110,1314
Arkansas,McCaskill,120,68,41,3,2,2,116
Arkansas,McCrory,1928,421,621,304,83,171,1600
Arkansas,Caddo Valley,641,100,257,74,0,36,467
Arkansas,McDougal,163,29,75,9,3,14,130
Arkansas,McGehee,4029,844,1322,315,85,307,2873
Arkansas,Cabot,25102,4087,11305,2469,172,1121,19154
Arkansas,Burdette,180,21,89,17,3,8,138
Arkansas,Bull Shoals,2107,276,937,286,68,227,1794
Arkansas,Buckner,280,79,105,34,8,11,237
Arkansas,Monette,1537,247,703,167,24,173,1314
Arkansas,Mitchellville,389,98,134,53,10,25,320
Arkansas,Minturn,66,8,33,12,6,5,64
Arkansas,Mineral Springs,1092,245,401,103,16,74,839
Arkansas,Midway,374,60,183,42,4,12,301
Arkansas,Midway,1319,427,469,185,0,77,1158
Arkansas,Menifee,344,102,158,18,3,12,293
Arkansas,Camden,11683,2767,3574,1438,387,1076,9242
Arkansas,Cammack Village,1036,215,420,64,7,41,747
Arkansas,Campbell Station,249,37,110,32,5,18,202
Arkansas,Bradley,489,56,185,35,54,43,373
Arkansas,Branch,362,93,164,23,5,28,313
Arkansas,Briarcliff,240,36,106,46,2,13,203
Arkansas,Brinkley,3007,916,811,316,158,209,2410
Arkansas,Brookland,2503,572,866,421,49,33,1941
Arkansas,Bryant,19162,4227,7537,2349,342,1096,15551
Arkansas,Washington,182,69,57,46,0,3,175
Arkansas,Watson,163,46,63,20,3,18,150
Arkansas,Weiner,762,154,273,95,7,78,607
Arkansas,Weldon,77,12,37,8,1,3,61
Arkansas,West Crossett,1123,252,388,163,24,71,898
Arkansas,Western Grove,415,66,226,48,5,26,371
Arkansas,West Fork,2454,378,1214,216,35,85,1928
Arkansas,West Memphis,25544,8081,6560,2601,1013,1515,19770
Arkansas,West Point,210,85,53,20,2,18,178
Arkansas,Wheatley,260,30,143,29,7,16,225
Arkansas,Dierks,1155,159,374,147,27,162,869
Arkansas,Diaz,1414,299,463,223,33,71,1089
Arkansas,Diamond City,911,118,449,94,40,118,819
Arkansas,DeWitt,3234,822,1202,350,26,237,2637
Arkansas,De Valls Bluff,622,92,238,69,15,66,480
Arkansas,Bradford,812,180,332,90,18,55,675
Arkansas,Des Arc,1862,408,819,223,44,107,1601
Arkansas,Booneville,3936,893,1185,477,78,454,3087
Arkansas,Bonanza,637,81,296,119,9,36,541
Arkansas,Prairie Grove,4859,853,2044,525,34,182,3638
Arkansas,Prairie Creek,2116,292,1156,174,17,153,1792
Arkansas,Poyen,318,71,132,12,11,23,249
Arkansas,Powhatan,76,7,38,7,0,5,57
Arkansas,Bentonville,40368,7735,17937,3396,431,1146,30645
Arkansas,Bergman,455,74,261,35,11,24,405
Arkansas,Berryville,5339,830,1850,613,60,488,3841
Arkansas,Bethel Heights,2776,677,975,144,36,65,1897
Arkansas,Bigelow,325,98,117,37,23,18,293
Arkansas,Big Flat,59,0,26,8,2,4,40
Arkansas,Biggers,278,41,140,19,7,19,226
Arkansas,Birdsong,41,6,8,7,0,9,30
Arkansas,Black Oak,267,35,83,36,11,29,194
Arkansas,Black Rock,642,179,205,85,10,83,562
Arkansas,Black Springs,35,8,24,1,0,1,34
Arkansas,Blevins,251,41,109,25,13,16,204
Arkansas,Blue Eye,39,0,4,24,2,5,35
Arkansas,Blue Mountain,94,25,37,16,0,0,78
Arkansas,Bluff City,101,10,47,25,0,10,92
Arkansas,Blytheville,15090,4120,4735,1585,460,924,11824
Arkansas,Bodcaw,172,53,77,10,0,15,155
Arkansas,Bono,2488,472,838,302,41,120,1773
Arkansas,Dermott,2787,819,729,338,111,249,2246
Arkansas,De Queen,6678,1274,2450,380,122,417,4643
Arkansas,Denning,161,26,79,17,1,18,141
Arkansas,Clarksville,9338,1956,3410,1341,112,498,7317
Arkansas,Clarkedale,445,77,202,12,2,9,302
Arkansas,Clarendon,1577,350,546,142,50,214,1302
Arkansas,Chidester,266,37,112,40,11,43,243
Arkansas,Chester,119,27,38,22,3,5,95
Arkansas,Cherry Valley,891,154,300,137,27,42,660
Arkansas,Cherokee Village,4581,461,1997,520,166,532,3676
Arkansas,Cherokee City,83,11,32,0,0,0,43
Arkansas,Charleston,2638,450,1041,375,8,251,2125
Arkansas,Central City,522,76,240,68,6,23,413
Arkansas,Centerton,10764,1930,4098,974,163,278,7443
Arkansas,Center Ridge,514,81,236,35,0,27,379
Arkansas,Cedarville,1723,194,973,120,39,78,1404
Arkansas,Cave Springs,2475,324,1371,128,4,48,1875
Arkansas,Cave City,2278,378,702,358,58,220,1716
Arkansas,Caulksville,203,26,117,19,0,24,186
Arkansas,Cash,348,75,128,36,15,27,281
Arkansas,Casa,208,39,76,31,9,19,174
Arkansas,Carthage,536,98,247,32,21,31,429
Arkansas,Carlisle,2084,365,806,277,26,211,1685
Arkansas,Caraway,1037,166,474,128,7,57,832
Arkansas,Clinton,2564,515,900,466,66,208,2155
Arkansas,Coal Hill,989,194,518,67,15,35,829
Arkansas,College City,427,326,72,5,0,7,410
Arkansas,College Station,617,259,64,138,21,64,546
Arkansas,Dennard,389,96,225,23,15,21,380
Arkansas,Dell,220,19,104,40,0,23,186
Arkansas,Delight,321,46,136,56,0,27,265
Arkansas,Delaplaine,62,10,37,8,0,6,61
Arkansas,Decatur,2306,566,789,131,30,92,1608
Arkansas,Datto,72,15,24,17,3,2,61
Arkansas,Dardanelle,4676,1446,1429,470,73,355,3773
Arkansas,Danville,2242,416,699,108,68,142,1433
Arkansas,Damascus,497,69,212,40,5,17,343
Arkansas,Daisy,120,17,52,30,3,7,109
Arkansas,McNeil,514,136,154,38,21,13,362
Arkansas,Cushman,547,72,254,64,11,25,426
Arkansas,Crawfordsville,519,132,193,50,9,38,422
Arkansas,Coy,164,10,48,24,2,7,91
Arkansas,Cove,433,78,164,58,15,14,329
Arkansas,Cotton Plant,587,204,139,94,33,60,530
Arkansas,Cotter,954,203,426,157,4,37,827
Arkansas,Corning,3223,556,1528,328,0,305,2717
Arkansas,Corinth,57,36,6,11,0,2,55
Arkansas,Conway,63555,21625,21056,5493,791,2406,51371
Arkansas,Concord,242,32,126,36,0,21,215
Arkansas,Colt,433,35,239,74,7,28,383
Arkansas,Crossett,5333,1114,1959,688,113,303,4177
Arkansas,McNab,49,9,19,2,10,3,43
California,Tipton,2787,843,855,82,74,66,1920
California,Atherton,7081,1651,3661,285,53,299,5949
California,Delleker,656,81,255,103,21,23,483
California,Delhi,10026,2692,3915,379,103,308,7397
California,Delft Colony,132,24,30,0,0,20,74
California,Delano,52807,17722,16946,2952,1289,1827,40736
California,Del Aire,10692,3173,3962,652,126,426,8339
California,Deer Park,1104,100,513,61,38,243,955
California,Day Valley,3836,839,1954,191,33,154,3171
California,Davis,66510,31335,20647,3687,629,1477,57775
California,Davenport,297,83,133,26,2,8,252
California,Darwin,24,0,24,0,0,0,24
California,Daphnedale Park,90,0,46,0,0,0,46
California,Three Rocks,212,127,70,0,0,15,212
California,Three Rivers,2185,432,1063,347,43,111,1996
California,Thousand Palms,8222,2198,2702,817,198,717,6632
California,Thousand Oaks,128565,30089,57976,9938,1834,5737,105574
California,Thornton,916,268,361,33,17,36,715
California,Agoura Hills,20697,5037,9000,2283,233,482,17035
California,Agua Dulce,3567,559,2161,194,32,84,3030
California,Aguanga,766,55,337,234,0,63,689
California,Ahwahnee,1709,149,1082,130,12,129,1502
California,Airport,1565,395,511,66,52,69,1093
California,Del Mar,4269,958,2230,342,65,185,3780
California,Alameda,76733,20757,32049,6775,1177,3223,63981
California,Del Monte Forest,5122,1382,2397,360,57,370,4566
California,Del Rey Oaks,1673,373,818,131,28,73,1423
California,Tobin,10,0,0,10,0,0,10
California,Tomales,208,46,84,58,0,20,208
California,Tonyville,572,247,80,56,33,19,435
California,Tooleville,391,164,75,64,14,47,364
California,Topanga,8419,1689,3730,866,170,176,6631
California,Topaz,202,33,22,0,42,0,97
California,Toro Canyon,1580,211,865,41,2,111,1230
California,Torrance,147589,36528,65110,11356,1824,7686,122504
California,Tracy,85284,20263,34817,5007,1398,2771,64256
California,Tranquillity,691,160,238,63,0,19,480
California,Tiburon,9158,1580,4611,750,93,491,7525
California,Desert View Highlands,2489,673,681,154,118,133,1759
California,Desert Shores,1383,335,481,92,8,108,1024
California,Desert Palms,6826,217,4550,642,22,1395,6826
California,Desert Hot Springs,27912,7231,8625,2984,520,971,20331
California,Desert Edge,4431,705,1967,600,179,432,3883
California,Desert Center,207,34,80,43,0,17,174
California,Descanso,1355,70,834,104,27,41,1076
California,Derby Acres,320,59,129,39,11,24,262
California,Denair,5176,1504,1862,363,103,171,4003
California,Del Rio,1925,284,1199,0,0,78,1561
California,Del Rey,1457,451,412,98,16,16,993
California,Atwater,28858,7806,9175,2443,668,1147,21239
California,Alamo,16301,3015,8850,792,87,413,13157
California,Albion,303,228,40,35,0,0,303
California,Angwin,3522,1793,1104,160,12,139,3208
California,Antelope,47763,12437,18844,3078,779,1687,36825
California,Antioch,107501,30687,39645,8612,2350,3878,85172
California,Anza,2771,527,1119,209,90,163,2108
California,Apple Valley,71083,17208,27506,6732,1300,3850,56596
California,Aptos,6048,1572,2646,607,46,194,5065
California,Aptos Hills-Larkin Valley,2221,617,940,250,25,34,1866
California,Arbuckle,3360,813,1334,162,64,117,2490
California,Arcadia,57564,13461,27469,3233,616,3174,47953
California,Arcata,17752,10245,3542,1376,266,451,15880
California,Timber Cove,127,46,57,12,0,12,127
California,Armona,3724,951,1112,315,99,153,2630
California,Arnold,2554,439,1319,360,81,86,2285
California,Aromas,2860,713,1322,204,22,130,2391
California,Arroyo Grande,17720,3506,8350,1574,360,1048,14838
California,Artesia,16785,4847,6995,775,526,948,14091
California,Artois,225,29,80,4,0,0,113
California,Arvin,20328,6109,6689,513,291,347,13949
California,Ashland,24226,8693,6634,1733,381,847,18288
California,Aspen Springs,45,0,30,0,0,0,30
California,Atascadero,29084,6259,12970,2743,397,1485,23854
California,Angels,3753,995,1381,462,61,393,3292
California,Albany,19249,4006,8697,1459,221,455,14838
California,Anderson,10122,2536,3186,1275,215,681,7893
California,Anaheim,345578,99914,127424,23715,8581,12444,272078
California,Alderpoint,311,150,114,8,20,0,292
California,Alhambra,84782,27465,33374,5849,1302,4229,72219
California,Alhambra Valley,557,134,338,37,0,31,540
California,Aliso Viejo,49829,11389,21427,4382,434,1343,38975
California,Alleghany,116,17,0,0,78,21,116
California,Allendale,1528,388,757,156,0,48,1349
California,Allensworth,565,182,152,29,13,6,382
California,Almanor,0,0,0,0,0,0,0
California,Alondra Park,7865,2367,2743,444,119,406,6079
California,Alpaugh,1103,272,347,47,10,2,678
California,Alpine,14830,3642,6523,1151,223,1129,12668
California,Alpine Village,116,43,52,3,4,7,109
California,Alta,455,80,222,54,2,33,391
California,Altadena,44621,13759,17658,3705,487,2012,37621
California,Alta Sierra,6624,1200,3437,557,55,459,5708
California,Alto,735,140,416,102,0,16,674
California,Alturas,2660,564,1073,285,0,214,2136
California,Alum Rock,11051,3297,4112,684,100,479,8672
California,Amador City,152,24,52,33,10,8,127
California,American Canyon,20271,5021,8525,1219,200,756,15721
California,Amesti,3274,800,1122,263,60,109,2354
California,Anchor Bay,329,21,246,53,0,9,329
California,Arden-Arcade,93993,26267,32179,10888,2201,5011,76546
California,Smartsville,82,24,26,2,0,14,66
California,Auburn,13785,2945,5822,1734,204,1028,11733
California,Camp Pendleton South,11394,1468,5003,225,0,0,6696
California,Camp Pendleton North,7457,2276,2679,139,22,0,5116
California,Campo,2883,738,1131,269,18,181,2337
California,Camp Nelson,101,0,101,0,0,0,101
California,Campbell,40688,11551,16418,4125,534,1299,33927
California,Camino Tassajara,2247,214,1238,109,0,0,1561
California,Camptonville,172,24,119,6,0,10,159
California,Camino,1905,460,859,219,20,55,1613
California,Cambrian Park,3363,616,1648,222,28,170,2684
California,Cambria,6279,1112,3380,597,52,508,5649
California,Camarillo,66445,14827,29012,5463,751,3736,53789
California,Camanche Village,720,110,454,31,0,10,605
California,Camanche North Shore,696,125,350,49,62,14,600
California,Calwa,1282,429,307,112,36,40,924
California,Cameron Park,19437,4427,7975,2193,379,907,15881
California,Calpine,207,67,64,48,0,28,207
California,San Diego Country Estates,10215,1978,4890,771,76,501,8216
California,San Fernando,24296,7998,8399,1139,515,761,18812
California,San Marcos,89578,22723,35250,6951,960,3748,69632
California,San Luis Obispo,46337,24221,12245,2988,530,1490,41474
California,San Lucas,384,141,104,11,10,11,277
California,San Lorenzo,24891,7034,10185,1635,312,1411,20577
California,San Leandro,88329,24727,35445,7079,1479,4317,73047
California,San Juan Capistrano,35897,7777,16480,2919,526,1388,29090
California,San Dimas,34073,9088,14392,2888,605,1861,28834
California,San Juan Bautista,2250,499,779,302,98,134,1812
California,San Joaquin,4008,1096,1308,88,81,56,2629
California,San Jacinto,45977,11737,15894,4027,771,1907,34336
California,San Geronimo,599,184,165,55,25,22,451
California,Sanger,24700,6320,8425,2023,502,900,18170
California,San Gabriel,40198,11815,17218,2574,328,2090,34025
California,San Francisco,840763,346143,288755,62078,11116,36633,744725
California,San Jose,1000860,276816,407289,65529,14943,35743,800320
California,San Marino,13353,2500,6992,478,62,658,10690
California,Calpella,419,123,207,13,0,9,352
California,Baldwin Park,76602,25783,26827,3562,1470,3188,60830
California,Bella Vista,2860,649,1275,279,25,182,2410
California,Bell Canyon,2094,404,1131,107,12,15,1669
California,Bellflower,77756,24925,24665,5482,2087,3023,60182
California,Bell Gardens,42842,15107,12374,1279,1032,1077,30869
California,Belmont,26766,5360,12609,2194,153,1221,21537
California,Belvedere,1992,217,1066,123,70,193,1669
California,Bell,35998,11642,11438,1518,1092,1420,27110
California,Benbow,230,53,153,20,0,0,226
California,Benicia,27657,6225,11718,3017,459,1120,22539
California,Ben Lomond,6507,1649,2850,562,41,271,5373
California,Benton,333,25,149,34,1,24,233
California,Berkeley,117384,58319,34390,8012,1255,3452,105428
California,Bermuda Dunes,8219,2109,3222,664,82,350,6427
California,Berry Creek,1325,276,566,210,43,92,1187
California,Bend,559,88,342,37,7,18,492
California,Bakersfield,363612,98473,128232,26038,7329,12203,272275
California,Belden,0,0,0,0,0,0,0
California,Beaumont,40899,8652,16735,3297,469,1513,30666
California,Ballard,373,83,206,21,4,10,324
California,Ballico,315,77,117,9,28,16,247
California,Bangor,586,97,290,47,24,25,483
California,Banning,30515,7752,11248,3121,761,2552,25434
California,Barstow,23281,6190,6945,2302,477,1040,16954
California,Bass Lake,739,112,441,28,6,71,658
California,Beckwourth,238,57,104,14,0,63,238
California,Bay Point,22473,7010,6739,1766,823,733,17071
California,Bayview CDP (Humboldt County),2548,589,903,291,54,180,2017
California,Beale AFB,1143,43,586,39,7,0,675
California,Bear Creek,167,92,0,36,0,39,167
California,Bear Valley CDP (Alpine County),25,4,10,5,0,0,19
California,Bear Valley CDP (Mariposa County),155,9,91,17,0,0,117
California,Bear Valley Springs,4661,601,2766,343,12,364,4086
California,Bayview CDP (Contra Costa County),1728,300,824,149,16,116,1405
California,San Martin,7170,1963,3200,363,83,374,5983
California,San Mateo,101335,26824,41855,8898,1516,4562,83655
California,San Miguel CDP (Contra Costa County),3366,374,1761,311,48,127,2621
California,Carmel-by-the-Sea,3834,490,1962,333,101,296,3182
California,Carlsbad,110830,22860,50620,10450,829,4365,89124
California,Caribou,0,0,0,0,0,0,0
California,Capitola,10077,2543,3831,1334,232,589,8529
California,Canyon Lake,10918,2239,5242,677,233,765,9156
California,Canyondam,102,0,102,0,0,0,102
California,Carmel Valley Village,4302,789,2380,379,39,168,3755
California,Cantua Creek,529,134,215,24,0,0,373
California,Shandon,1227,219,504,111,52,27,913
California,Shafter,17513,4337,6244,813,543,391,12328
California,Seville,545,202,148,14,8,10,382
California,Sereno del Mar,42,0,10,32,0,0,42
California,Sequoia Crest,27,0,27,0,0,0,27
California,Selma,24017,6695,8438,1651,502,735,18021
California,Canby,545,199,147,58,0,0,404
California,Seeley,1324,204,442,91,65,150,952
California,Carmet,15,15,0,0,0,0,15
California,Carnelian Bay,433,122,230,35,0,10,397
California,Castroville,6707,1955,2201,164,61,152,4533
California,Castro Valley,62044,14029,27235,4835,897,3197,50193
California,Castle Hill,1204,187,587,150,0,72,996
California,Castaic,19369,4442,8251,1240,340,456,14729
California,Cassel,362,24,253,53,0,1,331
California,Caspar,801,180,297,96,0,73,646
California,Carmichael,63712,16390,23700,7668,1204,4140,53102
California,Casmalia,116,22,52,16,0,10,100
California,Casa Conejo,3358,766,1414,307,36,172,2695
California,Caruthers,3128,926,978,150,72,164,2290
California,Cartago,39,22,11,0,0,6,39
California,Carson,92691,30046,32607,6956,1965,4904,76478
California,Carrick,67,43,24,0,0,0,67
California,Carpinteria,13449,3592,5960,1255,263,596,11666
California,Casa de Oro-Mount Helix,20222,4481,8877,2005,390,983,16736
California,Sebastopol,7583,2157,2607,1457,93,459,6773
California,Seaside,33999,10183,11585,2405,621,1447,26241
California,Searles Valley,1614,367,496,223,45,93,1224
California,Santa Maria,102618,28828,35007,5757,2018,3595,75205
California,Santa Margarita,1582,244,821,168,66,0,1299
California,Santa Fe Springs,17162,5126,5682,1505,310,910,13533
California,Santa Cruz,62752,31630,16322,5266,820,1798,55836
California,Santa Clarita,179950,47698,73228,13660,2701,6215,143502
California,Santa Clara,121374,34770,51431,7226,1493,3676,98596
California,Santa Monica,92169,37238,28967,9998,1857,3653,81713
California,Santa Barbara,90401,30249,32080,8054,1774,4065,76222
California,San Simeon,284,93,75,51,0,9,228
California,San Ramon,74571,13166,36496,3648,644,1680,55634
California,San Rafael,58819,16408,22812,5731,885,2590,48426
California,San Pasqual,2000,616,879,125,45,69,1734
California,San Pablo,29777,9890,9462,2206,661,1225,23444
California,San Miguel CDP (San Luis Obispo County),2461,588,789,233,36,45,1691
California,Santa Ana,333268,105582,112729,15820,8739,10363,253233
California,Santa Nella,1517,307,453,196,0,37,993
California,Santa Paula,30246,7882,11046,2002,528,1324,22782
California,Santa Rosa,172066,47864,61252,19419,2760,8177,139472
California,Sea Ranch,1068,38,692,232,0,106,1068
California,Seal Beach,24551,4846,10837,3168,292,2744,21887
California,Seacliff,3256,941,1408,399,30,109,2887
California,Scotts Valley,11780,2930,5063,974,127,553,9647
California,Scotia,814,171,256,97,32,21,577
California,Sausalito,7094,1970,2920,1325,73,277,6565
California,Sattley,40,0,40,0,0,0,40
California,Saticoy,1251,412,378,90,7,22,909
California,Saratoga,30817,4865,17426,1217,254,1652,25414
California,Saranap,5702,1046,2925,452,61,56,4540
California,Santee,56255,13327,22497,6252,873,2417,45366
California,Santa Ynez,4489,1199,2234,275,108,219,4035
California,Santa Venetia,5166,1578,2021,539,15,338,4491
California,Santa Susana,1071,375,509,97,0,24,1005
California,Santa Rosa Valley,3550,723,1931,184,21,168,3027
California,Bertsch-Oceanview,2516,559,860,316,87,130,1952
California,Cathedral City,53020,15448,17833,5122,1047,2014,41464
California,Bethel Island,2172,331,940,330,37,360,1998
California,Bieber,120,9,76,6,0,13,104
California,San Diego,1359791,450067,486068,112949,21661,50238,1120983
California,Callender,1710,411,755,198,39,57,1460
California,Calistoga,5267,1399,1927,717,141,124,4308
California,Calipatria,7557,3696,1530,745,309,170,6450
California,Calimesa,8269,1488,3592,936,136,824,6976
California,California Pines,335,40,140,36,0,37,253
California,Sand City,312,120,92,27,3,3,245
California,California Hot Springs,65,12,15,11,5,5,48
California,Calexico,39601,10709,13710,2291,1179,2133,30022
California,Calabasas,24075,5662,10630,1937,442,805,19476
California,Cabazon,3633,1090,755,308,87,278,2518
California,Bystrom,3889,1029,1268,413,104,125,2939
California,Byron,1325,299,472,198,6,101,1076
California,Buttonwillow,1425,288,511,65,35,58,957
California,California City,13201,3809,4534,1596,362,448,10749
California,Butte Valley,498,49,341,47,0,29,466
California,San Clemente,65017,13298,30446,5514,871,2358,52487
California,San Buenaventura (Ventura),108899,28512,41424,11915,1813,5130,88794
California,Sacramento,480566,155057,152495,45524,10280,20787,384143
California,St. Helena,5943,1269,2865,515,21,296,4966
California,Salida,13501,3565,5528,872,78,304,10347
California,Salinas,155366,50013,49713,7403,2867,4628,114624
California,Salmon Creek,44,27,17,0,0,0,44
California,Salton City,4782,1330,1476,407,134,215,3562
California,San Carlos,29454,5603,13683,2439,316,1413,23454
California,Salton Sea Beach,551,111,150,144,0,0,405
California,San Andreas,2706,384,1045,543,0,165,2137
California,San Anselmo,12566,2450,5818,1061,327,504,10160
California,San Antonio Heights,2963,835,1409,249,11,98,2602
California,San Ardo,746,208,179,50,44,28,509
California,San Bernardino,214112,73288,56414,16888,5775,7331,159696
California,San Bruno,42506,12453,17382,3105,522,1960,35422
California,Samoa,268,139,34,41,0,23,237
California,Rutherford,232,88,91,8,0,13,200
California,Butte Meadows,27,0,27,0,0,0,27
California,Burnt Ranch,344,92,165,28,13,27,325
California,Brawley,25656,6680,8372,2086,506,1198,18842
California,Bradley,125,37,64,6,2,1,110
California,Bradbury,839,188,467,68,3,44,770
California,Boyes Hot Springs,7229,1915,2508,686,92,161,5362
California,Bowles,194,61,44,0,0,45,150
California,Boulevard,461,24,194,0,0,70,288
California,Brea,40931,10136,17974,2901,694,1625,33330
California,Boulder Creek,4481,1236,2020,530,59,112,3957
California,Borrego Springs,2518,557,1166,178,41,232,2174
California,Boronda,1271,261,632,28,41,48,1010
California,Boron,2326,501,856,213,27,142,1739
California,Bootjack,836,145,489,36,0,35,705
California,Boonville,721,170,314,68,9,35,596
California,Bonsall,3896,628,2339,119,64,162,3312
California,Bostonia,16787,5082,5622,1461,194,777,13136
California,Butte Creek Canyon,938,137,457,132,9,98,833
California,Brentwood,55490,11815,24541,3588,976,1917,42837
California,Bridgeport,909,273,255,12,19,342,901
California,Burney,3257,712,1052,403,137,286,2590
California,Burlingame,29941,7400,12641,2559,267,1338,24205
California,Burbank,5736,1687,1820,798,177,103,4585
California,Burbank,104725,30557,41244,8557,1801,5052,87211
California,Buena Vista,326,61,146,36,21,0,264
California,Buena Park,82683,23598,32519,5510,1252,3398,66277
California,Bret Harte,5188,1671,1548,308,30,84,3641
California,Buellton,4977,956,2520,322,89,202,4089
California,Buck Meadows,52,20,32,0,0,0,52
California,Buckhorn,2179,279,1279,249,21,152,1980
California,Brooktrails,3225,644,1095,515,22,205,2481
California,Brookdale,2282,668,1107,190,0,35,2000
California,Broadmoor,5409,1455,2719,269,0,269,4712
California,Brisbane,4496,1314,1592,464,98,224,3692
California,Bucks Lake,16,7,0,9,0,0,16
California,Ruth,108,14,42,26,0,8,90
California,Running Springs,4793,1193,2073,450,36,134,3886
California,Rowland Heights,50440,14994,22085,3121,652,2474,43326
California,Blythe,19839,7181,5946,2560,550,750,16987
California,Bodega,212,60,65,87,0,0,212
California,Bodega Bay,671,167,345,68,0,91,671
California,Bodfish,2066,525,669,434,19,145,1792
California,Bolinas,1358,394,578,145,13,30,1160
California,Bombay Beach,250,59,15,66,0,89,229
California,Bluewater,179,5,113,19,0,42,179
California,Bonadelle Ranchos-Madera Ranchos,8866,2215,4149,396,209,282,7251
California,Bonny Doon,2947,830,1331,326,32,75,2594
California,Richfield,214,52,98,10,4,17,181
California,Richgrove,2972,983,877,68,40,43,2011
California,Richmond,107597,34118,34598,9741,3334,4114,85905
California,Richvale,111,12,86,13,0,0,111
California,Ridgecrest,28489,5800,11094,3003,651,1346,21894
California,Bonita,12931,2994,6087,934,221,651,10887
California,Ridgemark,3499,740,1775,267,33,173,2988
California,Blue Lake,1310,410,528,152,25,39,1154
California,Bloomfield,420,102,217,84,17,0,420
California,Big Bear City,13535,3370,5176,1904,336,535,11321
California,Big Bear Lake,5145,804,2119,905,130,257,4215
California,Big Bend,94,35,20,17,3,13,88
California,Big Creek,248,38,142,5,18,1,204
California,Biggs,1765,383,647,149,53,67,1299
California,Big Lagoon,92,20,39,11,2,14,86
California,Bloomington,24864,7639,8258,1516,845,799,19057
California,Big Pine,1661,311,720,122,39,112,1304
California,Biola,1151,385,323,13,17,69,807
California,Bishop,3839,1141,1023,654,105,262,3185
California,Blackhawk,9304,1249,5599,348,79,385,7660
California,Blacklake,727,0,547,53,0,108,708
California,Black Point-Green Point,1250,83,784,36,24,24,951
California,Blairsden,55,0,40,15,0,0,55
California,Big River,1068,144,462,218,26,139,989
California,Rio Dell,3385,1046,1094,349,81,175,2745
California,Rio del Mar,8964,1595,4621,975,85,534,7810
California,Rio Linda,14688,3586,5267,1846,256,688,11643
California,Romoland,1778,802,536,20,0,51,1409
California,Rosamond,19540,5339,7013,1588,349,666,14955
California,Rosedale,15509,2815,7813,1068,205,383,12284
California,Rose Hills,3205,886,1259,356,70,151,2722
California,Roseland,5594,1774,2012,415,170,160,4531
California,Rosemead,54615,17007,22616,2675,841,2701,45840
California,Rollingwood,2847,797,1120,203,0,102,2222
California,Rosemont,23515,7564,7422,2644,532,1081,19243
California,Ross,2306,349,1142,126,28,73,1718
California,Rossmoor,10461,2046,5347,529,92,598,8612
California,Rough and Ready,1581,235,776,172,0,74,1257
California,Round Mountain,113,50,39,16,0,8,113
California,Round Valley,485,228,153,61,1,32,475
California,Rouse,1820,758,474,62,24,10,1328
California,Roseville,126327,28532,52928,11078,1892,6144,100574
California,Rolling Hills Estates,8188,1247,4606,376,56,464,6749
California,Rolling Hills,816,99,509,36,0,24,668
California,Rolling Hills,1820,288,1068,74,15,98,1543
California,Rio Oso,491,113,168,50,13,6,350
California,Rio Vista,7826,1387,4052,926,39,723,7127
California,Ripley,601,181,95,51,31,49,407
California,Ripon,14801,3292,6590,819,230,685,11616
California,Riverbank,23564,5611,9558,1581,299,671,17720
California,Riverdale,4081,944,1440,242,107,47,2780
California,Riverdale Park,1023,386,215,93,125,53,872
California,River Pines,284,83,94,0,60,0,237
California,Riverside,316335,102174,105962,23813,6398,12223,250570
California,Robbins,334,57,183,17,0,26,283
California,Robinson Mill,0,0,0,0,0,0,0
California,Rocklin,59727,13563,25920,4665,796,2246,47190
California,Rodeo,9724,2811,3412,970,243,534,7970
California,Rodriguez Camp,153,20,62,0,6,0,88
California,Rohnert Park,41651,14057,13727,4474,870,1724,34852
California,Beverly Hills,34663,10309,14164,2348,525,1940,29286
California,Auberry,2420,390,1083,251,58,196,1978
California,Catheys Valley,747,122,460,46,0,75,703
California,Cazadero,243,81,83,37,8,17,226
California,Tamalpais-Homestead Valley,10542,2129,5038,1016,136,280,8599
California,Talmage,1547,468,682,96,35,37,1318
California,Tahoma,943,207,380,116,10,52,765
California,Tahoe Vista,1367,405,560,93,9,41,1108
California,Taft Mosswood,1117,357,399,75,9,60,900
California,Taft Heights,2859,772,799,259,89,63,1982
California,Tara Hills,4778,1409,1752,340,226,185,3912
California,Taft,9130,2877,3022,877,252,419,7447
California,Sutter Creek,2083,399,847,371,45,165,1827
California,Sutter,3195,641,1553,159,51,51,2455
California,Susanville,16048,7074,4425,2017,513,642,14671
California,Sun Village,11322,3113,3625,935,223,515,8411
California,Sunol,985,193,531,121,4,26,875
California,Sunnyvale,148178,35382,68818,8871,1422,4671,119164
California,Swall Meadows,243,27,155,12,0,16,210
California,Sunny Slopes,52,0,36,0,0,16,52
California,Tarpey Village,3460,893,1375,292,40,196,2796
California,Tecopa,128,39,24,38,0,3,104
California,Rialto,102018,30194,34346,5799,2502,3016,75857
California,Thermalito,7119,2092,2124,1017,107,296,5636
California,Thermal,3106,914,1075,184,132,15,2320
California,Teviston,1623,401,445,80,19,7,952
California,Terra Bella,2526,559,1079,57,13,81,1789
California,Terminous,371,38,184,73,0,44,339
California,Taylorsville,317,119,81,22,0,26,248
California,Tennant,100,0,69,6,0,4,79
California,Temple City,36079,9416,16523,1945,227,1971,30082
California,Temescal Valley,24654,4825,11846,1518,377,667,19233
California,Temelec,1543,175,718,336,15,299,1543
California,Temecula,107153,25372,44673,8096,1539,3047,82727
California,Tehama,410,69,206,38,0,19,332
California,Tehachapi,13536,4281,4179,1719,487,601,11267
California,Templeton,7377,1073,3314,844,112,573,5916
California,Reliez Valley,3656,659,1970,354,26,201,3210
California,Sunnyside-Tahoe City,1450,520,547,131,0,0,1198
California,Summerland,1505,472,645,250,42,17,1426
California,Cutler,4569,1462,1253,155,99,105,3074
California,Cupertino,60171,10303,31146,2274,242,2637,46602
California,Culver City,39469,12522,14906,3403,349,1898,33078
California,Cudahy,24138,8975,6957,547,732,452,17663
California,Crows Landing,207,35,57,44,0,38,174
California,Crowley Lake,654,25,366,61,0,0,452
California,Cutten,2999,711,1354,297,31,190,2583
California,Cromberg,132,38,48,25,0,21,132
California,C-Road,99,0,79,0,0,20,99
California,Creston,22,0,0,22,0,0,22
California,Crestline,9240,2146,3862,1020,160,452,7640
California,Crest,2712,623,1173,365,38,117,2316
California,Cressey,315,45,154,45,10,7,261
California,Crescent Mills,219,20,75,49,0,0,144
California,Crockett,3044,696,1326,387,92,128,2629
California,Sunnyside,4203,1269,1640,228,49,246,3432
California,Cuyama,91,12,35,0,0,3,50
California,Daly City,104930,33615,42296,6784,1670,5141,89506
California,Sultana,916,216,266,54,4,38,578
California,Suisun City,28867,8108,10489,2242,507,1014,22360
California,Sugarloaf Village,7,0,7,0,0,0,7
California,Sugarloaf Saw Mill,0,0,0,0,0,0,0
California,Sugarloaf Mountain Park,0,0,0,0,0,0,0
California,Strawberry CDP (Tuolumne County),246,81,163,1,0,1,246
California,Cypress,49008,12605,21905,3732,556,1903,40701
California,Strawberry CDP (Marin County),5901,1489,2290,886,75,186,4926
California,Stratford,1020,250,369,23,45,40,727
California,Storrie,0,0,0,0,0,0,0
California,Stonyford,260,55,100,41,6,11,213
California,Stockton,299722,87448,97052,22781,6354,12901,226536
California,Danville,43410,6909,21310,3159,252,2077,33707
California,Dana Point,34003,7803,15291,3661,514,1731,29000
California,Strathmore,2920,891,842,111,48,131,2023
California,Reedley,25092,6783,9444,1500,299,725,18751
California,Redwood Valley,2372,629,721,379,31,284,2044
California,Redwood City,81342,21774,32471,6551,1103,2827,64726
California,Pleasant Hill,34155,9256,13707,3580,339,1774,28656
California,Pleasanton,75009,14370,36492,4672,1013,2816,59363
California,Pleasure Point,5952,1760,2160,636,277,260,5093
California,Plumas Eureka,280,6,226,24,0,19,275
California,Plumas Lake,6548,1102,2805,472,46,189,4614
California,Plymouth,842,150,327,112,13,61,663
California,Planada,4392,1381,1601,182,118,123,3405
California,Point Arena,391,134,111,70,5,11,331
California,Pollock Pines,6797,1395,3054,710,57,507,5723
California,Pomona,151753,52013,48211,9658,3206,5387,118475
California,Ponderosa,87,0,87,0,0,0,87
California,Poplar-Cotton Center,2654,922,809,125,101,105,2062
California,Port Costa,311,105,140,66,0,0,311
California,Porterville,55218,14566,17713,3680,875,2600,39434
California,Point Reyes Station,600,129,195,157,0,53,534
California,Port Hueneme,22058,6537,7733,1859,530,899,17558
California,Plainview,1072,377,245,48,0,27,697
California,Placentia,52123,13605,21570,3415,724,2664,41978
California,Auburn Lake Trails,3866,536,2205,148,27,124,3040
California,August,8369,2626,2300,504,313,193,5936
California,Avalon,3777,1017,1273,296,98,202,2886
California,Avenal,14154,4899,3805,1494,727,362,11287
California,Avery,622,67,266,117,0,70,520
California,Avila Beach,1270,309,662,79,45,154,1249
California,Placerville,10471,2352,3769,1225,374,785,8505
California,Avocado Heights,15917,5182,5818,991,358,724,13073
California,Baker,831,260,226,90,23,13,612
California,Pioneer,1090,130,638,107,5,75,955
California,Piru,2061,559,822,102,20,77,1580
California,Pismo Beach,7890,1674,3574,757,282,405,6692
California,Pittsburg,66947,19363,23386,5505,1586,2656,52496
California,Pixley,3584,873,1080,101,48,133,2235
California,Azusa,48033,18921,14597,2790,820,1626,38754
California,Portola,2454,633,946,299,21,181,2080
California,Portola Valley,4515,754,2568,338,18,277,3955
California,Posey,8,0,8,0,0,0,8
California,Rancho Murieta,5563,671,3285,455,37,269,4717
California,Rancho Palos Verdes,42464,7602,22177,2764,376,2491,35410
California,Rancho San Diego,22062,5458,9860,1683,478,1253,18732
California,Rancho Santa Fe,2936,542,1584,141,26,176,2469
California,Rancho Santa Margarita,49026,10528,22475,3730,511,1134,38378
California,Rancho Tehama Reserve,2156,790,628,262,73,97,1850
California,Rancho Mirage,17770,3262,9224,2009,172,1745,16412
California,Randsburg,140,9,92,9,15,15,140
California,Red Corral,1713,476,726,67,137,62,1468
California,Redcrest,50,0,34,0,0,16,50
California,Redding,91063,22610,33858,11305,1218,5358,74349
California,Redlands,70186,19763,26551,6070,817,3089,56290
California,Redondo Beach,67695,17737,28029,6594,978,2123,55461
California,Redway,1031,302,439,72,88,0,901
California,Red Bluff,14065,3066,4592,1974,422,757,10811
California,Rancho Cucamonga,171858,48430,68024,14410,2822,5049,138735
California,Rancho Cordova,68326,18757,23988,6797,1347,2695,53584
California,Rancho Calaveras,6023,1223,3085,365,62,231,4966
California,Poso Park,6,0,6,0,0,0,6
California,Potrero,819,82,369,45,0,0,496
California,Potter Valley,520,143,183,41,0,31,398
California,Poway,49484,10402,23236,3551,609,2133,39931
California,Prattville,10,0,10,0,0,0,10
California,Princeton,198,37,117,15,0,14,183
California,Proberta,247,51,99,34,0,35,219
California,Prunedale,18932,5190,8234,1016,241,816,15497
California,Quartz Hill,10619,3100,4164,662,159,487,8572
California,Quincy,1543,426,499,298,12,169,1404
California,Rackerby,96,35,36,10,0,3,84
California,Rail Road Flat,349,32,208,54,0,19,313
California,Rainbow,1613,349,730,237,46,80,1442
California,Raisin City,234,70,50,21,2,15,158
California,Ramona,21824,5583,8934,1822,251,863,17453
California,Crescent City,7120,3286,1616,966,346,247,6461
California,Cayucos,2758,517,1407,372,40,180,2516
California,Cowan,525,124,162,75,0,45,406
California,Covelo,1346,352,432,126,13,61,984
California,Signal Hill,11332,3999,3780,778,90,283,8930
California,Sierraville,55,3,19,20,0,13,55
California,Sierra Village,521,67,284,96,0,0,447
California,Sierra Madre,11084,2223,5372,869,123,405,8992
California,Sierra City,218,38,158,6,0,16,218
California,Sierra Brooks,410,34,237,0,0,10,281
California,Silverado Resort,893,104,546,105,24,85,864
California,Shoshone,25,0,25,0,0,0,25
California,Shingle Springs,4533,1062,2357,338,159,108,4024
California,Sheridan,1567,562,533,141,0,27,1263
California,Shelter Cove,412,0,260,42,0,35,337
California,Shell Ridge,1039,100,657,14,0,10,781
California,Shaver Lake,742,143,415,40,12,21,631
California,Shasta Lake,10146,1928,3804,1523,241,474,7970
California,Shingletown,2432,391,1184,312,12,182,2081
California,Shasta,1669,223,949,129,24,85,1410
California,Silver City,0,0,0,0,0,0,0
California,Simi Valley,126103,30054,55320,10727,1419,4923,102443
California,Sonora,4827,1145,1818,667,138,296,4064
California,Sonoma,10897,2083,4411,1891,141,867,9393
California,Solvang,5456,1114,2510,540,56,532,4752
California,Soledad,25826,9682,6934,3000,691,864,21171
California,Solana Beach,13253,3358,5863,1354,152,740,11467
California,Soda Springs,59,26,33,0,0,0,59
California,Silver Lakes,5992,1072,3251,355,33,138,4849
California,Soda Bay,1429,323,728,73,1,219,1344
California,Smith River,767,158,265,56,22,23,524
California,Smith Corner,648,230,195,0,6,6,437
California,Diablo,818,39,444,55,17,70,625
California,Sleepy Hollow,2489,536,1378,176,0,54,2144
California,Sky Valley,2729,675,1134,240,18,193,2260
California,Sisquoc,291,52,111,10,0,9,182
California,Snelling,104,13,46,24,0,7,90
California,Soquel,10827,3060,4198,1161,232,171,8822
California,Cleone,648,84,362,78,9,7,540
California,Clearlake Oaks,1651,444,558,219,83,196,1500
California,Cherry Valley,6798,1463,3291,610,140,594,6098
California,Cherryland,15470,5254,4446,1251,303,631,11885
California,Cherokee Strip,243,57,67,30,16,15,185
California,Cherokee,111,16,67,0,0,8,91
California,Charter Oak,9247,2677,3285,702,136,437,7237
California,Channel Islands Beach,3072,900,1162,523,110,83,2778
California,Chester,2044,333,780,334,46,134,1627
California,Challenge-Brownsville,788,121,280,143,18,81,643
California,Cerritos,49701,12309,23850,2673,465,2838,42135
California,Ceres,46952,12473,16947,3332,624,1616,34992
California,Centerville,404,74,201,20,0,0,295
California,Cedarville,298,58,114,65,18,15,270
California,Cedar Slope,0,0,0,0,0,0,0
California,Cedar Ridge,1250,229,586,152,18,74,1059
California,Chalfant,581,133,255,35,0,30,453
California,Clearlake Riviera,2973,568,1265,450,83,138,2504
California,Chico,88455,34167,26085,9315,1106,3628,74301
California,China Lake Acres,1820,637,581,224,46,94,1582
California,Clearlake,15097,4217,4386,2371,229,1022,12225
California,Clear Creek,217,30,71,58,5,18,182
California,Clayton,11497,2459,5733,854,122,386,9554
California,Clay,1113,226,595,117,0,48,986
California,Clarksburg,472,63,213,53,7,8,344
California,Claremont,35762,11491,14112,2379,485,1712,30179
California,Chilcoot-Vinton,46,0,31,15,0,0,46
California,Citrus Heights,85408,22423,30938,10068,2334,4180,69943
California,Chula Vista,257296,67891,100528,18426,4717,10330,201892
California,Chualar,1229,422,421,27,1,9,880
California,Chowchilla,18384,6374,5154,2273,935,869,15605
California,Chino Hills,76796,18987,34517,4402,1082,2494,61482
California,Chino,82208,25237,29653,7257,2141,2808,67096
California,Chinese Camp,170,27,61,0,0,26,114
California,Citrus,11460,3676,3712,739,295,607,9029
California,Soulsbyville,2071,566,889,151,0,66,1672
California,South Dos Palos,2537,954,741,155,0,74,1924
California,South El Monte,20483,6885,6539,1049,631,1090,16194
California,Compton,97955,34735,27034,5385,2146,3655,72955
California,Comptche,73,16,34,23,0,0,73
California,Commerce,13017,4337,4187,837,283,669,10313
California,Colusa,5939,1572,2125,370,106,232,4405
California,Columbia,2597,566,1020,352,53,236,2227
California,Colton,53566,15938,16868,3641,1242,1453,39142
California,Concord,126268,32894,50986,11353,1995,5228,102456
California,Coloma,874,101,442,116,35,146,840
California,Collierville,1697,282,628,186,63,107,1266
California,College City,188,23,124,13,0,8,168
California,Colfax,2210,612,762,289,67,83,1813
California,Coleville,368,172,109,9,0,0,290
California,Cold Springs CDP (Tuolumne County),163,22,66,58,0,0,146
California,Cold Springs CDP (El Dorado County),573,150,268,74,0,6,498
California,Colma,1571,610,561,75,31,36,1313
California,Cohasset,933,252,498,114,0,0,864
California,Concow,550,102,260,80,13,18,473
California,Copperopolis,4396,879,1872,538,107,164,3560
California,Courtland,512,60,244,165,0,16,485
California,Country Club,9997,2890,3354,1277,181,474,8176
California,Coulterville,224,74,17,61,0,26,178
California,Cottonwood,3801,1020,1283,537,89,115,3044
California,Coto de Caza,14554,2403,8210,595,100,238,11546
California,Cotati,7376,2245,2668,768,153,217,6051
California,Contra Costa Centre,5940,1692,2712,742,90,155,5391
California,Costa Mesa,112377,37986,37972,10605,1833,3586,91982
California,Corralitos,2646,483,1438,209,0,58,2188
California,Coronita,3079,780,1175,245,63,179,2442
California,Coronado,24447,6734,10779,1903,282,1150,20848
California,Corona,159595,41118,65509,10151,2681,5018,124477
California,Corning,7586,1994,2402,500,138,390,5424
California,Corcoran,23216,9592,5702,2775,949,806,19824
California,Corte Madera,9595,1807,4318,1067,74,382,7648
California,Coffee Creek,142,52,69,11,0,0,132
California,Cobb,1016,210,586,31,0,14,841
California,Coarsegold,994,181,439,209,0,139,968
California,Spring Valley CDP (Lake County),1099,320,396,110,36,144,1006
California,Spring Garden,0,0,0,0,0,0,0
California,Spreckels,761,89,366,34,0,19,508
California,Spaulding,196,4,97,38,0,34,173
California,South Whittier,59358,18190,21383,3417,1265,2230,46485
California,South Taft,1740,481,475,157,38,105,1256
California,Spring Valley CDP (San Diego County),30392,7825,11190,3045,610,1048,23718
California,South San Jose Hills,21015,7219,6342,1009,659,903,16132
California,South San Francisco,66217,17997,27134,4816,963,3520,54430
California,South Pasadena,25999,7059,10439,2300,384,859,21041
California,South Oroville,6124,1888,1721,674,261,284,4828
California,South Monrovia Island,6768,2355,2339,519,107,266,5586
California,South Lake Tahoe,21437,6865,7527,2401,384,834,18011
California,South Gate,95350,33087,30112,4470,2835,3070,73574
California,South San Gabriel,8886,2650,3614,382,233,782,7661
California,Spring Valley Lake,7849,1915,3221,608,137,379,6260
California,Springville,763,100,269,195,13,80,657
California,Squaw Valley,2796,618,1211,328,48,139,2344
California,Coalinga,16940,6325,4866,1641,482,468,13782
California,Coachella,43308,12299,14500,1525,905,1011,30240
California,Clyde,751,195,451,31,11,0,688
California,Clovis,100437,25140,38733,8527,1666,3913,77979
California,Cloverdale,8735,1675,3983,844,36,334,6872
California,Clipper Mills,94,0,34,0,0,0,34
California,Clio,47,0,29,18,0,0,47
California,Stirling City,176,28,82,0,0,0,110
California,Stinson Beach,462,42,267,59,0,55,423
California,Stevinson,290,83,126,50,0,5,264
California,Stevenson Ranch,19408,4052,8375,958,398,565,14348
California,Stanton,38625,11372,13603,2929,996,1330,30230
California,Stanford,14213,10560,2402,146,29,112,13249
California,Stallion Springs,3263,676,1439,397,130,182,2824
California,Squirrel Mountain Valley,1120,284,547,120,28,36,1015
California,Covina,48587,13665,17810,3961,1083,1719,38238
California,Diablo Grande,1104,185,554,64,14,25,842
California,Healdsburg,11539,2456,5005,1372,124,700,9657
California,Diamond Springs,12459,2800,4777,1624,362,937,10500
California,Imperial,16215,3439,6234,1263,269,531,11736
California,Imperial Beach,27051,8126,8572,2920,659,1198,21475
California,Independence,657,161,278,91,11,45,586
California,Indian Falls,115,71,14,30,0,0,115
California,Indianola,909,219,355,105,7,45,731
California,Indian Wells,5158,442,3529,663,17,422,5073
California,Indio,84094,20558,32053,6442,1749,3086,63888
California,Indio Hills,1042,220,447,33,57,17,774
California,Industry,433,108,169,8,6,4,295
California,Inglewood,111411,39806,30535,8859,3258,4663,87121
California,Interlaken,6817,1944,2761,382,89,214,5390
California,Idyllwild-Pine Cove,2616,645,1255,374,29,106,2409
California,Inverness,1089,244,475,247,21,51,1038
California,Ione,7171,1615,3316,823,52,316,6122
California,Iron Horse,292,51,156,0,0,0,207
California,Irvine,238474,70112,100162,16430,2171,6396,195271
California,Irwindale,1426,446,455,92,28,62,1083
California,Isla Vista,26275,24100,1048,299,76,154,25677
California,Isleton,806,214,235,156,7,48,660
California,Ivanhoe,3837,1267,1347,243,25,146,3028
California,Jackson,4613,1111,1427,645,80,588,3851
California,Jacumba,144,0,144,0,0,0,144
California,Jamestown,2867,542,1066,340,41,330,2319
California,Jamul,5788,1353,3028,402,9,198,4990
California,Inyokern,702,50,419,55,0,122,646
California,Janesville,1486,193,895,90,6,27,1211
California,Idlewild,15,9,6,0,0,0,15
California,Hyampom,183,25,150,0,0,8,183
California,Highland,54314,15370,19221,3863,1000,1385,40839
California,Highlands-Baywood Park,4217,929,2108,251,34,192,3514
California,Hillsborough,11253,1850,6368,263,60,335,8876
California,Hilmar-Irwin,5313,1380,2368,457,0,206,4411
California,Diamond Bar,56471,15905,25524,3242,592,2574,47837
California,Hiouchi,327,98,142,20,0,52,312
California,Hollister,36529,9100,13436,2782,660,1231,27209
California,Holtville,6172,1361,2177,320,186,284,4328
California,Home Garden,1816,550,613,78,46,70,1357
California,Home Gardens,11420,3342,3951,672,193,388,8546
California,Homeland,6038,1472,2460,697,88,220,4937
California,Hydesville,1272,214,596,128,19,52,1009
California,Homestead Valley,3317,750,1155,607,44,368,2924
California,Honcut,166,44,41,61,0,0,146
California,Hood,293,77,82,14,26,50,249
California,Hoopa,2958,996,726,300,109,139,2270
California,Hopland,819,260,309,66,0,15,650
California,Hornbrook,269,65,84,28,7,8,192
California,Hornitos,51,0,28,0,0,0,28
California,Hughson,7032,1708,2229,684,102,489,5212
California,Humboldt Hill,3812,1102,1322,468,9,183,3084
California,Huntington Beach,197752,53597,81482,19012,2636,8533,165260
California,Huntington Park,59003,21357,17002,2262,1835,1935,44391
California,Huron,6792,2303,1711,237,201,163,4615
California,Homewood Canyon,8,0,0,8,0,0,8
California,Highgrove,3784,1388,1134,320,11,102,2955
California,Jenner,104,16,59,29,0,0,104
California,Johnstonville,1223,265,603,80,11,11,970
California,Moskowite Corner,202,24,81,24,22,10,161
California,Morro Bay,10471,2289,4534,1414,301,633,9171
California,Morongo Valley,3242,818,919,577,177,387,2878
California,Morgan Hill,40872,9387,18235,2698,565,1195,32080
California,Moreno Valley,200788,60627,67242,13964,5236,6013,153082
California,Moraga,16787,4282,7602,1106,152,790,13932
California,Morada,4518,659,1808,373,18,423,3281
California,Moorpark,35339,8775,16137,2258,262,956,28388
California,Monument Hills,1725,396,702,202,24,151,1475
California,Montgomery Creek,141,42,59,11,0,6,118
California,Monte Sereno,3508,578,2075,109,36,147,2945
California,Moss Beach,3704,593,1912,70,82,152,2809
California,Monte Rio,1005,494,228,129,16,48,915
California,Monterey Park,61085,17980,26111,3352,980,3825,52248
California,Monterey,28283,9114,10532,2973,375,1399,24393
California,Montecito,9471,2581,4138,722,171,470,8082
California,Montebello,63530,21783,20586,4347,1669,3636,52021
California,Montclair,38025,12634,12513,2664,941,1272,30024
California,Montara,2903,685,1341,301,41,137,2505
California,Montalvin Manor,3164,865,1253,264,47,166,2595
California,Montague,1518,333,590,168,43,41,1175
California,Monson,237,92,60,17,0,4,173
California,Monrovia,37164,10795,14294,2945,676,1419,30129
California,Mono Vista,2334,390,889,514,46,116,1955
California,Monterey Park Tract,86,34,32,0,0,0,66
California,Johannesburg,118,27,0,64,0,0,91
California,Moss Landing,153,60,33,15,27,8,143
California,Mountain Gate,1156,225,487,146,98,33,989
California,Johnsville,43,0,43,0,0,0,43
California,Joshua Tree,7357,1554,2771,1115,184,366,5990
California,Julian,1190,222,511,199,7,47,986
California,Junction City,790,147,437,49,28,19,680
California,June Lake,512,291,93,0,0,0,384
California,Jurupa Valley,98231,27230,35423,6727,2071,3422,74873
California,Keddie,58,27,11,14,0,6,58
California,Keeler,82,7,48,4,0,13,72
California,Keene,351,42,193,33,0,0,268
California,Kelly Ridge,2713,493,1156,384,54,288,2375
California,Kelseyville,3783,970,1740,152,23,149,3034
California,Mountain Center,78,0,23,0,0,5,28
California,Kennedy,3296,885,1162,227,0,90,2364
California,Kensington,5595,1186,2820,361,64,276,4707
California,Kentfield,6813,1293,3471,501,113,124,5502
California,Kenwood,1306,179,727,146,16,44,1112
California,Mount Hermon,910,235,419,107,0,0,761
California,Mount Hebron,78,14,33,0,0,15,62
California,Mountain View Acres,3578,1112,1170,455,55,122,2914
California,Mountain View,77973,22396,32195,6080,943,2261,63875
California,Mountain View,2295,592,934,220,27,128,1901
California,Mountain Ranch,1378,235,735,138,0,154,1262
California,Mountain Mesa,710,134,88,183,0,123,528
California,Mountain House,12916,2042,5681,614,213,308,8858
California,Kennedy Meadows,21,0,0,19,2,0,21
California,Hidden Valley Lake,5986,956,2826,607,0,279,4668
California,Hidden Meadows,3388,526,1942,393,0,134,2995
California,Hidden Hills,1557,317,763,74,25,68,1247
California,Nipomo,16727,3745,7147,1356,230,747,13225
California,Nipinnawasee,539,106,310,10,0,0,426
California,Niland,836,123,312,94,54,111,694
California,Nicolaus,213,29,124,16,14,8,191
California,Nice,2204,617,649,415,103,194,1978
California,Nicasio,93,15,36,15,0,3,69
California,Newport Beach,86911,21440,38172,9205,1143,4486,74446
California,New Pine Creek,59,21,12,11,0,0,44
California,Newman,10667,2549,3873,915,194,298,7829
California,Newell,307,58,108,57,0,20,243
California,New Cuyama,665,156,181,53,0,39,429
California,Norco,26966,6817,11027,2771,425,1201,22241
California,Newcastle,1416,395,551,215,8,140,1309
California,Nevada City,3101,799,1214,570,64,192,2839
California,Needles,4942,1187,1471,647,208,319,3832
California,National City,60043,18810,20472,4719,1482,3089,48572
California,Napa,79113,19098,31775,7895,1252,3571,63591
California,Myrtletown,5307,1541,1697,702,146,353,4439
California,Myers Flat,0,0,0,0,0,0,0
California,Muscoy,12417,4009,3473,425,385,353,8645
California,Murrieta,107507,23869,44035,7829,2167,4165,82065
California,Murphys,2091,391,885,315,46,228,1865
California,Muir Beach,275,58,146,41,0,6,251
California,Mount Shasta,3312,825,1189,548,52,260,2874
California,Newark,44207,11904,18921,2774,593,1885,36077
California,Mount Laguna,12,0,0,0,0,12,12
California,Nord,181,66,88,27,0,0,181
California,North Auburn,14496,3381,5876,1392,259,889,11797
California,Oakville,66,12,27,0,0,0,39
California,Oak View,4317,1295,1668,419,105,208,3695
California,Oak Shores,148,0,131,7,0,10,148
California,Oak Park,15087,2981,6991,1259,39,453,11723
California,Oakley,38243,9899,14843,2682,662,1512,29598
California,Oakland,408073,148262,126887,34849,9174,17278,336450
California,Oakhurst,2632,754,840,362,16,252,2224
California,Oak Hills,9363,2164,4591,426,181,405,7767
California,Oak Glen,776,292,253,32,31,37,645
California,Oakdale,21543,5200,7888,2359,363,819,16629
California,Nuevo,7738,2037,2845,499,66,219,5666
California,Norris Canyon,1093,210,521,2,0,15,748
California,Nubieber,16,3,0,6,0,7,16
California,Norwalk,106659,33091,37921,6232,2130,4609,83983
California,North Tustin,26454,5293,13746,1325,94,1395,21853
California,North Shore,3804,1083,1436,136,52,68,2775
California,North San Juan,295,91,52,60,0,0,203
California,North Richmond,3988,1271,1125,217,97,152,2862
California,North Lakeport,2633,565,1054,336,70,275,2300
California,North Highlands,46376,12357,15075,4769,1056,1905,35162
California,North Gate,534,114,299,29,0,12,454
California,North Fair Oaks,14793,4614,4618,1253,340,419,11244
California,North El Monte,4118,860,1915,246,17,248,3286
California,North Edwards,1014,190,393,121,0,63,767
California,Novato,54133,12490,22974,5730,809,2479,44482
California,Good Hope,8500,2965,2553,637,197,243,6595
California,Goodyears Bar,25,14,0,11,0,0,25
California,Goshen,3734,846,1280,123,22,33,2304
California,Hacienda Heights,55158,14783,24001,3347,704,2875,45710
California,Half Moon Bay,12052,2695,5973,1169,126,308,10271
California,Hamilton Branch,602,60,367,38,6,81,552
California,Hamilton City,1917,478,637,115,17,66,1313
California,Hanford,54790,12733,19864,4692,1221,2273,40783
California,Happy Camp,986,206,422,98,42,90,858
California,Harbison Canyon,4130,982,1964,389,84,149,3568
California,Hardwick,145,60,32,0,0,5,97
California,Hartland,0,0,0,0,0,0,0
California,Hartley,2908,622,1389,277,49,104,2441
California,Hasley Canyon,1144,289,492,85,22,62,950
California,Gustine,5656,1730,2265,474,13,250,4732
California,Hat Creek,267,86,157,0,0,24,267
California,Hawthorne,86564,30271,25390,6729,1975,2900,67265
California,Hayfork,2785,653,1430,342,15,141,2581
California,Hayward,152401,47562,56892,9114,2969,6563,123100
California,Heber,4370,1008,1791,125,66,135,3125
California,Hemet,82118,18916,27619,9585,2167,6642,64929
California,Herald,1210,361,524,150,26,18,1079
California,Hercules,24838,6863,10719,1796,524,929,20831
California,Herlong,1583,941,304,104,169,30,1548
California,Hermosa Beach,19747,6657,7103,1918,164,704,16546
California,Hesperia,92309,24842,31089,7506,1774,3465,68676
California,Hickman,526,106,249,46,13,12,426
California,Hawaiian Gardens,14475,4607,4970,673,290,502,11042
California,Guinda,749,299,155,26,38,34,552
California,Guerneville,3788,1321,1169,582,99,188,3359
California,Guadalupe,7218,1804,2469,384,115,232,5004
California,Graeagle,597,48,365,78,12,62,565
California,Grand Terrace,12331,3484,4849,871,328,547,10079
California,Grangeville,549,119,267,6,7,15,414
California,Granite Bay,22387,4038,11552,1642,170,825,18227
California,Granite Hills,3282,664,1839,262,0,108,2873
California,Graniteville,0,0,0,0,0,0,0
California,Grass Valley,12855,3272,3645,2287,336,1448,10988
California,Graton,1643,424,613,245,78,32,1392
California,Grayson,855,139,368,86,0,39,632
California,Greeley Hill,530,105,261,91,13,60,530
California,Greenacres,5321,1094,2353,479,35,213,4174
California,Green Acres,2460,694,650,239,60,106,1749
California,Greenfield,4347,1186,1769,243,66,53,3317
California,Greenfield,16869,4986,5575,346,325,270,11502
California,Greenhorn,180,11,82,64,0,12,169
California,Green Valley CDP (Los Angeles County),1012,277,406,110,24,86,903
California,Green Valley CDP (Solano County),1298,139,771,124,19,197,1250
California,Greenview,161,29,64,26,7,18,144
California,Greenville,997,189,284,193,42,139,847
California,Grenada,484,94,190,37,5,49,375
California,Gridley,6579,1559,2431,497,218,322,5027
California,Grimes,387,49,124,22,0,0,195
California,Grizzly Flats,880,129,417,14,60,41,661
California,Groveland,653,134,345,49,0,37,565
California,Grover Beach,13409,3962,4725,1508,395,511,11101
California,Mono City,67,0,29,1,0,10,40
California,Monmouth,209,79,52,20,3,22,176
California,Mokelumne Hill,719,189,232,41,38,0,500
California,Mojave,4297,1371,1365,263,97,196,3292
California,Lomita,20622,5925,7830,2133,401,1035,17324
California,Lompico,988,236,429,146,0,38,849
California,Lompoc,43428,12201,14077,4273,1387,1704,33642
California,London,2056,643,661,64,49,45,1462
California,Lone Pine,1923,481,670,172,57,113,1493
California,Long Barn,143,0,0,100,0,0,100
California,Long Beach,470237,168669,142856,37481,10997,17265,377268
California,Lookout,59,0,27,0,0,13,40
California,Loomis,6648,1570,2895,594,99,336,5494
California,Los Alamitos,11658,2999,4477,1129,285,508,9398
California,Los Alamos,1607,452,638,87,45,30,1252
California,Loma Rica,2584,223,1400,293,5,106,2027
California,Los Altos,30075,4490,16046,1375,150,1436,23497
California,Los Angeles,3900794,1460747,1225078,270078,89680,148573,3194156
California,Mentone,9844,2926,3392,918,199,356,7791
California,Menlo Park,33064,7973,14049,2186,383,1053,25644
California,Menifee,83442,18649,33674,8442,1483,4767,67015
California,Mendota,11402,4238,3045,397,103,314,8097
California,Mendocino,701,163,364,65,0,44,636
California,Meiners Oaks,3595,876,1496,441,67,147,3027
California,Mecca,9472,2521,3040,185,301,281,6328
California,Mead Valley,19110,5665,6501,1102,296,769,14333
California,Meadow Vista,3129,376,1820,236,64,132,2628
California,Meadow Valley,425,101,151,64,15,39,370
California,Los Altos Hills,8314,1229,4975,330,67,314,6915
California,Meadowbrook,3059,961,1082,298,50,189,2580
California,Loma Mar,149,0,77,7,0,0,84
California,Loleta,570,150,229,90,21,40,530
California,Leona Valley,1664,310,873,178,0,87,1448
California,Lewiston,1385,274,681,228,19,41,1243
California,Lexington Hills,2581,413,1291,253,11,54,2022
California,Likely,37,0,37,0,0,0,37
California,Lincoln,45038,6434,22725,3659,725,2349,35892
California,Lincoln Village,4108,1040,1632,239,21,165,3097
California,Linda,18256,4938,6027,1463,445,536,13409
California,Lindcove,494,160,207,26,7,8,408
California,Linden,1845,388,856,154,23,75,1496
California,Lindsay,12980,3595,3940,706,221,345,8807
California,Linnell Camp,875,354,169,97,34,37,691
California,Loma Linda,23751,6901,9236,1507,425,1534,19603
California,Litchfield,106,23,45,0,0,12,80
California,Little River,94,49,45,0,0,0,94
California,Littlerock,2228,884,695,8,29,60,1676
California,Little Valley,36,16,0,0,0,20,36
California,Live Oak,18038,5733,6261,1844,185,820,14843
California,Live Oak,8467,2104,2959,600,208,449,6320
California,Livermore,85286,18411,38012,7387,1283,2918,68011
California,Livingston,13611,4160,5056,649,206,336,10407
California,Lockeford,3410,801,1308,209,21,226,2565
California,Lockwood,446,88,97,37,25,25,272
California,Lodi,63589,14978,24277,5655,907,3500,49317
California,Lodoga,159,20,61,44,3,12,140
California,Little Grass Valley,0,0,0,0,0,0,0
California,Maywood,27739,9786,7932,1007,676,644,20045
California,Mayflower Village,5421,1627,2359,252,75,218,4531
California,Mayfair,4200,1461,1326,359,58,57,3261
California,McGee Creek,149,0,94,18,0,37,149
California,McFarland,13028,3593,4069,445,275,371,8753
California,Macdoel,158,99,33,5,0,0,137
California,McCloud,1175,267,533,84,10,95,989
California,McClenney Tract,6,0,4,2,0,0,6
California,McClellan Park,1098,436,95,176,17,91,815
California,McArthur,283,101,129,37,0,16,283
California,Mabie,47,0,29,18,0,0,47
California,Lytle Creek,1111,186,501,148,44,75,954
California,Lynwood,71191,25476,20300,2982,2066,2188,53012
California,Lucerne Valley,5425,1305,1687,1174,191,353,4710
California,McKinleyville,16291,4433,5954,1723,210,553,12873
California,Lucerne,3162,654,866,435,37,363,2355
California,Loyola,3539,530,2069,73,30,122,2824
California,Loyalton,890,211,391,73,15,44,734
California,Lower Lake,1639,375,611,311,75,37,1409
California,Lost Hills,2126,493,707,27,40,30,1297
California,Los Ranchos,1687,186,968,43,0,162,1359
California,Los Osos,15388,3267,7624,1415,158,921,13385
California,Los Olivos,1007,186,551,79,8,52,876
California,Los Molinos,2149,612,815,180,30,177,1814
California,Los Gatos,30398,6361,14254,2922,388,1076,25001
California,Los Berros,908,147,473,0,0,29,649
California,Los Banos,36847,9668,12578,2076,871,1141,26334
California,Lucas Valley-Marinwood,6250,1076,2954,796,29,340,5195
California,McKittrick,115,25,49,22,4,1,101
California,McSwain,4562,883,2370,289,23,132,3697
California,Madera,63053,19126,19666,3162,987,2046,44987
California,Maxwell,1033,189,404,63,10,63,729
California,Mather,4425,896,1841,388,135,106,3366
California,Matheny,1043,287,317,98,28,23,753
California,Marysville,12161,2895,3940,1516,206,761,9318
California,Martinez,37300,9806,15346,4450,640,1462,31704
California,Martell,234,77,73,0,0,0,150
California,Markleeville,205,60,67,46,0,4,177
California,Mariposa,1580,321,574,278,20,93,1286
California,Marin City,3048,812,924,310,74,108,2228
California,Marina del Rey,9289,3593,2659,1444,415,356,8467
California,Marina,20537,6534,7005,1929,387,872,16727
California,Maricopa,1221,325,402,141,4,58,930
California,March ARB,1004,249,370,88,32,202,941
California,Manton,423,68,185,37,8,15,313
California,Manteca,72251,17504,28813,5592,1363,2610,55882
California,Manila,724,317,146,147,21,50,681
California,Manhattan Beach,35603,8265,16239,2427,277,1050,28258
California,Manchester,226,67,85,6,7,6,171
California,Mammoth Lakes,8104,3318,2450,889,75,0,6732
California,Malibu,12856,2984,5811,1488,251,660,11194
California,Malaga,862,283,275,21,0,48,627
California,Magalia,11306,2560,4511,1387,214,814,9486
California,Mad River,482,125,189,71,0,27,412
California,Madison,555,157,216,75,0,0,448
California,Madera Acres,9747,2435,4007,358,149,300,7249
California,Lenwood,3844,1023,1123,453,20,103,2722
California,Oasis,5182,1405,1800,102,90,109,3506
California,Lennox,21850,7556,6758,759,539,485,16097
California,Lemoore,24974,7021,8315,1771,586,702,18395
California,Kettleman City,1651,412,653,27,45,57,1194
California,Keyes,6669,1680,1990,638,197,233,4738
California,King City,13389,4232,4146,423,164,533,9498
California,Kings Beach,3620,1241,1318,391,33,76,3059
California,Kingsburg,11681,2818,4573,754,237,603,8985
California,Kingvale,129,40,89,0,0,0,129
California,Kirkwood,75,65,8,2,0,0,75
California,Klamath,954,279,284,159,26,75,823
California,Knightsen,1531,304,715,146,0,60,1225
California,Knights Landing,1214,391,295,92,0,78,856
California,La Cañada Flintridge,20526,4747,10353,845,124,742,16811
California,Keswick,454,84,164,55,0,50,353
California,La Crescenta-Montrose,19940,4628,9040,1560,211,732,16171
California,Ladera Heights,7509,1992,2799,924,95,638,6448
California,Ladera Ranch,26714,3775,12593,957,287,274,17886
California,Lafayette,25082,4774,12527,1539,251,939,20030
California,Laguna Beach,23230,5572,10444,3137,351,726,20230
California,Laguna Hills,31017,7954,14128,2320,378,1260,26040
California,Laguna Niguel,64825,13742,31048,5698,990,2055,53533
California,Laguna Woods,16359,1313,7353,3162,183,4348,16359
California,Lagunitas-Forest Knolls,1485,451,538,271,0,41,1301
California,La Habra,61725,17884,22561,4357,1149,2739,48690
California,La Habra Heights,5425,936,3056,397,12,270,4671
California,La Honda,640,290,202,113,0,18,623
California,Ladera,1461,71,830,48,0,30,979
California,Lake Almanor Country Club,507,14,352,78,0,63,507
California,Kernville,1443,115,876,241,3,57,1292
California,Merced,81120,23715,24265,6879,1730,3154,59743
California,Mohawk Vista,85,0,29,28,0,0,57
California,Modesto,207482,56835,74464,19058,4169,8934,163460
California,Mi-Wuk Village,1191,312,435,32,82,106,967
California,Mission Viejo,95979,20565,46890,7123,802,4776,80156
California,Mission Hills,3679,898,1805,220,29,69,3021
California,Mission Canyon,2520,607,1270,168,37,97,2179
California,Miranda,525,245,100,45,0,0,390
California,Mira Monte,6990,1509,3274,810,126,422,6141
California,Minkler,1200,243,579,21,27,114,984
California,Mineral,199,29,122,6,3,8,168
California,Milpitas,71533,18722,32182,4113,1071,2490,58578
California,Kerman,14285,3630,4792,720,213,567,9922
California,Millville,821,97,414,69,0,31,611
California,Millbrae,22416,5379,10129,1629,211,1624,18972
California,Milford,192,24,168,0,0,0,192
California,Midway City,9500,3297,3196,643,138,607,7881
California,Midpines,826,124,488,78,1,42,733
California,Middletown,953,223,442,74,0,65,804
California,Mexican Colony,242,61,61,22,0,7,151
California,Mettler,108,43,24,15,0,2,84
California,Mesa Vista,208,37,102,24,7,13,183
California,Mesa Verde,739,215,265,60,16,33,589
California,Mesa,301,69,150,45,0,8,272
California,Meridian,500,103,188,67,2,36,396
California,Mill Valley,14243,2481,6618,1290,178,735,11302
California,Lake Almanor Peninsula,485,90,298,9,4,27,428
California,Lake Almanor West,239,13,200,0,0,26,239
California,Lake Arrowhead,11333,2188,5104,865,244,571,8972
California,La Porte,0,0,0,0,0,0,0
California,La Presa,36875,10359,13129,3143,760,1582,28973
California,La Puente,40496,12968,13520,1799,1379,1439,31105
California,La Quinta,39301,7577,18985,3966,484,1395,32407
California,La Riviera,11062,3521,3740,1268,158,448,9135
California,Larkfield-Wikiup,9090,2408,3430,1121,153,394,7506
California,Larkspur,12219,2563,5238,1685,110,741,10337
California,La Selva Beach,2708,553,1252,306,14,191,2316
California,Las Flores CDP (Orange County),6339,1210,3043,238,49,76,4616
California,Las Flores CDP (Tehama County),191,51,82,12,10,7,162
California,Las Lomas,2952,787,1142,144,23,73,2169
California,La Palma,15842,4098,7075,976,237,823,13209
California,Lathrop,19678,5078,7602,1212,375,513,14780
California,La Verne,31920,8030,13290,2695,487,1997,26499
California,La Vina,409,139,149,0,0,0,288
California,Lawndale,33231,10847,10689,2553,611,913,25613
California,Laytonville,1274,376,330,156,10,113,985
California,Lebec,1187,235,424,186,13,48,906
California,Lee Vining,90,17,73,0,0,0,90
California,Leggett,74,18,15,10,0,0,43
California,Le Grand,1800,571,610,95,39,52,1367
California,Lemon Cove,260,40,148,23,0,10,221
California,Lemon Grove,26225,7750,8659,3070,514,1102,21095
California,Lemon Hill,13128,3810,3707,1114,450,629,9710
California,Laton,1473,458,497,123,41,56,1175
California,Lancaster,159774,49884,51685,11101,3543,5136,121349
California,Lanare,304,37,95,47,10,20,209
California,Lamont,15941,4671,5020,637,272,279,10879
California,Lake California,2979,413,1469,255,103,90,2330
California,Lake City,23,7,4,0,3,9,23
California,Lake Davis,26,0,26,0,0,0,26
California,Lake Don Pedro,1054,89,669,84,0,102,944
California,Lake Elsinore,58003,14320,21725,3769,1273,1507,42594
California,Lake Forest,79928,19753,35796,6126,935,2353,64963
California,Lakehead,673,103,283,141,0,24,551
California,Lake Hughes,395,113,103,107,6,40,369
California,Lake Isabella,2966,674,1445,380,56,141,2696
California,Lakeland Village,11995,3335,4045,1273,255,459,9367
California,Lake Los Angeles,12136,3824,4276,593,192,327,9212
California,Lake Mathews,5511,1535,2012,748,74,232,4601
California,Lake Nacimiento,2910,304,1531,304,47,110,2296
California,Lake of the Pines,3627,820,1789,364,13,238,3224
California,Lake of the Woods,753,134,378,127,42,36,717
California,Lakeport,4740,1157,1752,723,87,285,4004
California,Lake Riverside,876,150,367,108,20,28,673
California,Lake San Marcos,4798,631,2030,661,16,920,4258
California,Lake Sherwood,1769,459,864,197,13,31,1564
California,Lakeside,21413,5035,8836,2034,251,1077,17233
California,Lakeview,2142,628,833,155,27,37,1680
California,Lake Wildwood,5375,884,3025,459,11,378,4757
California,Lakewood,81173,22337,32054,6747,1362,3563,66063
California,La Mesa,58858,16133,20702,7570,654,3505,48564
California,La Mirada,49182,14760,20563,2723,585,2396,41027
California,Lemoore Station,6875,1446,3194,113,43,70,4866
California,Occidental,1159,222,661,115,10,40,1048
California,Flournoy,139,32,74,2,0,2,110
California,Oceanside,173050,45070,69675,15899,2668,7761,141073
California,Petaluma,59340,13771,24233,6270,763,2531,47568
California,Pescadero,1026,172,477,67,0,0,716
California,Perris,72547,20753,22812,4505,1456,1980,51506
California,Penryn,767,81,448,20,22,33,604
California,Penn Valley,1843,584,718,268,0,69,1639
California,Penngrove,2799,465,1318,370,0,42,2195
California,Pearsonville,25,0,11,0,0,14,25
California,Paynes Creek,70,9,19,22,0,18,68
California,Paxton,0,0,0,0,0,0,0
California,Patton Village,575,103,192,41,27,69,432
California,Patterson Tract,1905,441,797,71,0,91,1400
California,Patterson,20967,5154,7190,1524,586,356,14810
California,Paskenta,84,5,32,16,5,9,67
California,Pasatiempo,1210,250,717,45,0,44,1056
California,Pasadena,139899,46163,51008,11254,2915,6998,118338
California,Parlier,14870,4779,4507,500,294,357,10437
California,Parkwood,2994,1091,611,126,105,218,2151
California,Parkway,15369,4532,4341,1282,566,550,11271
California,Parksdale,3280,1206,919,177,26,36,2364
California,Parklawn,1405,356,627,71,12,7,1073
California,Paramount,55023,17555,17723,2989,1412,1556,41235
California,Paradise Park,515,91,327,36,0,28,482
California,Paradise,170,39,76,24,4,11,154
California,Paradise,26289,6047,10358,3520,425,2335,22685
California,Panorama Heights,31,8,15,0,4,4,31
California,Palo Verde,56,0,0,9,0,47,56
California,Palos Verdes Estates,13614,2370,7842,375,43,660,11290
California,Palo Cedro,1543,207,776,111,10,88,1192
California,Palo Alto,66478,14880,31154,4436,634,2895,53999
California,Peters,440,70,238,32,0,10,350
California,Palm Springs,46305,15960,14828,6581,809,3268,41446
California,Phelan,13719,3371,5800,1460,278,537,11446
California,Philo,341,123,101,25,12,9,270
California,El Rancho,97,21,27,19,0,22,89
California,El Rio,7080,2154,2393,488,189,126,5350
California,El Segundo,16929,4854,6736,1673,157,507,13927
California,El Sobrante CDP (Contra Costa County),13388,3616,5409,1319,281,449,11074
California,El Sobrante CDP (Riverside County),15788,3364,7299,690,73,170,11596
California,El Verano,4008,810,1878,452,70,84,3294
California,Elverta,5551,1348,2361,447,172,226,4554
California,Emerald Lake Hills,4495,760,2494,319,27,98,3698
California,Emeryville,10830,4801,3247,1133,184,626,9991
California,Empire,4675,1169,1565,384,34,201,3353
California,Encinitas,61682,15066,27714,5114,623,2270,50787
California,Escalon,7320,1893,2595,859,330,354,6031
California,Escondido,149079,41859,55159,11263,2747,5871,116899
California,Esparto,3298,503,1435,268,75,153,2434
California,Etna,717,125,267,100,34,49,575
California,Pi?on Hills,6969,1576,3102,827,75,535,6115
California,Pinole,18922,4694,7872,1545,498,1116,15725
California,Pine Valley,1754,306,794,199,30,70,1399
California,Pine Mountain Lake,2471,308,1448,279,13,151,2199
California,Pine Mountain Club,1774,562,681,220,45,91,1599
California,Pine Hills,3167,672,1420,256,99,101,2548
California,Pine Grove,1578,280,807,209,23,136,1455
California,Pine Flat,143,20,55,36,5,16,132
California,Pine Canyon,1866,620,741,106,12,60,1539
California,Pike,133,14,29,60,0,7,110
California,Pierpoint,25,0,25,0,0,0,25
California,Piedmont,11099,1615,6086,353,76,361,8491
California,Pico Rivera,63839,20392,22118,3963,1514,2739,50726
California,Phoenix Lake,4741,691,2746,266,24,264,3991
California,Phillipsville,71,0,0,51,0,20,71
California,El Portal,467,86,221,0,14,11,332
California,Palm Desert,50565,10805,21942,5888,1178,4018,43831
California,Palermo,5895,1402,2260,698,144,305,4809
California,Farmersville,10704,3199,3495,493,129,299,7615
California,Farmington,80,0,39,0,0,41,80
California,Fellows,79,15,45,4,2,1,67
California,Felton,3991,994,1833,383,13,100,3323
California,Ferndale,1354,278,567,207,32,115,1199
California,Fetters Hot Springs-Agua Caliente,5019,1286,1998,401,62,128,3875
California,Fiddletown,83,6,64,13,0,0,83
California,Fieldbrook,823,159,421,75,2,34,691
California,Waterford,8649,2290,3230,545,160,187,6412
California,Waterloo,524,60,323,31,0,31,445
California,Watsonville,52543,15932,17873,2960,660,1645,39070
California,Waukena,191,51,72,2,10,2,137
California,Wawona,323,56,127,42,0,0,225
California,Weaverville,3151,420,1284,651,52,233,2640
California,Weed,2823,1078,680,323,8,166,2255
California,Weedpatch,2328,710,678,134,90,84,1696
California,Weldon,2752,327,1271,464,119,210,2391
California,Weott,237,108,116,0,0,13,237
California,West Athens,8320,3520,2190,588,307,391,6996
California,West Bishop,2873,526,1543,163,63,126,2421
California,West Carson,21437,5878,8531,1921,370,1485,18185
California,West Covina,107837,32360,41402,7182,1814,5168,87926
California,West Goshen,675,178,213,33,9,8,441
California,Westhaven-Moonstone,1031,278,417,165,36,34,930
California,West Hollywood,35332,20601,7796,3697,325,1643,34062
California,Westlake Village,8471,1631,4299,802,110,440,7282
California,Westley,759,141,247,22,0,10,420
California,West Menlo Park,3799,754,1696,260,38,96,2844
California,Westminster,91719,26108,37839,6433,1771,4571,76722
California,Fall River Mills,548,223,181,8,0,35,447
California,Palmdale,156672,45020,52409,10279,3256,4681,115645
California,Fallbrook,31573,7241,13873,2301,621,1325,25361
California,Fair Oaks,31537,7206,13713,3480,387,1766,26552
California,Pala,999,296,239,61,30,26,652
California,Pajaro Dunes,320,39,182,38,0,23,282
California,Pajaro,3230,814,1135,111,72,34,2166
California,Pacific Grove,15505,4065,6392,1756,247,940,13400
California,Pacifica,38665,10374,16192,3572,394,1646,32178
California,Pacheco,4282,1397,1528,587,117,106,3735
California,Oxnard,203495,59775,71008,14129,3808,6490,155210
California,Oroville East,8136,1606,3400,1014,116,542,6678
California,Oroville,16060,4695,4156,2103,572,930,12456
California,Orosi,8796,2643,3063,192,177,178,6253
California,Orland,7488,1532,2838,681,252,245,5548
California,Orinda,18703,3104,10510,771,87,727,15199
California,Orick,267,84,85,73,0,20,262
California,Orcutt,29908,5976,13734,2498,327,1554,24089
California,Orangevale,34836,8063,13926,4068,818,1653,28528
California,Orange Cove,9565,2850,2740,218,229,302,6339
California,Adin,173,34,84,15,0,18,151
California,Adelanto,32059,9289,8806,2110,826,855,21886
California,Acton,7058,1319,3665,566,35,238,5823
California,Acampo,787,416,286,18,0,0,720
California,Acalanes Ridge,1139,276,508,83,41,15,923
California,Eucalyptus Hills,5292,551,2540,336,120,193,3740
California,Eureka,26985,9620,8341,2869,738,1193,22761
California,Oceano,7857,2344,2687,748,189,368,6336
California,Fairbanks Ranch,2939,514,1621,164,0,210,2509
California,Fairfax,7584,1779,3240,836,106,394,6355
California,Fairfield,109468,28357,42819,8876,1654,4299,86005
California,Fairhaven,222,94,85,14,3,10,206
California,Fairmead,2187,712,574,168,43,83,1580
California,Fairview,10568,3162,4104,1013,100,581,8960
California,West Modesto,6041,1887,1645,459,81,227,4299
California,El Paso de Robles (Paso Robles),30863,7057,13161,2330,603,1336,24487
California,El Monte,115711,37544,41439,5454,3164,5440,93041
California,East Orosi,572,145,150,38,6,15,354
California,East Palo Alto,29198,10173,8979,1647,705,736,22240
California,East Pasadena,6063,1494,2678,385,189,227,4973
California,East Porterville,6395,1843,1853,310,156,264,4426
California,Traver,711,204,212,36,10,43,505
California,Tres Pinos,472,102,192,57,7,9,367
California,Trinidad,219,40,111,36,0,19,206
California,Trinity Center,211,0,150,14,6,23,193
California,Trinity Village,221,44,107,41,5,15,212
California,Trona,0,0,0,0,0,0,0
California,Trowbridge,220,41,77,28,0,14,160
California,Truckee,16184,3712,7597,1091,185,275,12860
California,Tulare,61204,15506,21319,4258,1110,2339,44532
California,Tulelake,1000,267,360,98,12,58,795
California,Tuolumne City,1763,577,549,158,58,138,1480
California,Tupman,206,78,52,14,4,4,152
California,Turlock,70596,18862,25960,5775,1137,3385,55119
California,Tustin,78787,23062,29555,5722,1613,2247,62199
California,Tuttle,0,0,0,0,0,0,0
California,Tuttletown,1068,125,697,29,12,70,933
California,Twain,31,0,0,0,0,31,31
California,Twain Harte,2297,555,1207,225,0,176,2163
California,Twentynine Palms,25769,6764,9668,2025,485,575,19517
California,Twin Lakes,5201,1485,2006,632,56,338,4517
California,Ukiah,15936,4249,4983,2450,242,792,12716
California,Union City,72690,19015,33007,3508,740,3308,59578
California,University of California-Davis,6865,5987,577,53,0,2,6619
California,University of California-Merced,0,0,0,0,0,0,0
California,Upland,75542,21352,28752,6649,1467,3188,61408
California,Easton,1964,477,814,173,48,78,1590
California,Upper Lake,712,235,225,69,0,50,579
California,East Oakdale,2882,372,1748,167,52,125,2464
California,East Los Angeles,125415,45602,37144,5366,3544,4986,96642
California,Dillon Beach,139,23,30,21,7,35,116
California,Dinuba,23243,6944,7274,1038,713,637,16606
California,Discovery Bay,14650,2772,7142,990,94,340,11338
California,Dixon,18908,4260,7830,1229,293,568,14180
California,Dixon Lane-Meadow Creek,2636,394,1213,230,28,306,2171
California,Dobbins,689,195,216,141,0,12,564
California,Dogtown,2337,324,1308,182,44,156,2014
California,Dollar Point,1135,370,431,171,6,18,996
California,Dorrington,286,43,202,26,9,5,285
California,Dorris,930,170,345,56,33,57,661
California,Dos Palos,5068,1332,1914,212,68,209,3735
California,Dos Palos Y,215,66,58,26,14,19,183
California,Douglas City,613,98,198,87,4,52,439
California,Downey,113407,35123,39161,7779,2693,4936,89692
California,Downieville,213,14,86,38,0,20,158
California,Doyle,452,0,232,118,18,44,412
California,Drytown,217,63,105,9,33,4,214
California,Duarte,21769,6220,8072,1836,344,1550,18022
California,Dublin,52063,11271,23726,3750,942,1489,41178
California,Ducor,661,162,262,6,7,8,445
California,Dunnigan,1183,211,587,96,22,49,965
California,Dunsmuir,1552,338,571,268,49,112,1338
California,Durham,5637,1360,2427,459,18,236,4500
California,Dustin Acres,523,116,191,73,32,15,427
California,Dutch Flat,162,22,86,30,5,6,149
California,Eagleville,74,12,33,17,0,4,66
California,Earlimart,8709,2504,2646,217,190,246,5803
California,East Foothills,6437,1230,3488,378,39,248,5383
California,East Hemet,19180,5015,6744,1668,417,838,14682
California,East Nicolaus,213,30,105,31,3,10,179
California,El Nido,515,188,175,12,0,8,383
California,Vacaville,94795,25091,35778,10192,2166,3594,76821
California,Vallecito,482,108,165,27,0,52,352
California,Warm Springs,3190,494,1128,409,157,87,2275
California,Warner Valley,4,0,0,0,0,4,4
California,Wasco,25973,9636,7443,1568,550,711,19908
California,Washington,24,0,0,24,0,0,24
California,East Quincy,2827,588,1120,393,75,179,2355
California,East Rancho Dominguez,15615,5854,4395,805,405,447,11906
California,East Richmond Heights,3272,844,1297,479,28,185,2833
California,East San Gabriel,15980,4014,7145,969,180,920,13228
California,East Shore,225,57,148,0,0,20,225
California,East Sonora,2368,367,978,397,14,424,2180
California,East Tulare Villa,954,229,404,89,0,7,729
California,Eastvale,56275,12388,24263,2486,852,1149,41138
California,East Whittier,10440,2856,4239,645,198,543,8481
California,Edgewood,27,0,20,0,0,0,20
California,Edmundson Acres,343,92,113,6,19,6,236
California,Edna,176,61,67,35,0,0,163
California,Edwards AFB,2401,224,1179,20,7,0,1430
California,El Cajon,102383,29627,34543,9999,1686,5165,81020
California,El Centro,43570,12029,14595,3162,1281,2052,33119
California,El Cerrito,24418,6011,11427,1822,213,1350,20823
California,El Cerrito,5581,1548,2318,414,77,245,4602
California,El Dorado Hills,43264,7298,21731,2702,333,1266,33330
California,Eldridge,1287,327,471,140,0,15,953
California,El Granada,5681,1168,2793,517,55,182,4715
California,Elizabeth Lake,1735,367,872,128,11,47,1425
California,Elk Creek,151,42,84,13,0,8,147
California,Elk Grove,161084,37121,66910,11915,2410,6100,124456
California,Elkhorn,1139,323,598,81,0,55,1057
California,Elmira,345,43,123,37,0,19,222
California,Walnut Park,16054,5856,5249,768,494,591,12958
California,Valinda,24026,8051,8362,1419,483,947,19262
California,Walnut Grove,1253,313,504,73,90,78,1058
California,Walnut,29970,7913,15097,1118,161,1213,25502
California,Vallejo,118995,38515,39662,11618,2905,5678,98378
California,Valle Vista,16127,3647,5876,2258,326,816,12923
California,Valley Acres,584,153,292,27,0,37,509
California,Valley Center,10261,2000,4810,757,212,321,8100
California,Valley Ford,155,59,34,32,0,0,125
California,Valley Home,290,89,126,34,17,16,282
California,Valley Ranch,44,0,44,0,0,0,44
California,Valley Springs,3321,782,1732,371,21,158,3064
California,Valley Wells,0,0,0,0,0,0,0
California,Val Verde,2697,881,944,244,45,22,2136
California,Vandenberg AFB,3317,472,1612,44,22,7,2157
California,Vandenberg Village,6763,1230,3106,589,74,453,5452
California,Verdi,107,45,28,13,0,21,107
California,Vernon,41,10,22,3,2,1,38
California,Victor,592,54,158,34,0,25,271
California,Victorville,120703,33395,37338,9865,3369,4026,87993
California,View Park-Windsor Hills,11648,3272,4180,1592,187,606,9837
California,Villa Park,5947,1280,3065,329,46,370,5090
California,Vina,181,79,30,56,0,8,173
California,Vincent,17006,4969,6741,876,340,642,13568
California,Vine Hill,4144,1307,1426,430,43,177,3383
California,Vineyard,26452,6064,10967,1729,367,906,20033
California,Visalia,127842,32236,46137,11413,1874,4854,96514
California,Vista,97564,29808,35408,8276,1084,3323,77899
California,Vista Santa Rosa,3173,794,1228,95,59,73,2249
California,Volcano,20,0,0,20,0,0,20
California,Volta,172,50,84,0,0,19,153
California,Walker,832,74,411,152,0,44,681
California,Wallace,877,287,442,0,43,105,877
California,Walnut Creek,66799,15199,30430,6200,577,5293,57699
California,Westmont,32566,13245,6656,2178,869,1341,24289
California,Exeter,10481,2733,3673,761,174,447,7788
California,Fortuna,11904,2830,4674,1110,240,678,9532
California,Woodcrest,16049,4174,7532,1030,187,581,13504
California,Woodbridge,3705,743,1854,295,107,157,3156
California,Woodacre,1623,246,681,321,13,200,1461
California,Wofford Heights,1684,267,1007,230,29,151,1684
California,Winton,11669,2916,4077,560,273,184,8010
California,Winters,6927,1596,3350,433,85,204,5668
California,Winterhaven,171,52,0,18,0,69,139
California,Winter Gardens,20703,4964,8408,2246,236,870,16724
California,Windsor,27205,5902,12262,2064,439,1218,21885
California,Winchester,2824,777,1046,181,41,334,2379
California,Wilton,5030,934,2615,311,96,277,4233
California,Wilsonia,0,0,0,0,0,0,0
California,Willows,6111,1428,2139,692,75,374,4708
California,Willow Creek,1553,282,601,334,27,17,1261
California,Willowbrook,20685,7322,5341,707,692,517,14579
California,Williams,5159,1307,2289,262,82,142,4082
California,Wilkerson,557,108,333,18,6,0,465
California,Wildomar,34220,9524,13080,2663,746,1235,27248
California,Whittier,86688,27369,30882,6124,1602,3927,69904
California,Whitley Gardens,280,57,162,17,25,0,261
California,Whitewater,611,126,172,83,0,21,402
California,Whitehawk,44,0,39,0,0,5,44
California,Wheatland,3543,1027,1505,206,30,100,2868
California,Westwood,1595,286,634,178,46,112,1256
California,West Whittier-Los Nietos,27114,9211,9426,1838,673,1156,22304
California,Westside,279,111,67,25,0,0,203
California,West Sacramento,50747,13608,17993,4902,1129,1965,39597
California,West Rancho Dominguez,22605,7857,6172,1452,862,1342,17685
California,West Puente Valley,24077,7799,8325,1534,631,1291,19580
California,Woodlake,7525,2102,2404,557,115,263,5441
California,Woodland,56997,13635,22497,4939,1080,2521,44672
California,Woodlands,632,24,434,57,32,52,599
California,Woodside,5479,961,2865,349,65,237,4477
California,Fountain Valley,56696,14649,25015,4669,658,2552,47543
California,Foster City,32377,6241,16643,1834,342,1307,26367
California,Fort Washington,734,92,355,0,0,0,447
California,Fort Jones,978,225,328,80,17,41,691
California,Fort Irwin,9238,1757,4057,110,14,15,5953
California,Fort Dick,918,278,351,96,0,44,769
California,Fort Bragg,7261,1938,2421,772,100,398,5629
California,Fort Bidwell,204,94,41,17,3,12,167
California,Forestville,3367,1267,1186,456,106,159,3174
California,Forest Ranch,831,72,514,140,0,42,768
California,Forest Meadows,1568,266,723,175,51,159,1374
California,Foresthill,1124,215,450,228,0,26,919
California,Ford City,4085,1248,1189,322,71,223,3053
California,Forbestown,344,0,177,51,0,0,228
California,West Point,628,147,240,123,0,71,581
California,Foothill Farms,33090,8928,11065,3599,870,1248,25710
California,Folsom,74156,16394,32314,7087,895,2744,59434
California,Floriston,40,0,26,8,0,6,40
California,Florin,50899,14365,16280,4670,1713,2130,39158
California,Florence-Graham,63177,22216,17943,2325,1892,1803,46179
California,Fish Camp,51,17,9,13,0,12,51
California,Firebaugh,8084,2965,2318,208,110,224,5825
California,Fillmore,15296,4002,5530,1020,124,622,11298
California,Fields Landing,229,72,146,0,0,0,218
California,Yorba Linda,67033,13593,34066,3380,520,2833,54392
California,Yolo,577,106,225,43,18,0,392
California,Yettem,300,196,0,0,24,0,220
California,Yankee Hill,270,72,107,69,3,10,261
California,Wrightwood,4442,992,1663,539,22,132,3348
California,Woodville,1798,489,676,45,4,60,1274
California,Fontana,203677,60285,70633,11903,3831,5652,152304
California,West Park,717,221,308,29,44,22,624
California,Willits,4853,1159,1540,670,99,569,4037
California,Friant,244,66,62,44,0,72,244
California,Galt,24607,5583,9516,2254,248,883,18484
California,Furnace Creek,187,91,44,28,6,18,187
California,Fulton,638,129,323,30,0,10,492
California,Fullerton,138976,43373,52802,9199,2485,5397,113256
California,Fuller Acres,970,302,290,46,38,17,693
California,Fruitridge Pocket,5725,1931,1522,309,223,287,4272
California,Onyx,604,196,241,106,0,29,572
California,Ontario,168218,51079,57269,11903,4150,5513,129914
California,Olivehurst,14293,3831,4688,1448,272,508,10747
California,Old Station,109,32,30,22,0,0,84
California,Old Fig Garden,5493,1346,2105,584,62,419,4516
California,Olancha,152,0,89,18,0,41,148
California,Ojai,7587,1409,3154,965,113,399,6040
California,Garberville,988,358,258,210,5,28,859
California,Oildale,33842,9457,9374,4582,1018,1534,25965
California,Fruitdale,980,265,418,85,10,31,809
California,Westmorland,1750,406,601,76,66,109,1258
California,Fresno,510451,155205,155053,42511,11862,18922,383553
California,French Valley,27752,5878,11609,1680,408,685,20260
California,French Gulch,494,124,202,59,12,39,436
California,French Camp,4057,1918,1121,359,122,52,3572
California,Fremont,225221,48433,109211,12130,2513,8090,180377
California,Freeport,51,0,14,23,0,0,37
California,Freedom,3027,887,1063,157,24,141,2272
California,Frazier Park,2654,389,1061,297,58,59,1864
California,Franklin CDP (Sacramento County),97,55,17,25,0,0,97
California,Franklin CDP (Merced County),7511,2028,2697,500,46,287,5558
California,Fowler,6006,1712,1770,395,247,319,4443
California,Ocotillo,252,100,34,39,0,25,198
California,Gardena,59931,17473,21812,4946,1690,3145,49066
California,Orange,139761,44821,53053,10108,1992,5061,115035
California,Garden Farms,265,30,158,36,0,0,224
California,Zayante,881,253,327,89,31,17,717
California,Yucca Valley,21258,4731,7355,2571,556,1850,17063
California,Yucaipa,52739,12015,21981,4925,877,2430,42228
California,Yuba City,66038,15347,26886,5934,878,2762,51807
California,Garden Acres,11278,3313,3929,725,318,370,8655
California,Yountville,2985,403,1104,555,26,664,2752
California,Yosemite Valley,1067,582,279,107,19,0,987
California,Yosemite Lakes,4990,866,2824,209,73,169,4141
California,Gonzales,8378,2316,2888,132,75,263,5674
California,Goleta,30541,9034,11891,2265,521,1634,25345
California,Gold River,7639,1083,4349,628,107,413,6580
California,Gold Mountain,21,0,21,0,0,0,21
California,Golden Hills,8313,1671,3642,601,169,330,6413
California,Yreka,7635,1546,2886,837,119,518,5906
California,Glen Ellen,593,78,281,133,60,20,572
California,Garden Grove,174721,51334,67389,11427,3254,7692,141096
California,Garey,170,86,69,10,0,5,170
California,Gasquet,596,98,286,34,0,35,453
California,Gazelle,56,9,26,10,1,6,52
California,Georgetown,2473,350,1076,263,50,152,1891
California,Garnet,6844,1741,2542,431,94,146,4954
California,Gerber,1129,290,464,123,8,50,935
California,Geyserville,1088,271,473,118,2,39,903
California,Gilroy,51649,13442,20026,3286,1118,1434,39306
California,Glendale,196984,55588,83631,13371,3479,11451,167520
California,Glendora,51137,14013,20710,3864,765,2564,41916
Colorado,Montrose,18970,3543,8338,2297,325,1056,15559
Colorado,Milliken,5975,1087,2973,315,0,72,4447
Colorado,Minturn,1050,402,353,77,9,55,896
Colorado,Moffat,131,20,58,39,0,8,125
Colorado,Monte Vista,4366,856,1702,488,25,325,3396
Colorado,Castle Pines Village,4504,665,2566,101,9,84,3425
Colorado,Montezuma,57,8,35,4,0,0,47
Colorado,Midland,163,49,83,5,15,0,152
Colorado,Monument,6252,1048,3022,270,77,83,4500
Colorado,Mount Crested Butte,859,306,326,88,9,35,764
Colorado,Morrison,394,61,142,70,6,88,367
Colorado,Mountain Meadows,192,40,85,52,0,0,177
Colorado,Mountain View,607,152,170,142,18,23,505
Colorado,Mountain Village,1405,564,464,148,26,4,1206
Colorado,Mulford,169,11,101,0,9,8,129
Colorado,Nederland,1531,448,498,190,39,30,1205
Colorado,Naturita,461,96,186,83,18,34,417
Colorado,Merino,245,78,58,39,6,19,200
Colorado,Morgan Heights,386,67,248,0,0,30,345
Colorado,Meridian,3107,814,1215,573,19,90,2711
Colorado,Aguilar,660,159,327,37,8,44,575
Colorado,Mead,3967,496,2081,242,53,55,2927
Colorado,Aetna Estates,1165,337,415,76,0,0,828
Colorado,Acres Green,2921,720,1370,239,0,67,2396
Colorado,New Castle,4569,792,2017,371,0,158,3338
Colorado,Carbondale,6516,1543,2579,708,175,191,5196
Colorado,Louviers,152,10,94,6,0,28,138
Colorado,Cascade-Chipita Park,1561,260,725,278,57,27,1347
Colorado,Castle Pines,10399,1289,5548,724,11,172,7744
Colorado,Loveland,71755,15156,31175,7537,658,3377,57903
Colorado,Meeker,2770,422,1277,230,5,145,2079
Colorado,Lynn,6,0,3,0,0,3,6
Colorado,McCoy,27,7,20,0,0,0,27
Colorado,Manassa,1060,244,443,52,15,51,805
Colorado,Mancos,1727,445,567,293,13,62,1380
Colorado,Manitou Springs,5211,1301,2469,615,26,191,4602
Colorado,Manzanola,445,154,150,56,9,27,396
Colorado,Marble,150,34,91,9,0,4,138
Colorado,Maybell,56,6,8,0,4,38,56
Colorado,Maysville,95,18,77,0,0,0,95
Colorado,Lyons,2056,505,913,166,0,26,1610
Colorado,Niwot,4497,912,2215,339,16,66,3548
Colorado,Estes Park,6103,1017,3102,749,5,392,5265
Colorado,Norrie,0,0,0,0,0,0,0
Colorado,Brush,5488,1095,1957,613,83,296,4044
Colorado,Broomfield,60699,12666,28104,4594,434,2145,47943
Colorado,Brookside,247,36,125,18,0,7,186
Colorado,Brighton,35582,8532,13598,3063,554,1206,26953
Colorado,Brick Center,34,0,34,0,0,0,34
Colorado,Breckenridge,4682,2164,1730,174,14,18,4100
Colorado,Branson,41,1,21,2,0,10,34
Colorado,Brandon,18,0,18,0,0,0,18
Colorado,Bow Mar,1045,188,557,42,3,31,821
Colorado,Boulder,103919,51370,30219,7520,657,2469,92235
Colorado,Boone,346,99,116,20,7,28,270
Colorado,Bonanza Mountain Estates,96,44,27,0,0,25,96
Colorado,Bonanza,8,6,0,2,0,0,8
Colorado,Blue Sky,0,0,0,0,0,0,0
Colorado,Blue River,784,246,330,51,4,8,639
Colorado,Blende,727,118,324,57,12,66,577
Colorado,Blanca,478,143,159,59,0,25,386
Colorado,Black Hawk,155,46,63,34,0,12,155
Colorado,Black Forest,12918,1988,7820,603,18,260,10689
Colorado,Buena Vista,2705,597,1198,228,15,111,2149
Colorado,Burlington,3931,919,1817,222,46,263,3267
Colorado,Byers,1357,264,707,125,14,41,1151
Colorado,Calhan,832,146,373,78,12,37,646
Colorado,Peyton,307,48,137,0,0,12,197
Colorado,Perry Park,1727,177,1110,118,19,80,1504
Colorado,Peoria,178,55,73,2,0,11,141
Colorado,Penrose,3211,468,1685,275,63,186,2677
Colorado,Peetz,242,69,97,27,4,14,211
Colorado,Parshall,57,0,44,0,0,13,57
Colorado,Parker,47342,7829,22567,3239,300,687,34622
Colorado,Paragon Estates,848,153,531,61,10,30,785
Colorado,Parachute,1095,233,304,128,33,57,755
Colorado,Beulah Valley,768,93,286,151,0,65,595
Colorado,Paonia,1255,237,491,205,18,93,1044
Colorado,Palmer Lake,2529,382,1216,278,0,68,1944
Colorado,Palisade,2654,560,977,425,37,140,2139
Colorado,Pagosa Springs,1729,501,488,269,36,102,1396
Colorado,Padroni,143,28,45,18,0,6,97
Colorado,Ovid,311,96,102,45,6,26,275
Colorado,Ouray,853,248,435,60,0,32,775
Colorado,Capulin,115,29,53,10,0,6,98
Colorado,Ca?on City,16408,3610,6564,1995,304,1059,13532
Colorado,Campo,41,0,30,4,1,6,41
Colorado,Paoli,63,8,46,6,0,3,63
Colorado,No Name,146,44,102,0,0,0,146
Colorado,Bethune,297,63,122,4,1,20,210
Colorado,Berkley,11599,3631,3510,1476,203,538,9358
Colorado,Alamosa East,1576,422,658,93,7,31,1211
Colorado,Alamosa,9592,3296,2807,839,183,398,7523
Colorado,Akron,1903,378,861,218,51,128,1636
Colorado,Air Force Academy,5864,4167,891,49,31,0,5138
Colorado,Otis,438,75,166,34,14,33,322
Colorado,Ordway,1393,437,283,144,24,93,981
Colorado,Orchard Mesa,6385,1474,2765,748,42,328,5357
Colorado,Orchard City,3047,324,1385,478,28,272,2487
Colorado,Orchard,113,5,73,18,0,5,101
Colorado,Ophir,226,37,104,11,0,0,152
Colorado,Olney Springs,507,99,165,50,11,19,344
Colorado,Olathe,1999,323,728,202,68,100,1421
Colorado,Oak Creek,836,189,326,115,23,34,687
Colorado,Nunn,524,132,226,43,6,21,428
Colorado,Nucla,525,84,238,80,0,45,447
Colorado,Norwood,595,89,223,130,5,33,480
Colorado,North Washington,272,110,124,9,0,15,258
Colorado,North La Junta,449,55,142,51,30,52,330
Colorado,Northglenn,37754,10143,13738,4153,634,1582,30250
Colorado,Allenspark,673,121,363,51,13,44,592
Colorado,Alma,302,129,65,50,4,3,251
Colorado,Alpine,146,0,131,0,0,0,131
Colorado,Altona,550,117,297,40,0,0,454
Colorado,Bennett,1915,450,830,194,31,32,1537
Colorado,Bayfield,2478,597,976,232,0,102,1907
Colorado,Battlement Mesa,4689,658,2512,201,58,196,3625
Colorado,Basalt,3791,797,1631,634,91,82,3235
Colorado,Bark Ranch,222,45,163,0,0,0,208
Colorado,Avondale,803,146,510,41,0,9,706
Colorado,Avon,6414,1968,2568,309,19,91,4955
Colorado,Aurora,345867,91229,123827,33208,7228,12109,267601
Colorado,Castle Rock,52143,8324,25282,3755,318,1183,38862
Colorado,Berthoud,5497,919,2452,647,159,285,4462
Colorado,Ault,1750,306,638,222,26,56,1248
Colorado,Aspen Park,748,119,312,125,0,28,584
Colorado,Aspen,6740,2510,2072,1312,19,88,6001
Colorado,Arvada,111658,24744,48461,12311,966,4884,91366
Colorado,Arriba,188,37,64,29,13,17,160
Colorado,Aristocrat Ranchettes,1275,279,484,99,27,102,991
Colorado,Arboles,246,28,136,24,10,13,211
Colorado,Applewood,7623,1641,3502,868,38,367,6416
Colorado,Antonito,757,186,234,101,12,74,607
Colorado,Amherst,56,0,16,40,0,0,56
Colorado,Atwood,228,42,73,48,0,11,174
Colorado,Cathedral,17,3,14,0,0,0,17
Colorado,La Junta,7018,1884,2764,633,47,366,5694
Colorado,Cattle Creek,731,240,203,18,20,0,481
Colorado,East Pleasant View,425,176,151,39,0,31,397
Colorado,Eaton,4662,843,2233,328,0,97,3501
Colorado,Eckley,342,78,120,31,9,25,263
Colorado,Edgewater,5237,2003,1281,821,68,189,4362
Colorado,Edwards,9792,2836,4017,822,64,26,7765
Colorado,Elbert,187,67,56,19,0,10,152
Colorado,Eldora,119,50,14,14,14,0,92
Colorado,Eldorado Springs,782,136,456,59,26,8,685
Colorado,Elizabeth,1236,310,504,80,31,37,962
Colorado,Eagle,6553,708,3157,393,113,198,4569
Colorado,El Jebel,3526,1096,1435,214,59,33,2837
Colorado,El Moro,325,71,178,12,0,3,264
Colorado,Empire,312,84,127,44,6,11,272
Colorado,Englewood,31877,10584,9944,4119,500,1659,26806
Colorado,Haswell,74,13,47,2,0,5,67
Colorado,Hasty,96,6,48,8,0,11,73
Colorado,Hartman,62,9,28,5,0,5,47
Colorado,Gypsum,6685,1276,2875,963,29,75,5218
Colorado,Gunnison,5955,3177,1236,611,55,215,5294
Colorado,Gunbarrel,9184,2640,4159,999,49,227,8074
Colorado,Ellicott,703,159,321,18,12,39,549
Colorado,Eads,612,120,231,67,0,73,491
Colorado,Durango,17486,7078,5473,1864,53,729,15197
Colorado,Downieville-Lawson-Dumont,474,157,227,15,0,37,436
Colorado,Crested Butte,1445,608,478,78,30,12,1206
Colorado,Crestone,107,27,4,49,6,9,95
Colorado,Cripple Creek,1341,364,373,220,23,81,1061
Colorado,Crisman,351,34,123,50,40,0,247
Colorado,Crook,143,35,50,12,0,16,113
Colorado,Crowley,284,92,75,42,2,19,230
Colorado,Dacono,4461,844,1863,529,43,235,3514
Colorado,Dakota Ridge,33580,7105,15745,3008,318,786,26962
Colorado,De Beque,369,76,156,43,0,22,297
Colorado,Deer Trail,573,69,257,48,16,43,433
Colorado,Del Norte,1984,453,695,273,65,111,1597
Colorado,Delta,8779,1502,3538,1088,156,741,7025
Colorado,Denver,649654,221200,208273,67926,11531,22247,531177
Colorado,Derby,8565,2287,2593,767,134,275,6056
Colorado,Dillon,865,243,345,163,10,8,769
Colorado,Dinosaur,313,33,149,14,1,23,220
Colorado,Divide,124,11,74,0,0,0,85
Colorado,Dolores,1048,273,328,149,15,53,818
Colorado,Dotsero,863,212,353,22,18,0,605
Colorado,Dove Creek,707,133,298,66,3,31,531
Colorado,Dove Valley,5600,1487,1912,670,77,50,4196
Colorado,Guffey,81,57,0,24,0,0,81
Colorado,Crawford,287,67,84,69,6,12,238
Colorado,Grover,83,13,48,3,4,0,68
Colorado,Green Mountain Falls,671,156,273,109,2,31,571
Colorado,Fraser,1102,483,291,147,20,22,963
Colorado,Franktown,203,0,123,13,0,11,147
Colorado,Foxfield,683,121,393,37,2,15,568
Colorado,Fowler,1144,148,471,152,19,98,888
Colorado,Fountain,27062,4190,12158,2310,347,471,19476
Colorado,Fort Morgan,11377,2370,4037,1122,434,519,8482
Colorado,Fort Lupton,7669,1430,2917,856,107,261,5571
Colorado,Fort Garland,470,112,211,30,15,14,382
Colorado,Fort Collins,153292,58011,53685,11713,980,4198,128587
Colorado,Frederick,10186,1543,4838,883,36,184,7484
Colorado,Fort Carson,14742,5372,4797,359,170,14,10712
Colorado,Florissant,77,22,46,0,0,0,68
Colorado,Florence,3884,637,1639,539,61,163,3039
Colorado,Fleming,608,75,260,69,0,33,437
Colorado,Flagler,596,160,171,63,15,60,469
Colorado,Firestone,11255,1631,5091,861,101,298,7982
Colorado,Federal Heights,12037,3011,4185,1337,140,424,9097
Colorado,Fairplay,817,310,274,74,6,16,680
Colorado,Fairmount,8222,1537,4226,724,37,257,6781
Colorado,Evergreen,8688,1565,4538,739,98,339,7279
Colorado,Floyd Hill,1153,134,795,85,0,20,1034
Colorado,Frisco,2855,1208,1236,121,0,17,2582
Colorado,Fruita,12750,2563,5407,1203,260,721,10154
Colorado,Fruitvale,7458,1238,3673,608,101,554,6174
Colorado,Greeley,97074,27977,33973,9173,1432,3819,76374
Colorado,Grand View Estates,689,146,321,3,0,0,470
Colorado,Grand Lake,329,76,159,51,0,12,298
Colorado,Grand Junction,59945,14973,22212,6900,968,3010,48063
Colorado,Granby,1864,304,908,209,14,38,1473
Colorado,Granada,507,114,238,24,6,20,402
Colorado,Gold Hill,189,4,124,45,0,0,173
Colorado,Goldfield,41,3,18,9,0,0,30
Colorado,Golden,19780,7586,6608,1732,285,565,16776
Colorado,Glenwood Springs,9756,2674,3746,985,101,509,8015
Colorado,Gleneagle,6470,629,3596,450,93,151,4919
Colorado,Glendale,112,49,63,0,0,0,112
Colorado,Glendale,4744,2922,893,422,108,78,4423
Colorado,Gilcrest,917,241,386,51,16,26,720
Colorado,Gerrard,122,6,107,9,0,0,122
Colorado,Georgetown,1031,282,398,176,15,34,905
Colorado,Genoa,85,5,42,11,4,11,73
Colorado,Genesee,3703,475,2188,284,0,128,3075
Colorado,Garfield,8,8,0,0,0,0,8
Colorado,Garden City,277,83,82,45,0,20,230
Colorado,Fulford,0,0,0,0,0,0,0
Colorado,Greenwood Village,14920,2994,7858,981,76,376,12285
Colorado,Catherine,288,51,96,22,0,34,203
Colorado,Craig,8983,1725,3463,986,131,526,6831
Colorado,Cortez,8571,2089,3028,1186,73,423,6799
Colorado,Larkspur,248,57,115,29,12,18,231
Colorado,Laporte,2497,480,1402,220,24,132,2258
Colorado,Lamar,7744,1785,3079,658,171,385,6078
Colorado,Lakewood,147836,39867,55955,17989,2096,7061,122968
Colorado,Lake City,354,33,208,32,4,29,306
Colorado,La Junta Gardens,25,0,25,0,0,0,25
Colorado,Erie,19948,2877,10346,1151,84,389,14847
Colorado,La Jara,713,173,278,65,6,70,592
Colorado,La Salle,2571,435,1120,222,8,77,1862
Colorado,Laird,30,0,18,6,0,6,30
Colorado,Kremmling,2090,603,831,187,8,56,1685
Colorado,Kittredge,1324,226,507,290,0,0,1023
Colorado,Kit Carson,263,58,96,15,0,20,189
Colorado,Kirk,102,5,54,31,0,6,96
Colorado,Kiowa,859,147,386,92,19,40,684
Colorado,Kim,61,14,29,8,0,6,57
Colorado,Keystone,1067,428,439,183,0,17,1067
Colorado,Kersey,1585,360,685,90,14,64,1213
Colorado,Ken Caryl,33021,6975,15436,3640,261,756,27068
Colorado,Lafayette,26430,6204,11296,2825,218,816,21359
Colorado,Las Animas,1813,251,687,211,19,283,1451
Colorado,La Veta,729,117,377,87,9,52,642
Colorado,Lazy Acres,977,98,464,194,19,48,823
Colorado,Cedaredge,2272,434,895,286,49,191,1855
Colorado,Centennial,106604,21223,51502,9221,765,3526,86237
Colorado,Center,2105,519,738,232,88,44,1621
Colorado,Central City,771,277,187,120,22,46,652
Colorado,Chacra,544,121,251,17,0,20,409
Colorado,Cheraw,175,17,69,44,6,12,148
Colorado,Cherry Creek,12087,2449,5607,913,204,302,9475
Colorado,Louisville,19548,3901,9599,1588,63,746,15897
Colorado,Longmont,89814,20429,36411,9276,1102,3259,70477
Colorado,Lone Tree,12462,2767,5969,883,71,258,9948
Colorado,Loma,1254,243,668,167,0,28,1106
Colorado,Log Lane Village,1003,170,439,96,15,46,766
Colorado,Loghill Village,452,62,332,5,0,34,433
Colorado,Lochbuie,5222,894,1976,583,20,145,3618
Colorado,Littleton,44553,10494,18529,5571,434,2141,37169
Colorado,Lincoln Park,3222,412,1682,331,13,325,2763
Colorado,Limon,1425,235,661,192,8,54,1150
Colorado,Leyner,30,0,30,0,0,0,30
Colorado,Lewis,391,10,172,13,0,27,222
Colorado,Leadville North,1815,265,829,265,43,49,1451
Colorado,Leadville,2595,664,988,365,56,113,2186
Colorado,Keenesburg,1319,269,524,175,9,82,1059
Colorado,Cotopaxi,7,0,0,7,0,0,7
Colorado,Julesburg,1218,235,479,158,30,80,982
Colorado,Johnson Village,224,20,78,55,11,6,170
Colorado,Hayden,1819,482,721,227,21,52,1503
Colorado,Haxtun,1005,167,424,111,6,62,770
Colorado,Cherry Hills Village,6329,779,3589,209,15,163,4755
Colorado,Cimarron Hills,16746,3612,6750,1579,137,516,12594
Colorado,City of Creede,189,31,74,41,10,30,186
Colorado,Clifton,20079,4515,7394,2360,366,838,15473
Colorado,Coal Creek,1894,363,1071,233,16,78,1761
Colorado,Coal Creek,335,37,206,23,3,16,285
Colorado,Coaldale,364,33,124,93,0,15,265
Colorado,Heeney,251,137,39,55,0,20,251
Colorado,Cokedale,140,14,47,19,4,15,99
Colorado,Colona,0,0,0,0,0,0,0
Colorado,Colorado City,2249,309,1212,191,24,36,1772
Colorado,Colorado Springs,442040,104301,179709,45649,6926,16349,352934
Colorado,Columbine,24709,4484,12208,2116,190,1196,20194
Colorado,Columbine Valley,1164,173,751,25,3,40,992
Colorado,Comanche Creek,375,19,248,23,0,8,298
Colorado,Commerce City,50346,10521,19043,4163,501,1479,35707
Colorado,Conejos,76,0,39,17,0,0,56
Colorado,Copper Mountain,268,77,53,60,0,0,190
Colorado,Collbran,646,325,167,47,1,35,575
Colorado,Hidden Lake,0,0,0,0,0,0,0
Colorado,Highlands Ranch,104432,16521,51063,7786,460,2087,77917
Colorado,Hillrose,280,61,124,22,9,20,236
Colorado,Joes,45,3,32,1,0,1,37
Colorado,Jansen,131,8,97,16,0,10,131
Colorado,Jamestown,256,75,105,30,2,4,216
Colorado,Jackson Lake,178,27,101,23,0,7,158
Colorado,Inverness,1109,340,531,179,0,26,1076
Colorado,Indian Hills,1380,342,585,130,0,0,1057
Colorado,Iliff,212,36,88,25,5,6,160
Colorado,Ignacio,887,158,366,117,21,45,707
Colorado,Idledale,282,69,135,25,0,0,229
Colorado,Idalia,45,8,25,0,0,2,35
Colorado,Idaho Springs,1996,455,734,318,47,90,1644
Colorado,Hugo,670,145,222,68,13,100,548
Colorado,Hudson,2138,641,683,307,75,97,1803
Colorado,Howard,794,70,561,68,19,33,751
Colorado,Hot Sulphur Springs,772,93,299,128,17,34,571
Colorado,Hotchkiss,932,155,338,135,12,78,718
Colorado,Hooper,55,3,25,19,0,8,55
Colorado,Holyoke,2185,282,1047,164,15,178,1686
Colorado,Holly Hills,2560,531,1174,305,31,88,2129
Colorado,Holly,882,149,386,59,2,69,665
Colorado,Hoehne,128,37,57,4,0,9,107
Colorado,Johnstown,12818,1747,6750,607,62,267,9433
Colorado,Cheyenne Wells,909,217,383,80,12,69,761
Colorado,Evans,20308,4497,7639,1652,340,452,14580
Colorado,Williamsburg,680,105,313,63,5,27,513
Colorado,Seven Hills,83,0,67,16,0,0,83
Colorado,Windsor,20455,3333,10210,1671,169,535,15918
Colorado,Winter Park,578,233,213,70,0,0,516
Colorado,Wolcott,0,0,0,0,0,0,0
Colorado,Woodland Park,7155,1306,3585,819,23,115,5848
Colorado,Woodmoor,8427,1278,4930,252,30,143,6633
Colorado,Woody Creek,276,86,122,42,0,0,250
Colorado,Wray,2714,395,871,351,67,212,1896
Colorado,Yampa,417,73,194,55,1,10,333
Colorado,Yuma,3601,694,1792,268,0,316,3070
Colorado,Wiley,350,77,134,61,9,12,293
Colorado,Stonegate,9264,1565,3948,960,44,89,6606
Colorado,Steamboat Springs,12148,4370,4277,1341,140,342,10470
Colorado,Starkville,31,0,18,4,0,7,29
Colorado,Springfield,1392,258,561,144,46,136,1145
Colorado,South Fork,589,59,351,30,2,24,466
Colorado,Southern Ute,156,24,81,17,0,7,129
Colorado,Snyder,145,19,102,0,0,0,121
Colorado,Snowmass Village,2865,1205,922,331,0,46,2504
Colorado,Smeltertown,174,90,49,35,0,0,174
Colorado,Simla,555,117,212,65,11,41,446
Colorado,Silverton,552,171,210,63,0,52,496
Colorado,Sterling,14046,4606,4599,1652,216,691,11764
Colorado,Silverthorne,4117,728,2142,318,0,107,3295
Colorado,Wiggins,1054,167,561,52,9,52,841
Colorado,West Pleasant View,3830,1182,1386,505,73,103,3249
Colorado,Two Buttes,63,4,27,21,0,0,52
Colorado,Upper Bear Creek,1143,99,845,27,0,0,971
Colorado,Vail,5321,2616,1591,464,30,101,4802
Colorado,Valdez,18,4,5,6,0,3,18
Colorado,Valmont,104,10,42,39,0,0,91
Colorado,Vernon,10,0,10,0,0,0,10
Colorado,Victor,374,75,176,75,6,20,352
Colorado,Vilas,214,30,45,24,14,0,113
Colorado,Vineland,166,7,63,36,10,0,116
Colorado,Vona,45,6,20,8,1,6,41
Colorado,Wheat Ridge,30863,7690,11420,4392,535,2107,26144
Colorado,Walden,535,98,240,51,5,51,445
Colorado,Walsh,618,73,298,57,9,75,512
Colorado,Ward,115,23,54,14,0,5,96
Colorado,Watkins,492,143,200,95,11,11,460
Colorado,Welby,16408,4305,5209,1754,408,623,12299
Colorado,Weldona,104,8,65,19,0,2,94
Colorado,Wellington,6934,1061,3148,557,69,121,4956
Colorado,Westcliffe,440,94,182,82,2,19,379
Colorado,Westcreek,117,4,80,20,0,0,104
Colorado,Westminster,110598,26544,45789,11689,1228,3878,89128
Colorado,Weston,51,23,12,3,3,5,46
Colorado,Walsenburg,2930,931,723,426,71,269,2420
Colorado,Silver Plume,239,64,94,39,2,16,215
Colorado,Silver Cliff,789,215,268,96,9,38,626
Colorado,Silt,2976,644,1289,216,19,63,2231
Colorado,Rock Creek Park,20,0,10,0,0,0,10
Colorado,Rockvale,475,66,210,37,0,50,363
Colorado,Rocky Ford,3877,1017,1259,453,50,399,3178
Colorado,Rollinsville,15,0,0,15,0,0,15
Colorado,Romeo,337,106,110,31,5,18,270
Colorado,Roxborough Park,9859,1167,5530,423,4,214,7338
Colorado,Rye,209,27,107,27,0,13,174
Colorado,Saddle Ridge,64,9,47,0,0,0,56
Colorado,Saguache,536,112,211,86,19,35,463
Colorado,St. Ann Highlands,350,64,208,27,0,0,299
Colorado,Rifle,9451,1870,4149,634,68,250,6971
Colorado,St. Mary's,291,25,152,0,0,0,177
Colorado,Salt Creek,662,244,164,76,17,49,550
Colorado,San Acacio,14,0,0,14,0,0,14
Colorado,Sanford,918,135,449,44,11,48,687
Colorado,San Luis,642,167,213,76,25,34,515
Colorado,Sawpit,30,0,24,0,0,0,24
Colorado,Security-Widefield,34836,6567,15547,2913,421,1191,26639
Colorado,Sedalia,131,7,46,52,0,9,114
Colorado,Sedgwick,155,22,61,34,6,16,139
Colorado,Segundo,153,10,63,10,9,11,103
Colorado,Seibert,182,33,81,36,3,13,166
Colorado,Salida,5373,915,2271,954,39,402,4581
Colorado,Ridgway,898,168,388,158,3,29,746
Colorado,Rico,199,49,48,51,4,11,163
Colorado,Redvale,171,46,72,24,10,6,158
Colorado,Sherrelwood,19209,5078,6330,2043,366,950,14767
Colorado,Sheridan Lake,85,11,19,14,0,0,44
Colorado,Sheridan,5912,1841,1623,889,173,249,4775
Colorado,Shaw Heights,4760,1494,1775,478,63,190,4000
Colorado,Phippsburg,139,0,83,49,0,0,132
Colorado,Piedra,61,0,54,0,0,0,54
Colorado,Pierce,946,200,456,126,6,24,812
Colorado,Pine Brook Hill,1263,190,710,72,0,13,985
Colorado,Pitkin,104,17,54,10,0,0,81
Colorado,Platteville,2574,498,1136,306,10,75,2025
Colorado,Poncha Springs,1172,345,477,164,0,15,1001
Colorado,Ponderosa Park,3211,701,1697,264,0,111,2773
Colorado,Portland,168,8,84,59,0,0,151
Colorado,Pritchett,130,16,86,8,5,12,127
Colorado,Pueblo,108073,29653,35324,13525,1812,6570,86884
Colorado,Pueblo West,30440,5839,14226,2807,250,1010,24132
Colorado,Ramah,72,13,35,11,3,5,67
Colorado,Rangely,2322,466,1091,142,0,57,1756
Colorado,Raymer (New Raymer),88,22,38,4,3,4,71
Colorado,Red Cliff,279,89,92,39,0,10,230
Colorado,Red Feather Lakes,181,38,108,0,15,15,176
Colorado,Redlands,10086,1447,5495,862,66,518,8388
Colorado,Redstone,26,11,0,15,0,0,26
Colorado,Twin Lakes CDP (Lake County),140,21,90,19,0,10,140
Colorado,Twin Lakes CDP (Adams County),6698,1888,2289,729,122,419,5447
Colorado,Severance,3448,482,1799,189,27,82,2579
Colorado,Trail Side,82,0,32,0,0,0,32
Colorado,Stonewall Gap,41,0,28,10,0,3,41
Colorado,Strasburg,3027,515,1327,210,49,104,2205
Colorado,Stratmoor,6035,1540,1821,849,162,229,4601
Colorado,Stratton,627,117,266,54,0,45,482
Colorado,Sugar City,434,208,92,57,8,20,385
Colorado,Sugarloaf,305,72,106,112,0,0,290
Colorado,Sunshine,151,0,134,0,0,0,134
Colorado,Superior,12815,2557,5950,913,73,221,9714
Colorado,Swink,659,177,207,60,8,37,489
Colorado,Trinidad,8470,2086,3269,931,186,484,6956
Colorado,Tall Timber,217,11,153,0,13,13,190
Colorado,Telluride,2019,983,487,302,0,0,1772
Colorado,The Pinery,11384,1870,6033,915,14,159,8991
Colorado,Thornton,127688,28760,51690,10502,1658,3443,96053
Colorado,Timnath,1204,139,668,23,0,18,848
Colorado,Todd Creek,3879,507,2310,111,38,120,3086
Colorado,Towaoc,787,264,220,41,5,20,550
Colorado,Towner,43,8,17,0,0,0,25
Colorado,Tabernash,355,75,239,0,0,0,314
Connecticut,South Woodstock,1155,240,461,169,0,102,972
Connecticut,Southwood Acres,7731,1505,3740,666,37,395,6343
Connecticut,South Windham,1458,481,559,89,0,112,1241
Connecticut,Southport,1667,281,875,131,0,128,1415
Connecticut,South Coventry,1117,224,649,66,0,14,953
Connecticut,Somers,1927,432,939,114,24,116,1625
Connecticut,Sharon,666,91,268,101,0,99,559
Connecticut,Sherwood Manor,5457,1143,2507,437,103,404,4594
Connecticut,Shelton,40783,9432,18735,3487,270,2735,34659
Connecticut,Stafford Springs,5061,1472,1657,667,69,266,4131
Connecticut,Saybrook Manor,1103,253,494,178,7,43,975
Connecticut,Salmon Brook,2676,504,1328,249,9,120,2210
Connecticut,Rockville,7459,2577,1751,952,138,419,5837
Connecticut,Simsbury Center,5926,1168,3019,333,35,280,4835
Connecticut,Stamford,126592,37033,48675,9962,2111,5313,103094
Connecticut,Tariffville,1272,344,454,160,7,51,1016
Connecticut,Storrs,15914,14459,722,176,17,315,15689
Connecticut,Bridgeport,147340,55909,38745,12475,3544,6216,116889
Connecticut,Bristol,60554,16754,22990,6642,502,3388,50276
Connecticut,Broad Brook,4504,874,1776,390,187,122,3349
Connecticut,Waterbury,109551,37518,30578,11085,2240,5170,86591
Connecticut,Wallingford Center,17710,5371,6562,2003,311,1099,15346
Connecticut,Trumbull,36571,7656,16855,2231,104,2185,29031
Connecticut,Stonington borough,971,265,381,166,6,76,894
Connecticut,Torrington,35493,8616,14192,4546,559,2238,30151
Connecticut,Thompsonville,8878,3361,2248,1318,126,356,7409
Connecticut,Thomaston,1909,514,555,306,30,270,1675
Connecticut,Terryville,5180,1253,2252,583,41,298,4427
Connecticut,Terramuggus,862,125,613,16,0,13,767
Connecticut,Suffield Depot,1468,457,514,119,0,92,1182
Connecticut,Stratford,52316,13648,22074,4661,347,3640,44370
Connecticut,Riverside,8592,1481,3898,497,100,364,6340
Connecticut,Ridgefield,7725,953,3741,569,31,446,5740
Connecticut,Orange,13946,2817,7068,641,73,853,11452
Connecticut,Putnam,7147,2035,2034,1100,146,385,5700
Connecticut,Noank,2133,439,1094,250,8,58,1849
Connecticut,Niantic,3005,745,1200,450,10,250,2655
Connecticut,Glastonbury Center,7409,1574,3003,873,144,466,6060
Connecticut,Glenville,2478,562,1143,174,78,151,2108
Connecticut,Greenwich,13499,3133,5810,1232,284,521,10980
Connecticut,Groton,9305,2840,3008,1177,164,340,7529
Connecticut,Norfolk,591,129,226,99,10,23,487
Connecticut,Groton Long Point borough,510,43,360,29,2,30,464
Connecticut,Hartford,124795,55816,24256,10800,3890,4476,99238
Connecticut,Lakeville,858,275,422,38,0,66,801
Connecticut,Lake Pocotopaug,3313,775,1483,345,16,137,2756
Connecticut,Kensington,8824,1741,4278,746,7,530,7302
Connecticut,Jewett City borough,3472,994,851,550,2,162,2559
Connecticut,Higganum,1683,243,827,205,14,86,1375
Connecticut,Guilford Center,2476,652,923,509,18,72,2174
Connecticut,North Granby,1781,243,937,148,0,22,1350
Connecticut,North Grosvenor Dale,1707,354,767,97,13,129,1360
Connecticut,North Haven,23937,5220,11631,1524,138,1507,20020
Connecticut,Portland,5619,1467,2310,562,56,481,4876
Connecticut,Poquonock Bridge,1828,809,562,142,23,52,1588
Connecticut,Plantsville,1672,354,695,326,25,77,1477
Connecticut,Plainfield Village,2244,639,807,268,27,195,1936
Connecticut,Pemberwick,3935,1018,1652,398,10,191,3269
Connecticut,Pawcatuck,5242,1449,1768,684,59,362,4322
Connecticut,Oxoboxo River,3081,794,1191,271,66,302,2624
Connecticut,Branford Center,6015,1923,1960,854,37,448,5222
Connecticut,Old Saybrook Center,2139,315,986,268,0,153,1722
Connecticut,Old Mystic,3625,720,1818,225,46,188,2997
Connecticut,Old Greenwich,6764,1009,3226,296,19,134,4684
Connecticut,Georgetown,1845,241,817,317,0,74,1449
Connecticut,Norwich,40254,12445,12495,5198,669,2049,32856
Connecticut,Norwalk,87701,25726,34780,7869,930,4349,73654
Connecticut,Northwest Harwinton,3167,695,1610,273,33,62,2673
Connecticut,Quinebaug,1102,320,455,94,34,50,953
Connecticut,Blue Hills,2872,1221,748,284,53,219,2525
Connecticut,Westbrook Center,2125,791,764,352,19,83,2009
Connecticut,Bethel,9731,2595,3832,1107,41,337,7912
Connecticut,Deep River Center,2417,648,892,328,0,75,1943
Connecticut,Darien,21392,3720,10303,815,96,632,15566
Connecticut,Danielson borough,4026,1244,1241,527,123,215,3350
Connecticut,Litchfield borough,1474,297,509,248,20,184,1258
Connecticut,Long Hill,4269,1230,1602,676,16,324,3848
Connecticut,Madison Center,2421,401,997,371,48,165,1982
Connecticut,Derby,12796,3997,4517,1125,76,713,10428
Connecticut,Manchester,30883,9841,9997,3453,331,1271,24893
Connecticut,Mashantucket,167,52,53,15,1,9,130
Connecticut,Meriden,60439,19660,21517,5749,724,3067,50717
Connecticut,Middletown,47218,17369,15601,4737,459,2158,40324
Connecticut,Milford city (balance),51643,12443,22138,5741,400,2863,43585
Connecticut,Moodus,1212,237,667,37,0,86,1027
Connecticut,Moosup,3192,1018,1339,260,0,134,2751
Connecticut,Mansfield Center,1127,239,500,59,0,36,834
Connecticut,Mystic,3981,892,1792,503,7,400,3594
Connecticut,Durham,2932,617,1374,225,0,170,2386
Connecticut,East Hampton,2643,406,1280,300,24,99,2109
Connecticut,Woodmont borough,1563,410,712,205,3,70,1400
Connecticut,Woodbury Center,1438,320,628,176,14,80,1218
Connecticut,Winsted,7753,2294,2928,1030,77,444,6773
Connecticut,Windsor Locks,12564,3174,5169,1444,319,648,10754
Connecticut,Wilton Center,712,239,173,158,10,27,607
Connecticut,Falls Village,403,118,152,55,0,44,369
Connecticut,East Brooklyn,1672,471,548,151,0,101,1271
Connecticut,Fenwick borough,81,7,66,4,0,4,81
Connecticut,Willimantic,17411,8540,3547,1591,533,619,14830
Connecticut,Wethersfield,26510,6294,12147,2055,95,1594,22185
Connecticut,West Simsbury,2466,401,1344,127,9,186,2067
Connecticut,Essex Village,2196,254,1343,235,51,92,1975
Connecticut,East Haven,29104,7975,11198,3238,355,1848,24614
Connecticut,East Hartford,51137,16933,16004,5219,1276,2390,41822
Connecticut,Gales Ferry,824,168,371,48,13,57,657
Connecticut,Bethlehem Village,1850,551,745,197,36,125,1654
Connecticut,Naugatuck borough,31722,8381,12638,2702,257,1871,25849
Connecticut,New Hartford Center,1557,513,436,249,0,65,1263
Connecticut,Canaan,1098,224,287,223,22,67,823
Connecticut,Byram,4836,1178,2006,380,123,189,3876
Connecticut,Brooklyn,908,455,279,112,32,30,908
Connecticut,Heritage Village,3934,271,1736,725,27,1007,3766
Connecticut,Westport,27343,4989,12981,1949,194,1013,21126
Connecticut,West Haven,55189,19339,16867,5745,621,2614,45186
Connecticut,Cannondale,117,27,39,22,0,0,88
Connecticut,West Hartford,63288,15868,27106,4596,568,3733,51871
Connecticut,Wauregan,1428,297,470,95,44,64,970
Connecticut,Watertown,2996,583,1492,339,0,135,2549
Connecticut,Waterford,2948,606,1155,411,38,242,2452
Connecticut,Ansonia,19035,5496,6646,1985,167,1066,15360
Connecticut,Baltic,1026,246,330,165,15,67,823
Connecticut,Bantam borough,842,177,291,166,40,75,749
Connecticut,Weatogue,3020,599,1626,163,34,56,2478
Connecticut,New Britain,72988,26696,20960,6354,1474,3292,58776
Connecticut,Canton Valley,1659,326,756,192,0,119,1393
Connecticut,Chester Center,1847,329,789,244,8,145,1515
Connecticut,New Haven,130612,58128,30159,10665,2019,5243,106214
Connecticut,Newington,30638,7867,13435,2748,227,1951,26228
Connecticut,New London,27423,12004,6541,2690,565,1281,23081
Connecticut,New Milford,6915,2303,2346,863,24,345,5881
Connecticut,New Preston,915,177,459,110,0,52,798
Connecticut,Newtown borough,2009,382,957,164,12,84,1599
Connecticut,Cheshire Village,5730,969,2874,490,25,344,4702
Connecticut,Danbury,83476,25626,30901,7510,1074,4061,69172
Connecticut,Coventry Lake,3393,900,1396,513,82,33,2924
Connecticut,Cos Cob,6433,1436,2973,435,45,207,5096
Connecticut,Conning Towers Nautilus Park,9814,3481,3688,280,68,148,7665
Connecticut,Collinsville,3518,603,1675,497,34,198,3007
Connecticut,Colchester,4309,1030,1596,649,95,307,3677
Connecticut,Clinton,3498,920,1480,392,19,164,2975
Connecticut,Crystal Lake,2220,537,1048,145,0,82,1812
Connecticut,Oakville,9246,2428,3800,705,32,713,7678
Connecticut,Hazardville,4868,1266,2071,427,22,257,4043
Delaware,Wilmington Manor,7912,1752,3244,761,61,385,6203
Delaware,Viola,164,47,66,14,3,3,133
Delaware,Townsend,2617,586,919,166,31,56,1758
Delaware,South Bethany,423,46,286,32,5,48,417
Delaware,Smyrna,10904,2140,4097,1280,253,489,8259
Delaware,Slaughter Beach,211,29,117,48,2,9,205
Delaware,Selbyville,2675,677,907,203,49,149,1985
Delaware,Seaford,7290,1897,2089,707,96,723,5512
Delaware,St. Georges,1141,274,494,84,9,25,886
Delaware,Rodney Village,1586,500,394,370,24,125,1413
Delaware,Riverview,2863,453,1486,138,17,56,2150
Delaware,Felton,1658,468,505,156,35,86,1250
Delaware,Fenwick Island,396,30,278,22,0,57,387
Delaware,Frankford,988,275,345,68,11,41,740
Delaware,Lewes,2887,513,1329,446,17,349,2654
Delaware,Little Creek,190,77,59,7,3,5,151
Delaware,Long Neck,2359,249,1025,488,42,257,2061
Delaware,Magnolia,192,52,71,22,6,2,153
Delaware,Middletown,19744,4615,7415,1587,227,805,14649
Delaware,Milford,9993,2433,3705,745,226,740,7849
Delaware,Millsboro,4050,984,1316,375,115,351,3141
Delaware,Millville,1510,254,604,123,23,70,1074
Delaware,Milton,2717,725,836,410,97,213,2281
Delaware,Newark,32740,18481,8647,1537,238,935,29838
Delaware,Wilmington,71549,29323,15093,7845,1349,3715,57325
Delaware,New Castle,5371,1630,1932,650,95,426,4733
Delaware,Farmington,91,20,22,10,5,9,66
Delaware,Woodside East,2027,768,488,289,45,89,1679
Delaware,Dover Base Housing,3417,316,1816,69,16,24,2241
Delaware,Dover,37144,13871,10288,3569,656,2010,30394
Delaware,Dewey Beach,250,43,128,29,1,36,237
Delaware,Delmar,1784,460,572,180,33,174,1419
Delaware,Delaware City,1933,592,616,266,16,73,1563
Delaware,Dagsboro,980,223,330,134,18,46,751
Delaware,Clayton,3034,576,1252,187,42,112,2169
Delaware,Claymont,9060,2549,3058,799,168,398,6972
Delaware,Cheswold,1219,277,432,149,27,106,991
Delaware,Camden,3501,629,1669,317,80,151,2846
Delaware,Brookside,13743,4186,4814,1497,230,673,11400
Delaware,Bridgeville,2364,511,1061,224,9,146,1951
Delaware,Bowers,320,101,122,49,2,13,287
Delaware,Blades,1303,313,400,162,28,92,995
Delaware,Bethel,171,33,90,27,3,2,155
Delaware,Bethany Beach,908,123,595,42,0,96,856
Delaware,Bellefonte,1318,346,557,136,11,54,1104
Delaware,Bear,19886,5679,7341,1740,337,698,15795
Delaware,Ardentown village,297,64,101,62,15,21,263
Delaware,Ardencroft village,262,75,123,18,2,16,234
Delaware,Arden village,538,154,217,83,9,28,491
Delaware,Elsmere,6154,2096,1758,703,84,314,4955
Delaware,Wyoming,1673,430,566,261,3,84,1344
Delaware,Woodside,150,46,44,35,0,11,136
Delaware,Edgemoor,6257,2203,1619,795,38,409,5064
Delaware,Newport,1165,383,327,95,58,47,910
Delaware,Georgetown,6775,2197,2033,436,116,354,5136
Delaware,North Star,7596,1270,4607,203,14,272,6366
Delaware,Ocean View,1880,286,1160,245,30,63,1784
Delaware,Odessa,598,132,292,78,3,13,518
Delaware,Pike Creek,8463,1698,4181,648,36,221,6784
Delaware,Pike Creek Valley,10672,3000,4003,1407,267,528,9205
Delaware,Rehoboth Beach,1098,261,530,121,28,132,1072
Delaware,Rising Sun-Lebanon,3970,1114,1584,272,70,98,3138
Delaware,Frederica,1053,273,359,114,26,40,812
Delaware,Leipsic,118,24,49,5,5,16,99
Delaware,Laurel,3916,1233,869,286,103,212,2703
Delaware,Ellendale,363,82,128,20,11,12,253
Delaware,Kent Acres,2283,445,716,240,103,120,1624
Delaware,Houston,390,104,189,22,11,15,341
Delaware,Glasgow,14640,3721,6362,1587,75,337,12082
Delaware,Greenville,2378,468,1151,159,7,200,1985
Delaware,Greenwood,1289,327,409,130,43,78,987
Delaware,Harrington,3665,864,1201,438,15,156,2674
Delaware,Hartly,54,11,25,1,0,4,41
Delaware,Henlopen Acres,157,16,109,6,2,13,146
Delaware,Highland Acres,3966,964,1705,261,66,186,3182
Delaware,Kenton,299,89,76,41,0,8,214
Delaware,Hockessin,13230,2446,6438,1126,31,879,10920
Florida,Palm Bay,105212,24433,40756,11989,2196,6327,85701
Florida,Palm Beach,8418,973,4659,1055,76,1195,7958
Florida,Palm Beach Gardens,50977,10683,23393,6676,545,3454,44751
Florida,Palmetto Bay village,24443,5665,10467,2095,272,1081,19580
Florida,Palm City,23413,3897,12302,2130,218,1635,20182
Florida,Palm Coast,79297,15599,35451,7816,1200,6047,66113
Florida,Palmetto,12973,2911,5097,1293,240,1162,10703
Florida,Palmetto Estates,16175,4827,5601,1684,455,654,13221
Florida,Palm Beach Shores,1077,290,436,200,7,96,1029
Florida,Palatka,10414,3412,2266,1447,249,735,8109
Florida,Page Park,549,182,65,132,50,10,439
Florida,Pahokee,6003,2137,1680,307,248,395,4767
Florida,Olga,2104,456,907,307,14,92,1776
Florida,Olympia Heights,14645,4100,5887,1272,560,1100,12919
Florida,Ona,94,0,57,0,0,0,57
Florida,Opa-locka,16139,6476,3250,1112,419,668,11925
Florida,Orange City,11023,2055,3513,2062,170,1486,9286
Florida,Orange Park,8545,2065,3424,945,234,539,7207
Florida,Orangetree,5248,1161,2474,237,64,66,4002
Florida,Paisley,1159,172,427,211,73,74,957
Florida,Orchid,374,3,338,3,3,17,364
Florida,Orlando,256738,89894,73163,28418,7552,10106,209133
Florida,Orlovista,5978,2006,1519,664,233,165,4587
Florida,Ormond Beach,39938,8879,17410,4376,387,3601,34653
Florida,Osprey,6664,972,4056,573,55,368,6024
Florida,Otter Creek,134,29,51,18,0,21,119
Florida,Oviedo,36617,9644,15453,2187,379,823,28486
Florida,Pace,21997,3785,10436,1704,343,755,17023
Florida,Oriole Beach,1608,226,680,153,55,114,1228
Florida,Ormond-by-the-Sea,7678,1575,3350,1333,71,856,7185
Florida,Dania Beach,30878,9886,8865,4748,841,1324,25664
Florida,Palm Harbor,59769,12731,27142,7229,726,4701,52529
Florida,Jasmine Estates,19604,5301,6440,2549,514,1630,16434
Florida,Jasper,4243,2106,844,611,135,153,3849
Florida,Jay,420,104,168,24,18,50,364
Florida,Jennings,668,121,241,55,9,59,485
Florida,Jensen Beach,12266,2197,5474,1964,284,969,10888
Florida,June Park,3981,1145,1768,410,17,315,3655
Florida,Juno Beach,3325,431,1543,600,98,499,3171
Florida,Juno Ridge,566,227,172,59,6,31,495
Florida,Wabasso Beach,1549,106,1139,107,0,137,1489
Florida,Wabasso,575,59,366,17,0,0,442
Florida,Jan Phyl Village,4690,1268,1841,320,21,190,3640
Florida,Virginia Gardens village,2957,728,1019,409,106,145,2407
Florida,Villas,10349,2770,3752,1862,170,879,9433
Florida,Villano Beach,3051,718,1252,369,119,62,2520
Florida,Viera West,8365,869,4566,865,65,239,6604
Florida,Viera East,11264,2015,5611,1108,119,908,9761
Florida,Verona Walk,2645,247,1802,208,0,153,2410
Florida,Vero Beach South,23973,5150,9285,3198,408,2350,20391
Florida,Vero Beach,15788,3845,6017,2673,357,1264,14156
Florida,Vernon,1144,224,360,88,9,67,748
Florida,Venice Gardens,7659,1434,3744,844,64,712,6798
Florida,Venice,21402,2834,11588,2761,163,3123,20469
Florida,Vineyards,3983,593,2550,311,43,150,3647
Florida,Oldsmar,13860,3580,5623,1309,167,536,11215
Florida,Jacob City,383,90,135,56,19,16,316
Florida,Jacksonville,846951,233460,293312,94927,18992,40096,680787
Florida,Okeechobee,5566,1240,2098,479,233,267,4317
Florida,Okahumpka,48,22,0,14,0,12,48
Florida,Highland City,10120,2307,4648,781,83,373,8192
Florida,Gulf Gate Estates,10358,2033,3964,1704,165,1293,9159
Florida,Gulfport,12167,3095,4233,2217,299,1087,10931
Florida,Gulf Stream,677,92,416,40,2,44,594
Florida,Gun Club Estates,1174,247,454,44,9,84,838
Florida,Haines City,21624,5707,7160,1617,327,1195,16006
Florida,Hallandale Beach,38725,9145,14065,6219,1051,2936,33416
Florida,Hampton,412,39,151,65,20,63,338
Florida,Jacksonville Beach,22149,6024,8367,2887,344,1321,18943
Florida,Harbor Bluffs,2786,429,1408,297,39,239,2412
Florida,Harlem,2347,591,606,309,53,125,1684
Florida,Harlem Heights,1423,648,294,140,0,171,1253
Florida,Inverness,7184,1314,2529,1013,139,1144,6139
Florida,Inverness Highlands North,2944,460,1201,239,0,240,2140
Florida,Inverness Highlands South,6375,1522,2243,981,36,626,5408
Florida,Inwood,6739,1961,1367,961,245,359,4893
Florida,Iona,13830,1692,7755,1844,28,1621,12940
Florida,Island Walk,3041,422,2050,300,0,208,2980
Florida,Istachatta,215,27,47,73,0,31,178
Florida,Ives Estates,20510,6543,6266,2567,718,1008,17102
Florida,Harbour Heights,3400,476,1737,322,79,386,3000
Florida,Palmona Park,1245,474,263,193,0,77,1007
Florida,Perry,7058,1978,1995,932,49,627,5581
Florida,Palm Shores,1123,167,526,129,11,27,860
Florida,Hillsboro Beach,1568,185,931,149,13,192,1470
Florida,Hill 'n Dale,1906,467,537,237,25,50,1316
Florida,Hilliard,3121,610,1174,373,89,174,2420
Florida,Hillcrest Heights,280,67,133,20,4,14,238
Florida,High Springs,5591,933,2384,529,121,173,4140
Florida,High Point,3409,644,1574,428,25,574,3245
Florida,Highland Park village,309,86,130,26,2,10,254
Florida,Fountainebleau,55596,14462,19449,8398,1551,3332,47192
Florida,Four Corners,32727,9980,12691,2520,909,922,27022
Florida,Franklin Park,958,406,167,49,44,28,694
Florida,Freeport,2346,401,1008,220,9,133,1771
Florida,Frostproof,3062,621,1299,298,95,299,2612
Florida,Fruit Cove,31146,6165,15061,2243,267,1352,25088
Florida,Fruitland Park,4330,980,1581,276,50,227,3114
Florida,Fruitville,13725,2724,5977,1570,197,1036,11504
Florida,Fuller Heights,9777,2489,4161,808,39,569,8066
Florida,Fussels Corner,5064,772,2421,607,43,566,4409
Florida,Gainesville,127559,69759,28175,9396,1876,4279,113485
Florida,Garcon Point,468,57,292,15,0,11,375
Florida,Garden Grove,462,78,248,81,0,16,423
Florida,Gardner,277,0,217,22,0,25,264
Florida,Gateway,8208,1996,3843,441,56,661,6997
Florida,Geneva,2459,473,1166,230,0,213,2082
Florida,Gibsonton,18070,4578,5331,2084,486,576,13055
Florida,Gifford,8750,1927,3114,590,341,1095,7067
Florida,Hillsboro Pines,401,111,161,61,0,15,348
Florida,Hobe Sound,13545,2903,5642,1859,195,1272,11871
Florida,Holden Heights,4065,1413,1251,473,175,140,3452
Florida,Holiday,20636,5072,8127,2373,411,1404,17387
Florida,Indiantown,6065,1685,1963,322,142,403,4515
Florida,Indian Shores,1469,234,781,225,53,143,1436
Florida,Indian Rocks Beach,4172,1021,1772,693,2,319,3807
Florida,Indian River Shores,4026,97,2935,290,0,620,3942
Florida,Indian River Estates,6439,857,2963,994,0,786,5600
Florida,Indian Harbour Beach,8315,1910,3154,1257,191,650,7162
Florida,Indian Creek village,60,9,36,4,0,0,49
Florida,Indialantic,2764,589,1319,300,60,106,2374
Florida,Immokalee,24879,8861,6364,1657,727,628,18237
Florida,Hypoluxo,2668,743,1184,375,9,144,2455
Florida,Hutchinson Island South,5026,520,3039,582,53,814,5008
Florida,Hunters Creek,22327,4495,10228,2225,218,607,17773
Florida,Gladeview,12525,5600,1769,1066,444,392,9271
Florida,Hudson,12033,1923,5244,1590,225,1552,10534
Florida,Hosford,740,112,307,75,9,41,544
Florida,Horseshoe Beach,123,5,61,31,0,19,116
Florida,Horizon West,19706,4029,8541,1062,100,347,14079
Florida,Homosassa Springs,13012,2727,5414,1980,245,1094,11460
Florida,Homosassa,1673,76,1101,256,0,180,1613
Florida,Homestead Base,1141,510,104,146,66,23,849
Florida,Homestead,64676,18905,19097,5741,1649,2429,47821
Florida,Homeland,212,44,70,10,0,0,124
Florida,Holmes Beach,4045,519,2379,550,13,379,3840
Florida,Hollywood,146791,40047,51645,18202,4496,7915,122305
Florida,Holly Hill,11726,3440,3065,2041,234,1163,9943
Florida,Holley,1531,272,600,133,55,89,1149
Florida,Howey-in-the-Hills,1234,158,690,106,8,106,1068
Florida,Palm River-Clair Mel,23017,6189,7398,3091,628,1023,18329
Florida,Glencoe,2843,878,1041,426,12,82,2439
Florida,Glen St. Mary,567,121,173,40,4,27,365
Florida,Pine Hills,66906,22285,18799,6071,1864,2435,51454
Florida,Pinecrest village,19174,4315,8852,940,229,685,15021
Florida,Pine Castle,10796,3513,3298,892,596,286,8585
Florida,Pine Air,2450,757,770,214,71,71,1883
Florida,Pierson,1466,365,673,80,7,93,1218
Florida,Vamo,4768,909,2064,687,25,757,4442
Florida,Pensacola,52752,15952,16718,6978,986,3588,44222
Florida,Penney Farms,618,97,260,80,0,173,610
Florida,Pembroke Pines,162243,38614,65098,16463,2876,9583,132634
Florida,Pembroke Park,6244,1599,1658,803,301,226,4587
Florida,Pelican Bay,5230,133,4102,204,30,709,5178
Florida,Pebble Creek,8111,1555,3787,670,171,201,6384
Florida,Pea Ridge,4036,784,1746,463,72,77,3142
Florida,Paxton,577,116,237,112,0,37,502
Florida,Patrick AFB,1371,338,601,43,0,15,997
Florida,Pasadena Hills,8292,1627,3718,988,109,553,6995
Florida,Parkland,27114,5002,12928,1425,178,809,20342
Florida,Parker,4462,1222,1381,767,116,379,3865
Florida,Paradise Heights,823,200,354,18,0,32,604
Florida,Panama City Beach,12092,2833,5310,1226,282,733,10384
Florida,Panama City,36917,9025,11935,5127,1106,2315,29508
Florida,Panacea,937,173,587,68,0,75,903
Florida,Palm Valley,21630,4397,10356,2414,189,898,18254
Florida,Palm Springs North,5648,1214,2670,383,66,217,4550
Florida,Palm Springs village,21832,6975,5736,2534,696,976,16917
Florida,Pine Island,0,0,0,0,0,0,0
Florida,Pine Island Center,1877,317,773,340,114,192,1736
Florida,Pine Lakes,626,173,255,35,0,28,491
Florida,Pineland,293,12,188,19,12,31,262
Florida,Glenvar Heights,17881,6054,6191,1891,478,880,15494
Florida,Golden Beach,709,181,316,46,0,35,578
Florida,Golden Gate,29258,9014,8618,2719,908,628,21887
Florida,Golden Glades,33806,13322,8459,2732,1083,1765,27361
Florida,Goldenrod,12603,4621,4001,1192,273,533,10620
Florida,Golf village,170,11,127,9,0,23,170
Florida,Gonzalez,14187,2318,6723,1480,128,662,11311
Florida,Goodland,330,90,194,0,46,0,330
Florida,Gotha,1810,429,816,98,0,49,1392
Florida,Goulding,4274,1910,727,600,155,352,3744
Florida,Goulds,10909,3419,2712,876,386,602,7995
Florida,Graceville,2321,841,501,263,62,227,1894
Florida,Glen Ridge,204,78,64,38,1,7,188
Florida,Grand Ridge,825,154,355,105,24,41,679
Florida,Greenacres,38840,11450,12771,3955,877,2134,31187
Florida,Greenbriar,2385,714,1024,268,24,128,2158
Florida,Green Cove Springs,7054,1735,2529,794,104,531,5693
Florida,Greensboro,664,146,265,45,20,38,514
Florida,Greenville,1080,432,227,90,30,96,875
Florida,Greenwood,882,223,273,104,2,36,638
Florida,Grenelefe,1800,549,518,192,0,226,1485
Florida,Gretna,1271,433,286,194,55,96,1064
Florida,Grove City,1982,287,767,475,101,280,1910
Florida,Groveland,9931,2222,4212,796,186,273,7689
Florida,Gulf Breeze,6092,1065,2925,548,77,337,4952
Florida,Pine Level,168,8,75,38,0,18,139
Florida,Grant-Valkaria,3938,633,2128,420,41,206,3428
Florida,Valrico,36975,7016,17605,2791,564,1393,29369
Florida,Hernando,9699,1931,4359,1346,163,534,8333
Florida,Upper Grand Lagoon,14216,3634,6367,1341,252,604,12198
Florida,Marco Island,17148,2349,10552,1472,140,1475,15988
Florida,Marathon,8563,2588,3064,997,279,398,7326
Florida,Mangonia Park,1929,671,446,141,25,42,1325
Florida,Mango,12267,3288,3711,1397,232,377,9005
Florida,Manatee Road,2790,550,1140,297,0,213,2200
Florida,Manasota Key,1131,45,821,166,0,77,1109
Florida,Manalapan,265,21,169,28,1,20,239
Florida,Stuart,16037,4619,4781,2388,475,1677,13940
Florida,Madeira Beach,4320,1036,1968,715,48,283,4050
Florida,Sumatra,197,0,102,36,0,0,138
Florida,Sun City Center,20554,1160,12180,2096,261,4277,19974
Florida,Suncoast Estates,4570,1332,1214,839,197,289,3871
Florida,Sunny Isles Beach,21837,5574,8961,2699,550,1952,19736
Florida,Margate,55678,14735,20160,6657,1357,4377,47286
Florida,Sunrise,89942,23069,32760,9951,2048,5868,73696
Florida,Surfside,5987,846,2663,594,27,417,4547
Florida,Sweetwater,20739,6157,6937,2392,975,1017,17478
Florida,Taft,1852,470,674,346,21,108,1619
Florida,Tallahassee,187024,89315,46665,15691,2347,5844,159862
Florida,Tamarac,63227,14677,22665,9324,1535,6402,54603
Florida,Tamiami,57195,15549,23008,5792,1999,3327,49675
Florida,Tampa,355603,121872,106463,38005,8910,15766,291016
Florida,Tangelo Park,2346,943,680,273,31,90,2017
Florida,Tangerine,2538,454,1204,226,25,140,2049
Florida,Chattahoochee,3229,1332,763,489,39,185,2808
Florida,Cheval,10833,2269,4402,1192,115,423,8401
Florida,Chiefland,2234,589,660,274,44,173,1740
Florida,Chipley,3564,902,1049,264,274,241,2730
Florida,Sunset,16069,3437,7023,1848,157,934,13399
Florida,Chokoloskee,418,129,147,0,0,55,331
Florida,Marianna,8860,2771,2289,942,452,882,7336
Florida,Mary Esther,4109,961,1895,467,75,288,3686
Florida,Munson,257,4,97,54,64,26,245
Florida,Mulberry,3900,546,1624,354,92,479,3095
Florida,Mulat,466,128,151,26,14,20,339
Florida,Mount Plymouth,5305,924,1884,594,282,214,3898
Florida,Mount Dora,12929,2376,5805,1901,86,997,11165
Florida,Mount Carmel,219,23,115,9,7,0,154
Florida,Morriston,70,0,55,15,0,0,70
Florida,Moore Haven,2818,1172,739,189,57,181,2338
Florida,Moon Lake,4774,1456,1385,586,155,231,3813
Florida,Montverde,1594,352,713,139,2,43,1249
Florida,Montura,3087,739,1329,301,48,80,2497
Florida,Monticello,2006,544,690,211,33,159,1637
Florida,Molino,1256,359,455,153,55,22,1044
Florida,Marineland,13,13,0,0,0,0,13
Florida,Miramar Beach,7120,1273,4005,743,0,405,6426
Florida,Minneola,10086,2466,4331,397,128,326,7648
Florida,Mims,6334,1372,2770,833,93,410,5478
Florida,Milton,9276,2442,3093,1181,230,702,7648
Florida,Midway CDP (Seminole County),1485,550,318,118,65,144,1195
Florida,Midway CDP (Santa Rosa County),17434,2829,7717,2200,369,852,13967
Florida,Midway,3234,965,1074,297,57,91,2484
Florida,Meadow Woods,28943,8552,11527,2307,398,897,23681
Florida,Meadow Oaks,2343,545,892,383,21,158,1999
Florida,Mayo,1145,269,325,207,44,114,959
Florida,Matlacha Isles-Matlacha Shores,354,33,261,39,0,0,333
Florida,Matlacha,851,172,332,215,0,132,851
Florida,Mascotte,5267,1160,2157,476,64,124,3981
Florida,Masaryktown,888,227,303,224,33,51,838
Florida,Miramar,131384,37024,47254,12715,2818,4356,104167
Florida,Myrtle Grove,16134,5085,4690,2139,478,976,13368
Florida,Christmas,2211,528,859,326,150,143,2006
Florida,Chumuckla,767,237,299,18,0,99,653
Florida,Cross City,2198,563,582,316,49,160,1670
Florida,Crystal Lake,6452,1908,1437,1052,280,223,4900
Florida,Crystal River,3060,617,1119,393,79,353,2561
Florida,Crystal Springs,968,208,333,179,14,57,791
Florida,Cudjoe Key,1833,259,1121,193,22,92,1687
Florida,Cutler Bay,43474,10858,15623,4862,830,1689,33862
Florida,Cypress Gardens,8955,1944,4141,823,97,572,7577
Florida,Cypress Lake,11964,2180,4374,2296,96,2029,10975
Florida,Cypress Quarters,1281,449,341,127,33,62,1012
Florida,Dade City,6655,2130,1627,878,197,756,5588
Florida,Malone,1926,1053,325,221,72,91,1762
Florida,Malabar,2822,600,1374,364,20,122,2480
Florida,Maitland,16630,4669,6777,1577,156,971,14150
Florida,Crooked Lake Park,1564,261,623,190,10,82,1166
Florida,Madison,2940,972,749,278,73,247,2319
Florida,Deltona,86418,19364,33785,9594,1630,4386,68759
Florida,Delray Beach,63939,19109,21751,8523,1583,5039,56005
Florida,De Leon Springs,2418,346,1440,87,39,135,2047
Florida,DeLand Southwest,826,395,141,91,0,52,679
Florida,DeLand,28524,7432,9974,3169,537,2347,23459
Florida,DeFuniak Springs,5543,1252,2130,608,105,403,4498
Florida,Deerfield Beach,78227,21893,25438,10106,2443,6020,65900
Florida,DeBary,19547,3462,8750,2778,300,1387,16677
Florida,Daytona Beach Shores,4294,674,2157,635,16,642,4124
Florida,Daytona Beach,62726,23494,16563,8528,1421,4793,54799
Florida,Day,168,32,62,54,10,0,158
Florida,Davie,97372,27511,36173,10748,1834,4080,80346
Florida,Davenport,3137,796,1274,306,68,283,2727
Florida,Desoto Lakes,3692,843,1494,318,145,164,2964
Florida,Chuluota,2481,599,898,371,0,142,2010
Florida,Crestview,22524,5177,8593,1866,508,831,16975
Florida,Crescent Beach,859,190,389,153,9,79,820
Florida,Cinco Bayou,348,86,93,98,11,24,312
Florida,Citrus Hills,8039,480,5863,285,123,886,7637
Florida,Citrus Park,25570,6574,10339,2268,492,858,20531
Florida,Citrus Springs,8695,1489,4386,932,68,489,7364
Florida,Clarcona,2785,671,959,409,128,177,2344
Florida,Clearwater,110381,28311,39358,14952,2626,7694,92941
Florida,Clermont,30319,5715,13365,2832,430,1452,23794
Florida,Cleveland,2881,679,1189,270,48,410,2596
Florida,Clewiston,7240,1980,2532,361,140,356,5369
Florida,Cloud Lake,114,30,43,18,1,4,96
Florida,Cobbtown,53,16,15,11,0,0,42
Florida,Cocoa,17339,4868,4848,2199,552,1146,13613
Florida,Cocoa Beach,11355,2385,5263,1653,135,1004,10440
Florida,Crescent City,1814,543,593,222,20,142,1520
Florida,Cocoa West,4910,1450,1523,701,83,286,4043
Florida,Coleman,575,86,258,106,7,51,508
Florida,Combee Settlement,5921,1494,1347,1091,122,507,4561
Florida,Connerton,3573,1725,767,453,204,68,3217
Florida,Conway,15187,3646,6666,1457,75,724,12568
Florida,Cooper City,33382,7879,14512,2887,260,1047,26585
Florida,Coral Gables,50059,15207,21299,3588,1020,2086,43200
Florida,Coral Springs,126673,34038,48617,11471,2496,3876,100498
Florida,Coral Terrace,23994,6116,9094,2945,821,1893,20869
Florida,Cortez,4043,634,1990,649,39,479,3791
Florida,Cottondale,947,237,309,90,16,27,679
Florida,Country Club,48622,14380,17221,4087,1514,1833,39035
Florida,Country Walk,16485,3949,6836,941,414,668,12808
Florida,Crawfordville,3998,880,1729,504,129,114,3356
Florida,Coconut Creek,56816,13798,20966,6597,1650,3855,46866
Florida,Valparaiso,5069,1888,1834,243,222,257,4444
Florida,Naples,20603,2268,11732,2569,269,2243,19081
Florida,Naples Park,6691,1809,2223,834,409,310,5585
Florida,The Crossings,23938,5888,9194,2919,662,876,19539
Florida,The Acreage,37853,8742,17148,2891,502,1708,30991
Florida,Tequesta village,5819,1146,2215,1032,172,296,4861
Florida,Temple Terrace,25354,8559,8645,2303,448,1042,20997
Florida,Taylor Creek,3600,697,1269,577,138,581,3262
Florida,Tavernier,2435,678,1008,261,57,79,2083
Florida,Tavares,14608,2719,6359,2010,193,1376,12657
Florida,Tarpon Springs,24003,4890,10006,3669,403,2071,21039
Florida,Middleburg,13062,2408,5489,1976,300,514,10687
Florida,Micco,8293,1198,3829,1448,154,1213,7842
Florida,Micanopy,668,145,245,76,12,65,543
Florida,Miami Springs,14397,3207,5797,1933,354,837,12128
Florida,Miami Shores village,10784,3437,3557,788,147,439,8368
Florida,The Hammocks,55713,15154,22406,4994,1268,2813,46635
Florida,Miami Lakes,30728,8085,11415,3253,732,1434,24919
Florida,Miami Beach,91564,29207,29396,12832,3388,3979,78802
Florida,Miami,424632,146957,122123,49388,15598,23867,357933
Florida,Mexico Beach,1355,220,821,172,14,53,1280
Florida,Merritt Island,35900,7967,14333,4875,613,2873,30661
Florida,Memphis,8152,2313,2600,740,158,743,6554
Florida,Melbourne Village,769,125,366,103,23,44,661
Florida,Melbourne Beach,3146,750,1513,285,32,221,2801
Florida,Melbourne,78012,20859,26875,11605,1444,6369,67152
Florida,Medulla,8334,1937,3456,635,164,315,6507
Florida,Lealman,20783,6594,5545,3229,652,1473,17493
Florida,Lecanto,5415,1252,2575,452,99,458,4836
Florida,Lee,561,148,194,46,4,20,412
Florida,Leesburg,21209,5234,6715,2451,567,1566,16533
Florida,Miami Gardens,112021,43442,27315,11320,3515,4785,90377
Florida,Lehigh Acres,110244,28859,36449,11111,2698,3707,82824
Florida,The Meadows,4022,508,1835,529,0,817,3689
Florida,Thonotosassa,13292,3020,4854,1896,282,917,10969
Florida,University Park,25870,8194,10020,2587,537,1752,23090
Florida,Hernando Beach,2376,502,1416,163,19,123,2223
Florida,Dade City North,2467,1015,461,241,70,120,1907
Florida,Heritage Pines,1987,45,1540,144,0,258,1987
Florida,Heathrow,5962,1010,3033,667,14,356,5080
Florida,Hawthorne,1670,416,478,203,39,68,1204
Florida,Haverhill,1979,676,585,193,31,65,1550
Florida,Havana,1895,462,740,176,45,176,1599
Florida,Hastings,682,178,244,100,9,81,612
Florida,Harold,908,225,339,109,53,19,745
Florida,University CDP (Orange County),32937,22959,4686,1724,121,492,29982
Florida,University CDP (Hillsborough County),41858,19172,8613,3455,1236,1770,34246
Florida,Union Park,10498,3543,3356,994,107,407,8407
Florida,The Villages,66083,2967,50672,4765,593,7021,66018
Florida,Umatilla,3586,338,1607,319,75,414,2753
Florida,Trinity,10459,1586,5753,581,81,481,8482
Florida,Trilby,333,102,104,81,0,17,304
Florida,Trenton,2199,580,688,218,29,177,1692
Florida,Treasure Island,6783,1173,3300,910,85,616,6084
Florida,Town 'n' Country,82219,24221,29083,9665,1656,3632,68257
Florida,Titusville,44363,11017,16686,5615,954,3403,37675
Florida,Timber Pines,5305,288,3302,449,11,1225,5275
Florida,Tildenville,1921,470,371,124,131,0,1096
Florida,Tiger Point,2978,660,1513,294,36,105,2608
Florida,Tierra Verde,3359,446,2140,285,8,160,3039
Florida,Tice,4293,1290,1247,536,141,156,3370
Florida,Three Oaks,3188,619,1529,300,52,16,2516
Florida,Three Lakes,16749,4241,6460,1693,221,673,13288
Florida,Tyndall AFB,3128,583,1293,71,27,6,1980
Florida,Naples Manor,5566,1302,1974,190,128,307,3901
Florida,Leisure City,25952,8775,7268,2188,953,929,20113
Florida,Lely Resort,5088,1085,2635,445,51,260,4476
Florida,North Sarasota,7587,2313,2457,760,123,498,6151
Florida,North River Shores,4068,1124,1346,458,1,411,3340
Florida,North Redington Beach,1484,182,894,216,20,87,1399
Florida,North Port,59555,12440,26187,5569,1365,3272,48833
Florida,North Palm Beach village,12425,2575,5578,1642,105,1038,10938
Florida,North Miami Beach,43489,15079,13182,4033,1363,2263,35920
Florida,North Miami,62042,24949,16918,5022,1996,2281,51166
Florida,North Lauderdale,42853,14292,12446,3571,1364,1352,33025
Florida,North Key Largo,1024,190,511,114,0,143,958
Florida,North Fort Myers,40560,6050,19612,5945,648,5480,37735
Florida,North DeLand,1511,379,465,228,0,125,1197
Florida,Northdale,22725,5793,9091,2504,267,1168,18823
Florida,North Brooksville,3695,573,1282,654,95,376,2980
Florida,North Weeki Wachee,8436,1347,4483,905,38,597,7370
Florida,North Bay Village,7689,2455,2503,1303,226,230,6717
Florida,Nokomis,3152,909,1143,545,70,250,2917
Florida,Nocatee,7306,837,3708,278,21,154,4998
Florida,Nobleton,335,68,107,64,0,6,245
Florida,Niceville,13929,2682,6310,1154,283,623,11052
Florida,New Smyrna Beach,23356,3610,11326,3598,186,1891,20611
Florida,New Port Richey East,8686,1711,3527,1224,187,863,7512
Florida,New Port Richey,15260,4020,5008,2189,322,1672,13211
Florida,Newberry,5307,979,2128,484,108,155,3854
Florida,Neptune Beach,6683,1772,2728,863,28,386,5777
Florida,Medley,998,314,265,207,24,93,903
Florida,Navarre,32949,6422,15370,2760,616,1044,26212
Florida,Nassau Village-Ratliff,5228,1103,2078,716,91,355,4343
Florida,Naranja,9392,2875,2363,521,554,338,6651
Florida,Noma,258,53,77,23,8,17,178
Florida,Lely,3589,653,1714,564,27,442,3400
Florida,Oak Hill,1517,212,703,219,46,125,1305
Florida,Oakland Park,43347,15636,12047,5042,1387,1678,35790
Florida,Lemon Grove,678,138,282,50,28,11,509
Florida,Lighthouse Point,10842,1947,5383,1154,198,750,9432
Florida,Limestone,269,63,34,50,10,13,170
Florida,Limestone Creek,1022,327,355,34,10,77,803
Florida,Lisbon,44,16,28,0,0,0,44
Florida,Live Oak,6920,1937,1733,1216,139,400,5425
Florida,Lloyd,378,14,164,28,9,7,222
Florida,Lochmoor Waterway Estates,4561,1061,2008,603,41,292,4005
Florida,Lockhart,14312,4694,4437,1616,393,235,11375
Florida,Longboat Key,7072,549,4839,453,29,1058,6928
Florida,Longwood,13848,3463,5401,1640,191,1069,11764
Florida,Loughman,2877,913,1240,200,0,51,2404
Florida,Lower Grand Lagoon,3722,1141,1433,508,190,201,3473
Florida,Oakland,2721,590,1249,180,35,103,2157
Florida,Loxahatchee Groves,3306,1008,1377,291,26,236,2938
Florida,Lynn Haven,19355,3856,8296,1893,293,900,15238
Florida,Macclenny,6414,1670,1927,461,276,416,4750
Florida,McGregor,7652,1586,3645,851,26,429,6537
Florida,McIntosh,357,49,153,83,0,40,325
Florida,Ojus,19030,4018,7544,2194,478,1182,15416
Florida,Odessa,7404,1596,2899,650,200,229,5574
Florida,Ocoee,39884,9061,15491,3559,689,1634,30434
Florida,Ocean Ridge,1590,246,772,241,9,166,1434
Florida,Ocean City,6120,1578,2350,675,120,306,5029
Florida,Ocean Breeze Park,241,37,75,75,10,44,241
Florida,Ocala,57209,15913,17170,7215,1328,3724,45350
Florida,Oak Ridge,23108,7582,6998,2071,587,756,17994
Florida,Oakleaf Plantation,23087,4464,9734,1560,393,434,16585
Florida,Lutz,20398,4110,9437,1856,308,785,16496
Florida,Navarre Beach,1079,124,698,55,27,22,926
Florida,Sugarmill Woods,9129,816,5715,1011,101,953,8596
Florida,Dickerson City,73,0,47,0,0,26,73
Florida,South Pasadena,5009,990,1644,863,57,1335,4889
Florida,South Palm Beach,1350,215,617,281,13,178,1304
Florida,South Miami Heights,38255,11254,12264,4147,1437,1871,30973
Florida,South Miami,12156,3865,4254,1156,246,371,9892
Florida,South Highpoint,4624,1352,1356,548,161,238,3655
Florida,South Gate Ridge,5902,1028,2485,1159,76,297,5045
Florida,South Patrick Shores,6529,1530,2882,665,152,444,5673
Florida,Southgate,7329,1441,2705,1367,119,663,6295
Florida,South Daytona,12343,3425,3991,1748,138,952,10254
Florida,Southchase,14987,4110,6511,866,137,392,12016
Florida,South Brooksville,3701,585,1575,541,138,427,3266
Florida,South Bradenton,23822,6053,7637,3662,593,1785,19730
Florida,South Beach,3320,299,2158,324,0,421,3202
Florida,South Bay,4976,2494,796,631,116,183,4220
Florida,Southeast Arcadia,8129,2797,2443,433,102,279,6054
Florida,South Sarasota,4973,1021,2253,799,70,270,4413
Florida,South Venice,14652,2927,6667,1921,173,1275,12963
Florida,Southwest Ranches,7676,2015,3603,498,116,329,6561
Florida,Destin,13055,3235,5664,1828,205,486,11418
Florida,White City,3407,761,1526,493,21,331,3132
Florida,White Springs,961,280,302,83,14,40,719
Florida,Whitfield CDP (Manatee County),3173,634,1443,404,23,267,2771
Florida,Whitfield CDP (Santa Rosa County),110,20,37,34,0,19,110
Florida,Wildwood,6052,985,2930,616,102,537,5170
Florida,Stock Island,3901,1370,1188,513,136,109,3316
Florida,Steinhatchee,962,118,476,194,0,94,882
Florida,Starke,5401,1311,1620,562,183,683,4359
Florida,Stacey Street,516,223,196,0,12,0,431
Florida,Spring Ridge,319,23,197,33,0,33,286
Florida,Spring Lake,454,100,257,32,36,29,454
Florida,Springhill,114,35,60,8,0,0,103
Florida,Spring Hill,101709,20524,43375,10200,1875,8205,84179
Florida,Springfield,9186,2596,2585,1421,333,678,7613
Florida,South Apopka,5372,1921,1349,552,168,164,4154
Florida,Wewahitchka,1979,639,619,311,31,186,1786
Florida,Sorrento,514,182,315,0,0,0,497
Florida,Solana,289,17,128,78,0,66,289
Florida,Sarasota Springs,15547,3637,6205,2332,198,1017,13389
Florida,Sarasota,53583,15510,18247,7376,1399,4109,46641
Florida,Sanibel,6899,794,4575,604,65,424,6462
Florida,Sanford,56170,16685,16373,6553,1568,2804,43983
Florida,San Castle,4358,1355,1587,395,101,144,3582
Florida,San Carlos Park,18443,4753,6829,2403,387,674,15046
Florida,Satellite Beach,10351,1787,5047,773,37,604,8248
Florida,San Antonio,1107,245,483,158,9,48,943
Florida,Samoset,4695,1473,1115,871,78,192,3729
Florida,St. Petersburg,250713,76548,82447,32766,5524,15178,212463
Florida,St. Pete Beach,9466,1950,4480,1348,92,805,8675
Florida,St. Marks,255,30,130,43,5,13,221
Florida,St. Lucie Village,613,89,311,78,5,14,497
Florida,St. Leo,1343,1110,163,29,5,13,1320
Florida,Samsula-Spruce Creek,6314,1220,2959,795,37,300,5311
Florida,Sawgrass,5321,792,2795,742,17,364,4710
Florida,Schall Circle,1253,289,379,43,56,57,824
Florida,Sea Ranch Lakes village,701,106,367,38,3,38,552
Florida,Sneads,1849,534,600,214,41,123,1512
Florida,Sky Lake,6260,2320,1763,513,236,454,5286
Florida,Silver Springs Shores,7809,1714,2242,983,194,556,5689
Florida,Silver Lake,1555,401,785,118,0,66,1370
Florida,Siesta Key,6058,546,3539,622,81,661,5449
Florida,Sharpes,2885,644,885,726,45,215,2515
Florida,Shalimar,676,114,360,67,4,36,581
Florida,Shady Hills,10817,2337,4489,1561,214,701,9302
Florida,Sewall's Point,2057,345,1121,166,11,143,1786
Florida,Seville,568,36,275,34,12,23,380
Florida,Seminole Manor,2866,824,923,287,0,97,2131
Florida,Seminole,17637,3488,7749,2013,231,2325,15806
Florida,Seffner,7907,1780,3077,901,104,413,6275
Florida,Sebring,10371,2536,3736,1221,209,983,8685
Florida,Sebastian,22920,4164,10178,3463,325,1556,19686
Florida,Sopchoppy,389,151,106,51,3,30,341
Florida,Westwood Lakes,12449,3047,5141,1404,362,900,10854
Florida,Westville,362,108,116,42,9,11,286
Florida,Westview,10624,4225,2344,1446,331,704,9050
Florida,Asbury Lake,8078,1599,3594,496,181,445,6315
Florida,Astatula,1541,313,647,146,34,77,1217
Florida,Astor,1742,398,726,189,19,163,1495
Florida,Atlantic Beach,12961,3437,5632,1666,123,544,11402
Florida,Atlantis,2175,318,1105,165,32,266,1886
Florida,Auburndale,14281,3387,5752,1111,329,767,11346
Florida,Aripeka,105,25,32,15,16,5,93
Florida,Aucilla,112,13,16,62,8,1,100
Florida,Aventura,37357,6623,16437,4822,694,3130,31706
Florida,Avon Park,9974,2331,3172,1173,310,756,7742
Florida,Azalea Park,13287,4040,4217,1569,365,648,10839
Florida,Babson Park,1337,409,473,104,15,60,1061
Florida,Bagdad,3951,846,1680,558,11,36,3131
Florida,Baldwin,1929,550,588,204,25,137,1504
Florida,Avalon,571,76,317,73,0,29,495
Florida,Archer,1180,264,346,193,18,56,877
Florida,Arcadia,7704,2632,2090,647,100,535,6004
Florida,Apopka,45801,10841,19599,4225,540,1804,37009
Florida,Welaka,642,181,217,77,6,63,544
Florida,Acacia Villas,375,101,89,40,0,14,244
Florida,Alachua,9435,1899,3924,1089,182,362,7456
Florida,Alafaya,85167,23790,33341,6291,1203,2005,66630
Florida,Alford,538,74,168,104,31,39,416
Florida,Allentown,946,110,557,105,0,40,812
Florida,Altamonte Springs,42218,12869,13870,5915,977,2409,36040
Florida,Altha,670,103,312,55,17,31,518
Florida,Altoona,123,11,51,7,0,4,73
Florida,Alturas,3756,799,1748,266,36,331,3180
Florida,Alva,2088,103,1201,283,61,229,1877
Florida,Andrews,1191,310,410,126,0,98,944
Florida,Anna Maria,1219,232,554,153,9,228,1176
Florida,Apalachicola,2077,525,882,191,8,150,1756
Florida,Apollo Beach,16336,2563,8223,1475,221,688,13170
Florida,Bal Harbour village,2677,364,1024,266,34,494,2182
Florida,Balm,1880,409,665,132,71,76,1353
Florida,Bardmoor,9448,2121,4452,860,154,479,8066
Florida,Bartow,18094,4536,6165,2075,323,1063,14162
Florida,Westchase,23222,4607,10531,1579,255,646,17618
Florida,Westchester,30585,6915,13411,3056,683,1949,26014
Florida,West DeLand,3997,733,1436,647,0,244,3060
Florida,Westgate,8310,3250,1801,651,146,378,6226
Florida,West Lealman,15838,3379,5570,3034,333,1492,13808
Florida,West Little River,30749,11144,8242,3001,1005,2067,25459
Florida,West Melbourne,19667,4450,7551,2240,233,1543,16017
Florida,West Miami,6400,1491,2223,1012,138,659,5523
Florida,Weston,68423,13658,31822,4671,584,1568,52303
Florida,West Palm Beach,103588,35061,31389,11462,2581,6219,86712
Florida,West Park,14779,4993,4166,1445,502,864,11970
Florida,West Pensacola,20538,6233,4851,3104,454,1956,16598
Florida,West Perrine,10399,3529,2673,1080,237,464,7983
Florida,West Samoset,7010,2180,1469,504,279,398,4830
Florida,West Vero Corridor,6945,961,2906,1075,94,1651,6687
Florida,West Bradenton,4492,964,2178,407,67,198,3814
Florida,St. James City,3900,326,2530,548,0,318,3722
Florida,Wesley Chapel,49735,9830,21093,4042,742,1610,37317
Florida,Belleair Bluffs,2236,369,947,375,47,210,1948
Florida,Bascom,94,21,33,13,4,10,81
Florida,Bay Harbor Islands,5921,1624,1778,585,294,378,4659
Florida,Bay Hill,5133,942,3099,212,56,116,4425
Florida,Bay Lake,31,7,8,1,0,2,18
Florida,Bayonet Point,25453,5185,9543,3370,544,3132,21774
Florida,Bay Pines,3240,784,1443,504,32,236,2999
Florida,Bayport,452,12,299,22,0,12,345
Florida,Bayshore Gardens,19446,4794,7375,2290,346,1554,16359
Florida,Beacon Square,6564,1216,2453,876,150,575,5270
Florida,Bear Creek,1840,555,714,265,12,115,1661
Florida,Bee Ridge,9836,1509,4731,1099,124,961,8424
Florida,Bell,505,133,185,36,9,35,398
Florida,Bellair-Meadowbrook Terrace,13987,4054,4569,1579,564,823,11589
Florida,Belleair,3941,693,1704,502,37,360,3296
Florida,Belleair Beach,1685,244,972,151,20,109,1496
Florida,Wellington village,60155,13284,27630,4267,721,2415,48317
Florida,Pinellas Park,50433,12309,18964,7321,951,3666,43211
Florida,Pine Manor,4451,1272,1144,263,272,37,2988
Florida,Pine Ridge CDP (Citrus County),10402,1106,6187,898,138,823,9152
Florida,Lake Harbor,0,0,0,0,0,0,0
Florida,Lake Hamilton,1080,296,476,63,22,44,901
Florida,Lake Clarke Shores,3483,675,1489,390,180,375,3109
Florida,Lake City,12082,3633,3309,1651,422,751,9766
Florida,Lake Butler,2224,509,666,213,88,116,1592
Florida,Lake Butler,16871,3637,7830,764,25,430,12686
Florida,Lake Hart,280,130,117,0,0,28,275
Florida,Lake Buena Vista,7,0,5,0,0,2,7
Florida,Lake Alfred,5213,965,1929,409,228,286,3817
Florida,Laguna Beach,3665,562,1682,795,61,171,3271
Florida,Lady Lake,14312,1951,6969,1793,230,1593,12536
Florida,La Crosse,261,49,125,43,2,10,229
Florida,Lacoochee,1630,381,526,37,81,188,1213
Florida,LaBelle,4648,1153,1757,165,333,228,3636
Florida,Lake Belvedere Estates,3475,700,1467,180,2,236,2585
Florida,Lake Helen,2643,440,1143,468,23,239,2313
Florida,Lake Kathryn,920,105,330,215,11,46,707
Florida,Lakeland,101302,28223,34599,11308,2230,6927,83287
Florida,Lakewood Park,11511,2272,5367,1392,224,874,10129
Florida,Lake Wales,14929,3063,5520,1107,326,1137,11153
Florida,Lakeside,31223,7262,12755,3669,526,1448,25660
Florida,Lake Sarasota,4759,1067,2058,548,41,145,3859
Florida,Lake Placid,2541,625,795,267,123,149,1959
Florida,Lake Park,8376,2529,2725,1079,190,461,6984
Florida,Lake Panasoffkee,3311,576,1323,578,98,303,2878
Florida,Lake Mystic,381,122,131,59,0,0,312
Florida,Lake Mary Jane,1430,358,799,24,0,83,1264
Florida,Lake Mary,15038,3095,7353,1193,123,956,12720
Florida,Lake Magdalene,28560,7138,11298,3547,597,1573,24153
Florida,Lake Mack-Forest Hills,568,103,219,122,37,87,568
Florida,Lake Lorraine,7152,1749,2759,923,116,524,6071
Florida,Lake Lindsey,39,8,0,9,0,12,29
Florida,Lakeland Highlands,11728,2412,5580,1001,99,631,9723
Florida,Kissimmee,65422,18797,22162,6792,1917,2281,51949
Florida,Key West,25366,7586,8654,4030,382,1163,21815
Florida,Key Vista,1559,195,1027,34,0,16,1272
Florida,Keystone Heights,1652,309,649,139,61,96,1254
Florida,Wilton Manors,12133,5582,3120,1693,301,489,11185
Florida,Wimauma,6405,1856,1878,346,234,196,4510
Florida,Windermere,3106,487,1532,335,5,126,2485
Florida,Windsor,157,0,122,15,0,0,137
Florida,Winter Beach,2594,353,1225,184,0,180,1942
Florida,Winter Garden,37955,8064,16773,2353,542,1422,29154
Florida,Winter Haven,35835,8691,13289,3713,662,3405,29760
Florida,Winter Park,29182,8200,11425,2598,266,1845,24334
Florida,Winter Springs,33973,8523,14343,3620,357,1518,28361
Florida,Wiscon,414,93,204,22,0,78,397
Florida,Woodlawn Beach,2026,297,1109,155,56,147,1764
Florida,Woodville,2695,722,1076,279,72,144,2293
Florida,World Golf Village,13323,1817,6620,635,123,490,9685
Florida,Worthington Springs,616,222,93,48,47,11,421
Florida,Wright,24862,6674,8598,2649,767,1183,19871
Florida,Willow Oak,4948,1458,1403,715,211,208,3995
Florida,Lake Worth,36403,12125,10145,4360,1196,1483,29309
Florida,Williston Highlands,2142,311,1083,194,93,112,1793
Florida,Williamsburg,8148,2184,3166,971,220,598,7139
Florida,Keystone,23271,3668,12847,1130,102,678,18425
Florida,Key Largo,10496,2186,4600,1634,162,658,9240
Florida,Key Colony Beach,739,12,497,89,34,107,739
Florida,Key Biscayne village,12888,2113,6024,746,171,611,9665
Florida,Kenwood Estates,1451,437,454,98,82,5,1076
Florida,Kensington Park,4185,920,1394,618,136,162,3230
Florida,Kenneth City,5013,1301,1721,581,66,544,4213
Florida,Kendall West,39347,10313,15656,4334,1272,1995,33570
Florida,Kendall,76267,21080,29415,8269,1450,4719,64933
Florida,Kendale Lakes,59354,15652,23203,7232,1595,3401,51083
Florida,Kathleen,5895,1379,2290,632,128,346,4775
Florida,Jupiter Island,656,104,408,35,11,69,627
Florida,Jupiter Inlet Colony,390,37,216,37,9,11,310
Florida,Jupiter Farms,11514,2131,6043,706,47,636,9563
Florida,Jupiter,59054,11984,26612,6407,665,4025,49693
Florida,Williston,2730,695,831,346,52,237,2161
Florida,Wekiwa Springs,23500,5817,10078,2227,197,1206,19525
Florida,Lamont,191,73,118,0,0,0,191
Florida,Lantana,10910,3360,3511,1101,419,569,8960
Florida,Port Richey,2699,620,1092,472,6,238,2428
Florida,Port St. Joe,3413,1013,1166,516,23,281,2999
Florida,Port St. John,11335,2652,4353,1682,220,439,9346
Florida,Port St. Lucie,172054,38160,71135,17268,2885,8854,138302
Florida,Port Salerno,9999,2335,4195,1269,119,872,8790
Florida,Pretty Bayou,3432,573,1507,398,110,331,2919
Florida,Port Orange,57858,12954,24597,7078,516,4703,49848
Florida,Princeton,26992,7387,7925,2617,1304,677,19910
Florida,Punta Gorda,17288,2303,10238,1894,228,1781,16444
Florida,Punta Rassa,1767,183,921,96,10,557,1767
Florida,Quail Ridge,1263,277,527,204,3,23,1034
Florida,Quincy,7947,2555,2171,1004,179,472,6381
Florida,Raiford,121,30,41,14,2,9,96
Florida,Raleigh,165,44,58,41,0,22,165
Florida,Progress Village,7366,2258,2389,594,114,296,5651
Florida,Port LaBelle,4385,1036,1522,385,60,233,3236
Florida,Port Charlotte,56434,11226,24367,7255,739,5651,49238
Florida,Ponce Inlet,3086,458,1721,385,69,255,2888
Florida,Pine Ridge CDP (Collier County),1994,512,901,199,10,100,1722
Florida,Pinewood,16992,6681,4041,1218,777,839,13556
Florida,Pioneer,728,242,224,51,37,86,640
Florida,Pittman,279,44,108,67,5,11,235
Florida,Plantation,89904,23230,34886,9491,1869,4062,73538
Florida,Plantation,4933,265,3379,413,26,765,4848
Florida,Plantation Island,452,64,98,87,0,14,263
Florida,Plantation Mobile Home Park,1123,319,338,100,0,52,809
Florida,Plant City,36382,8905,13719,3787,684,1297,28392
Florida,Poinciana,59927,16674,22613,4617,921,1706,46531
Florida,Point Baker,3440,735,1302,414,52,88,2591
Florida,Polk City,2413,441,855,275,109,121,1801
Florida,Pomona Park,732,201,249,97,10,51,608
Florida,Pompano Beach,104741,32600,32231,13015,2676,7611,88133
Florida,Ponce de Leon,496,74,159,73,30,47,383
Florida,Reddick,559,153,137,65,0,33,388
Florida,Redington Beach,1565,243,825,247,4,94,1413
Florida,Redington Shores,2046,286,1011,386,42,160,1885
Florida,Richmond Heights,9985,3784,2741,1204,193,626,8548
Florida,St. Augustine,13676,5048,4458,1522,303,885,12216
Florida,St. Augustine Beach,6564,1145,3451,778,35,219,5628
Florida,St. Augustine Shores,8024,1196,3182,1505,60,817,6760
Florida,St. Augustine South,5349,1296,2050,906,13,265,4530
Florida,St. Cloud,41502,10442,15608,4242,711,2121,33124
Florida,St. George Island,587,34,444,66,0,23,567
Florida,Lazy Lake village,33,23,1,5,1,3,33
Florida,Layton,122,7,86,16,0,8,117
Florida,Lawtey,1051,314,326,108,22,78,848
Florida,Laurel Hill,609,104,287,39,8,45,483
Florida,Laurel,9390,1719,4210,1283,207,1023,8442
Florida,Lauderhill,69979,24100,18031,7979,2178,4046,56334
Florida,Lauderdale Lakes,34103,10958,9967,3187,1097,1777,26986
Florida,Lauderdale-by-the-Sea,6313,1156,3190,949,41,689,6025
Florida,Largo,79737,19812,28212,12127,1774,6402,68327
Florida,Safety Harbor,17142,3094,7759,1949,348,1305,14455
Florida,Land O' Lakes,33812,7000,15514,3361,506,1614,27995
Florida,Ruskin,20643,4749,7386,2084,353,498,15070
Florida,Royal Palm Beach village,36175,8513,14394,3127,586,1776,28396
Florida,Richmond West,35693,8927,14579,3314,897,1603,29320
Florida,Ridgecrest,3237,736,844,365,127,248,2320
Florida,Ridge Manor,4593,867,1967,650,27,532,4043
Florida,Ridge Wood Heights,4760,1550,1340,847,74,218,4029
Florida,Rio,1022,399,366,157,0,67,989
Florida,Rio Pinar,5490,1048,2714,282,85,372,4501
Florida,River Park,5622,1370,1874,1102,208,545,5099
Florida,River Ridge,4601,758,2294,572,0,320,3944
Florida,Riverview,79886,17695,32833,6879,1678,2364,61449
Florida,Riviera Beach,33445,11100,9719,3234,1072,1891,27016
Florida,Rockledge,25798,5438,11306,2775,444,1569,21532
Florida,Roeville,513,68,257,98,6,0,429
Florida,Roosevelt Gardens,2760,1131,599,247,94,81,2152
Florida,Roseland,1669,200,1123,140,48,94,1605
Florida,Rotonda,8337,951,5130,740,56,948,7825
Florida,Royal Palm Estates,3014,1013,933,326,23,65,2360
Florida,Weeki Wachee Gardens,1527,126,855,305,0,160,1446
Florida,Whiskey Creek,4973,1007,2369,589,36,394,4395
Florida,Wedgefield,7800,1701,3161,562,195,194,5813
Florida,Cape Coral,165843,33252,69648,19562,3242,10303,136007
Florida,Cape Canaveral,10031,1729,4455,2017,204,861,9266
Florida,Canal Point,376,91,220,7,3,27,348
Florida,Campbellton,169,32,86,11,11,11,151
Florida,Campbell,2561,288,1054,329,162,521,2354
Florida,Callaway,14760,2955,6111,1535,360,839,11800
Florida,Captiva,163,94,24,35,0,10,163
Florida,Callahan,1291,289,369,211,34,95,998
Florida,Butler Beach,5629,1229,2970,544,59,505,5307
Florida,Bushnell,2973,510,1251,368,58,210,2397
Florida,Burnt Store Marina,1903,105,1471,150,10,167,1903
Florida,Bunnell,2762,768,741,365,57,285,2216
Florida,Buenaventura Lakes,31348,8633,10902,2901,938,1540,24914
Florida,Buckingham,4316,929,1973,420,81,225,3628
Florida,Cabana Colony,2266,488,949,219,107,83,1846
Florida,Buckhead Ridge,1595,216,783,224,65,189,1477
Florida,Carrabelle,2770,1074,747,475,52,94,2442
Florida,Caryville,300,113,82,27,8,20,250
Florida,Fort Pierce North,7058,2247,1831,784,246,415,5523
Florida,Fort Pierce South,4646,1334,1717,524,205,220,4000
Florida,Fort Walton Beach,20767,5383,7216,2869,348,1492,17308
Florida,Fort White,728,123,270,47,16,27,483
Florida,Weeki Wachee,1,0,1,0,0,0,1
Florida,Charlotte Park,2475,103,1651,341,0,207,2302
Florida,Carrollwood,35027,8938,13881,3802,988,1720,29329
Florida,Charlotte Harbor,4001,835,1521,312,134,727,3529
Florida,Century,1529,429,483,192,24,188,1316
Florida,Center Hill,1150,379,402,86,38,39,944
Florida,Celebration,7816,1380,3773,604,35,167,5959
Florida,Cedar Key,667,75,370,95,0,63,603
Florida,Cedar Grove,3313,862,1063,465,156,138,2684
Florida,Casselberry,26663,7776,9245,3522,751,1397,22691
Florida,Charleston Park,146,106,16,24,0,0,146
Florida,Brownsville,16410,7263,2357,1392,845,880,12737
Florida,Brownsdale,518,35,339,21,21,14,430
Florida,Brooksville,7752,1751,2531,1338,180,690,6490
Florida,Blountstown,2625,587,957,275,84,282,2185
Florida,Bloomingdale,22882,4971,10908,1659,252,745,18535
Florida,Black Hammock,963,107,492,220,0,31,850
Florida,Black Diamond,1114,145,572,63,0,178,958
Florida,Bithlo,8559,2271,3200,883,155,198,6707
Florida,Biscayne Park village,3193,861,1099,355,43,187,2545
Florida,Boca Raton,89793,23427,37640,10055,1284,5541,77947
Florida,Big Pine Key,4716,1125,2105,705,32,297,4264
Florida,Beverly Hills,8593,1892,3027,1043,158,1200,7320
Florida,Beverly Beach,342,26,214,44,7,42,333
Florida,Berrydale,406,147,113,63,4,14,341
Florida,Bellview,22341,4831,8979,2484,455,1341,18090
Florida,Belleview,4612,1231,1195,474,134,569,3603
Florida,Belle Isle,6403,1525,3599,317,38,163,5642
Florida,Big Coppitt Key,2567,552,989,442,87,89,2159
Florida,Bokeelia,1339,93,903,157,15,90,1258
Florida,Bonifay,2756,620,851,375,83,215,2144
Florida,Bonita Springs,47915,9123,23769,4655,422,3811,41780
Florida,Brookridge,4429,489,1849,1067,47,671,4123
Florida,Brooker,394,84,116,62,17,33,312
Florida,Bronson,955,230,359,141,8,74,812
Florida,Broadview Park,7593,2437,2377,534,451,139,5938
Florida,Bristol,1107,260,399,121,14,125,919
Florida,Briny Breezes,812,83,422,110,8,177,800
Florida,Brent,21957,9195,5195,2444,544,1062,18440
Florida,Branford,867,229,266,120,9,47,671
Florida,Brandon,108287,31533,39379,11306,2014,4788,89020
Florida,Bradley Junction,480,159,97,98,31,55,440
Florida,Bradenton Beach,946,181,406,170,27,99,883
Florida,Bradenton,51811,13829,17181,6613,920,4354,42897
Florida,Boynton Beach,71530,20579,25004,7774,1866,5215,60438
Florida,Bowling Green,2916,685,973,221,87,121,2087
Florida,Boulevard Gardens,1870,853,532,41,246,63,1735
Florida,Fort Pierce,43267,13171,12140,4785,1363,2784,34243
Florida,Fort Myers Shores,5541,1496,1935,613,367,240,4651
Florida,Fort Myers Beach,6668,939,3814,1003,38,695,6489
Florida,Fort Myers,68472,21650,21645,7767,1528,4095,56685
Florida,Dundee,3908,1013,1318,208,83,236,2858
Florida,Dunedin,35712,7477,14040,5382,738,3537,31174
Florida,Dunnellon,1783,308,570,348,93,271,1590
Florida,Eagle Lake,2486,527,948,241,44,142,1902
Florida,East Bronson,2355,593,645,550,0,178,1966
Florida,East Lake,32054,5669,16373,2952,297,2022,27313
Florida,Duck Key,665,149,291,103,0,64,607
Florida,East Lake-Orient Park,25373,7964,7851,2316,817,933,19881
Florida,East Palatka,1852,630,552,300,18,89,1589
Florida,Eastpoint,2165,299,1164,141,0,123,1727
Florida,East Williston,731,262,218,111,21,30,642
Florida,Eatonville,2299,1010,441,253,60,137,1901
Florida,Ebro,259,31,113,30,9,13,196
Florida,Edgewater,21050,3957,9501,2935,340,1555,18288
Florida,East Milton,12490,4592,3672,1842,202,420,10728
Florida,Dover,3817,1007,1442,214,89,107,2859
Florida,Doral,51382,11389,20786,4527,963,1202,38867
Florida,Zolfo Springs,2003,403,596,109,34,108,1250
Florida,Dixonville,182,0,151,14,0,17,182
Florida,Doctor Phillips,11501,2815,5177,937,159,657,9745
Florida,Highland Beach,3654,405,2374,300,53,354,3486
Florida,Hialeah Gardens,23092,6286,8982,1947,854,1291,19360
Florida,Hialeah,234714,70929,82907,22703,7742,16236,200517
Florida,Inglis,1370,255,623,230,26,104,1238
Florida,Yalaha,1117,124,764,104,0,86,1078
Florida,Yankeetown,514,54,275,74,3,38,444
Florida,Yeehaw Junction,213,0,105,73,0,21,199
Florida,Yulee,11672,2406,5277,1141,296,522,9642
Florida,Zellwood,3302,520,2060,215,0,254,3049
Florida,Zephyrhills,14275,2725,5900,2266,265,1481,12637
Florida,Zephyrhills North,2310,531,852,433,30,286,2132
Florida,Zephyrhills South,5359,587,2502,879,114,634,4716
Florida,Zephyrhills West,5207,414,3029,645,71,735,4894
Florida,Edgewood,2690,699,1265,189,7,107,2267
Florida,Belle Glade,17950,6281,4777,1360,646,711,13775
Florida,Eglin AFB,2384,223,1054,80,0,294,1651
Florida,Elfers,13982,3178,5290,1476,290,1232,11466
Florida,Five Points,812,281,209,142,25,82,739
Florida,Flagler Beach,4682,921,2447,621,9,321,4319
Florida,Flagler Estates,3051,702,1182,475,35,120,2514
Florida,Fleming Island,30350,5808,14505,2511,206,1060,24090
Florida,Floral City,4919,805,2116,807,87,513,4328
Florida,Florida City,12024,4915,2217,693,454,445,8724
Florida,Fish Hawk,16297,2630,7577,823,138,239,11407
Florida,Florida Ridge,19701,4570,8066,1777,273,1436,16122
Florida,Forest City,14924,3930,5269,1541,376,925,12041
Florida,Fort Denaud,1639,385,784,269,1,60,1499
Florida,Fort Green,161,55,60,37,0,3,155
Florida,Fort Green Springs,325,109,48,91,0,0,248
Florida,Fort Lauderdale,173570,59913,52698,21633,4532,8658,147434
Florida,Fort Meade,5824,1483,2152,531,49,302,4517
Florida,Floridatown,326,101,170,26,0,8,305
Florida,Fisher Island,232,83,0,0,0,0,83
Florida,Fidelis,37,7,12,0,0,18,37
Florida,Ferry Pass,32077,10704,9540,3412,700,2015,26371
Florida,Ellenton,3009,407,1876,213,13,231,2740
Florida,El Portal village,2492,827,812,309,49,136,2133
Florida,Englewood,14515,2048,8035,1597,175,1785,13640
Florida,Ensley,21981,5612,6633,3368,301,1549,17463
Florida,Estero village,29588,4209,17921,2228,273,1949,26580
Florida,Esto,375,87,131,56,7,14,295
Florida,Eustis,19198,4979,6918,2015,208,1536,15656
Florida,Everglades,268,46,158,14,6,4,228
Florida,Fairview Shores,10586,3481,3116,1091,275,653,8616
Florida,Fanning Springs,1046,201,418,104,17,140,880
Florida,Feather Sound,3370,833,1583,401,54,83,2954
Florida,Fellsmere,5390,1287,2222,173,127,56,3865
Florida,Fernandina Beach,11990,2274,5436,1408,233,1054,10405
Florida,Ferndale,469,28,246,0,0,109,383
Florida,Fern Park,8161,2197,2605,1485,229,648,7164
Florida,Egypt Lake-Leto,37408,11306,11976,4422,1433,1436,30573
Florida,Belleair Shore,62,6,44,3,2,2,57
Florida,Interlachen,1430,321,471,180,10,115,1097
Florida,Wacissa,229,13,139,30,7,0,189
Florida,Wahneta,5372,1704,1356,368,54,134,3616
Florida,Waldo,1004,323,270,159,19,46,817
Florida,Wallace,1502,370,823,90,0,78,1361
Florida,Warrington,13053,3321,3610,2225,356,1082,10594
Florida,Washington Park,1310,430,269,128,74,81,982
Florida,Watergate,3245,862,1135,485,40,64,2586
Florida,Warm Mineral Springs,4935,497,3216,228,54,743,4738
Florida,Wauchula,4909,1132,2167,337,10,350,3996
Florida,Waukeenah,148,24,67,6,0,7,104
Florida,Wausau,486,106,196,31,12,30,375
Florida,Waverly,828,252,55,151,45,99,602
Florida,Webster,813,187,307,92,12,59,657
Florida,Watertown,3318,910,940,454,166,201,2671
Georgia,Tifton,16656,6376,4143,1609,255,824,13207
Georgia,The Rock,192,44,114,0,0,10,168
Georgia,Thomaston,9032,2548,2814,960,186,726,7234
Georgia,Thomasville,18612,5007,6008,1875,814,1042,14746
Georgia,Thomson,6697,1956,1780,503,186,446,4871
Georgia,Thunderbolt,2594,717,935,331,81,152,2216
Georgia,Tiger,412,115,147,37,6,26,331
Georgia,Metter,4145,1057,1273,452,119,348,3249
Georgia,Toccoa,8302,1982,3153,687,96,442,6360
Georgia,Toomsboro,345,127,77,44,13,42,303
Georgia,Trenton,2123,361,977,219,74,105,1736
Georgia,Trion,2210,487,800,200,11,93,1591
Georgia,Tucker,27761,6884,10761,2840,393,1118,21996
Georgia,Tennille,1499,490,321,133,89,108,1141
Georgia,Tignall,523,124,179,78,16,56,453
Georgia,Temple,4248,1073,1575,430,107,83,3268
Georgia,Talbotton,1147,436,264,105,88,101,994
Georgia,Tate City,0,0,0,0,0,0,0
Georgia,Sunset Village,803,113,384,60,0,72,629
Georgia,Surrency,184,42,89,23,1,6,161
Georgia,Suwanee,17291,3150,8218,1091,136,474,13069
Georgia,Swainsboro,7456,2581,1389,734,287,418,5409
Georgia,Sycamore,788,293,271,41,14,37,656
Georgia,Sylvania,2550,707,859,197,76,205,2044
Georgia,Taylorsville,222,31,120,25,9,12,197
Georgia,Sylvester,6146,1738,1593,560,345,382,4618
Georgia,Riceboro,665,176,249,59,22,70,576
Georgia,Talking Rock,89,21,33,4,2,5,65
Georgia,Tallapoosa,3138,752,1135,318,135,235,2575
Georgia,Tallulah Falls,90,29,49,12,0,0,90
Georgia,Talmo,214,33,123,19,0,9,184
Georgia,Tarrytown,64,5,10,25,1,12,53
Georgia,Talahi Island,1237,146,758,88,66,94,1152
Georgia,Richland,1692,609,261,300,65,200,1435
Georgia,Roberta,843,267,195,125,15,88,690
Georgia,Riddleville,58,19,24,8,2,4,57
Georgia,Union City,20459,7456,3855,2339,467,1105,15222
Georgia,Unadilla,3699,1388,854,605,137,191,3175
Georgia,Ty Ty,985,318,265,61,19,47,710
Georgia,Tyrone,7081,1532,3449,650,21,201,5853
Georgia,Tybee Island,3058,806,1298,487,2,92,2685
Georgia,Twin City,2161,857,424,211,43,251,1786
Georgia,Turin,412,37,223,12,3,11,286
Georgia,Tunnel Hill,1096,162,532,94,25,58,871
Georgia,Sandy Springs,100691,29520,38629,8842,937,3913,81841
Georgia,Sandersville,5831,1788,1520,557,230,488,4583
Georgia,Salem,293,114,108,5,0,33,260
Georgia,Sale City,459,104,182,23,8,22,339
Georgia,St. Simons,13287,2228,6382,1846,88,994,11538
Georgia,St. Marys,17675,3830,7820,1065,199,733,13647
Georgia,Rutledge,937,189,411,112,26,62,800
Georgia,Russell,1374,629,275,180,0,37,1121
Georgia,Royston,2478,591,737,405,66,308,2107
Georgia,Rincon,9487,1633,3246,1021,257,305,6462
Georgia,Ringgold,3668,703,1424,404,31,216,2778
Georgia,Riverdale,15650,5296,4128,1597,511,546,12078
Georgia,Riverside,22,4,6,6,0,6,22
Georgia,Lovejoy,6450,2285,1446,771,84,161,4747
Georgia,Robins AFB,1405,434,534,24,6,3,1001
Georgia,Richmond Hill,10872,2081,4821,509,96,408,7915
Georgia,Rochelle,1076,321,347,113,58,84,923
Georgia,Rockmart,4197,1160,1334,456,197,322,3469
Georgia,Rocky Ford,221,17,95,19,8,18,157
Georgia,Rome,36278,9670,11710,3864,1115,2491,28850
Georgia,Roopville,363,73,138,45,3,21,280
Georgia,Rossville,4035,925,969,721,83,430,3128
Georgia,Roswell,93471,22929,40266,7613,685,3156,74649
Georgia,Rockingham,411,64,105,48,0,0,217
Georgia,Louisville,2581,810,722,202,77,190,2001
Georgia,Cadwell,611,274,166,52,1,32,525
Georgia,Lone Oak,62,13,24,15,0,8,60
Georgia,Mountain City,886,217,352,85,8,91,753
Georgia,Mountain Park,591,155,211,104,0,42,512
Georgia,Chattanooga Valley,3625,888,1391,404,39,279,3001
Georgia,Chauncey,345,84,113,39,7,12,255
Georgia,Cherry Log,159,15,92,26,11,15,159
Georgia,Chester,2037,1116,264,430,68,49,1927
Georgia,Chickamauga,3115,792,1165,231,85,310,2583
Georgia,Clarkesville,1937,416,732,231,33,152,1564
Georgia,Clarkston,11990,4125,3512,799,255,203,8894
Georgia,Claxton,2163,516,619,243,47,171,1596
Georgia,Clayton,2068,457,664,307,66,198,1692
Georgia,Clermont,1060,212,480,100,8,52,852
Georgia,Cleveland,3689,982,1299,287,151,181,2900
Georgia,Climax,165,31,83,20,1,17,152
Georgia,Cobbtown,339,46,150,45,5,41,287
Georgia,Cochran,4765,2159,1002,451,114,317,4043
Georgia,Cohutta,666,148,274,109,5,59,595
Georgia,Newnan,35224,8310,12599,2948,1020,1275,26152
Georgia,Newington,284,45,114,30,4,16,209
Georgia,Newborn,641,139,227,95,10,31,502
Georgia,Nelson,1407,281,601,78,4,106,1070
Georgia,Nashville,4914,990,1674,492,202,449,3807
Georgia,Nahunta,1095,196,318,205,29,121,869
Georgia,Moultrie,14474,4118,3538,1946,570,843,11015
Georgia,Mount Zion,1850,375,727,164,59,97,1422
Georgia,Mount Airy,1233,293,467,149,19,77,1005
Georgia,Mountain Park,12702,2888,5792,924,113,559,10276
Georgia,Collins,484,110,105,78,30,35,358
Georgia,College Park,14026,5806,2430,1288,373,658,10555
Georgia,Coleman,35,21,0,14,0,0,35
Georgia,Colbert,663,148,242,78,7,44,519
Georgia,Mount Vernon,2003,666,574,236,44,105,1625
Georgia,Lookout Mountain,1664,217,862,142,5,54,1280
Georgia,Morven,518,108,223,19,0,46,396
Georgia,Morganton,375,66,139,63,2,47,317
Georgia,Loganville,10855,1839,4754,1053,246,461,8353
Georgia,Locust Grove,5666,1802,1677,472,85,197,4233
Georgia,Byromville,446,145,119,48,14,55,381
Georgia,Byron,4818,747,2139,449,251,211,3797
Georgia,Union Point,1485,443,450,105,43,101,1142
Georgia,Cairo,9759,2688,3107,711,225,738,7469
Georgia,Calhoun,15948,3610,5537,1589,397,1085,12218
Georgia,Calvary,97,33,30,0,0,20,83
Georgia,Camak,187,28,78,8,2,17,133
Georgia,Camilla,5083,1794,1219,484,114,425,4036
Georgia,Candler-McAfee,22835,8614,4864,2935,921,1745,19079
Georgia,Canon,790,142,313,116,23,60,654
Georgia,Canoochee,93,5,52,0,0,15,72
Georgia,Canton,24305,4950,8990,2785,597,973,18295
Georgia,Carl,224,38,118,14,4,11,185
Georgia,Carlton,355,66,191,27,2,23,309
Georgia,Carnesville,664,163,217,86,13,22,501
Georgia,Morgan,2679,1781,480,285,52,53,2651
Georgia,Moreland,379,62,143,51,7,39,302
Georgia,Moody AFB,637,0,358,0,0,0,358
Georgia,Chattahoochee Hills,2575,563,1192,271,21,199,2246
Georgia,Chatsworth,4297,872,1674,617,102,387,3652
Georgia,Chamblee,27654,10742,8543,2009,480,677,22451
Georgia,Morrow,6982,2208,2063,1000,139,284,5694
Georgia,Centralhatchee,418,87,170,34,5,25,321
Georgia,Cedartown,9781,2206,2912,1034,169,590,6911
Georgia,Cedar Springs,22,0,22,0,0,0,22
Georgia,Cecil,391,132,102,34,16,27,311
Georgia,Cave Spring,1355,318,474,171,35,67,1065
Georgia,Cartersville,19964,4285,7271,2387,266,1271,15480
Georgia,Carrollton,25515,10803,6053,2293,761,974,20884
Georgia,Centerville,7519,1390,2955,719,239,598,5901
Georgia,Unionville,1574,820,265,136,53,72,1346
Georgia,Uvalda,565,104,244,48,8,29,433
Georgia,Valdosta,56504,22012,13927,5061,1665,2854,45519
Georgia,Sparks,2373,624,700,155,56,136,1671
Georgia,Sparta,1515,600,362,115,83,129,1289
Georgia,Springfield,2826,691,859,374,53,183,2160
Georgia,Stapleton,471,66,143,43,29,54,335
Georgia,Statenville,1142,276,418,97,4,35,830
Georgia,Statesboro,30059,18825,4766,1307,468,1087,26453
Georgia,Statham,2564,730,955,258,61,57,2061
Georgia,Stillmore,603,140,200,69,8,39,456
Georgia,Stockbridge,27328,7519,9629,2592,473,1190,21403
Georgia,Stone Mountain,5991,2229,1562,646,142,397,4976
Georgia,Sugar Hill,20323,4499,8647,1502,155,741,15544
Georgia,Summertown,213,66,69,11,4,12,162
Georgia,Summerville,4422,1167,1263,533,209,440,3612
Georgia,Sumner,402,99,159,49,7,13,327
Georgia,Buchanan,1260,351,399,143,37,135,1065
Georgia,Soperton,3073,893,741,353,187,369,2543
Georgia,Brunswick,15794,5317,3956,1837,558,941,12609
Georgia,Social Circle,4304,725,1828,388,111,213,3265
Georgia,Smyrna,53829,14916,20233,5418,661,1376,42604
Georgia,Matthews,250,18,89,42,0,10,159
Georgia,Buford,13244,3364,4492,1354,277,645,10132
Georgia,Buena Vista,2231,831,592,205,57,149,1834
Georgia,Buckhead,227,46,57,31,22,21,177
Georgia,Seville,155,73,58,3,0,6,140
Georgia,Shady Dale,321,52,138,24,1,10,225
Georgia,Shannon,1829,302,573,354,32,65,1326
Georgia,Sharon,110,36,36,11,9,15,107
Georgia,Sharpsburg,538,141,228,56,11,15,451
Georgia,Shellman,1071,352,337,52,28,70,839
Georgia,Shiloh,558,131,288,48,11,10,488
Georgia,Siloam,393,149,69,44,20,23,305
Georgia,Skidaway Island,8042,875,5324,254,10,816,7279
Georgia,Sky Valley,325,28,240,10,0,38,316
Georgia,Smithville,584,150,197,51,7,46,451
Georgia,Snellville,19199,4657,8152,1570,263,1016,15658
Georgia,Broxton,1101,336,360,59,18,85,858
Georgia,Brooks,637,97,334,47,5,17,500
Georgia,Brooklet,1540,353,681,175,5,65,1279
Georgia,Molena,496,167,144,30,17,24,382
Georgia,Mitchell,194,39,91,11,2,9,152
Georgia,Mineral Bluff,96,7,35,23,0,14,79
Georgia,Milton,35799,6418,17157,2202,383,770,26930
Georgia,Milner,1140,187,486,100,9,43,825
Georgia,Millen,3003,772,672,276,205,248,2173
Georgia,Milledgeville,18971,10203,3602,1498,500,885,16688
Georgia,Milan,705,133,292,52,11,76,564
Georgia,Midway,2040,495,725,200,54,69,1543
Georgia,Maxeys,301,83,110,26,6,17,242
Georgia,Maysville,2215,319,900,268,21,176,1684
Georgia,Meansville,157,22,77,27,6,8,140
Georgia,Meigs,918,251,261,57,46,51,666
Georgia,Mendes,45,10,26,0,0,9,45
Georgia,Menlo,496,105,169,77,9,30,390
Georgia,Monroe,13476,4630,3566,1533,420,544,10693
Georgia,Montezuma,3284,1158,958,211,145,205,2677
Georgia,Montgomery,4544,1149,1685,594,31,313,3772
Georgia,Monticello,2607,619,692,375,53,159,1898
Georgia,Brookhaven,50812,16225,17639,4039,1038,1798,40739
Georgia,Bronwood,191,35,58,33,3,19,148
Georgia,Brinson,344,115,139,33,2,17,306
Georgia,Bremen,6224,812,2670,658,86,306,4532
Georgia,Braswell,364,97,150,21,0,16,284
Georgia,Braselton,8074,1189,4004,570,126,151,6040
Georgia,Boykin,108,18,57,16,0,17,108
Georgia,Martinez,36895,8973,15187,3469,842,1420,29891
Georgia,Bowman,842,171,333,98,21,56,679
Georgia,Bowdon,2252,519,724,265,74,210,1792
Georgia,Bostwick,528,91,244,26,0,5,366
Georgia,Boston,1461,471,390,147,56,95,1159
Georgia,Bonanza,3873,1382,938,572,109,118,3119
Georgia,Bogart,1117,318,435,106,14,60,933
Georgia,Blythe,728,165,317,88,6,19,595
Georgia,Montrose,246,81,69,17,17,16,200
Georgia,Bowersville,414,99,168,35,10,16,328
Georgia,Martin,458,50,261,26,9,12,358
Georgia,Marshallville,1359,434,426,98,105,86,1149
Georgia,Marietta,58906,19439,18532,5891,1022,2023,46907
Georgia,Waynesboro,5801,1906,1313,389,297,250,4155
Georgia,Webster County unified governme,2720,700,976,209,86,218,2189
Georgia,West Point,3410,898,1055,291,136,347,2727
Georgia,Whigham,738,188,247,94,11,67,607
Georgia,White,762,122,312,87,33,33,587
Georgia,Sunnyside,1413,426,630,51,0,85,1192
Georgia,Sunny Side,94,8,40,20,0,6,74
Georgia,Ludowici,2343,607,714,280,94,200,1895
Georgia,Lula,2793,477,988,344,86,125,2020
Georgia,Lumber City,1327,368,460,127,52,142,1149
Georgia,Lumpkin,1311,430,267,129,80,101,1007
Georgia,Luthersville,1214,287,408,140,15,77,927
Georgia,Lyerly,534,121,230,77,0,23,451
Georgia,Lyons,4362,743,1582,459,71,301,3156
Georgia,Mableton,39589,9978,14430,3250,1019,1307,29984
Georgia,Waycross,14258,3158,4455,1843,424,1216,11096
Georgia,Waverly Hall,891,298,301,110,29,97,835
Georgia,Watkinsville,2871,658,1166,309,37,123,2293
Georgia,Washington,4001,950,1177,750,139,391,3407
Georgia,Varnell,1835,291,894,157,38,92,1472
Georgia,Vernonburg,126,16,80,3,0,3,102
Georgia,Vidalia,10627,2216,3928,890,154,723,7911
Georgia,Vidette,127,28,66,5,3,9,111
Georgia,Vienna,3846,1417,1068,306,121,244,3156
Georgia,Villa Rica,14435,2967,5394,1590,276,596,10823
Georgia,Vinings,11224,4472,4282,970,98,286,10108
Georgia,McCaysville,1176,172,428,150,59,99,908
Georgia,Waco,474,80,205,76,7,40,408
Georgia,Waleska,642,479,83,18,10,24,614
Georgia,Walnut Grove,1213,265,559,140,32,28,1024
Georgia,Walthourville,4136,882,1398,307,188,144,2919
Georgia,Warm Springs,518,141,141,65,12,56,415
Georgia,Warner Robins,72520,18459,24950,6944,1417,3006,54776
Georgia,Warrenton,2136,766,427,216,33,196,1638
Georgia,Warwick,418,160,87,51,14,35,347
Georgia,Wadley,1992,755,521,144,108,106,1634
Georgia,Midville,296,86,78,44,8,25,241
Georgia,McDonough,22830,5473,7114,2969,664,1024,17244
Georgia,Sardis,953,300,271,47,23,47,688
Georgia,Winterville,1084,185,515,82,9,56,847
Georgia,Winder,14928,3557,4496,1946,419,1088,11506
Georgia,Wilmington Island,14781,2570,7361,1357,134,804,12226
Georgia,Williamson,347,56,148,25,1,27,257
Georgia,Willacoochee,1547,389,441,178,36,84,1128
Georgia,Whitesburg,581,131,224,73,27,41,496
Georgia,White Plains,205,48,89,29,1,11,178
Georgia,Whitemarsh Island,7202,1757,3129,741,106,161,5894
Georgia,McIntyre,718,324,166,55,28,68,641
Georgia,Macon-Bibb,154608,48156,45949,14841,4497,8462,121905
Georgia,McRae-Helena,8720,4079,2188,681,121,427,7496
Georgia,Madison,3991,855,1305,384,155,393,3092
Georgia,Butler,1647,447,604,113,34,193,1391
Georgia,Manchester,4141,1062,1250,526,95,171,3104
Georgia,Mansfield,351,76,154,27,6,22,285
Georgia,Woodbine,1552,515,476,80,49,91,1211
Georgia,Woodbury,803,237,256,53,30,63,639
Georgia,Woodland,326,101,88,43,24,29,285
Georgia,Woodstock,26793,4283,11301,2597,533,759,19473
Georgia,Sasser,356,85,110,30,9,31,265
Georgia,Satilla,419,60,166,27,0,60,313
Georgia,Sautee-Nacoochee,315,19,220,38,0,0,277
Georgia,Savannah,142919,54239,36001,15319,3260,7716,116535
Georgia,Scotland,371,52,173,24,1,11,261
Georgia,Scottdale,10672,3110,3474,866,310,271,8031
Georgia,Screven,893,144,313,99,10,55,621
Georgia,Santa Claus,270,46,124,13,4,11,198
Georgia,Senoia,3773,848,1939,147,45,28,3007
Georgia,Young Harris,1004,741,122,32,0,13,908
Georgia,Yonah,391,5,148,78,0,19,250
Georgia,Yatesville,420,107,189,38,2,34,370
Georgia,Wrightsville,3689,1531,923,357,187,217,3215
Georgia,Wrens,2532,757,626,318,44,198,1943
Georgia,Woolsey,188,34,119,3,0,5,161
Georgia,Woodville,366,87,160,39,7,18,311
Georgia,Zebulon,1380,279,516,148,14,70,1027
Georgia,Manassas,133,7,60,10,0,19,96
Georgia,Druid Hills,13928,7315,4000,697,47,346,12405
Georgia,Franklin Springs,924,509,278,26,3,36,852
Georgia,Alma,3513,1141,940,410,102,271,2864
Georgia,Allentown,233,57,96,10,4,18,185
Georgia,Allenhurst,577,114,250,42,8,36,450
Georgia,Aldora,89,7,34,20,7,2,70
Georgia,Albany,76466,27622,17704,7750,2822,3800,59698
Georgia,Alapaha,735,257,171,79,32,14,553
Georgia,Alamo,4240,2496,660,599,164,163,4082
Georgia,Ailey,671,290,205,48,0,34,577
Georgia,Adrian,578,150,134,109,28,37,458
Georgia,Adel,5281,1301,1828,473,163,299,4064
Georgia,Adairsville,4712,1127,1464,545,115,241,3492
Georgia,Alpharetta,62054,12068,28347,4614,384,1764,47177
Georgia,Acworth,21512,5186,8158,2192,598,810,16944
Georgia,Rhine,508,111,177,56,17,62,423
Georgia,Reynolds,1257,331,400,168,33,130,1062
Georgia,Rest Haven,94,23,51,3,2,5,84
Georgia,Resaca,915,276,272,127,12,35,722
Georgia,Rentz,352,61,134,30,15,34,274
Georgia,Remerton,1393,1082,103,72,9,3,1269
Georgia,Reidsville,2623,494,849,355,119,153,1970
Georgia,Register,105,10,58,12,2,9,91
Georgia,Reed Creek,2967,410,1562,364,24,265,2625
Georgia,Redan,32614,11415,8211,4114,1112,1128,25980
Georgia,Rebecca,300,25,125,37,4,15,206
Georgia,Abbeville,2860,1356,559,496,65,165,2641
Georgia,Rayle,215,61,56,23,6,8,154
Georgia,Alston,152,29,73,12,0,18,132
Georgia,Ambrose,410,95,135,27,6,28,291
Georgia,Greensboro,3405,1310,722,222,178,162,2594
Georgia,Greenville,925,346,221,73,16,70,726
Georgia,Gresham Park,7607,3331,1754,697,134,406,6322
Georgia,Griffin,23312,7540,6228,2249,705,1089,17811
Georgia,Grovetown,12521,2509,5244,1005,172,285,9215
Georgia,Gumbranch,194,42,94,17,0,15,168
Georgia,Gumlog,2463,386,1136,170,126,115,1933
Georgia,Guyton,1963,465,647,199,72,97,1480
Georgia,Hagan,968,228,362,97,30,43,760
Georgia,Hahira,2843,622,1048,257,49,126,2102
Georgia,Hamilton,1013,412,229,104,29,59,833
Georgia,Alto,1165,322,446,79,15,28,890
Georgia,Hampton,7188,1662,2395,570,248,168,5043
Georgia,Hapeville,6649,2501,1411,754,204,282,5152
Georgia,Haralson,126,8,73,20,0,3,104
Georgia,Hardwick,3539,1513,738,312,163,218,2944
Georgia,Harlem,2872,626,1123,361,38,98,2246
Georgia,Harrison,525,180,178,32,8,26,424
Georgia,Hartwell,4504,1183,1486,330,66,412,3477
Georgia,Aragon,977,232,374,104,34,63,807
Georgia,Arabi,552,114,189,85,4,57,449
Georgia,Appling,656,109,337,74,0,26,546
Georgia,Andersonville,295,35,117,41,20,16,229
Georgia,Americus,16345,6331,3477,1199,533,1074,12614
Georgia,Hannahs Mill,3949,920,1606,265,84,167,3042
Georgia,Grayson,2778,785,1261,118,50,121,2335
Georgia,Ray City,1236,331,369,155,48,89,992
Georgia,Ranger,169,48,58,18,9,9,142
Georgia,Parrott,173,15,92,13,12,13,145
Georgia,Panthersville,9367,3477,1859,1298,320,582,7536
Georgia,Palmetto,4928,1346,1426,453,118,275,3618
Georgia,Oxford,2265,932,596,202,75,78,1883
Georgia,Orchard Hill,222,47,97,23,7,6,180
Georgia,Omega,1299,478,283,84,27,70,942
Georgia,Oliver,221,70,83,24,6,9,192
Georgia,Oglethorpe,1307,459,308,237,40,55,1099
Georgia,Offerman,433,79,192,59,6,20,356
Georgia,Odum,586,87,245,57,2,23,414
Georgia,Oconee,413,63,186,20,16,41,326
Georgia,Patterson,720,167,275,95,18,46,601
Georgia,Ocilla,3445,1379,881,188,84,204,2736
Georgia,Oakwood,4123,1199,1335,526,203,183,3446
Georgia,Oak Park,843,207,284,48,19,48,606
Georgia,Nunez,80,26,21,13,1,9,70
Georgia,Norwood,272,71,85,40,17,44,257
Georgia,North High Shoals,767,168,311,48,19,67,613
Georgia,North Druid Hills,18385,7805,5888,1332,271,915,16211
Georgia,North Decatur,17040,5897,5956,2068,150,820,14891
Georgia,Norristown,82,41,8,33,0,0,82
Georgia,Norman Park,1220,273,427,124,56,55,935
Georgia,Norcross,16103,4434,5651,909,263,327,11584
Georgia,Nicholson,1587,351,617,167,23,99,1257
Georgia,Ochlocknee,665,169,244,46,7,19,485
Georgia,Raoul,2982,885,1022,544,197,99,2747
Georgia,Pavo,580,155,177,67,13,86,498
Georgia,Peachtree City,34868,6910,16835,2408,238,1287,27678
Georgia,Quitman,3804,1152,896,487,149,275,2959
Georgia,Putney,2519,624,1054,325,63,145,2211
Georgia,Pulaski,310,46,115,19,0,62,242
Georgia,Powder Springs,14462,3377,5576,1236,395,710,11294
Georgia,Poulan,1031,273,398,125,26,52,874
Georgia,Port Wentworth,6619,1117,3033,615,4,252,5021
Georgia,Porterdale,1890,571,515,260,66,125,1537
Georgia,Portal,639,134,223,86,18,55,516
Georgia,Crooked Creek,927,156,554,89,0,22,821
Georgia,Plainville,335,72,137,40,3,14,266
Georgia,Plains,733,292,187,62,20,109,670
Georgia,Payne,208,76,19,11,6,23,135
Georgia,Pitts,463,134,103,31,27,42,337
Georgia,Pine Mountain,1419,423,521,117,18,134,1213
Georgia,Pine Lake,648,238,155,119,9,41,562
Georgia,Pinehurst,405,119,91,86,10,41,347
Georgia,Phillipsburg,459,124,47,65,0,32,268
Georgia,Perry,14991,4609,5168,1113,300,776,11966
Georgia,Perkins,243,165,52,26,0,0,243
Georgia,Pendergrass,464,110,191,46,5,17,369
Georgia,Pembroke,3036,723,860,358,58,112,2111
Georgia,Pelham,3828,870,1153,210,224,242,2699
Georgia,Pearson,1935,597,451,204,74,104,1430
Georgia,Peachtree Corners,39910,10527,16755,2806,495,984,31567
Georgia,Pineview,485,207,84,41,33,40,405
Georgia,Gray,3287,793,1183,317,62,193,2548
Georgia,Grantville,3124,524,1177,340,99,81,2221
Georgia,Graham,284,80,85,31,8,13,217
Georgia,Dawson,4388,1598,860,382,158,265,3263
Georgia,Dawsonville,2416,528,882,265,49,107,1831
Georgia,Dearing,552,113,228,40,3,36,420
Georgia,Decatur,20605,5060,7294,1862,233,844,15293
Georgia,Deenwood,1845,270,880,140,20,135,1445
Georgia,Deepstep,156,21,96,4,0,20,141
Georgia,Demorest,1842,852,511,200,65,44,1672
Georgia,Denton,241,85,87,16,4,20,212
Georgia,De Soto,309,67,81,13,15,6,182
Georgia,Dewy Rose,230,40,87,0,0,6,133
Georgia,Dexter,571,117,220,50,8,62,457
Georgia,Davisboro,1776,937,386,298,56,37,1714
Georgia,Dillard,401,110,182,44,8,26,370
Georgia,Doerun,790,164,225,70,37,50,546
Georgia,Donalsonville,2716,714,889,270,43,197,2113
Georgia,Dooling,322,78,92,24,6,11,211
Georgia,Doraville,10650,3280,3318,910,321,286,8115
Georgia,Douglas,11750,4194,2480,1341,323,732,9070
Georgia,Ball Ground,1869,300,964,192,24,37,1517
Georgia,Baldwin,3467,673,1362,250,51,70,2406
Georgia,Bainbridge,12576,3997,3634,1010,430,886,9957
Georgia,Baconton,794,262,207,40,21,20,550
Georgia,Avondale Estates,3066,680,1245,328,68,145,2466
Georgia,Avera,282,57,104,27,1,18,207
Georgia,Dock Junction,7272,2119,2214,1021,126,541,6021
Georgia,Avalon,266,56,109,34,23,11,233
Georgia,Dasher,881,251,366,68,14,36,735
Georgia,Danville,201,60,71,15,1,29,176
Georgia,Crawfordville,626,215,227,33,11,54,540
Georgia,Crawford,948,198,308,139,27,128,800
Georgia,Covington,13507,4147,3670,1770,385,927,10899
Georgia,Country Club Estates,8568,2285,2769,1128,214,451,6847
Georgia,Cornelia,4199,778,1377,398,73,335,2961
Georgia,Cordele,11140,3195,2923,790,424,833,8165
Georgia,Coolidge,598,177,168,75,10,34,464
Georgia,Conyers,15577,5189,3859,1620,352,743,11763
Georgia,Conley,5125,1384,1240,589,212,206,3631
Georgia,Concord,372,57,131,36,3,24,251
Georgia,Commerce,6575,1151,2349,849,243,371,4963
Georgia,Darien,2844,861,694,365,75,272,2267
Georgia,Comer,1280,235,587,112,13,59,1006
Georgia,Colquitt,2268,682,622,209,28,161,1702
Georgia,Cumming,5588,1678,1623,826,107,404,4638
Georgia,Cusseta-Chattahoochee County unified governme,11914,4157,4356,492,164,133,9302
Georgia,Cuthbert,3697,1318,759,244,251,256,2828
Georgia,Dacula,4831,973,1984,306,82,137,3482
Georgia,Dahlonega,6052,3187,1911,369,107,253,5827
Georgia,Daisy,146,27,62,14,0,14,117
Georgia,Dallas,12363,2384,4318,1372,327,439,8840
Georgia,Dalton,33496,7862,11159,3252,1011,1790,25074
Georgia,Damascus,332,108,98,41,3,12,262
Georgia,Danielsville,912,134,429,66,26,26,681
Georgia,Columbus,200285,58490,62659,21904,5076,10658,158787
Georgia,Austell,6994,1739,2530,656,196,263,5384
Georgia,Douglasville,31917,10028,9313,3253,803,1229,24626
Georgia,Augusta-Richmond County consolidated government (balance),196635,65148,54612,21411,4826,10793,156790
Georgia,Flowery Branch,6216,1297,2562,539,65,256,4719
Georgia,Folkston,5313,1711,1521,858,199,456,4745
Georgia,Forest Park,18953,5957,4439,2078,806,679,13959
Georgia,Forsyth,3993,1079,1040,477,154,332,3082
Georgia,Fort Gaines,1087,324,163,106,54,97,744
Georgia,Fort Oglethorpe,9547,1673,3685,1309,111,945,7723
Georgia,Fort Stewart,4977,1696,1682,135,39,0,3552
Georgia,Fort Valley,9192,4673,1646,655,179,395,7548
Georgia,Franklin,890,347,173,171,13,83,787
Georgia,Funston,790,128,271,69,0,14,482
Georgia,Gainesville,37115,11026,10844,3415,1125,1902,28312
Georgia,Flovilla,500,136,177,67,7,56,443
Georgia,Garden City,8966,2364,2534,1183,318,525,6924
Georgia,Gay,100,8,50,4,0,8,70
Georgia,Geneva,106,26,50,11,0,12,99
Georgia,Georgetown,12600,3517,4639,1272,267,355,10050
Georgia,Georgetown-Quitman County unified governme,2326,552,794,232,96,300,1974
Georgia,Gibson,695,125,214,137,8,100,584
Georgia,Gillsville,287,24,148,9,3,11,195
Georgia,Girard,154,40,41,13,13,16,123
Georgia,Glennville,5150,1826,1444,598,89,319,4276
Georgia,Glenwood,683,160,203,41,21,82,507
Georgia,Good Hope,236,48,110,23,5,26,212
Georgia,Gordon,2328,680,628,257,130,158,1853
Georgia,Garfield,191,33,85,21,6,6,151
Georgia,Flemington,877,197,435,42,6,9,689
Georgia,Fitzgerald,9032,3109,2090,839,166,691,6895
Georgia,Fayetteville,16500,3421,7007,1632,161,1088,13309
Georgia,Auburn,7409,1703,3314,668,41,192,5918
Georgia,Attapulgus,585,150,198,40,15,25,428
Georgia,Atlanta,448901,203192,102174,40451,8563,21719,376099
Georgia,Athens-Clarke County unified government (balance),119684,57911,30106,8333,1337,4096,101783
Georgia,Ashburn,3875,1249,995,286,192,371,3093
Georgia,Arnoldsville,451,77,198,78,6,18,377
Georgia,Arlington,1242,387,293,70,63,105,918
Georgia,Argyle,143,46,43,21,8,16,134
Georgia,Arcade,1471,293,645,151,30,106,1225
Georgia,Ellenton,108,8,35,30,2,26,101
Georgia,Ellijay,1952,441,688,232,14,209,1584
Georgia,Emerson,1461,264,733,120,17,66,1200
Georgia,Empire,421,136,149,25,38,46,394
Georgia,Enigma,903,299,284,72,47,27,729
Georgia,Ephesus,423,38,202,31,17,22,310
Georgia,Epworth,340,49,190,14,0,43,296
Georgia,Eton,1122,136,472,119,7,44,778
Georgia,Euharlee,4182,676,2105,244,53,147,3225
Georgia,Evans,33730,5897,16596,1843,208,1139,25683
Georgia,Experiment,2557,688,731,296,135,180,2030
Georgia,Fairburn,13697,4348,3798,1625,295,287,10353
Georgia,Fairmount,841,192,273,138,21,77,701
Georgia,Fair Oaks,9109,3318,2158,685,273,268,6702
Georgia,Fairview,8026,1880,2762,1003,189,436,6270
Georgia,Fargo,339,74,152,17,6,16,265
Georgia,Nicholls,4067,2277,591,748,90,73,3779
Georgia,Newton,699,228,216,67,2,58,571
Georgia,Pooler,21400,4002,9280,2495,119,808,16704
Georgia,Irwinton,703,218,260,55,19,46,598
Georgia,Jenkinsburg,342,87,106,17,11,20,241
Georgia,Jersey,126,25,56,14,1,16,112
Georgia,Jesup,10163,2877,2977,1098,461,753,8166
Georgia,Johns Creek,82203,15567,40195,4706,760,2029,63257
Georgia,Jonesboro,4669,2151,877,535,129,130,3822
Georgia,Junction City,152,55,50,17,5,3,130
Georgia,Kennesaw,32186,8000,11938,3937,515,1244,25634
Georgia,Keysville,245,59,87,25,13,18,202
Georgia,Kings Bay Base,1701,825,401,34,33,6,1299
Georgia,Jeffersonville,1111,347,237,142,52,126,904
Georgia,Kingsland,16239,3192,6745,1717,408,330,12392
Georgia,Kite,289,67,106,46,0,13,232
Georgia,Knoxville,60,22,26,12,0,0,60
Georgia,LaFayette,7107,1421,2655,923,220,526,5745
Georgia,LaGrange,30356,10029,7486,2828,1055,2036,23434
Georgia,Lake City,2650,1095,677,207,123,165,2267
Georgia,Lakeland,3378,1025,866,437,92,186,2606
Georgia,Lake Park,1070,307,283,172,8,48,818
Georgia,Lakeview,5878,1366,2250,646,120,384,4766
Georgia,Lakeview Estates,2789,790,775,46,20,16,1647
Georgia,Kingston,766,137,244,128,33,31,573
Georgia,Lavonia,1842,457,624,220,33,190,1524
Georgia,Jefferson,9771,1538,4253,980,221,565,7557
Georgia,Jakin,205,57,53,16,1,13,140
Georgia,Hinesville,34287,7469,13826,2698,898,950,25841
Georgia,Hiram,3681,924,1629,293,93,190,3129
Georgia,Hoboken,657,86,310,36,8,23,463
Georgia,Hogansville,3078,706,899,337,126,257,2325
Georgia,Holly Springs,9979,1614,4281,876,153,145,7069
Georgia,Homeland,1028,251,286,124,76,60,797
Georgia,Homer,1343,300,537,68,38,74,1017
Georgia,Homerville,2494,597,607,362,119,139,1824
Georgia,Hoschton,1781,422,732,155,33,59,1401
Georgia,Jasper,3715,588,1604,466,32,289,2979
Georgia,Howard,0,0,0,0,0,0,0
Georgia,Ideal,468,119,100,81,20,63,383
Georgia,Ila,428,87,151,54,5,17,314
Georgia,Indian Springs,2739,662,1237,193,122,114,2328
Georgia,Iron City,228,36,76,32,3,49,196
Georgia,Irondale,8488,2949,2323,725,21,161,6179
Georgia,Isle of Hope,2581,593,1284,235,0,99,2211
Georgia,Ivey,930,175,341,99,11,77,703
Georgia,Jackson,4949,1339,1342,557,84,516,3838
Georgia,Jacksonville,96,21,59,4,0,5,89
Georgia,Hull,239,41,76,48,0,16,181
Georgia,Lawrenceville,29738,8627,10367,2549,473,1191,23207
Georgia,Leary,519,81,260,50,12,32,435
Georgia,Leesburg,2965,716,1061,263,71,72,2183
Georgia,Blue Ridge,1492,310,486,284,20,191,1291
Georgia,Bluffton,73,8,39,11,0,5,63
Georgia,Ellaville,2022,424,732,207,43,106,1512
Georgia,Elberton,4474,1307,1230,449,139,494,3619
Georgia,Edison,1054,288,257,115,42,83,785
Georgia,Edge Hill,23,8,13,0,0,2,23
Georgia,Eatonton,6486,2139,2348,484,182,339,5492
Georgia,East Point,35357,14373,7050,4080,1149,1483,28135
Georgia,East Newnan,1495,211,699,123,65,72,1170
Georgia,Bloomingdale,2746,537,1223,310,33,112,2215
Georgia,Eastman,5375,1613,1366,452,268,366,4065
Georgia,East Ellijay,993,224,230,86,33,48,621
Georgia,East Dublin,2470,660,702,301,71,152,1886
Georgia,Eagle Grove,0,0,0,0,0,0,0
Georgia,Dutch Island,923,81,551,14,0,44,690
Georgia,Du Pont,177,39,53,10,2,31,135
Georgia,Dunwoody,47727,10819,20175,3563,764,1701,37022
Georgia,Duluth,28294,6668,11827,2632,382,905,22414
Georgia,Dudley,773,201,338,68,8,40,655
Georgia,Dublin,16181,4955,4356,1633,557,1281,12782
Georgia,East Griffin,1416,372,381,239,13,92,1097
Georgia,Blakely,4854,1594,1029,391,221,376,3611
Georgia,Blairsville,731,199,175,158,25,53,610
Georgia,Blackshear,3522,919,1036,234,115,437,2741
Georgia,Lenox,832,235,247,77,44,62,665
Georgia,Leslie,365,123,126,18,11,12,290
Georgia,Lexington,266,41,76,48,10,20,195
Georgia,Lilburn,12372,2905,4930,1021,155,471,9482
Georgia,Lilly,228,71,47,23,3,16,160
Georgia,Lincoln Park,500,192,140,114,9,45,500
Georgia,Lincolnton,1518,398,529,167,38,95,1227
Georgia,Lindale,4041,780,1597,467,96,237,3177
Georgia,Lithia Springs,17246,5099,5252,1983,339,457,13130
Georgia,Lithonia,1961,680,352,267,66,111,1476
Georgia,Barnesville,6609,2915,1424,382,191,471,5383
Georgia,Bartow,310,88,115,38,0,22,263
Georgia,Barwick,443,132,146,31,6,29,344
Georgia,Baxley,4428,1019,1495,446,139,426,3525
Georgia,Bellville,123,13,78,9,6,10,116
Georgia,Belvedere Park,16214,5777,3990,1913,376,916,12972
Georgia,Berkeley Lake,1796,320,1034,96,26,92,1568
Georgia,Berlin,554,103,243,33,10,47,436
Georgia,Bethlehem,700,119,293,90,0,24,526
Georgia,Between,331,52,161,12,2,15,242
Georgia,Bishop,296,38,121,9,3,4,175
Georgia,Hiltonia,469,239,123,33,3,32,430
Georgia,Hilltop,293,95,20,46,33,4,198
Georgia,Culloden,254,81,68,28,6,12,195
Georgia,Hazlehurst,4217,952,1622,381,169,229,3353
Georgia,Henderson,1886,591,873,74,103,0,1641
Georgia,Hephzibah,3950,1038,1613,239,45,204,3139
Georgia,Heron Bay,3539,711,1492,145,112,77,2537
Georgia,Hiawassee,982,260,368,129,6,161,924
Georgia,Higgston,429,72,156,32,26,21,307
Georgia,Hawkinsville,5546,2252,1464,562,133,520,4931
Georgia,Helen,296,66,141,42,3,23,275
Hawaii,Holualoa,8390,2043,3398,1048,124,294,6907
Hawaii,Kaanapali,1202,144,758,91,8,45,1046
Hawaii,Kaaawa,1139,260,481,107,20,54,922
Hawaii,Iroquois Point,3935,585,1753,281,68,71,2758
Hawaii,Honomu,364,146,130,34,12,13,335
Hawaii,Hauula,3755,934,1345,254,40,151,2724
Hawaii,Honokaa,2359,708,877,189,59,175,2008
Hawaii,Honalo,2571,589,851,337,27,135,1939
Hawaii,Hawaiian Acres,2516,642,966,289,139,60,2096
Hawaii,Hawaiian Ocean View,4276,819,1820,245,22,335,3241
Hawaii,Hawaiian Paradise Park,11684,2872,4796,1100,525,717,10010
Hawaii,Honaunau-Napoopoo,2813,646,1160,288,24,270,2388
Hawaii,Heeia,4481,696,2593,285,0,262,3836
Hawaii,Hickam Housing,9243,988,4707,106,43,17,5861
Hawaii,Hilo,45380,14117,16279,3679,628,3175,37878
Hawaii,Hawaiian Beaches,4453,1119,1253,519,82,425,3398
Hawaii,Hawi,1345,341,528,117,0,73,1059
Hawaii,Waimalu,13333,4006,5269,1335,202,620,11432
Hawaii,Hanapepe,2630,724,1122,168,76,179,2269
Hawaii,Ainaloa,3596,1213,1148,301,92,116,2870
Hawaii,Anahola,1951,531,681,158,16,164,1550
Hawaii,Captain Cook,4594,1072,1792,416,33,272,3585
Hawaii,Discovery Harbour,1107,207,542,99,9,63,920
Hawaii,East Honolulu,48092,9347,24661,3442,301,2736,40487
Hawaii,Eden Roc,687,226,156,129,16,18,545
Hawaii,Eleele,2604,687,1072,156,9,183,2107
Hawaii,Ewa Beach,14287,4070,5289,840,197,883,11279
Hawaii,Ewa Gentry,22676,5748,9371,1614,271,717,17721
Hawaii,Ewa Villages,7356,1851,2804,411,138,334,5538
Hawaii,Fern Acres,1426,328,645,160,27,27,1187
Hawaii,Fern Forest,669,152,206,152,15,32,557
Hawaii,Haena,280,57,145,25,2,9,238
Hawaii,Wailuku,16064,3652,6393,1674,205,953,12877
Hawaii,Halaula,530,170,185,28,12,46,441
Hawaii,Halawa,14812,4307,6167,883,53,1004,12414
Hawaii,Haleiwa,3576,852,1513,361,22,123,2871
Hawaii,Haliimaile,1190,394,422,95,3,64,978
Hawaii,Hana,1258,488,421,51,5,36,1001
Hawaii,Hanalei,210,34,114,15,3,14,180
Hawaii,Hanamaulu,4946,1325,2016,325,12,240,3918
Hawaii,Kahaluu,4565,1018,1756,341,12,303,3430
Hawaii,Kahaluu-Keauhou,3783,575,2024,189,29,246,3063
Hawaii,Kahuku,2513,651,944,129,9,110,1843
Hawaii,Kahului,28476,8160,10604,2268,348,1850,23230
Hawaii,Naalehu,847,212,364,37,0,64,677
Hawaii,Nanakuli,12405,4066,3661,798,130,685,9340
Hawaii,Nanawale Estates,1714,537,356,268,62,65,1288
Hawaii,Napili-Honokowai,6723,1958,2703,628,48,292,5629
Hawaii,Ocean Pointe,11336,1942,5624,567,118,218,8469
Hawaii,Olinda,1161,344,481,187,0,33,1045
Hawaii,Olowalu,92,33,26,11,9,1,80
Hawaii,Omao,1270,304,566,112,0,132,1114
Hawaii,Orchidlands Estates,3305,989,1188,255,110,108,2650
Hawaii,Paauilo,633,211,215,47,20,46,539
Hawaii,Mountain View,3088,798,1098,430,76,0,2402
Hawaii,Pahala,1405,251,630,66,10,60,1017
Hawaii,Paia,2561,964,852,230,19,101,2166
Hawaii,Punaluu,1064,233,473,96,21,59,882
Hawaii,Pukalani,8072,1558,3641,841,78,224,6342
Hawaii,Puhi,3435,980,1369,182,19,197,2747
Hawaii,Puako,741,118,422,114,6,24,684
Hawaii,Princeville,2400,388,1143,218,11,60,1820
Hawaii,Poipu,1042,183,568,121,3,68,943
Hawaii,Pepeekeo,1681,543,616,57,26,160,1402
Hawaii,Pearl City,47021,11744,21466,2461,365,2888,38924
Hawaii,Paukaa,520,161,232,35,4,58,490
Hawaii,Pahoa,826,285,236,72,23,63,679
Hawaii,Aiea,9262,2131,3862,641,78,645,7357
Hawaii,Mokuleia,1653,499,710,133,37,52,1431
Hawaii,Mililani Mauka,21055,4854,9605,1103,213,675,16450
Hawaii,Kailua CDP (Hawaii County),12652,3431,5081,1251,130,549,10442
Hawaii,Kailua CDP (Honolulu County),38722,9612,17643,2981,351,2024,32611
Hawaii,Kalaeloa,9,1,5,0,0,0,6
Hawaii,Lahaina,12118,3443,4622,1030,139,633,9867
Hawaii,Laie,5644,2097,2087,228,7,157,4576
Hawaii,Lanai City,3519,713,1446,333,70,238,2800
Hawaii,Launiupoko,505,113,277,35,6,4,435
Hawaii,Laupahoehoe,533,82,198,28,4,74,386
Hawaii,Lawai,2253,455,1024,243,8,151,1881
Hawaii,Leilani Estates,1557,442,580,239,28,80,1369
Hawaii,Mililani Town,28021,7616,12577,1759,198,940,23090
Hawaii,Lihue,7360,1846,2567,475,116,334,5338
Hawaii,Mahinahina,1016,178,594,53,0,7,832
Hawaii,Maili,8910,2173,3059,636,203,234,6305
Hawaii,Makaha,8813,2905,2546,662,259,506,6878
Hawaii,Makaha Valley,1284,418,415,130,13,34,1010
Hawaii,Makakilo,20631,5181,8350,1756,158,555,16000
Hawaii,Makawao,6523,1487,2500,760,41,304,5092
Hawaii,Makena,132,30,60,23,0,2,115
Hawaii,Manele,20,0,17,3,0,0,20
Hawaii,Maunaloa,431,123,121,19,0,9,272
Hawaii,Maunawili,2149,412,1135,107,6,156,1816
Hawaii,Maalaea,298,39,144,71,6,27,287
Hawaii,Ahuimanu,8354,2281,3614,627,26,360,6908
Hawaii,Haiku-Pauwela,7846,1649,3536,711,53,429,6378
Hawaii,Kula,7478,1379,3777,816,64,226,6262
Hawaii,Volcano,2430,851,911,170,26,72,2030
Hawaii,Wahiawa,17484,4602,6778,1587,266,1052,14285
Hawaii,Waialua,3690,823,1652,206,30,255,2966
Hawaii,Waianae,13632,4102,4199,799,246,727,10073
Hawaii,Waihee-Waiehu,9159,2618,3783,712,78,358,7549
Hawaii,Waikane,771,257,271,64,12,56,660
Hawaii,Waikapu,3561,800,1427,298,22,168,2715
Hawaii,Waikele,7786,1901,3706,343,22,342,6314
Hawaii,Waikoloa Village,6350,1435,2752,680,110,136,5113
Hawaii,Wailea,5656,953,3088,711,57,209,5018
Hawaii,Wailua,2584,646,1074,259,30,153,2162
Hawaii,Wailua Homesteads,5645,1376,2743,510,104,278,5011
Hawaii,Urban Honolulu,347973,107751,134088,30250,3958,20702,296749
Hawaii,Kurtistown,1070,249,515,156,0,68,988
Hawaii,Wheeler AFB,2712,275,1488,22,7,6,1798
Hawaii,West Loch Estate,5364,1476,2633,240,3,147,4499
Hawaii,Waipio Acres,4961,1367,1924,426,126,244,4087
Hawaii,Waipio,11261,3019,4821,902,77,508,9327
Hawaii,Waipahu,41165,12684,15206,2010,408,2849,33157
Hawaii,Waiohinu,112,34,39,4,0,15,92
Hawaii,Wainiha,168,39,58,18,0,17,132
Hawaii,Wainaku,1388,368,531,117,16,185,1217
Hawaii,Waimea CDP (Kauai County),1690,512,677,110,0,171,1470
Hawaii,Waimea CDP (Hawaii County),10817,2272,3935,756,134,435,7532
Hawaii,Waimanalo Beach,4255,1275,1506,362,33,281,3457
Hawaii,Waimanalo,6164,1685,2051,305,66,310,4417
Hawaii,Whitmore Village,4919,1516,1787,315,55,213,3886
Hawaii,Ualapue,372,105,142,37,3,21,308
Hawaii,Papaikou,1234,361,534,54,9,65,1023
Hawaii,Royal Kunia,14198,4006,6445,578,148,558,11735
Hawaii,Schofield Barracks,20858,4969,8590,231,62,16,13868
Hawaii,Kaumakani,940,215,385,60,0,68,728
Hawaii,Kaunakakai,3544,769,1423,329,1,227,2749
Hawaii,Kawela Bay,248,61,133,19,9,9,231
Hawaii,Keaau,2415,755,866,235,18,122,1996
Hawaii,Kealakekua,1894,523,751,195,17,67,1553
Hawaii,Kekaha,2915,792,1126,209,7,296,2430
Hawaii,Keokea,1951,500,797,130,15,70,1512
Hawaii,Kihei,22401,5650,8860,2376,277,826,17989
Hawaii,Kilauea,3208,940,1324,202,32,104,2602
Hawaii,Ko Olina,1872,350,1126,103,0,22,1601
Hawaii,Kualapuu,1998,561,708,103,14,113,1499
Hawaii,Koloa,2623,744,841,151,23,158,1917
Hawaii,Kapalua,322,41,211,15,1,17,285
Hawaii,Pupukea,5705,1059,2726,279,0,247,4311
Hawaii,Pakala Village,317,91,127,5,13,48,284
Hawaii,Kukuihaele,436,121,158,22,4,14,319
Hawaii,Kalaheo,4358,1163,1773,420,42,184,3582
Hawaii,Kapolei,18737,4760,7175,1162,319,506,13922
Hawaii,Kalihiwai,271,42,145,23,4,10,224
Hawaii,Kalaoa,12214,3374,5358,979,65,260,10036
Hawaii,Kaneohe,33654,8792,14793,2504,253,2061,28403
Hawaii,Kaneohe Station,11285,3095,5059,97,45,0,8296
Hawaii,Kapaa,10794,2534,4874,995,77,476,8956
Hawaii,Kapaau,1851,473,723,170,45,101,1512
Idaho,Groveland,834,319,340,41,0,33,733
Idaho,Greenleaf,1000,206,358,128,11,27,730
Idaho,Grand View,469,91,145,72,7,57,372
Idaho,Grangeville,3160,504,1199,727,24,267,2721
Idaho,Hagerman,1186,163,401,147,31,68,810
Idaho,Kimberly,3444,646,1482,244,61,107,2540
Idaho,Island Park,184,18,136,8,0,4,166
Idaho,Kendrick,456,89,203,60,4,26,382
Idaho,Kellogg,2192,449,799,384,49,113,1794
Idaho,Kamiah,1329,214,529,231,14,71,1059
Idaho,Juliaetta,635,83,327,95,5,25,535
Idaho,Jerome,11100,1989,4249,887,204,459,7788
Idaho,Hailey,8002,1248,4137,698,22,211,6316
Idaho,Ketchum,2706,677,1111,540,28,109,2465
Idaho,Hamer,71,22,32,0,1,1,56
Idaho,Hope,54,3,35,7,0,1,46
Idaho,Harrison,168,19,93,25,5,17,159
Idaho,Elk River,119,5,65,22,0,6,98
Idaho,Idaho Falls,58374,11213,22896,6381,1047,2685,44222
Idaho,Idaho City,485,121,131,82,5,35,374
Idaho,Huetter,78,33,12,13,1,2,61
Idaho,Horseshoe Bend,775,160,345,85,13,52,655
Idaho,Irwin,235,59,135,17,2,9,222
Idaho,Hansen,1448,232,554,142,6,118,1052
Idaho,Homedale,2590,667,663,395,31,197,1953
Idaho,Hidden Springs,2336,332,1117,96,0,8,1553
Idaho,Heyburn,3163,670,1229,318,50,50,2317
Idaho,Hazelton,742,148,308,69,8,39,572
Idaho,Hayden Lake,680,67,421,35,2,28,553
Idaho,Hayden,13749,2811,6237,1471,103,790,11412
Idaho,Hauser,694,159,271,129,15,18,592
Idaho,Hollister,168,35,65,20,18,14,152
Idaho,Iona,1980,243,966,132,9,37,1387
Idaho,Lapwai,1286,360,362,138,14,53,927
Idaho,Lincoln,2986,263,1123,225,18,73,1702
Idaho,East Hope,170,13,105,16,0,21,155
Idaho,Eden,398,65,202,19,10,27,323
Idaho,Elk City,174,44,26,28,0,28,126
Idaho,Gooding,3498,506,1272,606,9,270,2663
Idaho,Glenns Ferry,1137,148,423,140,9,141,861
Idaho,Georgetown,440,90,210,40,0,24,364
Idaho,Genesee,910,142,464,76,2,25,709
Idaho,Garden Valley,211,113,59,11,0,18,201
Idaho,Garden City,11313,2423,4483,1587,208,771,9472
Idaho,Fruitland,4842,808,1899,637,13,118,3475
Idaho,Franklin,654,87,278,64,6,14,449
Idaho,Fort Hall,3336,911,962,493,53,129,2548
Idaho,Firth,462,63,218,43,2,28,354
Idaho,Filer,2625,422,925,353,39,96,1835
Idaho,Fernan Lake Village,143,11,86,6,6,8,117
Idaho,Ferdinand,154,40,60,25,0,5,130
Idaho,Fairfield,536,87,191,96,5,19,398
Idaho,Emmett,6548,1411,2390,762,187,359,5109
Idaho,Inkom,894,130,402,58,0,43,633
Idaho,Eagle,21863,3606,11609,1247,216,714,17392
Idaho,Dubois,615,150,257,22,6,38,473
Idaho,Drummond,1,0,0,0,0,1,1
Idaho,Driggs,1936,541,655,174,17,46,1433
Idaho,Lewisville,488,115,227,39,16,10,407
Idaho,Lewiston,32284,6949,13229,4051,324,2080,26633
Idaho,Leadore,131,43,47,2,0,5,97
Idaho,Lava Hot Springs,333,72,106,77,0,34,289
Idaho,Kuna,16557,3063,7102,1203,100,238,11706
Idaho,Kootenai,913,166,248,190,14,35,653
Idaho,Kooskia,602,121,212,96,2,76,507
Idaho,Cottonwood,1019,267,407,105,0,59,838
Idaho,Council,962,144,388,142,3,60,737
Idaho,Grace,855,82,482,54,6,65,689
Idaho,Craigmont,472,51,263,46,8,35,403
Idaho,Culdesac,330,65,126,63,5,24,283
Idaho,Dalton Gardens,2331,379,1296,153,5,151,1984
Idaho,Dayton,526,67,215,31,0,13,326
Idaho,Deary,462,45,204,77,2,27,355
Idaho,Declo,563,151,224,26,3,28,432
Idaho,De Smet,174,63,20,27,0,16,126
Idaho,Dietrich,323,28,142,14,0,9,193
Idaho,Dover,798,124,412,55,8,29,628
Idaho,Downey,640,52,306,54,12,43,467
Idaho,Crouch,119,27,34,34,0,8,103
Idaho,Donnelly,77,18,19,0,0,0,37
Idaho,Worley,267,70,99,40,5,10,224
Idaho,Lowman,23,0,18,5,0,0,23
Idaho,Bliss,346,51,137,47,17,11,263
Idaho,Blanchard,160,0,129,17,0,14,160
Idaho,Blackfoot,11843,2054,4418,1186,144,645,8447
Idaho,Bennington,286,0,153,0,0,8,161
Idaho,Bellevue,2514,542,936,250,25,18,1771
Idaho,Basalt,344,72,132,33,9,19,265
Idaho,Banks,9,0,0,0,0,9,9
Idaho,Bancroft,308,44,173,26,0,7,250
Idaho,Bloomington,188,33,105,10,0,5,153
Idaho,Atomic City,21,0,8,4,0,2,14
Idaho,Ashton,968,151,450,71,17,57,746
Idaho,Arimo,344,48,168,11,0,18,245
Idaho,Arco,955,215,342,114,25,69,765
Idaho,Arbon Valley,715,139,270,101,6,41,557
Idaho,Ammon,14469,2068,6170,945,116,488,9787
Idaho,American Falls,4380,750,1681,557,17,193,3198
Idaho,Albion,254,66,97,21,0,14,198
Idaho,Acequia,140,22,61,15,0,9,107
Idaho,Athol,798,149,329,85,36,41,640
Idaho,Boise City,214196,58005,82753,24481,1805,7999,175043
Idaho,Bonners Ferry,2496,478,1059,339,28,164,2068
Idaho,Bovill,243,40,117,24,11,9,201
Idaho,Rigby,4011,551,1525,342,2,185,2605
Idaho,Riggins,267,62,128,32,2,38,262
Idaho,Ririe,790,169,337,67,0,2,575
Idaho,Yellow Pine,82,0,82,0,0,0,82
Idaho,Conkling Park,60,5,51,0,0,4,60
Idaho,Coeur d'Alene,46796,11103,18068,5803,575,2207,37756
Idaho,Clifton,374,72,150,16,0,17,255
Idaho,Clayton,0,0,0,0,0,0,0
Idaho,Clark Fork,423,83,163,81,8,46,381
Idaho,Chubbuck,14224,2112,6246,1215,86,381,10040
Idaho,Challis,883,107,469,108,26,31,741
Idaho,Castleford,147,22,39,22,9,10,102
Idaho,Cascade,1056,102,536,133,43,58,872
Idaho,Carey,539,105,275,39,0,15,434
Idaho,Cambridge,251,32,130,24,8,32,226
Idaho,Caldwell,49149,10899,17240,4599,697,1951,35386
Idaho,Butte City,81,0,50,13,0,5,68
Idaho,Burley,10245,2026,3986,810,85,521,7428
Idaho,Buhl,4205,443,1932,296,160,334,3165
Idaho,Aberdeen,2046,367,758,132,31,124,1412
Idaho,Riverside,1037,174,411,17,0,0,602
Idaho,Roberts,578,198,181,47,0,15,441
Idaho,Robie Creek,1487,144,849,170,0,83,1246
Idaho,Sweetwater,200,66,45,49,0,13,173
Idaho,Tensed,136,46,27,33,0,12,118
Idaho,Teton,1046,138,458,85,19,29,729
Idaho,Tetonia,347,83,119,26,26,16,270
Idaho,Troy,884,86,495,42,0,36,659
Idaho,Twin Falls,45984,9296,18216,4621,683,2402,35218
Idaho,Tyhee,1165,243,548,64,0,60,915
Idaho,Ucon,1397,346,548,76,12,49,1031
Idaho,Victor,2244,444,766,262,5,113,1590
Idaho,Wallace,781,188,266,164,20,37,675
Idaho,Wardner,196,46,102,11,5,8,172
Idaho,Warm River,0,0,0,0,0,0,0
Idaho,Weippe,540,94,254,80,13,34,475
Idaho,Weiser,5362,974,2060,614,161,377,4186
Idaho,Wendell,2734,406,1252,180,34,105,1977
Idaho,Weston,528,107,223,22,0,23,375
Idaho,White Bird,64,8,35,19,0,2,64
Idaho,Wilder,1452,318,516,128,18,16,996
Idaho,Winchester,304,28,145,49,8,19,249
Idaho,Swan Valley,126,4,72,17,0,7,100
Idaho,Richfield,429,115,175,40,0,27,357
Idaho,Sun Valley,1408,301,768,167,8,85,1329
Idaho,Stites,228,35,95,28,9,22,189
Idaho,Rockford,414,103,181,18,0,11,313
Idaho,Rockford Bay,213,12,156,18,7,6,199
Idaho,Rockland,358,86,129,17,4,14,250
Idaho,Rupert,5601,1019,2115,570,111,273,4088
Idaho,St. Anthony,3476,645,1643,345,40,66,2739
Idaho,St. Charles,110,22,48,15,0,6,91
Idaho,St. Maries,2208,476,855,313,36,205,1885
Idaho,Salmon,3052,741,1108,356,57,237,2499
Idaho,Sandpoint,7571,1410,2584,1415,193,499,6101
Idaho,Shelley,4404,802,1552,459,65,174,3052
Idaho,Shoshone,1542,321,592,178,7,111,1209
Idaho,Smelterville,679,130,258,116,2,40,546
Idaho,Smiths Ferry,162,0,44,109,0,9,162
Idaho,Soda Springs,2974,451,1372,250,10,169,2252
Idaho,Spencer,20,2,11,1,0,5,19
Idaho,Lost River,9,0,9,0,0,0,9
Idaho,Stanley,161,119,19,16,0,0,154
Idaho,Star,6768,1157,3089,310,25,162,4743
Idaho,State Line,20,8,2,5,2,0,17
Idaho,Sugar City,1301,215,553,44,4,42,858
Idaho,Rexburg,26723,9411,10580,527,82,546,21146
Idaho,Spirit Lake,2193,398,954,270,30,73,1725
Idaho,Rathdrum,7174,1257,2978,885,72,183,5375
Idaho,Marsing,1397,231,539,132,35,48,985
Idaho,Nampa,86203,18332,32573,8172,1149,3146,63372
Idaho,Newdale,341,40,185,12,0,13,250
Idaho,New Meadows,522,117,181,60,4,19,381
Idaho,New Plymouth,1952,425,666,293,33,148,1565
Idaho,Nezperce,487,133,206,38,5,32,414
Idaho,Notus,532,99,251,55,0,23,428
Idaho,Oakley,779,120,374,32,5,36,567
Idaho,Oldtown,235,76,77,33,0,20,206
Idaho,Onaway,190,21,120,20,0,8,169
Idaho,Orofino,3088,1055,955,453,77,184,2724
Idaho,Osburn,1429,252,688,152,0,101,1193
Idaho,Oxford,54,7,10,11,0,2,30
Idaho,Paris,462,52,284,34,0,9,379
Idaho,Parker,340,55,151,22,4,10,242
Idaho,Parkline,69,0,30,12,4,10,56
Idaho,Parma,2266,478,753,331,19,125,1706
Idaho,Murphy,95,24,46,18,7,0,95
Idaho,Paul,1299,208,651,50,27,61,997
Idaho,Mullan,717,161,280,47,17,46,551
Idaho,Moyie Springs,730,89,359,72,38,41,599
Idaho,Melba,501,76,196,55,1,25,353
Idaho,Menan,808,187,334,47,14,20,602
Idaho,Meridian,84018,14861,37689,6185,523,2368,61626
Idaho,Middleton,6145,1153,2675,517,24,119,4488
Idaho,Midvale,161,9,89,35,0,8,141
Idaho,Minidoka,66,9,27,0,4,0,40
Idaho,Montpelier,2545,444,1118,230,33,140,1965
Idaho,Moore,150,8,60,21,3,20,112
Idaho,Moreland,1295,391,415,103,0,20,929
Idaho,Moscow,24688,11412,7751,1296,175,786,21420
Idaho,Mountain Home,13804,2381,6072,1290,268,552,10563
Idaho,Mountain Home AFB,3190,643,1523,41,48,9,2264
Idaho,Malad City,2017,363,899,126,10,154,1552
Idaho,Mackay,434,75,194,71,0,34,374
Idaho,McCammon,630,67,291,67,3,35,463
Idaho,McCall,2955,797,1036,528,42,36,2439
Idaho,Reubens,68,1,41,3,0,2,47
Idaho,Mud Lake,421,91,140,28,2,6,267
Idaho,Payette,7428,1774,2803,780,181,374,5912
Idaho,Murtaugh,92,1,44,11,0,11,67
Idaho,Malta,237,43,121,0,0,17,181
Idaho,Peck,163,22,77,25,0,19,143
Idaho,Pierce,681,71,392,47,3,46,559
Idaho,Pinehurst,1686,269,755,180,6,183,1393
Idaho,Plummer,1145,268,284,170,32,58,812
Idaho,Pocatello,54549,13991,20101,5922,744,2015,42773
Idaho,Placerville,28,4,21,2,0,1,28
Idaho,Post Falls,29320,5320,12553,3277,208,1057,22415
Idaho,Potlatch,792,121,319,109,12,51,612
Idaho,Preston,5190,806,2350,468,37,222,3883
Idaho,Priest River,1659,270,757,199,15,71,1312
Idaho,Princeton,76,0,29,0,0,9,38
Idaho,Ponderay,947,284,269,130,8,98,789
Illinois,Iroquois village,160,37,79,10,0,17,143
Illinois,Ingalls Park,3047,865,1073,323,14,63,2338
Illinois,Inverness village,7431,1226,4319,365,53,356,6319
Illinois,Iola village,107,18,39,17,0,1,75
Illinois,Ipava village,560,84,275,36,2,31,428
Illinois,Irving village,445,111,174,50,0,24,359
Illinois,Jacksonville,19241,6339,6246,2418,335,965,16303
Illinois,Irwin village,82,24,27,4,0,4,59
Illinois,Island Lake village,8041,1954,3245,985,49,314,6547
Illinois,Itasca village,8574,1633,4068,735,142,473,7051
Illinois,Iuka village,472,106,200,66,7,32,411
Illinois,Ivesdale village,281,57,137,16,4,28,242
Illinois,Industry village,396,42,221,23,3,19,308
Illinois,Irvington village,848,205,314,141,7,45,712
Illinois,Indianola village,368,67,184,11,3,20,285
Illinois,Hutsonville village,567,105,225,82,4,16,432
Illinois,Indian Creek village,569,89,296,12,0,15,412
Illinois,Ina village,2342,1339,395,422,16,40,2212
Illinois,Illiopolis village,943,196,411,53,25,35,720
Illinois,Sailor Springs village,90,14,31,19,0,9,73
Illinois,Jeffersonville village,497,74,225,43,11,24,377
Illinois,Hurst,780,155,317,111,25,62,670
Illinois,Huntley village,25412,3323,13844,1466,101,1847,20581
Illinois,Hume village,366,56,159,58,8,23,304
Illinois,Humboldt village,448,52,229,59,12,20,372
Illinois,Hull village,499,105,201,52,1,32,391
Illinois,Sadorus village,394,96,172,41,5,15,329
Illinois,Rutland village,256,41,147,20,8,18,234
Illinois,Russellville village,61,7,19,10,0,8,44
Illinois,Rushville,3159,654,1187,418,38,260,2557
Illinois,Indian Head Park village,3827,834,1468,563,34,382,3281
Illinois,Saybrook village,785,156,299,72,32,45,604
Illinois,Scales Mound village,518,129,209,52,7,12,409
Illinois,Jerseyville,8583,1695,3864,924,61,584,7128
Illinois,St. Joseph village,4302,742,1758,346,0,203,3049
Illinois,St. Libory village,625,75,315,75,20,19,504
Illinois,St. Peter village,303,59,136,32,0,34,261
Illinois,Salem,7054,1454,2759,817,153,537,5720
Illinois,Sammons Point village,379,85,170,25,2,15,297
Illinois,Sandoval village,1196,238,373,173,28,55,867
Illinois,Sandwich,7540,2110,2831,854,59,412,6266
Illinois,San Jose village,601,139,270,51,11,26,497
Illinois,Sauget village,219,60,82,27,0,29,198
Illinois,Sauk Village village,10540,3998,2447,993,218,420,8076
Illinois,Saunemin village,348,74,155,32,3,12,276
Illinois,Savanna,2980,732,1046,354,69,261,2462
Illinois,Savoy village,8066,2546,3123,597,35,361,6662
Illinois,Sawyerville village,264,38,141,10,0,18,207
Illinois,Scott AFB,2982,324,1355,103,0,8,1790
Illinois,Sciota village,86,2,30,17,0,8,57
Illinois,Schram City village,473,75,226,40,2,37,380
Illinois,Schiller Park village,11834,2957,5047,1052,228,472,9756
Illinois,Schaumburg village,74559,18260,32676,5980,775,3545,61236
Illinois,St. Johns village,224,24,107,17,0,13,161
Illinois,Jerome village,1579,406,652,227,4,96,1385
Illinois,St. Jacob village,1226,162,625,65,19,52,923
Illinois,Ste. Marie village,275,31,120,48,1,19,219
Illinois,Jewett village,276,58,100,46,8,11,223
Illinois,Johnsburg village,6321,1288,3002,475,61,217,5043
Illinois,Shelbyville,4964,955,2247,489,17,402,4110
Illinois,Sheffield village,760,176,337,84,4,44,645
Illinois,Shawneetown,1330,182,514,200,29,96,1021
Illinois,Shannon village,625,136,305,37,6,46,530
Illinois,Shabbona village,936,206,386,92,14,134,832
Illinois,Seymour,373,93,74,47,31,0,245
Illinois,Sesser,1959,447,771,242,5,116,1581
Illinois,Seneca village,2521,704,930,299,23,105,2061
Illinois,Secor village,355,61,153,40,1,33,288
Illinois,Seatonville village,311,45,161,17,4,19,246
Illinois,Seaton village,236,23,140,19,8,10,200
Illinois,Scottville village,68,6,53,1,0,4,64
Illinois,St. Anne village,1422,301,540,145,39,68,1093
Illinois,St. Augustine village,120,12,50,19,3,20,104
Illinois,St. Charles,33685,6785,15650,2909,318,1870,27532
Illinois,St. David village,609,156,249,68,14,38,525
Illinois,St. Elmo,1340,296,473,152,33,127,1081
Illinois,St. Francisville,440,65,214,33,7,31,350
Illinois,Jeisyville village,111,10,49,7,1,18,85
Illinois,Bowen village,458,104,219,29,11,10,373
Illinois,Brimfield village,901,233,324,80,2,38,677
Illinois,Hillview village,182,53,62,20,2,0,137
Illinois,Hillside village,8190,2650,2899,756,141,541,6987
Illinois,Hillsdale village,547,115,206,89,10,18,438
Illinois,Hillsboro,8545,3323,2526,1196,275,365,7685
Illinois,Hillcrest village,1167,317,465,88,24,25,919
Illinois,Highwood,5391,1534,1952,421,85,201,4193
Illinois,Highland Park,29789,4765,15331,1685,226,1466,23473
Illinois,Highland,9848,1789,4406,1035,96,648,7974
Illinois,Hidalgo village,108,12,50,12,4,3,81
Illinois,Ruma village,293,38,138,24,1,9,210
Illinois,Hickory Hills,13933,3489,5905,1076,112,696,11278
Illinois,Heyworth village,2937,595,1304,224,5,161,2289
Illinois,Hettick village,176,38,64,45,7,5,159
Illinois,Herscher village,1548,302,645,118,13,114,1192
Illinois,Belleville,42898,12406,13811,5360,823,2779,35179
Illinois,Bellevue village,1566,360,704,207,21,48,1340
Illinois,Bellflower village,330,79,155,25,1,12,272
Illinois,Hinckley village,2035,450,910,173,20,81,1634
Illinois,Bellmont village,204,27,80,52,0,18,177
Illinois,Hindsboro village,330,70,150,29,2,16,267
Illinois,Hodgkins village,2097,575,675,211,75,160,1696
Illinois,Huey village,199,42,90,33,0,5,170
Illinois,Hudson village,1931,324,1012,101,17,59,1513
Illinois,Hoyleton village,661,183,217,38,14,22,474
Illinois,Hopkins Park village,409,125,92,33,40,77,367
Illinois,Hopewell village,451,47,284,25,0,4,360
Illinois,Hopedale village,1013,185,403,107,9,110,814
Illinois,Hooppole village,337,28,150,10,2,9,199
Illinois,Hoopeston,5420,1011,2292,485,94,534,4416
Illinois,Homewood village,19375,5077,7161,1850,388,1321,15797
Illinois,Hometown,4356,1282,1301,607,23,383,3596
Illinois,Homer Glen village,24358,5148,12399,1340,139,994,20020
Illinois,Homer village,1246,198,521,148,7,95,969
Illinois,Hollowayville village,68,22,34,6,3,0,65
Illinois,Holiday Shores,2913,367,1577,229,0,117,2290
Illinois,Holiday Hills village,658,141,300,55,18,25,539
Illinois,Hoffman Estates village,52271,11722,24999,3032,690,1597,42040
Illinois,Hoffman village,474,94,223,29,4,12,362
Illinois,Hinsdale village,17308,3149,8422,677,163,450,12861
Illinois,Broadlands village,380,81,131,62,12,22,308
Illinois,Bellwood village,19190,6937,5515,1411,315,1222,15400
Illinois,Bement village,1744,326,827,178,12,83,1426
Illinois,Bluford village,617,161,245,75,3,25,509
Illinois,Bolingbrook village,74371,17983,31728,4266,937,2097,57011
Illinois,Bondville village,476,121,207,52,6,21,407
Illinois,Bone Gap village,201,37,82,12,5,24,160
Illinois,Bonfield village,319,61,157,21,0,15,254
Illinois,Bonnie village,403,57,198,47,4,29,335
Illinois,Boody,232,41,104,20,12,17,194
Illinois,Boulder Hill,8584,1961,3823,647,56,242,6729
Illinois,Bourbonnais village,18656,5942,6848,1336,201,859,15186
Illinois,Braceville village,757,204,261,86,6,31,588
Illinois,Bradford village,707,153,330,52,5,36,576
Illinois,Bradley village,15763,4510,5802,1530,162,790,12794
Illinois,Braidwood,6049,1241,2516,745,77,375,4954
Illinois,Breese,4539,1104,1820,309,0,432,3665
Illinois,Bridgeport,1196,138,492,115,9,117,871
Illinois,Bridgeview village,16359,3986,6075,1444,269,1070,12844
Illinois,Brighton village,2109,395,887,206,10,155,1653
Illinois,Bluffs village,795,194,333,77,15,25,644
Illinois,Belvidere,25741,6214,9389,2524,481,1238,19846
Illinois,Blue Mound village,1055,130,478,143,3,56,810
Illinois,Bloomington,78206,20954,30459,6666,851,3246,62176
Illinois,Benld,1657,400,604,162,18,113,1297
Illinois,Bensenville village,18485,5024,7317,1288,323,867,14819
Illinois,Benson village,427,57,183,58,3,23,324
Illinois,Bentley,37,7,16,10,0,4,37
Illinois,Benton,7319,1824,2506,911,103,664,6008
Illinois,Berkeley village,5217,1444,1978,471,17,265,4175
Illinois,Berlin village,144,29,73,11,9,16,138
Illinois,Berwyn,56706,16847,19392,4355,1523,2149,44266
Illinois,Bethalto village,9406,1641,3906,903,143,723,7316
Illinois,Bethany village,1308,251,535,137,3,73,999
Illinois,Biggsville village,298,89,123,17,1,49,279
Illinois,Big Rock village,1128,207,601,58,11,35,912
Illinois,Bingham village,45,16,10,9,1,1,37
Illinois,Bishop Hill village,136,23,85,13,0,7,128
Illinois,Bismarck village,598,117,314,23,5,22,481
Illinois,Blandinsville village,693,120,353,67,13,48,601
Illinois,Bloomingdale village,22261,4877,10072,1897,400,1569,18815
Illinois,Blue Island,23096,7594,6361,1833,791,1274,17853
Illinois,Royalton village,1177,189,506,144,23,120,982
Illinois,Princeville village,2024,366,789,183,28,143,1509
Illinois,Royal village,231,37,117,16,0,12,182
Illinois,Mitchell,1161,289,495,78,0,135,997
Illinois,Minooka village,11505,2523,5049,584,21,194,8371
Illinois,Minonk,2087,350,880,162,37,225,1654
Illinois,Minier village,1346,317,639,84,0,56,1096
Illinois,Mineral village,248,61,99,30,0,11,201
Illinois,Milton village,287,24,146,19,0,18,207
Illinois,Pittsburg village,559,72,330,50,4,33,489
Illinois,Pittsfield,4611,1049,1915,566,22,283,3835
Illinois,Plainfield village,40855,8017,17684,2403,204,994,29302
Illinois,Plainville village,417,81,154,32,8,10,285
Illinois,Plano,11920,3173,4412,865,22,443,8915
Illinois,Plattville village,274,68,120,2,4,14,208
Illinois,Pleasant Hill village,1110,195,493,83,8,58,837
Illinois,Pleasant Plains village,904,142,392,97,0,44,675
Illinois,Plymouth village,429,85,198,59,9,38,389
Illinois,Pocahontas village,631,167,236,64,9,60,536
Illinois,Polo,2172,523,825,195,26,190,1759
Illinois,Metropolis,6417,1561,1890,980,76,699,5206
Illinois,Mettawa village,430,77,216,53,2,25,373
Illinois,Middletown village,280,42,112,39,0,32,225
Illinois,Midlothian village,14906,4469,5441,1158,305,832,12205
Illinois,Milan village,5137,1173,2050,625,177,393,4418
Illinois,Milford village,1289,295,477,142,19,115,1048
Illinois,Modesto village,174,21,84,27,0,7,139
Illinois,Millbrook village,342,66,204,39,0,5,314
Illinois,Milledgeville village,1061,180,527,89,3,68,867
Illinois,Millington village,643,126,295,58,3,22,504
Illinois,Mill Shoals village,204,43,94,25,3,10,175
Illinois,Millstadt village,3930,755,1789,345,32,249,3170
Illinois,Pontoon Beach village,5840,1545,2160,665,91,230,4691
Illinois,Pontiac,12085,3563,3857,1693,159,832,10104
Illinois,Mill Creek village,36,8,20,8,0,0,36
Illinois,Metcalf village,204,22,88,28,2,19,159
Illinois,Mokena village,19369,4421,9387,1059,62,783,15712
Illinois,Momence,2845,846,1146,228,56,133,2409
Illinois,Muncie village,193,45,77,27,2,5,156
Illinois,Mulkeytown,151,0,120,0,0,8,128
Illinois,Mulberry Grove village,662,110,253,85,4,34,486
Illinois,Muddy village,39,6,9,13,6,2,36
Illinois,Moweaqua village,1776,370,736,160,23,165,1454
Illinois,Mount Zion village,6118,1040,2702,491,74,286,4593
Illinois,Mount Vernon,15136,3783,5022,2023,493,1131,12452
Illinois,Mount Sterling,2080,557,605,237,42,260,1701
Illinois,Mount Pulaski,1336,146,672,92,5,124,1039
Illinois,Mount Prospect village,54710,12254,25502,3401,320,2707,44184
Illinois,Mount Olive,2090,437,837,276,29,87,1666
Illinois,Mount Morris village,2997,594,1106,421,39,264,2424
Illinois,Mount Erie village,87,12,46,6,1,6,71
Illinois,Mount Clare village,206,42,103,25,3,20,193
Illinois,Mount Carroll,1685,316,736,168,28,168,1416
Illinois,Mount Carmel,7098,1482,2960,909,36,481,5868
Illinois,Mount Auburn village,535,102,243,42,3,20,410
Illinois,Monee village,5114,1075,2169,385,21,281,3931
Illinois,Monmouth,9302,2934,3102,789,64,671,7560
Illinois,Monroe Center village,477,81,252,31,0,13,377
Illinois,Montgomery village,19196,3891,7653,1590,189,620,13943
Illinois,Monticello,5493,747,2879,488,20,269,4403
Illinois,Montrose village,280,56,83,30,3,31,203
Illinois,Moline,43062,9692,17132,4739,424,2822,34809
Illinois,Morris,14402,3434,5731,1421,182,827,11595
Illinois,Morrisonville village,903,156,410,67,35,44,712
Illinois,Morton village,16534,2711,8315,1218,115,760,13119
Illinois,Morton Grove village,23472,4979,11922,1108,213,1472,19694
Illinois,Mound City,634,175,161,68,5,39,448
Illinois,Mounds,1131,307,292,116,38,79,832
Illinois,Mound Station village,165,33,82,12,0,4,131
Illinois,Morrison,4225,881,1752,397,39,299,3368
Illinois,Mundelein village,31624,6954,14756,1916,447,1132,25205
Illinois,Metamora village,3454,548,1447,253,0,297,2545
Illinois,Meredosia village,1043,166,475,97,32,53,823
Illinois,Mansfield village,896,154,441,96,5,57,753
Illinois,Manlius village,423,78,144,55,4,38,319
Illinois,Manito village,1689,385,768,159,7,79,1398
Illinois,Manhattan village,7161,1290,3166,487,52,218,5213
Illinois,Manchester village,327,52,187,29,0,13,281
Illinois,Malta village,1118,230,402,111,21,55,819
Illinois,Malden village,375,95,130,36,0,11,272
Illinois,Makanda village,588,114,281,63,7,26,491
Illinois,Mahomet village,7762,1311,3849,426,14,328,5928
Illinois,Magnolia village,386,73,138,40,9,10,270
Illinois,Maeystown village,123,32,49,7,1,10,99
Illinois,Madison,4063,1504,877,388,212,213,3194
Illinois,Macon,1229,287,488,124,4,70,973
Illinois,Macomb,18944,9599,5072,1254,99,759,16783
Illinois,McNabb village,360,39,181,19,0,14,253
Illinois,Abingdon,3105,726,1009,428,29,247,2439
Illinois,Adair,150,10,114,0,0,10,134
Illinois,Alma village,371,58,141,56,8,21,284
Illinois,Allerton village,231,41,135,16,0,16,208
Illinois,Allenville village,170,20,113,23,0,0,156
Illinois,Allendale village,717,140,323,50,1,28,542
Illinois,Alhambra village,633,167,203,73,5,115,563
Illinois,Algonquin village,30278,6447,14925,1706,171,960,24209
Illinois,Manteno village,9251,1954,3953,772,187,413,7279
Illinois,Alexis village,967,196,459,91,6,36,788
Illinois,Albion,2154,491,738,210,33,196,1668
Illinois,Albers village,1134,190,584,54,0,51,879
Illinois,Albany village,1039,195,438,111,5,108,857
Illinois,Adeline village,83,16,44,2,2,11,75
Illinois,Addison village,37270,9569,15096,2404,490,1388,28947
Illinois,Addieville village,311,73,130,29,2,15,249
Illinois,Aledo,3590,746,1529,351,15,331,2972
Illinois,Merrionette Park village,1812,652,592,205,20,100,1569
Illinois,Maple Park village,1316,297,563,98,9,39,1006
Illinois,Maquon village,340,71,141,47,0,18,277
Illinois,Menominee village,264,31,112,21,0,23,187
Illinois,Mendota,7321,1765,2662,679,73,513,5692
Illinois,Mendon village,912,208,381,81,16,59,745
Illinois,Melvin village,509,79,196,40,16,33,364
Illinois,Melrose Park village,25491,7437,8175,1776,721,915,19024
Illinois,Medora village,408,84,180,20,14,13,311
Illinois,Media village,148,28,59,29,3,12,131
Illinois,Mechanicsburg village,560,89,238,83,5,22,437
Illinois,Mazon village,1024,205,398,125,11,48,787
Illinois,Maywood village,24138,8872,6519,1706,629,1272,18998
Illinois,Maunie village,122,25,59,16,0,6,106
Illinois,Mattoon,17646,4452,5938,2487,413,1269,14559
Illinois,Matteson village,19159,5013,7760,1183,340,884,15180
Illinois,Matherville village,960,156,418,122,0,27,723
Illinois,Mason City,2305,451,889,318,33,223,1914
Illinois,Mason,463,117,150,64,0,30,361
Illinois,Mascoutah,7801,1693,3168,703,126,327,6017
Illinois,Marengo,7714,1379,3650,624,45,309,6007
Illinois,Marietta village,218,45,135,20,4,2,206
Illinois,Marine village,1107,237,541,109,18,66,971
Illinois,Marion,17588,3525,7545,2029,221,1281,14601
Illinois,Marissa village,2011,409,705,252,105,184,1655
Illinois,Mark village,599,150,259,59,13,29,510
Illinois,Mapleton village,329,87,115,40,1,14,257
Illinois,Markham,12685,4680,3023,1080,379,834,9996
Illinois,Marquette Heights,2851,475,1363,265,24,111,2238
Illinois,Marseilles,4757,1149,1721,572,67,313,3822
Illinois,Marshall,3895,624,1516,511,131,260,3042
Illinois,Martinsville,1219,296,482,119,6,93,996
Illinois,Martinton village,304,83,141,24,2,8,258
Illinois,Maryville village,7791,1511,3641,612,83,647,6494
Illinois,Maroa,1724,371,722,188,17,94,1392
Illinois,Murphysboro,8055,2494,2751,847,189,624,6905
Illinois,Murrayville village,472,75,231,50,11,27,394
Illinois,Naperville,145058,31243,70066,7328,893,4565,114095
Illinois,Oak Brook village,7977,1484,4662,260,34,593,7033
Illinois,Norwood village,491,100,254,35,6,22,417
Illinois,North Utica village,1401,184,746,134,16,72,1152
Illinois,North Riverside village,6991,2264,2198,710,189,468,5829
Illinois,North Pekin village,1480,263,609,167,14,70,1123
Illinois,Northlake,12353,3759,4339,675,172,744,9689
Illinois,North Henderson village,184,59,67,27,0,8,161
Illinois,Northfield village,5305,1063,2577,452,38,288,4418
Illinois,North City village,834,189,367,48,14,34,652
Illinois,North Chicago,29925,14394,7260,1503,549,678,24384
Illinois,Northbrook village,33572,5085,18345,1692,157,1993,27272
Illinois,North Barrington village,3032,581,1768,125,28,68,2570
Illinois,North Aurora village,17154,3475,7560,1565,105,667,13372
Illinois,Norris City village,1358,289,562,155,16,46,1068
Illinois,Norris village,172,29,63,23,0,21,136
Illinois,Norridge village,14856,3985,6377,920,94,1497,12873
Illinois,Normal,54488,25124,16204,3112,496,1415,46351
Illinois,Oreana village,885,134,403,87,0,67,691
Illinois,New Holland village,179,30,92,21,0,16,159
Illinois,New Lenox village,25024,5436,11675,1410,69,817,19407
Illinois,Newman,916,139,407,106,7,63,722
Illinois,New Milford village,791,156,301,114,10,41,622
Illinois,New Minden village,233,54,101,14,0,20,189
Illinois,Oakbrook Terrace,2252,696,995,208,20,106,2025
Illinois,New Salem village,129,28,53,14,0,5,100
Illinois,Niantic village,628,136,232,67,6,71,512
Illinois,Niles village,29955,7057,13189,1979,417,3085,25727
Illinois,Nilwood,223,33,102,43,1,14,193
Illinois,Noble village,574,115,204,86,5,40,450
Illinois,Nokomis,2294,247,982,245,15,187,1676
Illinois,Nora village,113,25,51,15,1,8,100
Illinois,Newton,2818,660,1085,389,51,152,2337
Illinois,Oregon,3715,977,1450,502,60,262,3251
Illinois,Oakdale village,189,36,84,13,4,7,144
Illinois,Oak Forest,28134,7868,12144,1934,290,1270,23506
Illinois,Orangeville village,929,194,326,137,6,45,708
Illinois,Oquawka village,1367,264,593,171,15,85,1128
Illinois,Opdyke,339,15,170,37,4,5,231
Illinois,Oneida,776,178,320,72,2,30,602
Illinois,Onarga village,1381,383,561,77,13,60,1094
Illinois,Omaha village,308,52,148,24,9,20,253
Illinois,Olympia Fields village,4916,1266,2249,366,53,452,4386
Illinois,Olney,9085,1698,3424,1182,105,965,7374
Illinois,Olmsted village,422,52,168,60,4,37,321
Illinois,Olivet,319,98,187,11,0,8,304
Illinois,Olive Branch,698,89,272,101,0,75,537
Illinois,Old Shawneetown village,174,59,39,23,9,10,140
Illinois,Old Ripley village,100,15,56,11,0,12,94
Illinois,Old Mill Creek village,152,35,65,19,0,9,128
Illinois,Okawville village,1460,350,594,119,33,80,1176
Illinois,Ohlman village,110,22,41,9,2,11,85
Illinois,Ohio village,424,83,200,26,0,27,336
Illinois,Oak Grove village,762,175,181,177,11,30,574
Illinois,Oakland,910,164,427,95,8,75,769
Illinois,Oak Lawn village,56980,14600,22734,4484,711,4111,46640
Illinois,Oak Park village,52080,14540,20937,3881,667,1685,41710
Illinois,Oak Run,499,53,347,28,0,28,456
Illinois,Oakwood village,1650,202,709,202,11,134,1258
Illinois,Oakford village,335,87,108,51,4,26,276
Illinois,Oakwood Hills village,2152,571,1012,212,7,39,1841
Illinois,Oconee village,199,47,82,9,0,11,149
Illinois,Odell village,1000,219,388,107,26,58,798
Illinois,Odin village,1052,180,391,127,14,143,855
Illinois,O'Fallon,29144,6506,12615,2318,412,1051,22902
Illinois,Ogden village,740,142,337,75,18,23,595
Illinois,Oglesby,3880,617,1766,360,64,198,3005
Illinois,Oblong village,1472,326,590,133,15,127,1191
Illinois,Orient,358,94,143,38,18,20,313
Illinois,Orion village,2011,325,960,223,8,107,1623
Illinois,Orland Hills village,7259,1911,3107,488,60,228,5794
Illinois,Peru,10019,2608,3978,913,68,840,8407
Illinois,Pesotum village,520,91,267,43,4,19,424
Illinois,Petersburg,2357,418,884,298,32,155,1787
Illinois,Phillipstown village,30,1,14,0,0,11,26
Illinois,Philo village,1737,297,810,116,0,55,1278
Illinois,Phoenix village,2088,743,418,216,146,182,1705
Illinois,Pierron village,460,97,170,56,0,48,371
Illinois,Pinckneyville,5450,2208,1574,453,34,380,4649
Illinois,Pingree Grove village,5460,1132,1746,660,0,263,3801
Illinois,Piper City village,825,176,345,51,21,93,686
Illinois,Pistakee Highlands,3212,857,1456,272,53,104,2742
Illinois,New Haven village,373,68,151,51,4,28,302
Illinois,New Grand Chain village,173,29,62,33,0,13,137
Illinois,New Douglas village,355,50,168,32,3,17,270
Illinois,New Canton,364,89,131,54,3,22,299
Illinois,New Burnside village,205,18,119,23,2,11,173
Illinois,New Boston,698,101,304,134,0,33,572
Illinois,Naplate village,438,137,119,76,8,32,372
Illinois,Naples,48,7,24,9,1,5,46
Illinois,Nashville,3265,584,1200,450,10,391,2635
Illinois,Nason,241,58,102,38,9,17,224
Illinois,Nauvoo,1362,259,737,61,35,49,1141
Illinois,Nebo village,310,95,112,29,1,26,263
Illinois,Perry village,329,62,131,53,0,54,300
Illinois,Nelson village,153,34,48,11,2,8,103
Illinois,Neponset village,603,131,256,56,6,29,478
Illinois,Newark village,1131,189,548,37,0,40,814
Illinois,New Athens village,2072,408,945,123,10,118,1604
Illinois,New Baden village,3432,676,1687,227,0,146,2736
Illinois,New Bedford village,67,12,36,8,0,4,60
Illinois,New Berlin village,1501,278,670,129,4,44,1125
Illinois,Neoga,1602,335,587,234,23,143,1322
Illinois,Percy village,854,201,271,187,0,58,717
Illinois,Peotone village,3990,1011,1794,336,8,120,3269
Illinois,Peoria Heights village,6046,1926,1898,767,92,461,5144
Illinois,Panama village,262,46,95,34,3,15,193
Illinois,Pana,5684,1043,2071,895,113,461,4583
Illinois,Palos Park village,4944,844,2264,537,1,495,4141
Illinois,Palos Hills,17596,5103,6767,1823,117,1182,14992
Illinois,Palos Heights,12566,2582,6044,889,63,1264,10842
Illinois,Palmyra village,584,151,211,74,15,35,486
Illinois,Panola village,53,4,38,0,0,0,42
Illinois,Palmer village,135,27,76,6,0,11,120
Illinois,Palatine village,69188,16906,29267,5046,1303,2763,55285
Illinois,Paderborn,36,14,22,0,0,0,36
Illinois,Owaneco village,183,29,86,15,4,16,150
Illinois,Ottawa,18565,4520,6989,2070,151,1199,14929
Illinois,Oswego village,32468,6243,15663,1200,134,1027,24267
Illinois,Orland Park village,58273,13072,28079,3782,318,3873,49124
Illinois,Palestine village,1375,294,520,200,12,118,1144
Illinois,Alorton village,1867,791,224,170,56,90,1331
Illinois,Papineau village,306,106,127,3,0,5,241
Illinois,Park City,7432,2127,2128,550,148,273,5226
Illinois,Peoria,115847,37260,37205,9799,1291,5529,91084
Illinois,Penfield,159,21,74,27,4,15,141
Illinois,Pekin,33905,7351,13638,4199,455,1880,27523
Illinois,Pecatonica village,2234,473,871,275,8,101,1728
Illinois,Pearl City village,884,193,363,49,8,48,661
Illinois,Pearl village,250,45,84,15,4,16,164
Illinois,Paris,8517,1701,3442,1126,74,587,6930
Illinois,Payson village,1261,239,567,151,19,35,1011
Illinois,Paw Paw village,797,150,353,122,19,47,691
Illinois,Pawnee village,2730,495,1164,231,16,161,2067
Illinois,Patoka village,529,133,204,67,14,35,453
Illinois,Park Ridge,37608,7952,17352,2249,211,2250,30014
Illinois,Park Forest village,21928,7014,5843,2415,541,1187,17000
Illinois,Parkersburg village,147,30,66,15,1,3,115
Illinois,Paxton,4252,791,1793,467,14,433,3498
Illinois,Alpha village,558,86,310,47,2,39,484
Illinois,Alsey village,233,27,89,31,9,15,171
Illinois,Alsip village,19396,6149,6282,1634,538,983,15586
Illinois,Kempton village,150,55,58,16,1,7,137
Illinois,Kell village,196,46,90,23,4,5,168
Illinois,Keithsburg,609,149,276,46,6,38,515
Illinois,Keensburg village,138,13,75,14,0,8,110
Illinois,Keenes village,71,14,39,3,2,6,64
Illinois,Kaskaskia village,20,4,16,0,0,0,20
Illinois,Karnak village,605,176,213,73,2,54,518
Illinois,Kappa village,313,70,122,38,7,1,238
Illinois,Kansas village,655,88,289,79,16,39,511
Illinois,Kankakee,26821,8960,6888,2426,682,1400,20356
Illinois,Kangley village,337,102,131,37,3,12,285
Illinois,Kaneville village,432,76,202,29,5,27,339
Illinois,Kane village,383,82,149,51,12,7,301
Illinois,Kampsville village,304,61,150,30,9,13,263
Illinois,Justice village,13015,3847,4238,938,276,435,9734
Illinois,Junction City village,513,104,199,71,13,31,418
Illinois,Junction village,113,24,47,12,5,3,91
Illinois,Annapolis,40,4,18,4,0,4,30
Illinois,Anna,4360,1035,1368,687,37,404,3531
Illinois,Andover village,554,79,286,45,0,54,464
Illinois,Andalusia village,1384,382,600,168,13,39,1202
Illinois,Anchor village,145,29,55,7,1,10,102
Illinois,Amboy,2535,676,880,366,0,200,2122
Illinois,Kenilworth village,2653,411,1347,63,12,91,1924
Illinois,Alvan village,286,57,110,34,1,28,230
Illinois,Johnsonville village,57,18,21,4,0,8,51
Illinois,Johnston City,3531,753,1144,500,160,228,2785
Illinois,Joliet,147918,40529,53561,10987,1899,4894,111870
Illinois,Jonesboro,2059,442,788,296,10,119,1655
Illinois,Joppa village,342,76,104,31,7,31,249
Illinois,Joy village,378,72,173,43,6,24,318
Illinois,Alto Pass village,402,114,128,40,16,10,308
Illinois,Annawan,900,160,376,100,10,61,707
Illinois,Kenney village,330,60,168,40,2,12,282
Illinois,Keyesport village,542,130,184,63,11,28,416
Illinois,Lake Villa village,8878,1773,4088,414,35,287,6597
Illinois,Lake Summerset,1999,203,1190,212,0,81,1686
Illinois,Lake Petersburg,628,52,436,53,0,68,609
Illinois,Lake of the Woods,2941,555,1218,386,24,80,2263
Illinois,Lakemoor village,6535,1668,2684,499,81,76,5008
Illinois,Lake Ka-Ho village,232,22,83,50,13,23,191
Illinois,Lake in the Hills village,28968,5715,12848,2376,344,714,21997
Illinois,Lake Holiday,4852,1093,2300,463,27,133,4016
Illinois,Lake Forest,18951,3729,9621,1115,135,756,15356
Illinois,Lake Catherine,1712,418,629,250,38,113,1448
Illinois,Lake Camelot,1986,244,1120,117,8,36,1525
Illinois,Lake Bluff village,5813,1028,3067,375,49,171,4690
Illinois,Lake Barrington village,4934,706,2893,486,52,326,4463
Illinois,La Harpe,1414,240,599,156,22,129,1146
Illinois,La Grange Park village,13649,2950,6017,776,68,939,10750
Illinois,La Grange village,15709,3109,6614,1007,120,736,11586
Illinois,La Fayette village,252,70,109,17,0,18,214
Illinois,Kilbourne village,284,62,90,61,4,23,240
Illinois,Kildeer village,3938,721,2178,168,18,126,3211
Illinois,Kincaid village,1653,358,653,171,24,85,1291
Illinois,Kinderhook village,269,36,141,10,5,8,200
Illinois,Kingston village,1066,223,426,119,8,39,815
Illinois,Kingston Mines village,288,67,107,26,0,30,230
Illinois,Kewanee,12736,3198,4464,1487,130,1069,10348
Illinois,Kinmundy,1015,209,364,93,12,72,750
Illinois,Kirkland village,1655,390,652,116,30,77,1265
Illinois,Kirkwood village,773,145,331,84,0,27,587
Illinois,Knollwood,1613,404,682,165,58,76,1385
Illinois,Knoxville,2827,549,1272,282,21,239,2363
Illinois,Lacon,1996,411,812,199,7,198,1627
Illinois,Ladd village,1212,259,628,91,21,26,1025
Illinois,Kinsman village,118,17,51,14,0,5,87
Illinois,Antioch village,14386,2876,6198,1040,299,441,10854
Illinois,Apple Canyon Lake,304,48,230,9,0,8,295
Illinois,Apple River village,456,80,190,66,9,8,353
Illinois,Basco village,78,23,26,11,0,12,72
Illinois,Batavia,26105,5514,12274,1690,209,1231,20918
Illinois,Batchtown village,189,34,109,15,0,17,175
Illinois,Bath village,267,53,120,28,5,20,226
Illinois,Baylis village,195,50,84,28,2,19,183
Illinois,Bay View Gardens village,336,97,139,34,3,18,291
Illinois,Beach Park village,13833,3263,5925,1151,204,691,11234
Illinois,Beardstown,6217,1609,2147,424,123,452,4755
Illinois,Beason,70,6,23,18,0,3,50
Illinois,Beaverville village,285,59,111,24,2,31,227
Illinois,Beckemeyer village,948,290,332,98,17,65,802
Illinois,Bedford Park village,646,231,187,48,18,38,522
Illinois,Beecher village,4532,837,1993,579,64,253,3726
Illinois,Beecher City village,454,92,136,73,2,48,351
Illinois,Belgium village,325,57,100,75,8,29,269
Illinois,Belknap village,54,9,23,6,0,3,41
Illinois,Belle Prairie City,60,11,33,1,3,2,50
Illinois,Roxana village,1653,315,630,193,59,88,1285
Illinois,Round Lake Park village,7957,1649,3347,543,137,636,6312
Illinois,Round Lake Heights village,2908,714,1046,184,37,96,2077
Illinois,Round Lake Beach village,27966,7245,10816,1956,366,972,21355
Illinois,Round Lake village,18446,3748,7909,901,168,313,13039
Illinois,Rossville village,1675,389,643,143,28,98,1301
Illinois,Bartonville village,6438,1299,2762,765,11,353,5190
Illinois,Rosiclare,950,170,339,136,29,67,741
Illinois,Roseville village,1135,207,475,148,14,81,925
Illinois,Rosemont village,4305,1316,1434,397,114,176,3437
Illinois,Roselle village,22979,5807,9968,1860,212,809,18656
Illinois,Rose Hill village,50,10,19,13,0,3,45
Illinois,Roscoe village,10536,1836,4904,740,188,332,8000
Illinois,Belle Rive village,301,42,143,33,4,22,244
Illinois,Rosewood Heights,4051,848,2043,473,46,144,3554
Illinois,Bartlett village,41552,8108,21142,1855,391,1300,32796
Illinois,Bartelso village,608,174,289,10,2,31,506
Illinois,Barry,1300,231,514,167,18,134,1064
Illinois,Ashton village,958,260,367,94,3,65,789
Illinois,Ashmore village,828,145,377,87,28,45,682
Illinois,Ashley,563,140,197,89,0,45,471
Illinois,Ashland village,1318,282,555,120,9,112,1078
Illinois,Ashkum village,795,155,342,81,12,50,640
Illinois,Arthur village,2563,567,1095,229,22,170,2083
Illinois,Assumption,1315,235,457,145,10,117,964
Illinois,Arrowsmith village,316,61,133,16,0,20,230
Illinois,Armington village,360,43,160,39,2,16,260
Illinois,Arlington Heights village,75802,16047,36822,4832,622,4037,62360
Illinois,Arlington village,166,39,68,24,0,14,145
Illinois,Argenta village,958,170,446,72,2,46,736
Illinois,Arenzville village,364,63,178,24,5,21,291
Illinois,Arcola,2961,591,1280,286,34,116,2307
Illinois,Aroma Park village,659,203,283,21,0,36,543
Illinois,Lakewood village,4258,910,2146,278,31,148,3513
Illinois,Astoria,1198,358,393,105,14,82,952
Illinois,Atkinson,1006,201,502,72,0,53,828
Illinois,Barrington Hills village,3370,600,1989,284,0,130,3003
Illinois,Barrington village,10576,1924,5155,614,31,610,8334
Illinois,Bardolph village,268,62,84,35,17,10,208
Illinois,Bannockburn village,1390,807,416,22,0,25,1270
Illinois,Banner village,207,40,95,22,0,19,176
Illinois,Baldwin village,409,124,117,56,11,15,323
Illinois,Athens,1776,287,785,174,28,90,1364
Illinois,Avon village,686,190,242,90,9,39,570
Illinois,Ava,661,150,250,63,7,59,529
Illinois,Aurora,200614,51967,76200,12848,2927,4834,148776
Illinois,Augusta village,573,163,262,65,0,39,529
Illinois,Auburn,4870,1045,1988,348,77,233,3691
Illinois,Atwood village,1115,188,548,108,0,103,947
Illinois,Atlanta,1321,183,630,93,18,65,989
Illinois,Aviston village,2228,416,1086,112,8,90,1712
Illinois,Royal Lakes village,155,35,69,14,3,12,133
Illinois,Lakewood Shores,1385,336,572,151,0,83,1142
Illinois,La Moille village,793,151,346,100,4,39,640
Illinois,Richton Park village,13744,5034,3867,1505,353,632,11391
Illinois,Richview village,203,49,81,18,4,11,163
Illinois,Ridge Farm village,838,200,379,98,23,40,740
Illinois,Ridgway village,804,139,337,102,8,104,690
Illinois,Ridott village,155,52,56,16,1,4,129
Illinois,Ringwood village,791,156,392,50,2,18,618
Illinois,Rio village,204,49,105,10,8,8,180
Illinois,Ripley village,94,21,32,16,0,5,74
Illinois,Riverdale village,13106,5787,2224,1144,466,560,10181
Illinois,River Forest village,11233,2716,5260,560,45,301,8882
Illinois,River Grove village,10260,2426,4213,925,208,555,8327
Illinois,Riverside village,8859,2072,4027,352,157,409,7017
Illinois,Riverton village,3478,861,1111,488,56,164,2680
Illinois,Riverwoods village,3811,547,2265,92,5,137,3046
Illinois,Roanoke village,2189,403,1127,145,21,146,1842
Illinois,Robbins village,5157,2584,847,415,144,311,4301
Illinois,Roberts village,311,64,119,30,7,26,246
Illinois,Rome,1831,510,656,253,8,67,1494
Illinois,Rolling Meadows,23401,5997,9466,2052,296,1242,19053
Illinois,Rockwood village,63,27,11,18,0,3,59
Illinois,Rockton village,7567,1622,3248,716,202,365,6153
Illinois,Rock Island Arsenal,131,28,66,4,0,0,98
Illinois,Rock Island,38946,11684,12856,4114,611,2270,31535
Illinois,Richmond village,1989,531,689,325,24,94,1663
Illinois,Rockford,150283,42692,48131,16180,2365,8397,117765
Illinois,Rockdale village,2061,629,677,244,48,78,1676
Illinois,Rock City village,288,44,135,18,0,16,213
Illinois,Rockbridge village,180,35,87,23,2,18,165
Illinois,Rochester village,3883,713,1749,408,0,96,2966
Illinois,Rochelle,9440,2247,3489,900,135,639,7410
Illinois,Robinson,7506,2065,2706,1056,73,496,6396
Illinois,Rock Falls,9178,2265,3069,1328,107,651,7420
Illinois,Romeoville village,39774,9755,16058,2635,387,1407,30242
Illinois,Reynolds village,451,51,203,65,4,21,344
Illinois,Redmon village,124,18,72,9,0,11,110
Illinois,Altamont,2399,542,931,198,7,242,1920
Illinois,Alton,27335,7893,8260,3696,581,1477,21907
Illinois,Altona village,494,113,184,35,0,34,366
Illinois,Pontoosuc village,94,27,36,19,2,3,87
Illinois,Poplar Grove village,5258,720,2587,182,263,119,3871
Illinois,Port Barrington village,1451,231,768,59,3,62,1123
Illinois,Port Byron village,1708,303,882,169,9,61,1424
Illinois,Posen village,6319,1883,2098,470,32,284,4767
Illinois,Potomac village,700,139,226,99,13,45,522
Illinois,Prairie City village,508,108,199,37,11,30,385
Illinois,Prairie du Rocher village,694,133,298,55,16,41,543
Illinois,Prairie Grove village,1685,383,806,130,8,73,1400
Illinois,Prestbury,1580,68,1029,179,0,55,1331
Illinois,Preston Heights,2907,875,884,303,79,158,2299
Illinois,Princeton,7719,1649,3100,1019,140,637,6545
Illinois,Broadview village,7957,2685,2320,962,103,680,6750
Illinois,Prophetstown,2150,511,810,247,16,171,1755
Illinois,Reddick village,353,81,148,15,0,14,258
Illinois,Red Bud,3623,681,1675,252,71,276,2955
Illinois,Raymond village,781,105,392,71,3,58,629
Illinois,Raritan village,93,16,51,7,4,5,83
Illinois,Rapids City village,1047,185,605,54,4,40,888
Illinois,Rantoul village,13256,3705,3986,1258,374,753,10076
Illinois,Rentchler,0,0,0,0,0,0,0
Illinois,Ransom village,354,104,135,46,12,16,313
Illinois,Ramsey village,1274,328,453,96,17,72,966
Illinois,Raleigh village,306,39,138,44,10,29,260
Illinois,Radom village,163,44,71,12,0,22,149
Illinois,Quincy,40763,9446,15519,4314,380,2935,32594
Illinois,Pulaski village,182,83,37,9,3,25,157
Illinois,Prospect Heights,16370,3295,7542,1222,199,746,13004
Illinois,Rankin village,393,112,126,57,6,35,336
Illinois,Roodhouse,1788,366,625,287,35,136,1449
Illinois,McLeansboro,2894,597,1221,234,22,276,2350
Illinois,McLean village,821,129,433,59,8,64,693
Illinois,Lindenhurst village,14414,2883,6649,1040,37,544,11153
Illinois,Lincolnwood village,12666,2696,6442,383,114,863,10498
Illinois,Lincolnshire village,7271,1134,3641,438,18,872,6103
Illinois,Lincoln,14285,3260,5722,1410,248,1005,11645
Illinois,Limestone village,1435,250,694,138,3,91,1176
Illinois,Lima village,175,15,99,5,0,13,132
Illinois,Lily Lake village,1113,249,542,45,6,26,868
Illinois,Libertyville village,20395,3953,10071,1318,72,922,16336
Illinois,Liberty village,512,111,229,30,0,35,405
Illinois,Lexington,2153,388,1056,102,0,145,1691
Illinois,Lewistown,2395,502,954,360,40,180,2036
Illinois,Le Roy,3584,750,1528,361,8,212,2859
Illinois,Lerna village,324,89,115,26,3,26,259
Illinois,Leonore village,75,16,20,20,4,7,67
Illinois,Lenzburg village,509,127,168,61,9,28,393
Illinois,Lena village,2935,565,1394,254,6,183,2402
Illinois,Lemont village,16513,3758,7837,926,86,830,13437
Illinois,Lanark,1625,311,750,146,21,67,1295
Illinois,Langleyville,348,42,213,17,0,22,294
Illinois,Lansing village,28445,8656,10451,2298,504,1720,23629
Illinois,LaPlace,157,44,81,6,0,7,138
Illinois,La Prairie village,84,17,46,2,0,5,70
Illinois,La Rose village,113,39,24,12,4,15,94
Illinois,Lisbon village,368,92,141,29,2,7,271
Illinois,LaSalle,9510,2504,3355,1203,138,550,7750
Illinois,Lawrenceville,4486,524,1896,550,94,371,3435
Illinois,Leaf River village,585,134,192,71,11,49,457
Illinois,Lebanon,4259,1142,1823,305,34,274,3578
Illinois,Lee village,352,86,126,46,0,11,269
Illinois,Leland village,978,195,466,82,0,49,792
Illinois,Leland Grove,1617,244,938,112,6,84,1384
Illinois,Latham village,277,58,132,25,2,11,228
Illinois,Lisle village,22747,6327,9640,1842,131,1009,18949
Illinois,Litchfield,7004,1428,2667,923,34,474,5526
Illinois,Littleton village,175,25,89,14,2,11,141
Illinois,Loves Park,24494,5833,9762,2718,300,1126,19739
Illinois,Lovington village,1042,172,484,123,0,64,843
Illinois,Ludlow village,393,113,85,59,7,26,290
Illinois,Lyndon village,682,117,297,83,13,26,536
Illinois,Lynnville village,62,9,30,8,0,2,49
Illinois,Lynwood village,9297,2698,3143,930,301,243,7315
Illinois,Louisville village,1038,204,469,118,3,47,841
Illinois,Lyons village,10668,3240,3509,1188,56,683,8676
Illinois,McCook village,208,58,77,23,3,11,172
Illinois,McCullom Lake village,913,267,336,55,23,41,722
Illinois,Macedonia village,59,11,43,5,0,0,59
Illinois,McHenry,26739,6428,11516,2023,358,1324,21649
Illinois,Machesney Park village,23037,5733,9336,2290,245,1058,18662
Illinois,Mackinaw village,2357,512,1019,174,15,80,1800
Illinois,McClure village,376,65,148,65,5,6,289
Illinois,Lake Zurich village,19923,3831,10297,927,46,604,15705
Illinois,Lost Nation,650,103,429,11,0,49,592
Illinois,Loraine village,301,44,135,34,2,27,242
Illinois,Little York village,288,66,111,34,1,16,228
Illinois,Liverpool village,144,45,46,21,0,8,120
Illinois,Livingston village,809,145,359,90,1,71,666
Illinois,Loami village,932,176,359,111,6,21,673
Illinois,Lockport,25088,5330,10938,1765,81,964,19078
Illinois,Loda village,323,57,133,50,21,23,284
Illinois,Lostant village,396,80,170,38,3,25,316
Illinois,Lomax village,358,48,187,53,1,33,322
Illinois,London Mills village,375,90,158,50,1,12,311
Illinois,Long Creek village,1528,292,727,134,7,42,1202
Illinois,Long Grove village,8086,1784,4072,332,42,260,6490
Illinois,Long Lake,3715,870,1750,240,79,58,2997
Illinois,Long Point village,204,29,102,21,2,9,163
Illinois,Longview village,146,21,69,20,0,4,114
Illinois,Lombard village,43957,11637,18245,3784,409,2656,36731
Illinois,Broadwell village,117,27,69,6,0,3,105
Illinois,Otterville,99,10,54,14,7,0,85
Illinois,Winfield village,9492,1704,4932,872,49,292,7849
Illinois,Smithboro village,169,38,74,13,0,14,139
Illinois,Smithfield village,187,23,89,11,0,22,145
Illinois,Smithton village,3827,726,1815,246,9,253,3049
Illinois,Somonauk village,2128,440,875,159,30,145,1649
Illinois,Sorento village,527,96,177,72,25,23,393
Illinois,South Barrington village,4835,748,2971,80,43,138,3980
Illinois,South Beloit,8131,1622,3205,741,100,246,5914
Illinois,South Chicago Heights village,4152,1458,1359,240,52,240,3349
Illinois,South Elgin village,22227,4430,9689,1542,253,694,16608
Illinois,Southern View village,2010,537,588,347,31,153,1656
Illinois,South Holland village,22124,6489,7721,2081,561,1356,18208
Illinois,South Jacksonville village,3299,498,1652,375,88,154,2767
Illinois,Darmstadt,0,0,0,0,0,0,0
Illinois,South Pekin village,1175,273,444,105,13,36,871
Illinois,South Roxana village,2362,693,690,277,18,151,1829
Illinois,South Wilmington village,770,195,326,72,9,26,628
Illinois,Sparland village,395,81,172,50,12,26,341
Illinois,Sleepy Hollow village,3337,684,1701,207,11,109,2712
Illinois,Skokie village,65061,15638,29151,4237,1122,4167,54315
Illinois,Sims village,313,91,105,18,4,23,241
Illinois,Simpson village,103,18,30,4,0,5,57
Illinois,Bryant village,200,46,76,44,0,11,177
Illinois,Buckingham village,304,74,114,32,0,8,228
Illinois,Buckley village,578,128,289,60,5,40,522
Illinois,Buckner village,428,54,167,74,6,43,344
Illinois,Buda village,644,143,254,83,14,31,525
Illinois,Sheldon village,1222,295,385,170,32,60,942
Illinois,Sheridan village,2320,1379,446,240,27,57,2149
Illinois,Sherman village,4565,618,2509,208,25,271,3631
Illinois,Sparta,4371,1590,1375,532,77,319,3893
Illinois,Sherrard village,759,151,370,50,4,28,603
Illinois,Shipman,679,131,306,72,1,10,520
Illinois,Shorewood village,16354,3516,7548,1045,121,667,12897
Illinois,Shumway village,188,56,81,11,0,11,159
Illinois,Sibley village,355,57,183,19,0,17,276
Illinois,Sidell village,598,100,294,56,6,46,502
Illinois,Sidney village,1300,277,558,134,20,71,1060
Illinois,Sigel,394,83,158,32,0,22,295
Illinois,Silvis,7522,1392,2628,1004,142,463,5629
Illinois,Shiloh village,12902,2761,6189,720,37,626,10333
Illinois,Brussels village,132,35,60,11,2,10,118
Illinois,Spaulding village,773,174,385,48,10,25,642
Illinois,Spring Bay village,502,109,188,71,16,17,401
Illinois,Streamwood village,40865,9649,18111,2885,505,1529,32679
Illinois,Streator,12990,3499,4387,1455,138,1071,10550
Illinois,Stronghurst village,811,161,358,87,2,76,684
Illinois,Sublette village,413,103,187,37,0,38,365
Illinois,Sugar Grove village,9195,2003,4309,954,29,145,7440
Illinois,Davis village,790,118,356,55,12,29,570
Illinois,Davis Junction village,2532,440,1047,174,26,58,1745
Illinois,Dawson village,545,157,205,95,2,20,479
Illinois,Dayton,491,165,220,51,12,11,459
Illinois,Decatur,74654,20927,25116,8961,1200,4665,60869
Illinois,Deer Creek village,731,160,330,52,9,32,583
Illinois,Deerfield village,18588,3071,9267,1304,139,743,14524
Illinois,Deer Grove village,38,6,11,7,0,5,29
Illinois,Deer Park village,3323,572,1863,93,6,67,2601
Illinois,DeKalb,43483,21082,10557,2842,396,1202,36079
Illinois,De Land village,430,105,156,60,2,31,354
Illinois,Delavan,1625,299,790,82,18,118,1307
Illinois,Strawn village,109,24,40,16,4,4,88
Illinois,Strasburg village,550,79,282,47,0,28,436
Illinois,Stoy village,164,56,60,10,0,8,134
Illinois,Stonington village,957,216,403,71,7,44,741
Illinois,Springerton village,120,21,57,14,0,8,100
Illinois,Springfield,117061,33450,39739,13736,1669,6759,95353
Illinois,Spring Grove village,5510,1109,2847,222,25,168,4371
Illinois,Spring Valley,5405,1200,2228,428,110,395,4361
Illinois,Standard village,235,58,59,34,6,32,189
Illinois,Standard City village,214,35,80,44,1,1,161
Illinois,Stanford village,688,153,301,47,5,23,529
Illinois,Staunton,4965,936,2214,625,21,492,4288
Illinois,Spillertown village,250,62,109,12,2,13,198
Illinois,Steeleville village,2171,396,917,186,25,192,1716
Illinois,Sterling,15170,3593,5173,1830,177,1117,11890
Illinois,Steward village,338,78,138,26,0,13,255
Illinois,Stewardson village,757,133,343,104,5,27,612
Illinois,Stickney village,6804,1586,2567,564,138,469,5324
Illinois,Stillman Valley village,1048,191,514,65,11,57,838
Illinois,Stockton village,1931,482,704,272,21,137,1616
Illinois,Stonefort village,404,63,166,28,3,16,276
Illinois,Stone Park village,4947,1419,1692,268,227,165,3771
Illinois,Steger village,9563,2576,3596,825,177,509,7683
Illinois,De Pue village,1852,497,671,166,29,60,1423
Illinois,Brownstown village,777,178,317,48,11,40,594
Illinois,Browning village,103,26,35,12,0,8,81
Illinois,Campbell Hill village,304,49,126,49,7,15,246
Illinois,Camden village,114,33,51,13,0,2,99
Illinois,Timberlane village,937,123,542,25,8,10,708
Illinois,Time village,21,0,4,7,0,10,21
Illinois,Tinley Park village,57176,13551,24921,4534,341,2964,46311
Illinois,Tiskilwa village,898,174,352,109,4,54,693
Illinois,Toledo village,1309,239,506,162,0,95,1002
Illinois,Tolono village,3066,533,1271,299,52,70,2225
Illinois,Toluca,1332,335,552,101,18,125,1131
Illinois,Tonica village,771,160,356,63,3,39,621
Illinois,Topeka village,82,25,30,16,0,1,72
Illinois,Toulon,1336,302,520,133,13,134,1102
Illinois,Tovey village,483,79,216,54,11,15,375
Illinois,Towanda village,561,105,275,65,2,23,470
Illinois,Tower Hill village,508,75,260,36,2,23,396
Illinois,Tower Lakes village,1158,173,657,37,0,33,900
Illinois,Tremont village,2170,420,1017,194,38,153,1822
Illinois,Camp Point village,1150,248,516,68,23,81,936
Illinois,Campton Hills village,11012,2074,5724,464,93,252,8607
Illinois,Campus village,158,36,64,14,6,1,121
Illinois,Candlewick Lake,4486,1233,1664,349,26,263,3535
Illinois,Thornton village,2615,662,990,207,35,228,2122
Illinois,Tilden village,687,109,330,88,12,50,589
Illinois,Tilton village,2669,389,1181,381,46,210,2207
Illinois,Carterville,5691,1130,2160,757,30,240,4317
Illinois,Carrollton,2478,398,1117,263,17,250,2045
Illinois,Carrier Mills village,2081,428,823,278,29,153,1711
Illinois,Carpentersville village,38264,9709,14345,2053,489,955,27551
Illinois,Carol Stream village,40253,10049,17970,2874,594,1462,32949
Illinois,Trenton,2698,584,1201,185,4,215,2189
Illinois,Carmi,5107,788,2206,466,114,522,4096
Illinois,Carlock village,613,153,240,53,5,24,475
Illinois,Carlinville,5452,1410,1888,727,67,399,4491
Illinois,Carbon Hill village,328,75,117,34,2,19,247
Illinois,Carbondale,26192,15728,5215,1398,185,410,22936
Illinois,Carbon Cliff village,2076,430,686,257,30,140,1543
Illinois,Capron village,1846,506,611,165,30,53,1365
Illinois,Cantrall village,233,47,107,12,0,5,171
Illinois,Canton,14539,4019,4913,2221,207,876,12236
Illinois,Carlyle,3299,786,1272,387,20,190,2655
Illinois,Browns village,127,22,72,12,5,9,120
Illinois,Trout Valley village,557,135,302,23,6,24,490
Illinois,Troy Grove village,240,35,121,23,0,9,188
Illinois,Dalton City village,434,73,202,67,2,13,357
Illinois,Dalzell village,725,113,377,70,2,43,605
Illinois,Damiansville village,522,159,238,17,9,13,436
Illinois,Dana village,126,50,36,19,0,8,113
Illinois,Danforth village,577,87,211,76,5,99,478
Illinois,Danvers village,1204,261,566,66,7,31,931
Illinois,Danville,32337,9420,8834,4238,842,1951,25285
Illinois,Darien,22263,4677,10665,2017,140,1336,18835
Illinois,Goodfield village,884,210,428,21,8,22,689
Illinois,Golf village,474,73,256,3,0,15,347
Illinois,Golden Gate village,66,17,19,19,0,5,60
Illinois,Golden village,681,153,274,42,2,63,534
Illinois,Brocton village,357,52,166,34,3,22,277
Illinois,Brookfield village,18964,4499,7778,1878,183,991,15329
Illinois,Brooklyn village,836,366,72,42,34,49,563
Illinois,Brookport,883,139,371,144,8,105,767
Illinois,Broughton village,218,47,59,25,0,8,139
Illinois,Dallas City,1254,245,481,155,38,98,1017
Illinois,Dakota village,511,101,200,80,0,9,390
Illinois,Dahlgren village,375,39,170,62,0,65,336
Illinois,Cypress village,247,50,104,36,10,12,212
Illinois,Tuscola,4405,932,1858,401,29,464,3684
Illinois,Twin Grove,1789,366,1081,74,3,44,1568
Illinois,Ullin village,406,79,129,70,17,67,362
Illinois,Union village,535,110,250,17,5,29,411
Illinois,Union Hill village,85,2,38,1,0,1,42
Illinois,University Park village,6963,2715,1478,632,201,315,5341
Illinois,Urbana,41988,24528,9513,2198,421,1217,37877
Illinois,Ursa village,639,115,302,54,11,32,514
Illinois,Troy,9939,2132,4425,798,154,302,7811
Illinois,Valier village,599,114,255,102,7,38,516
Illinois,Valmeyer village,1434,289,647,83,14,28,1061
Illinois,Crossville village,691,143,276,86,15,36,556
Illinois,Crystal Lake,40635,9228,17574,3410,299,1748,32259
Illinois,Crystal Lawns,2122,355,844,313,44,130,1686
Illinois,Cuba,1561,411,534,146,9,114,1214
Illinois,Cullom village,607,141,220,60,11,47,479
Illinois,Curran village,190,34,52,31,11,23,151
Illinois,Cutler village,389,80,141,67,2,28,318
Illinois,Valley City village,3,0,0,2,0,1,3
Illinois,Carthage,2580,487,1195,276,9,200,2167
Illinois,De Soto village,1567,391,499,182,36,103,1211
Illinois,Varna village,420,67,193,30,3,42,335
Illinois,Winnetka village,12407,1969,6328,385,52,342,9076
Illinois,Winslow village,245,67,91,28,2,17,205
Illinois,Winthrop Harbor village,6849,1666,3270,527,18,229,5710
Illinois,Witt,774,99,375,75,4,45,598
Illinois,Wonder Lake village,3966,707,1827,284,0,152,2970
Illinois,Wood Dale,13923,3313,5915,1144,122,943,11437
Illinois,Woodhull village,945,169,451,78,6,46,750
Illinois,Woodland village,328,61,125,51,2,14,253
Illinois,Woodlawn village,676,99,314,65,4,28,510
Illinois,Woodridge village,33321,8563,14833,2589,310,1083,27378
Illinois,Wood River,10417,2605,3586,1430,178,699,8498
Illinois,Woodson village,417,55,190,59,13,25,342
Illinois,Woodstock,25247,6115,9624,2492,427,1083,19741
Illinois,Worden village,1250,272,497,117,28,52,966
Illinois,Worth village,10829,3390,3814,1003,282,455,8944
Illinois,Wyanet village,1122,274,423,69,5,56,827
Illinois,Wyoming,1599,268,769,142,13,102,1294
Illinois,Winnebago village,3027,546,1538,194,33,87,2398
Illinois,Forest View village,703,178,262,43,27,73,583
Illinois,Windsor,1445,219,542,95,10,135,1001
Illinois,Windsor village,988,222,370,122,18,55,787
Illinois,East Cape Girardeau village,619,107,179,111,25,52,474
Illinois,East Carondelet village,587,214,190,65,12,12,493
Illinois,East Dubuque,1812,343,792,177,7,106,1425
Illinois,White Hall,2569,574,859,395,31,241,2100
Illinois,White Heath,234,85,90,28,0,10,213
Illinois,Williamsfield village,540,140,233,42,0,42,457
Illinois,Williamson village,212,27,105,24,2,11,169
Illinois,Williamsville village,1526,312,756,88,10,35,1201
Illinois,Xenia village,493,103,183,62,5,37,390
Illinois,Willisville village,448,100,150,69,0,47,366
Illinois,Willowbrook,2044,567,983,159,67,108,1884
Illinois,Willow Hill village,233,49,87,41,7,14,198
Illinois,Willow Springs village,5676,1231,2690,496,39,315,4771
Illinois,Wilmette village,27420,4494,13636,1395,177,1128,20830
Illinois,Wilmington village,128,25,57,13,0,4,99
Illinois,Wilmington,5776,1542,1829,615,81,455,4522
Illinois,Wilsonville village,563,144,239,69,3,29,484
Illinois,Winchester,1569,314,568,247,22,114,1265
Illinois,Willowbrook village,8629,2154,3864,778,192,521,7509
Illinois,East Brooklyn village,142,39,63,20,1,8,131
Illinois,Yale village,80,7,40,5,1,7,60
Illinois,Yorkville,18222,3524,7827,1046,65,457,12919
Illinois,Burnham village,4224,1874,860,405,84,225,3448
Illinois,Burnt Prairie village,66,5,47,5,0,1,58
Illinois,Burr Ridge village,10753,1854,5674,767,53,721,9069
Illinois,Bush village,265,44,123,45,2,13,227
Illinois,Bushnell,3022,785,1117,282,81,203,2468
Illinois,Butler village,130,20,61,7,5,6,99
Illinois,Byron,3672,583,1723,288,10,183,2787
Illinois,Cabery village,326,119,108,22,6,13,268
Illinois,Cahokia village,14740,5427,3187,1562,372,774,11322
Illinois,Cairo,2758,853,558,292,197,257,2157
Illinois,Caledonia village,219,39,95,25,4,6,169
Illinois,Calhoun village,204,16,92,62,2,9,181
Illinois,Calumet City,37184,12924,9134,3919,1027,2377,29381
Illinois,Calumet Park village,8367,3541,2096,834,124,377,6972
Illinois,Camargo village,550,106,206,70,16,28,426
Illinois,Cambria village,1380,396,451,164,39,47,1097
Illinois,Cambridge village,2126,399,1051,158,24,85,1717
Illinois,Burlington village,659,163,303,44,15,12,537
Illinois,Bureau Junction village,242,65,83,31,7,11,197
Illinois,Burbank,29157,7465,12058,1848,141,1797,23309
Illinois,Bunker Hill,1719,425,693,246,29,106,1499
Illinois,Zeigler,1804,448,620,169,54,129,1420
Illinois,Zion,24251,7647,7554,1872,385,985,18443
Illinois,Forest Park village,14194,5211,4777,1607,376,465,12436
Illinois,Forest Lake,1719,295,933,131,18,27,1404
Illinois,Forest City village,222,52,104,17,3,7,183
Illinois,Ford Heights village,2780,1373,431,260,56,86,2206
Illinois,Foosland village,115,29,35,4,5,3,76
Illinois,Flossmoor village,9492,2273,4192,759,80,526,7830
Illinois,Yates City village,813,148,385,49,2,52,636
Illinois,Florence village,40,16,6,8,0,6,36
Illinois,Flora,5027,1052,1702,784,4,328,3870
Illinois,Flat Rock village,347,73,141,31,0,40,285
Illinois,Flanagan village,1138,193,452,107,5,165,922
Illinois,Fithian village,504,127,235,47,2,20,431
Illinois,Buffalo Grove village,41591,7531,21331,3010,268,1748,33888
Illinois,Bull Valley village,1085,144,664,59,4,23,894
Illinois,Bulpitt village,262,40,86,39,0,20,185
Illinois,Buncombe village,203,43,73,24,4,12,156
Illinois,Floraville,0,0,0,0,0,0,0
Illinois,Vandalia,6550,2547,1924,768,163,352,5754
Illinois,East Alton village,6215,1323,2345,1202,126,412,5408
Illinois,Eagarville village,169,25,76,18,6,7,132
Illinois,Gifford village,861,144,407,60,6,71,688
Illinois,Gibson City,3542,656,1435,380,25,255,2751
Illinois,German Valley village,440,80,248,15,3,21,367
Illinois,Germantown Hills village,3480,535,1758,176,24,88,2581
Illinois,Germantown village,1112,286,487,51,5,68,897
Illinois,Georgetown,3413,842,1192,465,57,200,2756
Illinois,Georgetown,477,75,198,77,0,52,402
Illinois,Genoa,5233,1270,1809,565,64,220,3928
Illinois,Geneva,21704,4434,10822,1426,155,719,17556
Illinois,Geneseo,6523,1125,2995,476,84,481,5161
Illinois,Gays village,288,75,137,25,0,10,247
Illinois,Garrett village,108,21,50,15,1,12,99
Illinois,Gardner village,1211,246,524,134,5,59,968
Illinois,Garden Prairie,198,40,94,34,0,16,184
Illinois,Galva,2543,516,1163,273,14,167,2133
Illinois,Galesburg,31696,10151,9402,4255,481,2313,26602
Illinois,Galena,3345,816,1440,369,18,261,2904
Illinois,Gilberts village,7338,1232,3478,306,0,262,5278
Illinois,Gillespie,3310,796,1328,307,59,157,2647
Illinois,Gilman,1680,365,660,161,25,149,1360
Illinois,Gilson,132,20,59,45,0,0,124
Illinois,Venedy village,125,19,68,4,0,5,96
Illinois,Venetian Village,2709,724,1127,265,55,120,2291
Illinois,Venice,1963,849,260,191,78,203,1581
Illinois,Vergennes village,269,52,100,20,1,28,201
Illinois,Vermilion village,235,30,104,21,0,13,168
Illinois,Golconda,770,262,205,136,28,66,697
Illinois,Godley village,752,217,230,80,24,29,580
Illinois,Godfrey village,17868,3736,8428,1661,169,956,14950
Illinois,Galatia village,941,166,374,136,8,94,778
Illinois,Glenwood village,8923,2587,3134,933,116,488,7258
Illinois,Glen Ellyn village,27890,5661,13324,1669,223,1199,22076
Illinois,Glendale Heights village,34497,9282,14087,2293,428,982,27072
Illinois,Glencoe village,8881,1215,4707,388,45,242,6597
Illinois,Glen Carbon village,12882,2718,5640,750,244,690,10042
Illinois,Glasgow village,126,33,56,20,2,8,119
Illinois,Glasford village,1201,269,503,157,0,35,964
Illinois,Gladstone village,221,46,86,33,2,23,190
Illinois,Girard,1805,314,613,250,41,173,1391
Illinois,Glenview village,45969,8560,22521,2504,141,3304,37030
Illinois,Earlville,1847,415,769,231,22,142,1579
Illinois,Gages Lake,10025,2285,4643,839,132,181,8080
Illinois,Fulton,3467,580,1785,337,36,213,2951
Illinois,Dixon,15196,4563,5179,1574,355,1007,12678
Illinois,Dolton village,23283,9164,5950,1992,673,1087,18866
Illinois,Dongola village,913,213,330,54,37,32,666
Illinois,Donnellson village,140,25,41,31,7,18,122
Illinois,Donovan village,281,68,102,27,0,19,216
Illinois,Dorchester village,157,16,85,19,4,6,130
Illinois,Dover village,146,20,62,13,0,7,102
Illinois,Dowell village,328,65,122,43,0,28,258
Illinois,Downers Grove village,49504,11473,22967,3260,353,2223,40276
Illinois,Downs village,972,152,413,103,13,45,726
Illinois,Du Bois village,150,39,79,13,3,3,137
Illinois,Dunfermline village,273,54,84,55,1,16,210
Illinois,Dunlap village,1478,284,711,69,0,31,1095
Illinois,Dupo village,4006,997,1556,446,37,145,3181
Illinois,Du Quoin,6002,1593,1777,936,145,598,5049
Illinois,Durand village,1201,294,497,129,8,124,1052
Illinois,Dwight village,4192,866,1824,393,48,270,3401
Illinois,Dixmoor village,3626,1306,802,291,41,106,2546
Illinois,Dix village,464,100,147,64,9,51,371
Illinois,Divernon village,1292,284,474,175,27,84,1044
Illinois,Dieterich village,679,133,299,45,5,31,513
Illinois,Freeport,24973,6160,8824,2892,472,1820,20168
Illinois,Freeman Spur village,200,62,82,19,5,7,175
Illinois,Freeburg village,4226,937,1796,457,18,261,3469
Illinois,Franklin Park village,18410,5331,7365,1556,213,890,15355
Illinois,Franklin Grove village,1185,208,505,70,10,112,905
Illinois,Franklin village,505,94,222,64,5,11,396
Illinois,Frankfort Square,9258,2226,4305,552,84,217,7384
Illinois,Frankfort village,18295,3480,9191,620,82,704,14077
Illinois,Fults village,18,4,13,0,0,0,17
Illinois,Fox River Grove village,4739,1424,1946,338,0,101,3809
Illinois,Fox Lake village,10539,2574,4073,1269,201,718,8835
Illinois,Forsyth village,3493,533,1915,216,7,127,2798
Illinois,Forreston village,1707,336,672,202,14,110,1334
Illinois,Forrest village,1193,235,538,52,10,93,928
Illinois,Des Plaines,58930,13995,26203,4343,670,3633,48844
Illinois,Detroit village,110,43,41,4,0,2,90
Illinois,De Witt village,224,57,80,39,9,12,197
Illinois,Diamond village,2612,604,990,194,41,83,1912
Illinois,Fox Lake Hills,2190,529,927,349,0,98,1903
Illinois,Cary village,18038,3578,9031,1161,44,442,14256
Illinois,Buffalo village,537,82,236,73,0,39,430
Illinois,Caseyville village,4103,1273,1382,352,60,329,3396
Illinois,Ferris village,143,36,61,12,0,10,119
Illinois,Fidelity village,133,28,49,13,4,3,97
Illinois,Fieldon village,198,31,113,21,1,9,175
Illinois,Fillmore village,262,35,137,17,2,19,210
Illinois,Findlay village,718,146,314,73,9,43,585
Illinois,Fisher village,1860,363,809,114,40,122,1448
Illinois,Fayetteville village,408,83,163,55,5,28,334
Illinois,Casey,2546,450,961,351,40,342,2144
Illinois,Waggoner village,166,33,51,20,8,5,117
Illinois,Walnut village,1554,235,695,128,16,91,1165
Illinois,Walnut Hill village,91,24,27,16,2,7,76
Illinois,Walshville village,41,10,24,4,0,0,38
Illinois,Waltonville village,434,83,139,72,5,28,327
Illinois,Wamac,1351,345,350,216,44,88,1043
Illinois,Wadsworth village,3700,1021,1844,140,50,211,3266
Illinois,Farmington,2455,526,1052,180,12,130,1900
Illinois,Farmersville village,569,112,283,53,0,26,474
Illinois,Farmer City,1947,391,838,282,15,139,1665
Illinois,Villa Grove,2166,365,913,243,70,184,1775
Illinois,Villa Park village,21800,5863,9098,1367,136,786,17250
Illinois,Viola village,897,182,441,49,20,73,765
Illinois,Virden,3539,840,1326,399,23,252,2840
Illinois,Virgil village,339,78,160,12,1,7,258
Illinois,Virginia,1322,240,595,183,9,112,1139
Illinois,Volo village,3757,619,1626,291,57,146,2739
Illinois,Fairbury,3722,738,1458,532,0,301,3029
Illinois,Fairfield,4882,890,2012,603,75,485,4065
Illinois,Fairmont,2322,815,654,229,60,136,1894
Illinois,Fairmont City village,2498,842,639,173,54,145,1853
Illinois,Fairmount village,671,117,330,52,15,50,564
Illinois,Fairview village,515,94,261,26,0,24,405
Illinois,Fairview Heights,17014,4247,7166,1637,489,914,14453
Illinois,Farina village,576,98,253,70,0,22,443
Illinois,Wapella village,565,122,259,55,13,39,488
Illinois,Warren village,1510,311,675,156,12,126,1280
Illinois,Warrensburg village,1217,325,487,129,12,31,984
Illinois,Warrenville,13373,3348,5856,1093,194,430,10921
Illinois,Wenona,1165,300,419,149,3,81,952
Illinois,Wenonah village,45,1,29,2,0,0,32
Illinois,West Brooklyn village,124,23,56,18,5,5,107
Illinois,Westchester village,16783,3920,7456,1279,111,1142,13908
Illinois,West Chicago,27461,7090,10986,1369,296,712,20453
Illinois,West City village,709,129,223,139,21,62,574
Illinois,West Dundee village,7391,1519,3525,546,114,224,5928
Illinois,Western Springs village,13125,1970,6860,431,36,495,9792
Illinois,Westervelt,107,25,13,17,0,11,66
Illinois,Westfield village,742,129,344,90,17,25,605
Illinois,West Frankfort,7720,1581,2677,1162,113,761,6294
Illinois,Westmont village,25389,7033,10192,2161,287,1527,21200
Illinois,West Peoria,4445,1120,1567,737,24,359,3807
Illinois,West Point village,224,49,84,18,0,2,153
Illinois,West Salem village,923,191,406,68,21,67,753
Illinois,Wellington village,268,50,121,21,2,20,214
Illinois,Vienna,1450,316,483,226,43,150,1218
Illinois,Weldon village,461,66,191,59,2,32,350
Illinois,Wayne City village,1138,215,488,122,6,63,894
Illinois,Warsaw,1538,252,821,135,13,65,1286
Illinois,Washburn village,1028,247,380,89,3,48,767
Illinois,Washington,15824,2464,7786,929,76,696,11951
Illinois,Washington Park village,4072,1766,880,398,161,161,3366
Illinois,Chapin village,479,73,197,70,2,34,376
Illinois,Ewing village,265,54,111,29,3,15,212
Illinois,Wataga village,725,132,356,74,5,31,598
Illinois,Waterloo,10151,1901,4990,795,126,434,8246
Illinois,Waterman village,1539,392,653,109,12,52,1218
Illinois,Watseka,5426,1074,2242,662,35,508,4521
Illinois,Watson village,714,185,291,73,18,15,582
Illinois,Wauconda village,13140,2755,5519,1300,118,555,10247
Illinois,Waukegan,88570,27426,28785,6660,1975,2665,67511
Illinois,Waverly,1201,236,526,112,18,81,973
Illinois,Wayne village,2318,549,1314,141,0,55,2059
Illinois,Waynesville village,544,112,288,33,5,40,478
Illinois,West Union,354,44,198,6,8,27,283
Illinois,Victoria village,311,81,151,26,6,7,271
Illinois,Verona village,240,67,81,19,6,10,183
Illinois,Cicero,84361,26345,26020,4288,2492,2090,61235
Illinois,Cisco village,251,47,108,30,1,9,195
Illinois,Cisne village,646,117,264,83,14,60,538
Illinois,Cissna Park village,834,141,382,53,0,117,693
Illinois,Claremont village,244,28,121,18,2,12,181
Illinois,Clarendon Hills village,8609,1732,3791,399,122,348,6392
Illinois,Christopher,2876,542,1143,371,36,237,2329
Illinois,Clay City village,898,167,311,173,6,71,728
Illinois,Clear Lake village,240,49,102,40,0,14,205
Illinois,Cleveland village,175,29,67,23,4,12,135
Illinois,Clifton village,1581,369,664,108,17,67,1225
Illinois,Clinton,6987,1555,2726,836,82,417,5616
Illinois,Coal City village,5724,1317,2389,387,54,329,4476
Illinois,Coalton village,283,40,140,22,6,23,231
Illinois,Clayton village,613,138,235,98,5,35,511
Illinois,Chrisman,1346,228,642,119,8,151,1148
Illinois,Chillicothe,6092,1240,2491,767,0,407,4905
Illinois,Chicago Ridge village,14407,3813,4833,1381,211,568,10806
Illinois,Evergreen Park village,19934,5635,7453,1570,236,1202,16096
Illinois,Evansville village,671,158,278,79,2,26,543
Illinois,Evanston,75603,26914,26268,5450,995,3170,62797
Illinois,Chatham village,12341,2023,5849,906,284,213,9275
Illinois,Chatsworth,1012,213,384,115,8,74,794
Illinois,Chebanse village,1129,200,486,114,2,38,840
Illinois,Chemung,294,80,76,16,0,19,191
Illinois,Chenoa,1763,385,778,166,12,96,1437
Illinois,Cherry village,446,100,174,67,3,19,363
Illinois,Cherry Valley village,2913,604,1455,255,36,205,2555
Illinois,Chester,8592,3334,2369,891,183,488,7265
Illinois,Chesterfield village,238,42,116,21,2,8,189
Illinois,Chestnut,169,6,89,18,0,5,118
Illinois,Chicago,2717534,1078741,770209,188533,55288,117247,2210018
Illinois,Chicago Heights,30428,11094,8632,1870,599,1742,23937
Illinois,Coal Valley village,3784,682,1923,392,0,117,3114
Illinois,Coatsburg village,164,22,86,17,2,12,139
Illinois,Cobden village,1425,461,443,176,16,71,1167
Illinois,Coffeen,405,58,184,59,1,19,321
Illinois,Countryside,5984,1568,2152,815,88,367,4990
Illinois,Cowden village,547,139,171,105,17,49,481
Illinois,Coyne Center,953,220,439,101,0,52,812
Illinois,Crab Orchard,293,40,147,43,0,10,240
Illinois,Crainville village,1287,242,575,140,16,75,1048
Illinois,Creal Springs,446,65,251,50,4,18,388
Illinois,Crescent City village,728,171,310,81,8,16,586
Illinois,Crest Hill,20479,6514,6878,2053,473,1137,17055
Illinois,Creston village,740,227,251,81,15,37,611
Illinois,Crestwood village,11027,3273,3570,1130,143,1196,9312
Illinois,Crete village,8246,1860,3602,711,218,433,6824
Illinois,Creve Coeur village,5652,1418,2166,845,147,196,4772
Illinois,Vermont village,674,169,248,74,7,55,553
Illinois,Vernon village,104,12,49,3,4,6,74
Illinois,Vernon Hills village,25768,5215,12111,1750,197,1027,20300
Illinois,Country Club Hills,16806,5754,4731,1917,294,844,13540
Illinois,Versailles village,489,62,260,41,6,22,391
Illinois,Coulterville village,969,233,275,130,17,107,762
Illinois,Cornland,50,0,34,7,0,9,50
Illinois,Colchester,1539,365,536,230,48,89,1268
Illinois,Coleta village,212,19,70,26,2,11,128
Illinois,Colfax village,1101,188,511,95,20,80,894
Illinois,Collinsville,25025,6715,9968,2370,316,1091,20460
Illinois,Colona,4918,1066,2200,557,46,155,4024
Illinois,Colp village,253,51,91,20,5,5,172
Illinois,Columbia,10029,2044,4624,976,28,600,8272
Illinois,Columbus village,80,24,22,18,2,4,70
Illinois,Como,405,61,253,11,0,46,371
Illinois,Compton village,266,60,120,21,9,4,214
Illinois,Concord village,186,26,86,18,2,4,136
Illinois,Congerville village,483,69,246,25,0,15,355
Illinois,Cooksville village,194,43,72,26,0,18,159
Illinois,Cordova village,624,117,315,78,0,47,557
Illinois,Cornell village,353,77,155,59,4,8,303
Illinois,Cortland,4323,1120,1597,259,81,62,3119
Illinois,Westville village,3355,805,1075,514,14,207,2615
Illinois,Exeter village,105,20,34,22,0,6,82
Illinois,Wheaton,53585,13905,24079,3386,337,1923,43630
Illinois,Edinburg village,1097,203,447,190,8,63,911
Illinois,Edgewood village,507,108,229,37,2,32,408
Illinois,Eddyville village,63,21,14,2,3,12,52
Illinois,East St. Louis,26689,11273,3721,2662,816,1691,20163
Illinois,East Peoria,23137,4971,9748,2852,336,1482,19389
Illinois,Easton village,347,67,159,38,0,20,284
Illinois,Edwardsville,24896,8392,9108,1805,155,913,20373
Illinois,East Moline,21422,5481,7459,2289,320,1527,17076
Illinois,Harvey,25773,11699,4914,1806,641,1518,20578
Illinois,Harwood Heights village,8649,2007,3713,902,191,692,7505
Illinois,Havana,3395,652,1403,284,143,273,2755
Illinois,Hawthorn Woods village,7634,1174,4456,253,8,181,6072
Illinois,Hazel Crest village,14195,4929,3993,1131,472,938,11463
Illinois,Hebron village,1237,333,477,96,12,54,972
Illinois,Harvel village,182,55,68,17,2,15,157
Illinois,Effingham,12513,2855,4463,1497,39,1024,9878
Illinois,Elburn village,5785,902,2723,480,40,147,4292
Illinois,El Dara village,123,2,110,3,0,0,115
Illinois,Hanna City village,1361,279,621,115,16,79,1110
Illinois,Hanover village,711,188,301,79,23,55,646
Illinois,Hanover Park village,38373,9404,16795,1736,431,973,29339
Illinois,Hardin village,944,168,439,78,18,76,779
Illinois,Harmon village,122,17,62,13,0,9,101
Illinois,Harrisburg,9247,2222,2796,1446,270,835,7569
Illinois,Harrison,957,201,353,66,19,88,727
Illinois,Harristown village,1330,242,710,123,16,42,1133
Illinois,Hartford village,1654,389,558,223,48,108,1326
Illinois,Hartsburg village,243,63,95,27,2,21,208
Illinois,Harvard,9802,2044,3811,516,23,358,6752
Illinois,Elizabeth village,744,231,231,106,14,58,640
Illinois,Elgin,112105,29104,43022,7391,1558,4418,85493
Illinois,Eldred village,207,39,63,31,4,47,184
Illinois,Eldorado,4103,1041,1451,423,74,334,3323
Illinois,Hecker village,467,72,213,19,4,22,330
Illinois,Henderson village,237,39,109,32,18,9,207
Illinois,Hennepin village,905,119,470,76,3,48,716
Illinois,Henning village,354,65,206,7,5,4,287
Illinois,Tamms village,827,373,182,75,36,40,706
Illinois,Tamaroa village,494,108,174,71,0,34,387
Illinois,Tallula village,445,76,198,36,7,23,340
Illinois,Table Grove village,365,53,169,35,0,28,285
Illinois,Symerton village,107,21,36,11,1,8,77
Illinois,Sycamore,17572,4915,6520,2018,89,865,14407
Illinois,Swansea village,13869,3131,5745,1232,154,731,10993
Illinois,Sun River Terrace village,450,134,72,73,21,49,349
Illinois,Sumner,5988,3867,962,600,275,127,5831
Illinois,Summit village,11447,3459,3815,837,116,384,8611
Illinois,Summerfield village,581,150,211,88,18,34,501
Illinois,Sullivan,4600,1001,1713,706,26,417,3863
Illinois,Charleston,21552,10959,5633,1519,178,946,19235
Illinois,East Dundee village,3074,660,1345,390,43,227,2665
Illinois,East Galesburg village,801,154,390,86,0,29,659
Illinois,Tampico village,684,182,254,47,7,59,549
Illinois,Hanaford village,297,47,118,56,0,48,269
Illinois,Taylor Springs village,556,76,224,82,0,82,464
Illinois,Tennessee village,131,20,48,35,8,4,115
Illinois,Henry,2343,494,1003,218,28,220,1963
Illinois,Heritage Lake,1354,220,655,97,20,15,1007
Illinois,East Hazel Crest village,1611,638,445,125,39,91,1338
Illinois,Herrick village,440,103,160,48,3,22,336
Illinois,Herrin,12797,2687,4813,1472,257,943,10172
Illinois,Thomson village,736,174,332,48,5,41,600
Illinois,Thompsonville village,735,122,272,90,11,40,535
Illinois,Thomasboro village,1230,250,498,194,24,50,1016
Illinois,Third Lake village,1246,221,735,27,7,19,1009
Illinois,The Galena Territory,996,82,804,49,12,37,984
Illinois,Thebes village,372,69,100,29,4,15,217
Illinois,Thayer village,726,257,261,89,14,23,644
Illinois,Thawville village,192,22,70,35,3,14,144
Illinois,West York,152,17,93,0,0,0,110
Illinois,Teutopolis village,1793,388,858,62,13,64,1385
Illinois,Taylorville,11068,2398,4489,1427,119,691,9124
Illinois,East Gillespie village,256,40,139,16,0,20,215
Illinois,Hampton village,1942,322,957,173,18,114,1584
Illinois,Elizabethtown village,256,42,93,44,10,25,214
Illinois,El Paso,2694,625,984,239,39,207,2094
Illinois,Elmwood Park village,24971,6680,9830,2342,290,1663,20805
Illinois,Elmwood,2253,412,1049,131,28,107,1727
Illinois,Elmhurst,45469,9865,20421,2630,339,2281,35536
Illinois,Ellsworth village,259,89,100,19,9,11,228
Illinois,Ellisville village,106,26,36,13,0,4,79
Illinois,Elsah village,739,607,59,38,0,10,714
Illinois,Ellis Grove village,439,78,167,42,10,56,353
Illinois,Elkville village,1047,238,415,115,5,53,826
Illinois,Elkhart village,346,40,163,25,1,26,255
Illinois,Catlin village,1981,360,898,174,4,60,1496
Illinois,Cave-In-Rock village,365,103,97,67,4,26,297
Illinois,Cedar Point village,322,70,129,30,0,19,248
Illinois,Cedarville village,633,120,328,68,0,36,552
Illinois,Elliott village,239,41,120,32,3,14,210
Illinois,Elvaston village,119,13,41,31,5,7,97
Illinois,Elwood village,2130,348,944,205,15,139,1651
Illinois,Emden village,348,43,173,22,4,36,278
Illinois,Wheeler village,118,26,26,29,7,12,100
Illinois,Wheeling village,37982,8532,16350,3149,640,1727,30398
Illinois,Whiteash,341,56,165,30,3,6,260
Illinois,White City village,189,34,84,25,4,17,164
Illinois,Channel Lake,1505,429,543,217,59,95,1343
Illinois,Channahon village,12845,2596,6155,691,75,293,9810
Illinois,Chandlerville village,621,121,258,43,12,38,472
Illinois,Champaign,84008,38088,24503,5961,1182,2210,71944
Illinois,Eureka,5704,1264,2422,443,37,549,4715
Illinois,Essex village,858,156,430,26,3,18,633
Illinois,Erie village,1507,310,674,126,13,84,1207
Illinois,Equality village,551,148,219,45,0,62,474
Illinois,Enfield village,628,158,273,48,7,42,528
Illinois,Energy village,1215,208,567,145,4,74,998
Illinois,Emington village,87,20,28,11,2,5,66
Illinois,Central City village,1047,169,379,147,3,78,776
Illinois,Hampshire village,5851,927,2795,420,0,179,4321
Illinois,Centralia,12798,2988,4372,1842,211,1001,10414
Illinois,Cerro Gordo village,1348,269,597,114,5,88,1073
Illinois,Green Oaks village,3850,717,2039,104,13,75,2948
Illinois,Greenup village,1769,368,618,277,23,138,1424
Illinois,Green Valley village,733,136,364,46,6,48,600
Illinois,Greenview village,860,186,354,111,11,51,713
Illinois,Greenville,6842,2522,1867,722,146,450,5707
Illinois,Greenwood village,400,91,194,18,0,7,310
Illinois,Gridley village,1356,225,698,107,3,90,1123
Illinois,Griggsville,1161,133,504,92,0,96,825
Illinois,Gulf Port village,19,4,14,1,0,0,19
Illinois,Gurnee village,31136,7120,13781,2510,255,1202,24868
Illinois,Hainesville village,3690,705,1615,276,26,60,2682
Illinois,Hamburg village,77,15,39,5,3,6,68
Illinois,Hamel village,886,126,416,76,6,28,652
Illinois,Hamilton,2918,410,1343,406,59,144,2362
Illinois,Hammond village,446,75,198,64,6,12,355
Illinois,Greenfield,1412,352,463,133,23,146,1117
Illinois,Centreville,5142,2106,720,559,205,415,4005
Illinois,Grayville,1630,311,726,187,10,120,1354
Illinois,Granville village,1380,301,539,158,8,92,1098
Illinois,Chadwick village,481,72,258,53,6,33,422
Illinois,Good Hope village,387,65,206,38,10,19,338
Illinois,Goofy Ridge,167,80,39,17,3,15,154
Illinois,Goreville village,1206,210,401,162,9,94,876
Illinois,Gorham village,173,41,55,28,5,15,144
Illinois,Grafton,616,119,281,81,7,45,533
Illinois,Grayslake village,21117,5024,8977,1602,263,739,16605
Illinois,Grand Detour,548,78,294,63,0,36,471
Illinois,Grand Tower,451,91,165,100,17,31,404
Illinois,Grandview village,1406,382,412,167,27,95,1083
Illinois,Grandwood Park,5757,1134,2595,343,57,145,4274
Illinois,Granite City,29421,7358,10656,3782,452,1831,24079
Illinois,Grantfork village,337,57,180,16,2,9,264
Illinois,Elk Grove Village village,33333,7275,14806,3513,514,1675,27783
Illinois,Grant Park village,1270,300,596,85,29,48,1058
Illinois,Grand Ridge village,538,121,221,38,7,33,420
Indiana,Westphalia,79,25,16,30,8,0,79
Indiana,Austin,4235,1144,1535,444,122,287,3532
Indiana,Leo-Cedarville,3785,694,1781,235,11,58,2779
Indiana,Avoca,710,140,289,31,0,19,479
Indiana,Wynnedale,162,31,84,21,0,15,151
Indiana,Yeoman,137,23,54,13,0,7,97
Indiana,Yorktown,11268,1876,5268,1057,115,613,8929
Indiana,Zanesville,639,111,305,56,9,13,494
Indiana,Zionsville,25072,3881,12409,1410,104,775,18579
Indiana,Marion,29075,8990,8267,4187,441,2219,24104
Indiana,Marengo,852,130,277,173,13,76,669
Indiana,Manilla,240,71,121,16,0,32,240
Indiana,Madison,12054,2955,4561,1960,165,811,10452
Indiana,Macy,269,57,92,14,9,5,177
Indiana,Worthington,1214,236,496,193,26,84,1035
Indiana,Mackey,92,25,27,17,0,9,78
Indiana,Lyons,784,143,330,119,10,59,661
Indiana,Lynnville,936,139,403,87,12,60,701
Indiana,Lynn,1113,170,534,97,12,90,903
Indiana,Crawfordsville,15982,4220,5113,2175,307,1079,12894
Indiana,Cromwell,478,75,179,59,7,26,346
Indiana,Crothersville,1574,348,644,256,17,89,1354
Indiana,Crown Point,28444,6503,12369,2483,342,2076,23773
Indiana,Crows Nest,113,43,50,2,0,8,103
Indiana,Culver,1444,282,584,179,39,130,1214
Indiana,Cumberland,5316,1422,2124,568,160,61,4335
Indiana,McCordsville,5224,1294,2278,671,0,52,4295
Indiana,Cynthiana,561,100,271,75,9,15,470
Indiana,Woodlawn Heights,63,5,41,3,0,6,55
Indiana,Wolcottville,1009,197,392,121,2,29,741
Indiana,West Point,566,168,195,47,0,0,410
Indiana,Westport,1403,198,614,171,23,90,1096
Indiana,West Terre Haute,2505,635,798,309,31,128,1901
Indiana,Westville,7065,3491,1324,1396,189,97,6497
Indiana,Wheatfield,990,278,347,117,8,43,793
Indiana,Wheatland,455,85,188,60,0,17,350
Indiana,Wheeler,347,83,103,90,0,17,293
Indiana,Whiteland,4732,835,2080,530,27,117,3589
Indiana,Whitestown,4864,739,2208,384,45,53,3429
Indiana,Whitewater,80,5,28,15,3,4,55
Indiana,Woodburn,1549,334,670,119,18,67,1208
Indiana,Whiting,4905,1673,1522,394,102,261,3952
Indiana,Williams,322,62,210,50,0,0,322
Indiana,Williams Creek,396,52,223,9,4,5,293
Indiana,Williamsport,1842,364,842,198,11,190,1605
Indiana,Winamac,2623,642,1105,275,44,161,2227
Indiana,Winchester,4822,1044,1913,509,63,459,3988
Indiana,Windfall City,856,162,351,94,7,58,672
Indiana,Winfield,5054,952,2278,173,19,362,3784
Indiana,Wingate,257,55,95,47,5,13,215
Indiana,Winona Lake,4935,1476,2111,333,77,235,4232
Indiana,Wolcott,1055,178,436,126,8,59,807
Indiana,Wilkinson,474,109,194,59,5,16,383
Indiana,Avilla,2193,466,809,328,22,171,1796
Indiana,Dale,1789,337,725,220,4,155,1441
Indiana,Dana,546,109,259,62,2,44,476
Indiana,Leesburg,589,63,351,28,0,26,468
Indiana,Lebanon,15762,3068,6259,2330,163,976,12796
Indiana,Leavenworth,283,66,74,44,9,58,251
Indiana,Lawrenceburg,4996,1371,1348,1003,124,344,4190
Indiana,Dublin,752,160,346,97,2,53,658
Indiana,Dubois,409,84,168,6,28,35,321
Indiana,Dugger,799,199,345,79,7,42,672
Indiana,Dune Acres,188,27,127,14,1,11,180
Indiana,Dunkirk,2446,494,849,405,60,115,1923
Indiana,Dunlap,6220,1234,2957,388,107,306,4992
Indiana,Lewisville,382,73,158,39,15,35,320
Indiana,Dunreith,208,45,69,23,7,9,153
Indiana,Dyer,16257,3791,7750,1056,135,947,13679
Indiana,Earl Park,407,95,142,67,6,24,334
Indiana,East Chicago,29178,10259,6839,2359,716,1538,21711
Indiana,Bedford,13371,2369,5048,2265,123,1017,10822
Indiana,Battle Ground,1085,223,553,91,2,48,917
Indiana,Batesville,6398,1105,2964,442,60,521,5092
Indiana,Bass Lake,1330,241,527,212,13,87,1080
Indiana,Bargersville,6492,687,3194,517,63,272,4733
Indiana,Bainbridge,841,192,378,79,7,23,679
Indiana,Avon,15145,2939,5975,1684,125,382,11105
Indiana,Dupont,276,56,114,28,12,7,217
Indiana,Daleville,1588,389,609,197,15,89,1299
Indiana,Liberty,2074,414,831,276,6,106,1633
Indiana,Linden,783,113,300,105,7,37,562
Indiana,Danville,9379,1493,3931,1087,135,593,7239
Indiana,Darlington,750,183,271,110,17,35,616
Indiana,Darmstadt,1471,260,824,113,4,74,1275
Indiana,Dayton,1500,279,608,182,3,41,1113
Indiana,Decatur,9084,1878,3554,1107,43,721,7303
Indiana,Decker,257,52,122,32,0,4,210
Indiana,Delphi,2874,668,1020,395,24,208,2315
Indiana,De Motte,3944,882,1497,438,23,282,3122
Indiana,Denver,506,122,202,69,17,18,428
Indiana,Deputy,17,0,0,9,0,8,17
Indiana,Ligonier,4361,1183,1579,456,44,125,3387
Indiana,Dillsboro,1634,266,599,163,4,191,1223
Indiana,Dresser,24,6,0,18,0,0,24
Indiana,Lowell,9400,2527,3853,667,90,329,7466
Indiana,Losantville,223,53,73,43,11,21,201
Indiana,Loogootee,2701,574,770,630,37,182,2193
Indiana,Long Beach,1127,119,721,74,6,112,1032
Indiana,Logansport,17716,4643,5956,1986,315,1095,13995
Indiana,Lizton,519,143,177,71,2,12,405
Indiana,Livonia,132,19,58,9,1,6,93
Indiana,Little York,159,21,73,20,4,5,123
Indiana,Linton,5340,1011,1988,734,34,520,4287
Indiana,Dover Hill,141,0,61,35,0,12,108
Indiana,Winslow,1087,264,354,165,3,38,824
Indiana,Norway,492,147,192,42,11,10,402
Indiana,Reynolds,562,116,250,67,2,22,457
Indiana,Laconia,77,2,51,15,0,2,70
Indiana,La Crosse,582,101,259,64,11,21,456
Indiana,Ladoga,1057,171,444,102,6,37,760
Indiana,Lafayette,70661,20261,24001,8518,889,2986,56655
Indiana,La Fontaine,727,122,291,95,16,105,629
Indiana,Lagrange,2723,514,931,406,57,241,2149
Indiana,Lagro,548,96,201,58,11,27,393
Indiana,Lake Dalecarlia,1373,344,505,209,6,24,1088
Indiana,Lake Holiday,879,158,472,61,12,68,771
Indiana,Lake Santee,858,60,547,43,14,29,693
Indiana,Lakes of the Four Seasons,6692,1270,3632,517,14,244,5677
Indiana,Lake Station,12268,2758,4371,1231,304,598,9262
Indiana,Laketon,444,66,200,54,0,19,339
Indiana,Lake Village,667,126,281,193,0,45,645
Indiana,Lakeville,831,176,336,107,4,46,669
Indiana,Landess,299,39,151,60,0,8,258
Indiana,Lanesville,604,147,239,81,11,27,505
Indiana,La Paz,639,120,276,53,0,12,461
Indiana,Lapel,1833,329,818,247,37,142,1573
Indiana,La Porte,22242,5313,7940,2800,245,1294,17592
Indiana,Larwill,333,62,91,41,4,30,228
Indiana,Laurel,547,107,127,63,17,36,350
Indiana,Lawrence,47120,11531,16557,4525,940,1906,35459
Indiana,Chrisney,446,91,208,48,2,27,376
Indiana,Chesterton,14124,3229,5938,1303,146,580,11196
Indiana,Chesterfield,2590,596,1094,354,31,118,2193
Indiana,Newtown,294,45,128,48,6,4,231
Indiana,Kouts,1899,364,837,190,15,98,1504
Indiana,Koontz Lake,1431,350,656,103,22,103,1234
Indiana,Kokomo,58054,12699,21822,8279,712,3454,46966
Indiana,Churubusco,1953,357,833,176,13,117,1496
Indiana,West Lebanon,818,149,268,166,0,64,647
Indiana,Covington,2553,429,1135,257,46,178,2045
Indiana,Country Squire Lakes,3155,649,1178,526,46,135,2534
Indiana,Country Club Heights,114,27,52,7,0,17,103
Indiana,Corydon,3121,487,892,585,75,373,2412
Indiana,Corunna,245,53,64,55,3,14,189
Indiana,Cordry Sweetwater Lakes,1024,113,632,187,0,36,968
Indiana,Converse,1455,271,540,136,64,89,1100
Indiana,Connersville,13241,2665,4593,2318,170,1099,10845
Indiana,Columbus,45868,10179,18433,5037,557,2331,36537
Indiana,Columbia City,9070,2208,3113,1243,109,566,7239
Indiana,Collegeville,614,584,19,0,0,11,614
Indiana,Colfax,820,131,328,108,12,28,607
Indiana,New Trenton,354,26,282,31,0,0,339
Indiana,Colburn,349,128,64,84,0,0,276
Indiana,Coalmont,336,99,139,41,0,6,285
Indiana,Cloverdale,1794,297,741,241,33,141,1453
Indiana,Clinton,4812,932,1309,1067,2,533,3843
Indiana,Clifford,218,44,74,22,0,28,168
Indiana,Clermont,1352,411,527,157,17,42,1154
Indiana,Clear Lake,500,54,327,37,3,40,461
Indiana,Clayton,957,154,500,62,2,37,755
Indiana,Claypool,361,67,157,33,16,19,292
Indiana,Clay City,789,126,343,73,12,79,633
Indiana,Clarksville,21627,5055,7342,3000,348,1851,17596
Indiana,Clarks Hill,583,80,253,85,10,22,450
Indiana,Clarksburg,323,127,88,63,0,0,278
Indiana,Cicero,4894,1090,2195,559,49,234,4127
Indiana,Coatesville,618,147,272,38,20,28,505
Indiana,New Washington,538,114,239,44,18,26,441
Indiana,New Whiteland,5725,1267,2352,414,35,229,4297
Indiana,Noblesville,58013,10665,25737,4971,525,2005,43903
Indiana,Parkers Settlement,799,77,521,35,0,37,670
Indiana,Patoka,1061,285,342,153,0,34,814
Indiana,Patriot,339,45,131,36,10,2,224
Indiana,Pendleton,4224,637,2022,594,35,240,3528
Indiana,Pennville,769,125,299,101,15,26,566
Indiana,Perrysville,502,64,246,60,12,26,408
Indiana,Peru,11197,2609,3901,1519,206,640,8875
Indiana,Petersburg,2592,514,1060,297,12,206,2089
Indiana,Pierceton,1074,167,426,129,0,65,787
Indiana,Pine Village,193,35,66,28,2,31,162
Indiana,Pittsboro,3116,485,1471,237,9,53,2255
Indiana,Plainfield,29710,7133,11808,3504,357,1400,24202
Indiana,Plainville,637,76,293,68,0,50,487
Indiana,Parker City,1411,288,578,179,26,129,1200
Indiana,Plymouth,10031,2474,3474,1154,110,498,7710
Indiana,Poneto,138,31,67,16,2,10,126
Indiana,Portage,37197,9239,13953,4163,665,2038,30058
Indiana,Porter,4887,1060,2275,458,14,129,3936
Indiana,Portland,6201,1410,2184,780,117,434,4925
Indiana,Poseyville,1311,227,547,111,0,98,983
Indiana,Pottawattamie Park,266,34,135,25,1,15,210
Indiana,Princes Lakes,1433,245,730,198,4,47,1224
Indiana,Princeton,8618,1884,3007,1248,153,413,6705
Indiana,Raglesville,53,0,0,0,53,0,53
Indiana,Ragsdale,157,25,86,7,0,15,133
Indiana,Redkey,1456,300,497,179,7,74,1057
Indiana,Remington,1165,206,517,165,12,35,935
Indiana,Rensselaer,5495,1196,2278,588,74,355,4491
Indiana,Point Isabel,136,21,84,6,0,10,121
Indiana,Richland,453,62,190,47,2,28,329
Indiana,Paragon,791,141,315,114,21,31,622
Indiana,Palmyra,1290,196,428,245,13,60,942
Indiana,North Crows Nest,54,8,24,2,0,1,35
Indiana,North Judson,1867,423,620,295,44,113,1495
Indiana,North Liberty,1883,339,577,231,3,109,1259
Indiana,North Manchester,6303,2030,2105,427,81,548,5191
Indiana,North Salem,528,135,257,39,0,28,459
Indiana,North Terre Haute,4505,959,1697,575,24,320,3575
Indiana,North Vernon,6895,1680,2338,944,67,461,5490
Indiana,North Webster,1196,195,516,131,41,58,941
Indiana,Notre Dame,6446,6323,39,47,0,37,6446
Indiana,Oakland City,2601,668,858,422,62,213,2223
Indiana,Oaktown,708,142,268,84,3,73,570
Indiana,Odon,1477,219,580,159,16,173,1147
Indiana,Ogden Dunes,1203,187,674,96,23,95,1075
Indiana,Paoli,3852,733,1415,609,69,283,3109
Indiana,Oldenburg,670,212,232,23,13,60,540
Indiana,Oolitic,1091,165,508,136,0,98,907
Indiana,Orestes,436,86,189,32,5,31,343
Indiana,Orland,391,85,153,73,6,18,335
Indiana,Orleans,2212,371,907,243,49,164,1734
Indiana,Osceola,2711,549,1250,226,0,80,2105
Indiana,Osgood,1806,364,698,217,26,91,1396
Indiana,Ossian,3658,665,1658,287,32,271,2913
Indiana,Otterbein,1404,322,487,238,8,28,1083
Indiana,Otwell,428,49,261,33,9,21,373
Indiana,Owensburg,797,117,511,10,0,10,648
Indiana,Owensville,1233,221,573,111,0,82,987
Indiana,Oxford,1171,269,455,153,0,59,936
Indiana,Painted Hills,849,74,371,211,0,12,668
Indiana,Onward,133,44,58,13,0,3,118
Indiana,West Lafayette,43999,29299,8478,1251,59,1210,40297
Indiana,Jamestown,1038,213,484,118,35,69,919
Indiana,Westfield,33744,5889,16185,2028,190,648,24940
Indiana,Center Point,229,31,84,43,4,13,175
Indiana,Cedar Lake,11757,2660,4860,990,82,531,9123
Indiana,Cedar Grove,246,50,106,32,0,12,200
Indiana,Cayuga,1000,177,441,141,25,68,852
Indiana,Carthage,794,166,312,118,9,32,637
Indiana,Merrillville,35322,10256,11969,3537,506,2048,28316
Indiana,Metamora,84,0,62,8,0,14,84
Indiana,Mexico,790,104,502,47,0,41,694
Indiana,Michiana Shores,277,46,165,25,6,14,256
Indiana,Michigan City,31412,9827,9452,4352,510,1686,25827
Indiana,Michigantown,434,46,174,45,18,27,310
Indiana,Middlebury,3494,524,1864,222,17,118,2745
Indiana,Middletown,2272,501,698,372,34,159,1764
Indiana,Mier,136,0,106,0,0,0,106
Indiana,Milan,2088,349,855,248,15,191,1658
Indiana,Milford,1683,311,633,201,29,107,1281
Indiana,Millersburg,1016,198,361,135,10,53,757
Indiana,Millhousen,155,20,83,14,0,4,121
Indiana,Milltown,912,215,346,138,16,40,755
Indiana,Milroy,709,116,300,58,14,71,559
Indiana,Milton,492,83,178,92,8,20,381
Indiana,Mishawaka,48121,13870,15246,6257,758,2729,38860
Indiana,Mitchell,4291,573,1765,812,79,412,3641
Indiana,Centerville,2609,488,918,436,47,105,1994
Indiana,Chalmers,450,71,185,57,0,26,339
Indiana,Chandler,3355,630,1497,270,31,114,2542
Indiana,Charlestown,7906,1870,2864,917,154,448,6253
Indiana,Ferdinand,2092,476,840,210,38,166,1730
Indiana,Farmland,1392,230,596,204,11,66,1107
Indiana,Farmersburg,1257,207,469,219,14,87,996
Indiana,Fairview Park,1191,238,572,168,9,50,1037
Indiana,Fairmount,3002,614,1190,319,38,146,2307
Indiana,Fairland,663,173,233,36,2,94,538
Indiana,Evansville,120212,32625,40220,16201,1202,7172,97420
Indiana,Etna Green,751,148,335,120,1,34,638
Indiana,English,860,224,274,132,3,39,672
Indiana,Emison,157,0,82,15,0,17,114
Indiana,Elwood,8484,1823,3459,972,119,484,6857
Indiana,Modoc,206,23,78,38,1,11,151
Indiana,Elnora,585,100,253,86,0,31,470
Indiana,Elkhart,52354,14023,15404,6120,917,2674,39138
Indiana,Elizabethtown,487,131,134,53,17,12,347
Indiana,Elizabeth,214,51,85,18,0,12,166
Indiana,Elberfeld,699,142,337,43,4,35,561
Indiana,Edwardsport,338,74,154,33,3,17,281
Indiana,Edinburgh,4346,899,1621,590,88,316,3514
Indiana,Edgewood,1872,265,926,204,0,146,1541
Indiana,Economy,163,37,69,14,4,17,141
Indiana,Eaton,1671,283,744,192,12,101,1332
Indiana,East Germantown,262,44,144,36,5,16,245
Indiana,East Enterprise,413,83,147,32,0,0,262
Indiana,Ellettsville,6434,1252,2298,956,59,388,4953
Indiana,Monon,1910,360,648,242,13,88,1351
Indiana,Monroe,646,106,301,69,5,23,504
Indiana,Monroe City,598,66,295,32,0,24,417
Indiana,Newberry,161,16,97,17,0,11,141
Indiana,Newburgh,3306,608,1612,430,47,100,2797
Indiana,New Carlisle,2028,410,839,201,33,73,1556
Indiana,New Castle,17755,4011,5965,2836,324,1303,14439
Indiana,New Chicago,2081,631,684,293,9,103,1720
Indiana,New Goshen,476,63,239,70,7,24,403
Indiana,New Harmony,715,154,325,80,8,91,658
Indiana,New Haven,15832,3334,6273,1816,201,872,12496
Indiana,New Market,546,111,235,79,7,6,438
Indiana,New Middletown,27,7,9,10,0,0,26
Indiana,Southport,2288,439,916,211,6,110,1682
Indiana,New Amsterdam,15,1,12,0,0,0,13
Indiana,South Haven,5145,1067,2231,507,35,280,4120
Indiana,Somerville,213,25,97,18,0,16,156
Indiana,Somerset,502,34,266,0,9,72,381
Indiana,Smithville-Sanders,3440,693,1560,443,0,210,2906
Indiana,Sims,180,13,57,14,0,59,143
Indiana,Simonton Lake,4446,774,2010,570,25,282,3661
Indiana,Silver Lake,1002,239,346,97,35,46,763
Indiana,Sidney,81,15,32,11,5,3,66
Indiana,West Harrison,417,126,117,50,22,24,339
Indiana,Shoals,789,184,249,101,8,128,670
Indiana,Shirley,874,202,352,70,5,56,685
Indiana,Shipshewana,688,158,278,69,13,29,547
Indiana,South Bend,100590,31392,28975,10016,1788,5128,77299
Indiana,Fillmore,659,214,258,52,2,23,549
Indiana,New Albany,36582,9959,11681,5171,609,2584,30004
Indiana,Nappanee,6650,1087,2891,478,140,248,4844
Indiana,Monroeville,1188,282,477,99,9,118,985
Indiana,Monrovia,1725,351,712,140,26,32,1261
Indiana,Monterey,310,61,128,35,0,18,242
Indiana,Montezuma,1021,236,318,145,0,60,759
Indiana,Montgomery,335,81,144,35,0,21,281
Indiana,Monticello,5332,954,2048,568,103,660,4333
Indiana,Montmorenci,184,7,146,20,0,0,173
Indiana,Montpelier,1704,350,535,279,41,131,1336
Indiana,Mooreland,294,45,124,43,0,13,225
Indiana,Moores Hill,696,162,231,92,8,28,521
Indiana,Mooresville,9508,1900,4087,1055,108,646,7796
Indiana,Nashville,1255,243,413,260,7,124,1047
Indiana,Morgantown,889,188,268,148,7,75,686
Indiana,Morristown,1264,314,431,183,20,115,1063
Indiana,Mount Auburn,120,27,30,21,2,12,92
Indiana,Mount Ayr,116,19,54,16,2,9,100
Indiana,Mount Carmel,58,12,26,5,0,0,43
Indiana,Mount Etna,97,9,67,4,1,4,85
Indiana,Mount Summit,537,153,185,87,15,30,470
Indiana,Mount Vernon,6610,1583,2616,797,53,382,5431
Indiana,Mulberry,1362,268,504,125,2,181,1080
Indiana,Muncie,70173,29273,19061,7571,851,3585,60341
Indiana,Munster,23250,5355,9939,1594,392,1812,19092
Indiana,Napoleon,189,38,79,26,0,22,165
Indiana,Morocco,1111,195,436,180,20,82,913
Indiana,Fishers,83177,14848,38108,5610,750,1582,60898
Indiana,Fish Lake,915,129,461,104,13,39,746
Indiana,Flora,2148,399,986,172,9,113,1679
Indiana,Union City,3486,792,994,565,25,238,2614
Indiana,Ulen,125,3,88,4,1,9,105
Indiana,Troy,287,40,148,37,6,20,251
Indiana,Tri-Lakes,1241,250,707,149,13,19,1138
Indiana,Trail Creek,2006,364,858,200,4,166,1592
Indiana,Trafalgar,1161,233,518,97,8,41,897
Indiana,Town of Pines,734,181,319,80,7,31,618
Indiana,Topeka,1060,226,370,61,22,15,694
Indiana,Toad Hop,52,0,11,41,0,0,52
Indiana,Tipton,5252,1018,2194,543,42,448,4245
Indiana,Thorntown,1648,315,710,172,36,66,1299
Indiana,Uniondale,303,45,134,24,4,18,225
Indiana,Terre Haute,61061,22151,17242,7495,819,3257,50964
Indiana,Tell City,7234,1439,2978,779,106,519,5821
Indiana,Tecumseh,734,65,340,48,0,56,509
Indiana,Taylorsville,1080,99,476,81,0,17,673
Indiana,Syracuse,2864,584,972,428,12,156,2152
Indiana,Switz City,288,42,115,43,0,22,222
Indiana,Sweetser,1242,144,598,97,24,67,930
Indiana,Swayzee,1025,102,533,70,0,60,765
Indiana,Sunman,919,133,440,87,19,26,705
Indiana,Summitville,1026,192,461,121,3,57,834
Indiana,Sulphur Springs,390,90,159,49,0,31,329
Indiana,Sullivan,4184,825,1578,688,26,324,3441
Indiana,Tennyson,335,90,100,47,6,11,254
Indiana,Straughn,253,37,107,29,4,7,184
Indiana,Universal,295,50,90,36,6,36,218
Indiana,Utica,711,179,266,90,5,22,562
Indiana,Waynetown,1237,207,492,143,22,29,893
Indiana,Waveland,351,52,157,41,7,15,272
Indiana,Waterloo,2210,411,763,274,24,29,1501
Indiana,Washington,11874,2330,4669,1176,81,891,9147
Indiana,Warsaw,14385,3036,5814,1586,172,741,11349
Indiana,Warren Park,1697,460,530,210,17,220,1437
Indiana,Warren,1511,256,689,158,21,94,1218
Indiana,Wanatah,1158,226,482,117,16,57,898
Indiana,Walton,1102,182,517,124,6,51,880
Indiana,Wallace,122,30,26,12,0,17,85
Indiana,Walkerton,1874,366,821,187,13,120,1507
Indiana,Upland,3883,1879,1190,180,19,124,3392
Indiana,Waldron,603,106,252,71,0,47,476
Indiana,Wabash,10469,2142,4117,1291,134,837,8521
Indiana,Vincennes,18135,5191,5937,2349,186,1217,14880
Indiana,Vevay,1471,387,528,212,10,153,1290
Indiana,Versailles,2126,513,751,329,26,125,1744
Indiana,Vernon,382,40,129,36,15,35,255
Indiana,Vera Cruz,116,11,55,12,2,2,82
Indiana,Veedersburg,2237,410,982,252,6,95,1745
Indiana,Van Buren,867,205,333,141,12,68,759
Indiana,Van Bibber Lake,276,39,108,97,0,12,256
Indiana,Valparaiso,32123,9938,11071,3376,386,1888,26659
Indiana,Vallonia,274,41,79,101,34,6,261
Indiana,Wakarusa,2024,353,926,117,12,173,1581
Indiana,Sheridan,2841,747,946,360,60,100,2213
Indiana,Stockwell,594,104,213,135,27,0,479
Indiana,Stilesville,206,43,99,34,0,22,198
Indiana,Gas City,6046,1385,2106,1149,26,283,4949
Indiana,Gary,78483,27438,17043,8934,1956,5625,60996
Indiana,Garrett,6552,1375,2496,789,38,322,5020
Indiana,Galveston,1068,160,441,185,24,39,849
Indiana,Galena,1803,316,730,109,8,153,1316
Indiana,Fulton,516,134,112,97,19,11,373
Indiana,French Lick,1989,434,583,330,33,151,1531
Indiana,Fremont,2255,525,880,358,9,107,1879
Indiana,Freetown,265,69,139,35,0,0,243
Indiana,Freelandville,617,134,291,44,0,53,522
Indiana,Fredericksburg,110,60,8,20,0,13,101
Indiana,Gaston,945,157,391,90,25,47,710
Indiana,Frankton,1878,405,707,224,31,120,1487
Indiana,Frankfort,16467,3665,5518,1890,283,1045,12401
Indiana,Francisco,703,152,260,86,3,24,525
Indiana,Francesville,867,170,400,99,19,65,753
Indiana,Fowlerton,276,51,103,41,0,4,199
Indiana,Fowler,2269,501,761,375,23,231,1891
Indiana,Fountain City,732,147,296,71,5,51,570
Indiana,Fort Wayne,257059,69623,89842,26669,2903,11841,200878
Indiana,Fortville,4095,793,1686,478,84,320,3361
Indiana,Fort Branch,2971,551,1429,282,6,180,2448
Indiana,Fontanet,334,63,202,14,0,0,279
Indiana,Florence,78,0,28,26,0,24,78
Indiana,Franklin,24090,5121,9409,2997,234,1435,19196
Indiana,Stinesville,183,50,51,50,3,20,174
Indiana,Geneva,1407,258,642,177,5,90,1172
Indiana,Georgetown,3084,462,1364,238,39,126,2229
Indiana,Staunton,562,118,271,33,4,16,442
Indiana,State Line City,165,21,68,27,1,7,124
Indiana,Star City,194,34,81,20,0,0,135
Indiana,Spurgeon,171,20,100,29,3,6,158
Indiana,Springport,173,24,68,31,2,7,132
Indiana,Spring Lake,304,59,153,45,0,12,269
Indiana,Spring Hill,87,14,47,17,0,9,87
Indiana,Spring Grove,384,53,168,33,9,67,330
Indiana,Spiceland,917,194,397,60,6,38,695
Indiana,Spencer,2374,536,820,363,41,209,1969
Indiana,Speedway,12100,3699,3762,1458,170,757,9846
Indiana,Gentryville,344,69,140,45,1,25,280
Indiana,South Whitley,1903,327,731,331,34,90,1513
Indiana,Greensboro,139,22,53,14,3,7,99
Indiana,Greenfield,21179,4289,7680,3054,382,1308,16713
Indiana,Greendale,4554,991,2012,374,60,216,3653
Indiana,Greencastle,10314,4041,2664,1074,123,632,8534
Indiana,Granger,30690,5320,16388,1334,142,984,24168
Indiana,Grandview,700,134,316,39,6,40,535
Indiana,Grabill,1454,234,599,186,0,53,1072
Indiana,Gosport,740,146,249,123,0,88,606
Indiana,Goshen,32946,8386,11568,3128,289,1904,25275
Indiana,Goodland,1003,224,369,197,23,59,872
Indiana,Glenwood,309,45,145,28,3,10,231
Indiana,Greensburg,12054,2525,4510,1550,194,708,9487
Indiana,Shepardsville,380,97,147,23,0,38,305
Indiana,Shorewood Forest,2494,459,1358,159,8,86,2070
Indiana,Shelby,612,212,217,62,0,46,537
Indiana,Andrews,1090,211,392,154,20,77,854
Indiana,Angola,8615,2690,2590,932,206,465,6883
Indiana,Arcadia,1248,235,486,129,5,90,945
Indiana,Argos,1944,386,710,243,26,87,1452
Indiana,Arlington,518,114,257,7,0,16,394
Indiana,Ashley,1080,186,388,151,31,58,814
Indiana,Atlanta,702,152,273,84,17,30,556
Indiana,Attica,3352,661,1286,454,51,313,2765
Indiana,Auburn,12979,2960,5100,1606,46,947,10659
Indiana,Aurora,3744,890,1396,433,46,170,2935
Indiana,New Palestine,2169,397,949,225,4,114,1689
Indiana,New Paris,1160,316,443,84,23,31,897
Indiana,New Pekin,1497,425,523,173,13,95,1229
Indiana,New Point,315,46,110,70,3,20,249
Indiana,Newport,500,92,230,102,5,19,448
Indiana,New Richmond,351,82,138,31,1,9,261
Indiana,New Ross,342,46,135,32,0,17,230
Indiana,New Salisbury,495,60,257,37,0,15,369
Indiana,Carlisle,594,125,226,77,5,34,467
Indiana,Carbon,463,113,139,34,7,43,336
Indiana,Cannelton,1520,303,578,215,14,65,1175
Indiana,Cannelburg,193,34,72,34,0,10,150
Indiana,Canaan,52,7,36,9,0,0,52
Indiana,Campbellsburg,609,105,188,61,18,44,416
Indiana,Camden,684,127,287,48,0,53,515
Indiana,Anderson,55630,14628,17662,8461,942,3458,45151
Indiana,Cambridge City,1773,428,632,253,21,166,1500
Indiana,Amo,508,95,235,50,11,17,408
Indiana,Amboy,323,44,167,22,1,27,261
Indiana,Rolling Prairie,712,109,262,117,17,0,505
Indiana,Rocky Ripple,693,168,263,96,2,29,558
Indiana,Rockville,2577,440,983,457,6,231,2117
Indiana,Rockport,2467,409,848,398,8,214,1877
Indiana,Rochester,6123,1232,2478,959,54,439,5162
Indiana,Roanoke,1784,339,849,131,11,63,1393
Indiana,Roann,492,117,184,38,14,17,370
Indiana,Roachdale,949,192,340,137,4,59,732
Indiana,River Forest,24,5,18,0,0,0,23
Indiana,Rising Sun,2456,572,886,306,64,248,2076
Indiana,Riley,171,41,56,21,3,19,140
Indiana,Ridgeville,590,123,230,67,7,48,475
Indiana,Richmond,36291,9352,12001,5015,728,2402,29498
Indiana,Carmel,85367,15080,43230,4647,371,2476,65804
Indiana,Aberdeen,1756,216,915,100,37,66,1334
Indiana,Advance,464,74,243,47,2,11,377
Indiana,Akron,1488,253,575,176,13,36,1053
Indiana,Alamo,53,17,11,16,0,2,46
Indiana,Albany,2076,442,937,200,20,148,1747
Indiana,Albion,2468,558,918,314,39,158,1987
Indiana,Alexandria,5074,922,1809,735,32,350,3848
Indiana,Alfordsville,86,23,51,5,0,4,83
Indiana,Alton,52,17,14,13,2,6,52
Indiana,Altona,228,51,94,29,8,16,198
Indiana,Ambia,205,32,93,21,1,11,158
Indiana,Americus,409,65,190,43,0,12,310
Indiana,Cadiz,178,38,68,14,0,4,124
Indiana,Butlerville,136,34,19,72,0,11,136
Indiana,Butler,2870,760,825,462,76,156,2279
Indiana,Bloomfield,2507,481,934,437,6,170,2028
Indiana,Blanford,264,47,182,0,0,13,242
Indiana,Birdseye,420,66,186,48,4,29,333
Indiana,Bicknell,3080,711,1092,406,32,226,2467
Indiana,Beverly Shores,547,78,344,44,4,37,507
Indiana,Bethany,94,17,36,9,0,7,69
Indiana,Berne,3863,725,1736,248,5,390,3104
Indiana,Beech Grove,14000,3620,4651,1680,155,736,10842
Indiana,Merom,184,29,71,31,2,16,149
Indiana,Meridian Hills,1660,259,892,105,3,65,1324
Indiana,Mentone,937,173,356,107,2,59,697
Indiana,Memphis,732,131,320,53,43,6,553
Indiana,Melody Hill,3866,729,1938,347,0,91,3105
Indiana,Mellott,203,37,87,21,0,14,159
Indiana,Medora,548,107,168,113,6,36,430
Indiana,Medaryville,554,92,197,59,22,23,393
Indiana,Mecca,422,72,134,54,2,25,287
Indiana,Mauckport,59,26,14,7,6,2,55
Indiana,Matthews,593,135,236,103,2,34,510
Indiana,Martinsville,11739,2781,3936,1720,397,605,9439
Indiana,Marshall,277,19,131,55,7,29,241
Indiana,Markleville,514,94,233,63,4,19,413
Indiana,Markle,1164,246,515,143,5,74,983
Indiana,West Baden Springs,530,82,275,53,14,48,472
Indiana,West College Corner,782,196,216,126,0,77,615
Indiana,Bloomingdale,313,34,173,21,3,18,249
Indiana,Bloomington,82813,48142,17535,6173,612,2212,74674
Indiana,Blountsville,122,16,60,13,1,2,92
Indiana,Bluffton,9536,1985,3764,1125,126,652,7652
Indiana,Burns Harbor,1326,318,540,159,5,25,1047
Indiana,Burns City,145,37,108,0,0,0,145
Indiana,Burnettsville,343,52,151,37,3,19,262
Indiana,Burlington,594,89,275,74,0,43,481
Indiana,Burket,148,20,56,27,0,16,119
Indiana,Bunker Hill,603,122,229,117,4,30,502
Indiana,Buffalo,1041,131,587,111,15,0,844
Indiana,Buck Creek,157,49,108,0,0,0,157
Indiana,Bryant,252,55,102,22,0,10,189
Indiana,Bruceville,525,82,220,62,9,30,403
Indiana,Brownstown,2958,628,1069,381,26,254,2358
Indiana,Brownsburg,23484,3880,11052,1981,129,1375,18417
Indiana,Rome City,1159,195,585,127,28,88,1023
Indiana,Brookville,2573,542,1006,363,4,139,2054
Indiana,Brooksburg,77,18,29,12,0,5,64
Indiana,Brooklyn,1635,361,716,169,11,52,1309
Indiana,Brook,1012,219,378,89,17,69,772
Indiana,Bristol,1809,371,849,199,18,79,1516
Indiana,Bright,4946,1031,2298,474,12,339,4154
Indiana,Bremen,4588,1004,1703,604,42,196,3549
Indiana,Brazil,8028,1772,2907,1165,112,358,6314
Indiana,Bourbon,1697,312,719,197,12,100,1340
Indiana,Boswell,733,188,272,84,5,42,591
Indiana,Boston,150,9,81,7,5,17,119
Indiana,Borden,755,124,320,77,10,34,565
Indiana,Boonville,6213,825,2811,644,33,537,4850
Indiana,Brookston,1526,262,563,190,4,84,1103
Indiana,Shelbyville,19250,4503,6465,2646,233,1388,15235
Indiana,Rosedale,656,127,254,95,13,33,522
Indiana,Knox,3723,958,1146,592,88,303,3087
Indiana,Russellville,383,100,150,50,7,11,318
Indiana,Rushville,6192,1273,2184,884,116,569,5026
Indiana,Royal Center,919,154,358,118,4,62,696
Indiana,Rossville,1623,259,700,146,21,110,1236
Indiana,Roselawn,4087,693,1907,270,11,194,3075
Indiana,Greens Fork,482,122,175,57,2,29,385
Indiana,Greentown,2710,459,1156,304,97,139,2155
Indiana,Greenville,666,213,250,97,0,17,577
Indiana,Greenwood,53828,11743,22501,5780,447,2391,42862
Indiana,Griffin,164,24,87,12,0,6,129
Indiana,Griffith,16643,4644,6170,1659,137,604,13214
Indiana,Grissom AFB,2779,873,654,484,86,103,2200
Indiana,Hagerstown,1584,353,686,149,23,83,1294
Indiana,Hamilton,1665,300,711,225,22,106,1364
Indiana,Hamlet,890,180,313,108,7,40,648
Indiana,Hammond,78983,24629,24133,7389,1716,3708,61575
Indiana,Hanna,311,11,217,34,0,12,274
Indiana,Hanover,3495,1461,906,392,50,193,3002
Indiana,Hardinsburg,185,36,78,31,0,9,154
Indiana,Harlan,1669,299,942,136,6,8,1391
Indiana,Harmony,719,164,324,76,0,54,618
Indiana,Harrodsburg,769,74,331,80,0,25,510
Indiana,Hartford City,6156,1205,2648,671,112,363,4999
Indiana,Hartsville,363,61,156,52,0,19,288
Indiana,Hatfield,788,124,400,67,0,70,661
Indiana,Russiaville,1104,184,479,156,4,43,866
Indiana,Haubstadt,1587,271,736,144,5,106,1262
Indiana,St. Bernice,432,68,163,79,0,36,346
Indiana,St. John,15789,2523,8395,806,73,695,12492
Indiana,Shelburn,1200,277,428,151,18,68,942
Indiana,Sharpsville,695,127,325,69,3,41,565
Indiana,Shamrock Lakes,261,39,152,19,1,10,221
Indiana,Shadeland,1746,395,887,198,2,91,1573
Indiana,Seymour,18861,3423,7635,2152,326,1270,14806
Indiana,Selma,735,161,312,94,4,36,607
Indiana,Sellersburg,8675,1686,3423,883,157,492,6641
Indiana,Seelyville,919,170,404,156,21,29,780
Indiana,Scottsburg,6677,1570,2477,909,114,335,5405
Indiana,Scotland,149,42,47,27,0,0,116
Indiana,Scipio,63,7,16,22,0,18,63
Indiana,Schneider,278,54,90,44,16,15,219
Indiana,Schererville,28987,6841,12869,2455,212,1460,23837
Indiana,Saratoga,197,45,63,34,0,19,161
Indiana,Santa Claus,2671,388,1381,175,5,93,2042
Indiana,San Pierre,96,17,38,26,0,15,96
Indiana,Sandborn,385,66,158,48,3,36,311
Indiana,Saltillo,100,20,41,5,14,12,92
Indiana,Salt Creek Commons,2380,465,1006,128,0,52,1651
Indiana,Salem,6256,1160,2120,975,116,640,5011
Indiana,Salamonia,232,32,68,13,6,8,127
Indiana,St. Paul,1112,251,434,127,13,57,882
Indiana,St. Meinrad,550,229,252,4,4,31,520
Indiana,St. Mary of the Woods,781,342,179,112,10,114,757
Indiana,St. Leon,666,142,359,24,2,34,561
Indiana,St. Joe,511,107,174,38,9,16,344
Indiana,Hayden,1299,361,515,91,0,45,1012
Indiana,Hazleton,291,32,131,36,3,29,231
Indiana,Hebron,3723,987,1426,356,36,172,2977
Indiana,Roseland,561,159,218,79,9,21,486
Indiana,Crane,215,48,71,31,3,10,163
Indiana,Jasonville,2370,526,748,461,31,142,1908
Indiana,Jasper,15538,3056,6658,1623,144,968,12449
Indiana,Jeffersonville,46259,11477,16783,5990,557,2360,37167
Indiana,Jonesboro,1621,319,659,179,25,134,1316
Indiana,Jonesville,158,18,84,19,0,18,139
Indiana,Kempton,368,60,147,51,5,35,298
Indiana,Kendallville,9870,2061,3237,1398,272,628,7596
Indiana,Jalapa,204,17,146,23,0,0,186
Indiana,Kennard,435,82,175,50,10,20,337
Indiana,Kentland,1886,434,655,243,20,129,1481
Indiana,Kewanna,797,251,275,72,19,42,659
Indiana,Kimmell,528,136,206,112,0,6,460
Indiana,Kingman,517,109,217,41,2,20,389
Indiana,Kingsbury,309,47,166,20,0,10,243
Indiana,Kingsford Heights,1477,316,521,189,15,68,1109
Indiana,Kirklin,791,182,291,87,12,51,623
Indiana,Knightstown,2123,603,764,251,29,144,1791
Indiana,Knightsville,805,94,330,129,0,125,678
Indiana,Kent,110,0,41,32,0,10,83
Indiana,Ingalls,2123,399,815,167,15,51,1447
Indiana,Crandall,171,17,62,29,4,7,119
Indiana,Indianapolis city (balance),841449,265109,257806,91611,15892,34490,664908
Indiana,Henryville,1837,402,499,468,61,93,1523
Indiana,Herbst,47,0,39,8,0,0,47
Indiana,Heritage Lake,2885,710,1412,238,22,76,2458
Indiana,Hidden Valley,5138,993,2814,263,11,120,4201
Indiana,Highland,23285,5807,9196,2497,279,1505,19284
Indiana,Highland,4226,699,2142,364,0,183,3388
Indiana,Hillsboro,668,128,284,54,12,38,516
Indiana,Hoagland,887,137,460,25,12,90,724
Indiana,Hobart,28943,6898,11781,3040,478,1531,23728
Indiana,Holland,738,131,282,83,13,21,530
Indiana,Holton,610,96,261,61,5,17,440
Indiana,Homecroft,685,184,294,54,19,35,586
Indiana,Hope,2306,391,947,288,28,129,1783
Indiana,Howe,716,271,265,105,1,0,642
Indiana,Hudson,594,139,202,60,5,16,422
Indiana,Hudson Lake,1424,294,644,107,0,26,1071
Indiana,Huntertown,5260,804,2488,457,4,174,3927
Indiana,Huntingburg,6446,1373,2457,574,174,287,4865
Indiana,Huntington,17231,4976,5915,1911,190,1097,14089
Indiana,Idaville,686,144,260,11,0,28,443
Indiana,Hymera,680,135,238,99,17,63,552
Indiana,Indian Village,118,34,41,21,0,8,104
Iowa,La Motte,239,40,141,7,0,12,200
Iowa,Lamont,378,51,171,45,9,22,298
Iowa,Lambs Grove,196,21,96,13,0,12,142
Iowa,Lake View,1124,147,563,125,0,144,979
Iowa,Lakeside,662,140,354,45,6,28,573
Iowa,Lake Park,1112,265,491,97,15,53,921
Iowa,Lake Panorama,1097,72,809,71,0,38,990
Iowa,Lake Mills,2010,294,935,190,27,190,1636
Iowa,Lake City,1766,349,749,169,19,214,1500
Iowa,Lakota,235,46,108,25,5,23,207
Iowa,Lamoni,2559,1113,775,200,17,95,2200
Iowa,Nichols,392,94,178,45,5,10,332
Iowa,Lansing,953,179,476,80,0,108,843
Iowa,South Amana,124,41,22,40,4,17,124
Iowa,Somers,129,36,56,9,0,6,107
Iowa,Solon,2302,400,1048,135,3,90,1676
Iowa,Soldier,154,29,67,13,6,12,127
Iowa,Smithland,160,41,70,19,2,21,153
Iowa,Sloan,1067,197,530,80,5,67,879
Iowa,Slater,1612,244,733,84,11,44,1116
Iowa,Sioux Rapids,663,142,263,72,3,41,521
Iowa,Sioux City,82792,21370,29433,8572,1207,4116,64698
Iowa,Sioux Center,7312,2091,3172,167,69,192,5691
Iowa,Silver City,177,17,111,13,1,10,152
Iowa,Sigourney,2071,407,861,253,26,176,1723
Iowa,Sidney,1001,188,395,132,8,81,804
Iowa,Sibley,2687,460,1212,238,26,211,2147
Iowa,Shueyville,594,60,333,15,0,17,425
Iowa,Sherrill,202,34,105,9,0,6,154
Iowa,Shenandoah,5062,829,2155,555,20,449,4008
Iowa,South English,269,58,118,12,3,10,201
Iowa,Shellsburg,1143,210,452,108,14,71,855
Iowa,Spencer,11186,1978,4764,1138,253,805,8938
Iowa,Spirit Lake,4948,748,2576,457,41,350,4172
Iowa,Stout,191,11,110,12,1,9,143
Iowa,Story City,3435,608,1581,342,10,287,2828
Iowa,Storm Lake,10814,2928,3798,737,207,592,8262
Iowa,Stone City,298,50,196,0,0,7,253
Iowa,Stockton,209,35,76,21,2,7,141
Iowa,Stockport,254,40,109,35,7,11,202
Iowa,Steamboat Rock,292,53,129,44,5,24,255
Iowa,State Center,1355,221,608,141,3,90,1063
Iowa,Stanwood,572,101,255,74,2,36,468
Iowa,Stanton,694,94,397,39,6,42,578
Iowa,Stanley,114,17,49,11,0,9,86
Iowa,Stanhope,401,99,160,57,9,26,351
Iowa,Stacyville,545,78,247,51,6,83,465
Iowa,Springville,1034,178,513,101,14,41,847
Iowa,Spring Hill,63,15,14,3,0,8,40
Iowa,Springbrook,175,29,97,7,0,7,140
Iowa,Spragueville,93,32,18,4,4,14,72
Iowa,Spillville,409,97,155,33,1,36,322
Iowa,Stratford,632,89,310,44,2,72,517
Iowa,Shell Rock,1188,207,563,103,7,125,1005
Iowa,Sheldahl,266,66,132,29,0,7,234
Iowa,Lincoln,128,22,48,13,3,12,98
Iowa,Linden,186,44,70,29,1,22,166
Iowa,Lineville,197,44,97,15,2,15,173
Iowa,Linn Grove,137,19,67,18,0,12,116
Iowa,Lisbon,1990,292,901,236,5,87,1521
Iowa,Liscomb,317,57,152,22,4,9,244
Iowa,Little Cedar,45,0,36,9,0,0,45
Iowa,Little Rock,492,114,233,24,5,38,414
Iowa,Little Sioux,140,32,64,24,0,6,126
Iowa,Livermore,451,79,195,53,6,18,351
Iowa,Lockridge,272,64,113,32,6,13,228
Iowa,Logan,1627,355,604,238,11,73,1281
Iowa,Lohrville,371,58,169,35,1,19,282
Iowa,Lone Rock,136,19,80,11,0,9,119
Iowa,Lone Tree,1374,316,599,82,17,83,1097
Iowa,Long Grove,894,122,476,41,5,14,658
Iowa,Lorimor,378,95,135,51,14,12,307
Iowa,Lime Springs,429,78,186,38,0,48,350
Iowa,Sheldon,5024,1272,2580,165,30,332,4379
Iowa,Lidderdale,139,20,85,9,0,10,124
Iowa,Ladora,320,69,142,28,8,10,257
Iowa,Shelby,578,158,221,69,7,22,477
Iowa,Sheffield,1146,186,517,91,19,93,906
Iowa,Sharpsburg,76,18,33,12,0,4,67
Iowa,Shannon City,73,15,21,7,2,4,49
Iowa,Shambaugh,189,50,90,17,1,13,171
Iowa,Seymour,664,89,230,93,15,73,500
Iowa,Sexton,41,9,15,0,0,0,24
Iowa,Sergeant Bluff,4356,812,1884,125,46,120,2987
Iowa,Searsboro,161,40,33,37,5,7,122
Iowa,Scranton,563,78,270,42,4,36,430
Iowa,Schleswig,808,175,389,61,19,47,691
Iowa,Schaller,802,156,342,63,19,43,623
Iowa,Scarville,63,9,29,9,0,4,51
Iowa,Saylorville,3485,697,1392,769,15,31,2904
Iowa,Sandyville,82,19,32,4,1,4,60
Iowa,Sanborn,1306,183,586,95,16,150,1030
Iowa,Salix,372,68,159,41,4,12,284
Iowa,Libertyville,335,40,187,20,2,28,277
Iowa,Strawberry Point,1407,197,633,123,36,136,1125
Iowa,Struble,86,7,53,8,2,3,73
Iowa,Stuart,1593,320,581,191,22,146,1260
Iowa,Lewis,470,76,218,42,20,16,372
Iowa,Anthon,728,149,252,78,6,83,568
Iowa,Aplington,1152,159,560,66,8,87,880
Iowa,Arcadia,512,101,232,35,0,26,394
Iowa,Archer,167,9,77,9,9,3,107
Iowa,Aredale,53,5,24,3,0,13,45
Iowa,Arion,185,41,83,6,0,5,135
Iowa,Arispe,63,11,23,7,0,10,51
Iowa,Arlington,520,99,242,44,11,24,420
Iowa,Armstrong,918,158,425,101,3,69,756
Iowa,Arnolds Park,1128,328,522,80,15,68,1013
Iowa,Arthur,210,20,100,14,1,23,158
Iowa,Asbury,5014,645,2580,272,9,122,3628
Iowa,Ashton,435,93,196,41,6,25,361
Iowa,Aspinwall,18,2,8,2,0,3,15
Iowa,Atalissa,327,71,151,32,5,8,267
Iowa,Athelstan,49,12,17,0,0,0,29
Iowa,Letts,407,84,171,44,7,16,322
Iowa,Atkins,1839,212,1074,28,2,34,1350
Iowa,Lester,268,22,149,8,0,21,200
Iowa,Leon,1999,401,886,140,56,149,1632
Iowa,La Porte City,2315,471,972,190,0,115,1748
Iowa,Larchwood,952,158,454,70,3,55,740
Iowa,Larrabee,187,39,82,24,0,12,157
Iowa,Latimer,463,76,218,30,10,45,379
Iowa,Laurel,316,94,105,40,2,15,256
Iowa,Laurens,1271,296,570,112,17,80,1075
Iowa,Lawler,331,37,181,25,2,26,271
Iowa,Lawton,851,149,390,45,5,64,653
Iowa,Leando,64,15,16,0,25,8,64
Iowa,Le Claire,3888,698,1785,411,15,180,3089
Iowa,Ledyard,117,29,57,8,2,11,107
Iowa,Le Grand,1041,136,486,95,6,47,770
Iowa,Lehigh,407,100,159,73,0,31,363
Iowa,Leighton,168,37,79,1,0,11,128
Iowa,Leland,275,49,105,30,3,17,204
Iowa,Le Mars,9757,1842,4307,931,122,693,7895
Iowa,Lenox,1433,223,616,146,43,126,1154
Iowa,Le Roy,6,0,3,0,0,3,6
Iowa,Atlantic,6929,1198,2943,870,73,607,5691
Iowa,Auburn,278,52,133,33,0,17,235
Iowa,Audubon,2054,312,951,145,25,242,1675
Iowa,Beaverdale,1435,305,484,126,0,30,945
Iowa,Bedford,1491,229,641,184,10,103,1167
Iowa,Belle Plaine,2528,376,1027,269,49,189,1910
Iowa,Bellevue,2134,318,969,205,4,229,1725
Iowa,Belmond,2438,345,1025,201,47,265,1883
Iowa,Bennett,384,65,193,36,5,21,320
Iowa,Bentley,136,6,104,0,0,9,119
Iowa,Benton,43,5,26,2,0,8,41
Iowa,Berkley,22,5,8,6,0,3,22
Iowa,Bernard,123,51,47,2,3,8,111
Iowa,Swan,78,12,26,21,0,2,61
Iowa,Swaledale,187,35,68,25,6,9,143
Iowa,Sutherland,582,95,262,85,0,56,498
Iowa,Superior,184,31,81,13,0,7,132
Iowa,Sun Valley Lake,223,9,179,19,5,11,223
Iowa,Sumner,2114,275,985,183,28,164,1635
Iowa,Sully,812,133,429,31,14,30,637
Iowa,Beaver,125,50,24,10,0,9,93
Iowa,Beaman,234,27,119,22,0,5,173
Iowa,Beaconsfield,25,0,21,2,0,2,25
Iowa,Beacon,573,110,226,68,15,30,449
Iowa,Aurelia,1002,195,480,60,0,87,822
Iowa,Aurora,233,45,110,17,0,6,178
Iowa,Avoca,1378,240,586,124,6,119,1075
Iowa,Ayrshire,152,37,39,34,0,23,133
Iowa,Badger,572,112,300,24,0,22,458
Iowa,Bagley,330,77,143,30,0,20,270
Iowa,Baldwin,110,21,57,5,0,10,93
Iowa,Balltown,68,1,47,3,0,6,57
Iowa,Lanesboro,114,23,59,13,3,2,100
Iowa,Bancroft,747,126,343,63,4,38,574
Iowa,Barnes City,286,56,97,53,8,11,225
Iowa,Barnum,271,72,83,7,2,10,174
Iowa,Bartlett,0,0,0,0,0,0,0
Iowa,Bassett,69,16,37,14,1,1,69
Iowa,Batavia,669,96,254,103,21,18,492
Iowa,Battle Creek,701,91,323,96,4,62,576
Iowa,Baxter,929,184,386,134,3,59,766
Iowa,Bayard,470,101,210,57,5,19,392
Iowa,Bankston,79,33,41,0,0,1,75
Iowa,Lacona,446,82,181,55,3,20,341
Iowa,Ankeny,51489,10402,23219,3956,455,1174,39206
Iowa,Knierim,81,17,25,6,0,8,56
Iowa,Hardy,98,6,34,8,6,2,56
Iowa,Harlan,5029,1002,2232,571,41,413,4259
Iowa,Harper,93,19,41,4,1,6,71
Iowa,Harpers Ferry,291,34,181,38,2,23,278
Iowa,Harris,155,26,76,29,1,7,139
Iowa,Hartford,847,111,355,71,26,20,583
Iowa,Hartley,1695,247,761,130,21,187,1346
Iowa,Hartwick,99,20,53,2,0,3,78
Iowa,Harvey,269,46,110,36,0,15,207
Iowa,Hastings,172,48,57,16,0,5,126
Iowa,Havelock,152,21,71,13,0,11,116
Iowa,Haverhill,204,55,110,8,0,4,177
Iowa,Hawarden,2551,360,1168,239,31,201,1999
Iowa,Hawkeye,549,116,219,50,0,23,408
Iowa,Hayesville,40,3,23,6,0,6,38
Iowa,Hayfield,7,0,0,0,0,7,7
Iowa,Hazleton,902,180,298,147,0,39,664
Iowa,Hedrick,849,190,286,98,27,63,664
Iowa,Henderson,165,10,74,15,0,7,106
Iowa,Wellman,1395,241,699,82,25,103,1150
Iowa,Wellsburg,939,185,422,48,3,60,718
Iowa,Welton,127,30,54,16,0,7,107
Iowa,Wesley,354,89,147,27,1,22,286
Iowa,Whittemore,474,97,241,19,2,36,395
Iowa,Whiting,874,206,345,63,6,84,704
Iowa,Wheatland,685,155,244,89,12,62,562
Iowa,What Cheer,701,179,194,89,21,62,545
Iowa,Westwood,146,16,84,6,0,10,116
Iowa,West Union,2692,533,1109,314,6,175,2137
Iowa,Westside,333,68,163,19,0,36,286
Iowa,West Point,1113,170,534,132,0,84,920
Iowa,Westphalia,126,28,41,26,2,8,105
Iowa,Hepburn,56,8,32,0,0,0,40
Iowa,Weston,96,17,58,0,0,11,86
Iowa,West Liberty,3737,699,1806,187,21,118,2831
Iowa,Westgate,187,43,92,24,1,7,167
Iowa,Westfield,172,34,46,19,3,9,111
Iowa,West Des Moines,61266,15101,26802,5100,566,1853,49422
Iowa,West Chester,106,8,58,16,1,10,93
Iowa,West Burlington,3021,782,1041,483,48,206,2560
Iowa,West Branch,2716,552,1159,301,39,92,2143
Iowa,West Bend,890,104,417,79,14,110,724
Iowa,West Amana,243,159,15,44,0,0,218
Iowa,West Okoboji,290,40,161,26,0,49,276
Iowa,Hiawatha,7150,1514,2970,892,40,271,5687
Iowa,High Amana,111,16,21,15,14,9,75
Iowa,Hills,810,230,308,34,7,76,655
Iowa,Iowa City,71832,35321,20418,4389,540,1778,62446
Iowa,Iowa Falls,5198,1282,2014,510,52,421,4279
Iowa,Ireton,667,114,319,54,0,43,530
Iowa,Irvington,26,0,13,0,0,0,13
Iowa,Irwin,380,73,208,30,7,20,338
Iowa,Jackson Junction,46,15,18,1,0,4,38
Iowa,Jacksonville,31,0,15,8,0,8,31
Iowa,Jamaica,215,47,92,34,0,13,186
Iowa,Janesville,880,144,420,88,3,63,718
Iowa,Ionia,351,55,163,29,0,18,265
Iowa,Jefferson,4272,714,2055,339,9,374,3491
Iowa,Jewell Junction,1281,227,568,124,33,45,997
Iowa,Johnston,19550,3420,9452,1631,178,566,15247
Iowa,Joice,190,57,81,22,1,6,167
Iowa,Jolley,37,2,28,0,1,0,31
Iowa,Kalona,2447,478,907,235,4,247,1871
Iowa,Kamrar,184,19,108,12,4,10,153
Iowa,Kanawha,690,133,301,57,12,74,577
Iowa,Kellerton,278,51,110,30,0,15,206
Iowa,Kelley,323,65,165,28,8,5,271
Iowa,Jesup,2691,496,1251,243,0,101,2091
Iowa,Whitten,153,30,70,6,5,4,115
Iowa,Inwood,817,55,436,58,5,105,659
Iowa,Independence,5986,1296,2427,510,40,538,4811
Iowa,Hillsboro,228,23,104,15,2,28,172
Iowa,Hinton,864,138,411,74,6,28,657
Iowa,Holiday Lake,340,24,170,83,9,36,322
Iowa,Holland,235,45,116,11,4,8,184
Iowa,Holstein,1454,272,719,148,0,96,1235
Iowa,Holy Cross,376,80,168,20,3,23,294
Iowa,Homestead,201,0,110,0,0,0,110
Iowa,Hopkinton,567,147,247,45,2,56,497
Iowa,Hornick,273,51,122,17,15,14,219
Iowa,Indianola,15165,4163,5200,1542,227,790,11922
Iowa,Hospers,793,128,393,26,3,32,582
Iowa,Hubbard,961,154,464,43,4,97,762
Iowa,Hudson,2391,365,1297,186,16,57,1921
Iowa,Hull,2317,431,1104,92,18,101,1746
Iowa,Humboldt,4635,704,1990,469,84,410,3657
Iowa,Humeston,493,67,257,30,2,46,402
Iowa,Hutchins,11,0,11,0,0,0,11
Iowa,Huxley,3430,514,1669,259,0,172,2614
Iowa,Ida Grove,2199,279,1008,248,21,191,1747
Iowa,Imogene,34,3,16,2,7,1,29
Iowa,Houghton,151,17,88,9,0,4,118
Iowa,Kellogg,746,206,273,80,8,22,589
Iowa,Willey,108,23,52,3,0,0,78
Iowa,Williamsburg,3128,409,1546,274,12,202,2443
Iowa,Geneva,142,35,67,15,0,7,124
Iowa,George,1065,159,543,70,14,99,885
Iowa,Gibson,57,17,21,6,2,6,52
Iowa,Gilbert,1237,207,580,76,0,22,885
Iowa,Gilbertville,700,240,292,63,0,56,651
Iowa,Gillett Grove,56,15,21,10,0,1,47
Iowa,Gilman,696,90,303,71,2,39,505
Iowa,Gilmore City,417,82,189,35,1,46,353
Iowa,Gladbrook,839,103,438,71,0,99,711
Iowa,Glenwood,5243,1397,2041,547,111,319,4415
Iowa,Glidden,1336,270,595,111,11,60,1047
Iowa,Goldfield,658,132,313,64,1,34,544
Iowa,Goodell,129,18,44,21,1,5,89
Iowa,Goose Lake,263,52,124,12,0,6,194
Iowa,Gowrie,1093,212,449,114,23,70,868
Iowa,Graettinger,702,153,267,104,1,63,588
Iowa,Graf,77,8,41,6,0,0,55
Iowa,Grafton,326,79,144,21,6,25,275
Iowa,Grand Junction,854,207,329,59,15,73,683
Iowa,Garwin,464,83,223,54,4,12,376
Iowa,Garrison,384,62,164,47,5,18,296
Iowa,Garner,3100,578,1483,146,12,207,2426
Iowa,Garnavillo,855,189,326,98,17,74,704
Iowa,New Virginia,472,84,219,47,5,11,366
Iowa,Fontanelle,667,115,260,122,0,75,572
Iowa,Forest City,4110,1114,1713,300,36,340,3503
Iowa,Fort Atkinson,267,59,116,19,5,25,224
Iowa,Fort Dodge,24789,7768,8063,2655,373,1694,20553
Iowa,Fort Madison,10832,2640,4076,1441,176,631,8964
Iowa,Fostoria,163,27,80,13,8,6,134
Iowa,Franklin,114,22,62,11,0,7,102
Iowa,Fraser,165,19,80,22,0,6,127
Iowa,Grand Mound,507,121,257,40,11,19,448
Iowa,Fredericksburg,1123,215,410,85,26,119,855
Iowa,Fredonia,388,99,127,21,6,15,268
Iowa,Fremont,691,105,284,114,9,22,534
Iowa,Fruitland,1281,219,581,94,14,22,930
Iowa,Frytown,79,16,63,0,0,0,79
Iowa,Galt,80,15,42,4,0,3,64
Iowa,Galva,519,63,231,33,1,25,353
Iowa,Garber,141,37,64,7,0,1,109
Iowa,Garden City,64,24,31,5,0,0,60
Iowa,Garden Grove,228,51,89,13,16,7,176
Iowa,Frederika,192,45,80,30,0,9,164
Iowa,Grand River,247,35,99,44,4,12,194
Iowa,Grandview,512,71,209,66,9,28,383
Iowa,Granger,1587,275,609,117,18,96,1115
Iowa,Harcourt,246,38,133,21,3,7,202
Iowa,Zwingle,125,34,28,27,1,5,95
Iowa,Zearing,591,115,290,41,3,38,487
Iowa,Yorktown,78,18,35,0,5,2,60
Iowa,Yetter,25,12,8,0,0,4,24
Iowa,Yale,289,42,130,38,6,32,248
Iowa,Wyoming,442,89,187,69,1,34,380
Iowa,Worthington,406,60,222,20,0,21,323
Iowa,Woolstock,195,34,90,25,0,14,163
Iowa,Hansell,86,17,49,9,0,3,78
Iowa,Woodward,1623,707,446,140,8,53,1354
Iowa,Woodbine,1660,394,613,154,14,154,1329
Iowa,Woden,257,70,78,22,6,22,198
Iowa,Wiota,92,18,58,10,0,6,92
Iowa,Winthrop,922,166,400,82,0,48,696
Iowa,Winterset,5159,913,2202,460,105,380,4060
Iowa,Winfield,1001,187,386,139,3,58,773
Iowa,Windsor Heights,4888,788,2457,379,13,270,3907
Iowa,Wilton,2791,606,1280,333,8,124,2351
Iowa,Williamson,108,4,40,22,1,9,76
Iowa,Woodburn,273,55,127,41,4,12,239
Iowa,Williams,506,86,213,37,6,22,364
Iowa,Hanlontown,215,42,117,18,0,11,188
Iowa,Hampton,4371,965,1808,296,12,287,3368
Iowa,Grant,90,15,24,19,0,12,70
Iowa,Granville,384,63,178,30,0,21,292
Iowa,Gravity,162,26,93,24,4,4,151
Iowa,Gray,155,45,67,10,0,2,124
Iowa,Greeley,263,58,105,27,4,18,212
Iowa,Greene,1194,202,539,108,12,122,983
Iowa,Greenfield,2007,364,878,188,35,178,1643
Iowa,Green Mountain,113,2,55,23,0,10,90
Iowa,Greenville,89,19,41,5,4,3,72
Iowa,Hancock,169,26,80,17,2,17,142
Iowa,Grimes,9509,1632,4361,607,81,217,6898
Iowa,Griswold,1111,194,531,100,18,57,900
Iowa,Grundy Center,2706,483,1248,264,14,158,2167
Iowa,Gruver,98,16,43,8,0,12,79
Iowa,Guernsey,68,17,33,4,1,7,62
Iowa,Guthrie Center,1715,358,637,142,40,184,1361
Iowa,Guttenberg,1823,349,828,206,9,168,1560
Iowa,Halbur,262,71,100,10,0,4,185
Iowa,Hamburg,1111,245,381,151,11,77,865
Iowa,Hamilton,183,60,65,8,3,3,139
Iowa,Grinnell,9132,3322,2799,880,73,689,7763
Iowa,Kensett,274,75,118,23,10,16,242
Iowa,Kent,52,10,16,14,5,0,45
Iowa,Keokuk,10705,2639,3799,1394,106,574,8512
Iowa,Exira,871,179,337,107,7,123,753
Iowa,Everly,564,110,251,48,16,28,453
Iowa,Evansdale,4777,1184,2043,489,43,247,4006
Iowa,Estherville,6091,1617,2313,566,73,372,4941
Iowa,Essex,924,189,405,89,12,52,747
Iowa,Epworth,2057,499,963,96,16,37,1611
Iowa,Emmetsburg,3817,817,1737,203,26,349,3132
Iowa,Emerson,478,81,207,43,3,18,352
Iowa,Ely,1994,349,901,178,5,42,1475
Iowa,Elma,654,145,264,51,0,90,550
Iowa,Ellsworth,596,121,239,33,4,47,444
Iowa,Ellston,23,4,8,8,0,1,21
Iowa,Elliott,417,60,209,26,3,16,314
Iowa,Elk Run Heights,942,195,491,91,3,50,830
Iowa,Elkport,30,10,6,7,0,0,23
Iowa,Elk Horn,543,95,238,61,4,78,476
Iowa,Elkhart,653,150,254,88,3,31,526
Iowa,Elkader,1252,267,596,113,6,129,1111
Iowa,Elgin,785,174,360,55,2,28,619
Iowa,Exline,135,17,67,23,1,11,119
Iowa,Fairbank,1109,176,524,110,0,49,859
Iowa,Fairfax,2300,296,1107,190,13,88,1694
Iowa,Fairfield,9739,3280,3324,1113,143,572,8432
Iowa,Thayer,52,14,10,20,0,0,44
Iowa,Terril,399,89,164,46,5,19,323
Iowa,Tennant,60,7,38,2,0,6,53
Iowa,Templeton,368,68,185,30,2,12,297
Iowa,Tama,2830,469,1218,257,26,165,2135
Iowa,Tabor,1237,280,407,133,4,128,952
Iowa,Swisher,838,95,478,62,9,17,661
Iowa,Swea City,525,99,235,46,6,38,424
Iowa,Fonda,575,124,218,50,11,49,452
Iowa,Eldridge,6017,1009,2496,522,79,234,4340
Iowa,Floyd,403,89,185,43,0,18,335
Iowa,Fertile,336,63,174,23,12,19,291
Iowa,Ferguson,133,14,60,31,3,11,119
Iowa,Fenton,325,51,153,25,4,23,256
Iowa,Fayette,1137,654,258,70,3,82,1067
Iowa,Farragut,461,60,249,53,2,46,410
Iowa,Farnhamville,337,53,142,48,4,38,285
Iowa,Farmington,783,179,327,77,3,61,647
Iowa,Farmersburg,264,49,103,22,12,15,201
Iowa,Farley,1590,310,808,73,0,53,1244
Iowa,Floris,177,20,63,24,0,17,124
Iowa,Eldora,2717,701,1120,223,39,234,2317
Iowa,Eldon,999,163,424,124,22,101,834
Iowa,Elberon,156,25,73,15,0,11,124
Iowa,Douds,52,15,21,0,0,8,44
Iowa,Doon,538,113,252,24,11,28,428
Iowa,Donnellson,856,207,322,75,10,93,707
Iowa,Donahue,366,63,192,25,1,16,297
Iowa,Dolliver,64,10,31,8,0,5,54
Iowa,Dixon,225,64,101,6,2,9,182
Iowa,Dike,1376,199,693,127,0,75,1094
Iowa,Dickens,188,46,69,39,1,5,160
Iowa,Diamondhead Lake,359,82,157,15,21,40,315
Iowa,Dougherty,91,27,39,4,0,3,73
Iowa,Keosauqua,1059,156,481,116,24,96,873
Iowa,Keswick,252,42,108,17,0,23,190
Iowa,Keystone,656,84,347,40,6,53,530
Iowa,Kimballton,296,49,125,40,1,29,244
Iowa,Kingsley,1456,291,646,89,29,73,1128
Iowa,Kinross,42,5,22,5,0,8,40
Iowa,Kirkman,72,18,36,13,0,5,72
Iowa,Kirkville,177,29,110,12,2,3,156
Iowa,Kiron,229,52,97,6,10,26,191
Iowa,Klemme,498,114,181,38,11,26,370
Iowa,Keota,954,128,426,105,1,62,722
Iowa,Thompson,463,47,252,40,0,50,389
Iowa,Dow City,514,101,179,74,0,36,390
Iowa,Drakesville,177,33,89,25,4,7,158
Iowa,Edgewood,818,151,356,78,12,110,707
Iowa,Eddyville,1333,377,446,171,6,57,1057
Iowa,East Peru,93,6,58,3,2,9,78
Iowa,East Amana,38,8,30,0,0,0,38
Iowa,Early,683,156,295,55,19,34,559
Iowa,Earlville,805,162,388,48,0,61,659
Iowa,Earling,476,72,203,21,1,64,361
Iowa,Earlham,1752,298,698,151,14,53,1214
Iowa,Eagle Grove,3483,675,1692,299,32,148,2846
Iowa,Dows,453,97,254,33,3,32,419
Iowa,Dysart,1609,312,780,109,3,75,1279
Iowa,Durant,1983,363,909,203,0,120,1595
Iowa,Durango,14,7,5,2,0,0,14
Iowa,Dunlap,1252,202,547,94,26,114,983
Iowa,Dunkerton,879,152,384,82,7,32,657
Iowa,Dundee,165,31,79,8,0,6,124
Iowa,Duncombe,363,93,114,55,6,24,292
Iowa,Duncan,95,88,0,7,0,0,95
Iowa,Dumont,734,142,306,47,11,64,570
Iowa,Dubuque,58409,17608,21685,5239,466,3442,48440
Iowa,Dyersville,4214,705,1990,204,42,312,3253
Iowa,Thor,163,37,76,12,3,11,139
Iowa,Thornburg,95,14,49,12,0,1,76
Iowa,Thornton,494,102,230,39,7,11,389
Iowa,Ames,62815,33837,18230,2614,209,1231,56121
Iowa,Anamosa,5518,1487,1932,727,79,352,4577
Iowa,Anderson,0,0,0,0,0,0,0
Iowa,Andover,88,7,47,8,0,2,64
Iowa,Andrew,441,104,163,35,1,24,327
Iowa,Anita,954,138,440,92,4,78,752
Iowa,Lost Nation,506,126,163,50,19,37,395
Iowa,Weldon,156,18,69,37,6,3,133
Iowa,Webster City,7869,1449,3518,738,109,579,6393
Iowa,Amana,404,58,253,45,0,12,368
Iowa,Webster,127,36,56,6,0,9,107
Iowa,Wayland,1133,195,496,93,3,104,891
Iowa,Waverly,10013,3252,4076,442,152,500,8422
Iowa,Waukon,3818,721,1740,269,78,364,3172
Iowa,Waukee,16956,2828,7441,1458,66,349,12142
Iowa,Waucoma,281,56,125,29,3,13,226
Iowa,Watkins,93,16,46,0,0,19,81
Iowa,Waterville,137,33,61,9,1,12,116
Iowa,Waterloo,68432,18888,23797,7086,923,3831,54525
Iowa,Washta,196,59,73,18,7,19,176
Iowa,Webb,158,27,66,20,1,15,129
Iowa,Washington,7348,1483,3033,760,85,635,5996
Iowa,Alvord,231,30,125,15,0,14,184
Iowa,Alton,1285,268,667,68,7,32,1042
Iowa,Keomah Village,64,13,37,10,0,2,62
Iowa,Ackley,1706,293,860,90,10,200,1453
Iowa,Ackworth,40,7,27,2,0,1,37
Iowa,Adair,854,166,386,85,4,54,695
Iowa,Adel,4055,573,1767,409,29,317,3095
Iowa,Afton,970,270,414,100,6,45,835
Iowa,Agency,655,103,322,60,8,55,548
Iowa,Ainsworth,568,126,257,25,8,12,428
Iowa,Albert City,631,149,268,41,4,56,518
Iowa,Altoona,15808,3360,6872,1086,246,592,12156
Iowa,Albia,3799,842,1438,285,65,379,3009
Iowa,Alburnett,607,103,278,46,3,42,472
Iowa,Alden,803,221,321,70,19,52,683
Iowa,Alexander,157,29,66,12,6,5,118
Iowa,Algona,5494,984,2443,493,50,488,4458
Iowa,Alleman,524,75,283,48,2,11,419
Iowa,Allerton,536,83,212,50,6,52,403
Iowa,Allison,1160,284,478,80,1,112,955
Iowa,Alta,2056,352,990,150,19,98,1609
Iowa,Alta Vista,288,65,102,43,0,10,220
Iowa,Albion,468,100,228,44,9,22,403
Iowa,Knoxville,7245,1485,2821,901,86,414,5707
Iowa,Washburn,997,243,429,107,23,35,837
Iowa,Walnut,688,111,346,64,12,52,585
Iowa,University Heights,1222,432,486,41,3,37,999
Iowa,Unionville,64,9,42,7,0,3,61
Iowa,Union,517,98,221,61,3,32,415
Iowa,Underwood,884,79,410,80,9,20,598
Iowa,Udell,37,1,29,2,0,1,33
Iowa,Twin Lakes,247,13,193,19,0,22,247
Iowa,Turin,111,4,48,13,0,9,74
Iowa,Truro,512,119,179,29,11,36,374
Iowa,Truesdale,139,29,73,12,0,3,117
Iowa,University Park,594,138,224,35,5,14,416
Iowa,Tripoli,1350,249,595,96,22,130,1092
Iowa,Traer,1726,327,705,144,16,224,1416
Iowa,Toronto,136,18,74,7,3,8,110
Iowa,Toledo,2146,454,898,221,11,156,1740
Iowa,Toeterville,40,5,6,7,0,18,36
Iowa,Titonka,500,134,193,45,2,49,423
Iowa,Tipton,3202,528,1542,232,31,225,2558
Iowa,Tingley,178,6,82,27,4,13,132
Iowa,Tiffin,2358,646,854,233,40,47,1820
Iowa,Thurman,209,41,93,19,3,8,164
Iowa,Treynor,1013,139,512,47,2,43,743
Iowa,Wapello,2017,366,890,209,7,157,1629
Iowa,Urbana,1402,209,721,98,19,28,1075
Iowa,Ute,411,84,185,46,1,32,348
Iowa,Wall Lake,664,115,317,28,2,92,554
Iowa,Wallingford,128,24,66,12,0,10,112
Iowa,Walker,775,145,382,40,2,46,615
Iowa,Walford,1563,171,823,92,3,43,1132
Iowa,Walcott,1575,356,668,162,11,74,1271
Iowa,Wahpeton,323,38,199,36,0,30,303
Iowa,Wadena,325,43,133,22,0,15,213
Iowa,Volga,204,38,100,9,6,18,171
Iowa,Vinton,5197,961,2116,582,111,515,4285
Iowa,Urbandale,42099,8041,20457,2827,264,1845,33434
Iowa,Vining,69,12,33,5,0,5,55
Iowa,Villisca,1249,261,497,143,35,81,1017
Iowa,Victor,1087,147,488,98,0,76,809
Iowa,Ventura,738,141,425,40,0,41,647
Iowa,Varina,79,2,34,7,0,3,46
Iowa,Van Wert,178,30,92,22,0,5,149
Iowa,Van Meter,1549,351,609,175,0,41,1176
Iowa,Van Horne,717,171,313,40,10,27,561
Iowa,Valeria,52,15,17,2,0,5,39
Iowa,Vail,470,73,225,52,2,25,377
Iowa,Vincent,165,25,77,6,14,10,132
Iowa,Loveland,40,10,18,12,0,0,40
Iowa,Akron,1454,292,589,136,21,122,1160
Iowa,New Vienna,393,105,210,21,0,13,349
Iowa,Norwalk,9671,1661,4544,948,28,339,7520
Iowa,Northwood,2028,413,899,221,17,150,1700
Iowa,North Washington,143,24,72,6,1,5,108
Iowa,North Liberty,14972,4027,5463,1261,179,242,11172
Iowa,North English,1232,159,506,119,25,74,883
Iowa,North Buena Vista,73,17,38,11,0,7,73
Iowa,Northboro,40,7,17,10,0,4,38
Iowa,Nora Springs,1553,310,641,169,12,89,1221
Iowa,Milton,576,136,224,35,9,20,424
Iowa,Minburn,330,55,149,38,4,14,260
Iowa,Minden,629,56,358,30,7,18,469
Iowa,Mineola,118,9,30,34,0,8,81
Iowa,Mingo,216,19,103,31,0,21,174
Iowa,Missouri Valley,2723,748,932,319,10,266,2275
Iowa,Mitchell,128,12,65,17,0,3,97
Iowa,Mitchellville,2303,638,835,299,51,141,1964
Iowa,Modale,283,38,136,23,1,23,221
Iowa,Mona,115,52,47,0,7,0,106
Iowa,Mondamin,348,60,204,23,5,17,309
Iowa,Monmouth,144,44,43,17,1,15,120
Iowa,Monona,1632,292,887,98,5,162,1444
Iowa,Monroe,1805,261,870,152,17,78,1378
Iowa,Montezuma,1576,201,783,141,3,90,1218
Iowa,Monticello,3800,661,1651,364,29,324,3029
Iowa,Montour,238,23,144,30,0,7,204
Iowa,Norway,613,191,219,58,4,28,500
Iowa,Numa,68,8,33,13,0,4,58
Iowa,Oakland,1585,309,675,119,7,88,1198
Iowa,Oakland Acres,111,23,70,4,0,3,100
Iowa,Maxwell,919,134,489,56,0,26,705
Iowa,Maynard,563,116,260,21,0,36,433
Iowa,Maysville,139,30,59,23,0,11,123
Iowa,Mechanicsville,1082,248,388,126,5,129,896
Iowa,Mediapolis,1342,208,620,114,12,119,1073
Iowa,Melbourne,891,183,348,82,18,38,669
Iowa,Melcher-Dallas,1203,131,537,171,20,80,939
Iowa,Melrose,133,19,75,15,4,0,113
Iowa,Melvin,237,41,109,28,0,8,186
Iowa,Menlo,410,72,162,40,8,22,304
Iowa,Meriden,206,31,91,17,0,10,149
Iowa,Merrill,845,139,362,110,8,38,657
Iowa,Montrose,925,222,307,117,14,89,749
Iowa,Meservey,226,44,107,20,0,14,185
Iowa,Middle Amana,495,94,246,31,0,70,441
Iowa,Middletown,313,52,127,41,0,18,238
Iowa,Miles,454,117,190,36,4,22,369
Iowa,Milford,2971,388,1379,242,10,226,2245
Iowa,Miller,0,0,0,0,0,0,0
Iowa,Millersburg,198,53,72,30,1,7,163
Iowa,Millerton,14,2,4,3,0,2,11
Iowa,Milo,829,117,388,75,5,38,623
Iowa,Newton,15147,3265,5627,2007,257,1095,12251
Iowa,Odebolt,1090,213,535,68,2,94,912
Iowa,Ocheyedan,504,47,238,84,0,38,407
Iowa,Oakville,131,27,50,13,3,10,103
Iowa,Meyer,0,0,0,0,0,0,0
Iowa,Moorhead,248,41,118,28,8,20,215
Iowa,Moorland,205,43,65,34,5,9,156
Iowa,Moravia,814,161,342,95,7,55,660
Iowa,Pleasant Hill,9099,1910,4295,551,36,432,7224
Iowa,Plano,60,4,42,3,0,5,54
Iowa,Plainfield,428,73,220,34,4,19,350
Iowa,Pisgah,240,57,90,35,4,20,206
Iowa,Pioneer,7,4,3,0,0,0,7
Iowa,Pilot Mound,174,53,63,28,4,15,163
Iowa,Pierson,426,76,172,43,0,33,324
Iowa,Peterson,300,46,144,45,3,33,271
Iowa,Persia,266,54,118,21,4,14,211
Iowa,Perry,8086,1791,2907,703,165,474,6040
Iowa,Percival,24,0,20,0,0,4,24
Iowa,Peosta,1747,248,799,57,0,16,1120
Iowa,Pleasanton,18,1,15,0,0,0,16
Iowa,Pella,10316,2722,4346,507,65,553,8193
Iowa,Patterson,150,26,63,9,9,8,115
Iowa,Paton,268,49,95,37,4,17,202
Iowa,Parnell,213,51,77,36,3,14,181
Iowa,Park View,2438,778,1051,150,0,0,1979
Iowa,Parkersburg,1877,240,956,139,3,117,1455
Iowa,Panorama Park,102,22,39,21,0,14,96
Iowa,Panora,1117,203,484,95,6,99,887
Iowa,Panama,199,30,98,18,0,10,156
Iowa,Palo,1050,144,485,99,11,29,768
Iowa,Palmer,149,20,65,21,5,13,124
Iowa,Packwood,286,50,118,22,12,11,213
Iowa,Pacific Junction,350,71,151,39,3,40,304
Iowa,Paullina,982,101,501,87,0,78,767
Iowa,Maurice,286,48,150,10,1,13,222
Iowa,Pleasant Plain,47,5,29,2,0,5,41
Iowa,Plover,41,8,18,1,2,6,35
Iowa,Morley,107,34,30,12,4,12,92
Iowa,Morning Sun,877,161,415,67,17,55,715
Iowa,Morrison,97,15,48,5,0,2,70
Iowa,Moulton,608,78,263,59,4,53,457
Iowa,Mount Auburn,100,11,57,11,0,7,86
Iowa,Mount Ayr,1799,280,791,178,41,195,1485
Iowa,Mount Pleasant,8575,2455,3009,1047,147,484,7142
Iowa,Mount Sterling,36,0,28,4,0,0,32
Iowa,Climbing Hill,166,34,59,24,0,0,117
Iowa,Clermont,653,83,333,54,6,39,515
Iowa,Protivin,284,30,167,22,1,29,249
Iowa,Promise City,203,62,76,25,2,23,188
Iowa,Pleasantville,1819,453,685,225,21,123,1507
Iowa,Princeton,1106,228,512,121,14,43,918
Iowa,Marquette,399,101,142,82,8,18,351
Iowa,Prescott,292,74,160,10,1,4,249
Iowa,Prairie City,1848,289,763,213,4,129,1398
Iowa,Prairieburg,156,45,61,26,2,8,142
Iowa,Postville,2281,393,927,61,28,148,1557
Iowa,Portsmouth,154,50,67,18,1,8,144
Iowa,Portland,12,0,12,0,0,0,12
Iowa,Popejoy,56,4,25,1,0,0,30
Iowa,Pomeroy,835,150,369,54,13,74,660
Iowa,Polk City,3953,453,2042,383,0,139,3017
Iowa,Pocahontas,1717,310,732,188,12,222,1464
Iowa,Plymouth,352,50,207,24,1,15,297
Iowa,Primghar,995,188,375,113,0,62,738
Iowa,Oyens,87,14,41,5,0,0,60
Iowa,Matlock,85,23,54,0,0,4,81
Iowa,Masonville,92,33,29,14,3,3,82
Iowa,Luxemburg,189,24,111,7,0,27,169
Iowa,Lu Verne,336,65,131,42,2,18,258
Iowa,Luther,161,40,81,12,3,7,143
Iowa,Lucas,196,45,105,14,5,7,176
Iowa,Luana,317,81,138,23,2,20,264
Iowa,Low Moor,195,25,82,16,6,9,138
Iowa,Lowden,823,143,373,71,5,70,662
Iowa,Lovilia,608,94,264,46,4,28,436
Iowa,Pulaski,258,29,139,22,10,11,211
Iowa,Quasqueton,511,80,280,40,11,30,441
Iowa,Quimby,376,81,164,23,10,18,296
Iowa,Radcliffe,560,116,279,31,2,30,458
Iowa,Rake,172,26,57,29,0,23,135
Iowa,Ralston,81,6,31,8,2,8,55
Iowa,Randalia,61,8,30,11,0,3,52
Iowa,Randall,174,13,87,22,9,4,135
Iowa,Randolph,188,23,86,25,0,8,142
Iowa,Rathbun,87,21,47,9,0,3,80
Iowa,Raymond,824,125,433,46,6,36,646
Iowa,Readlyn,885,133,442,53,3,61,692
Iowa,Reasnor,185,32,84,21,0,11,148
Iowa,Redding,61,4,32,2,0,9,47
Iowa,Redfield,782,152,356,98,16,49,671
Iowa,Red Oak,5588,1192,2165,582,47,498,4484
Iowa,Reinbeck,1750,283,825,151,36,169,1464
Iowa,Luzerne,102,18,45,10,3,2,78
Iowa,Lynnville,482,78,289,21,9,23,420
Iowa,Lytton,315,63,131,55,4,13,266
Iowa,McCallsburg,329,47,118,35,4,22,226
Iowa,Marne,131,27,54,16,0,5,102
Iowa,Marion,36311,6743,15391,4294,416,1517,28361
Iowa,Marengo,2518,630,963,242,57,127,2019
Iowa,Marcus,1309,197,612,109,34,105,1057
Iowa,Marble Rock,304,66,132,19,3,34,254
Iowa,Marathon,276,52,101,30,16,14,213
Iowa,Maquoketa,6029,1444,2296,690,90,372,4892
Iowa,Mapleton,1430,296,582,144,15,112,1149
Iowa,Manson,1843,343,862,129,25,124,1483
Iowa,Manning,1558,325,697,157,3,132,1314
Iowa,Manly,1464,286,545,165,21,127,1144
Iowa,Manilla,979,199,372,77,11,100,759
Iowa,Rembrandt,146,38,59,10,6,14,127
Iowa,Manchester,5106,937,1925,608,0,564,4034
Iowa,Maloy,24,0,14,2,0,0,16
Iowa,Mallard,308,61,164,31,5,8,269
Iowa,Malcom,282,49,131,50,4,15,249
Iowa,Maharishi Vedic City,738,535,138,47,5,5,730
Iowa,Magnolia,157,39,76,15,1,22,153
Iowa,Madrid,2554,507,882,314,52,236,1991
Iowa,Macksburg,130,10,53,24,0,9,96
Iowa,McIntire,117,24,44,19,0,18,105
Iowa,McGregor,776,148,299,134,15,49,645
Iowa,Macedonia,254,63,106,33,2,22,226
Iowa,McClelland,129,16,76,5,0,5,102
Iowa,McCausland,338,48,178,34,6,11,277
Iowa,Malvern,1063,174,496,85,13,67,835
Iowa,Remsen,1878,347,793,82,21,154,1397
Iowa,Renwick,291,36,157,27,2,14,236
Iowa,Rhodes,283,54,107,52,7,18,238
Iowa,Royal,429,132,159,31,3,30,355
Iowa,Rudd,373,74,170,44,10,22,320
Iowa,Runnells,541,109,225,60,5,9,408
Iowa,Russell,552,95,199,80,16,43,433
Iowa,Ruthven,721,117,267,69,11,67,531
Iowa,Rutland,115,22,42,13,0,8,85
Iowa,Ryan,355,79,152,34,7,31,303
Iowa,Sabula,496,72,235,52,7,60,426
Iowa,Sac City,2232,418,952,277,22,198,1867
Iowa,Sageville,82,23,51,2,0,1,77
Iowa,St. Ansgar,1057,175,482,87,6,84,834
Iowa,St. Anthony,115,25,25,12,5,6,73
Iowa,Rowley,316,38,171,13,8,19,249
Iowa,St. Benedict,24,6,12,0,0,0,18
Iowa,St. Donatus,132,12,85,0,0,11,108
Iowa,St. Joseph,78,8,25,0,0,0,33
Iowa,St. Lucas,164,17,108,8,0,9,142
Iowa,St. Marys,138,14,92,7,0,6,119
Iowa,St. Olaf,140,32,48,20,2,4,106
Iowa,St. Paul,89,15,43,10,5,4,77
Iowa,Salem,478,120,176,71,0,35,402
Iowa,Martelle,255,47,128,23,7,14,219
Iowa,Martensdale,463,87,144,94,3,29,357
Iowa,Martinsburg,148,18,63,10,4,3,98
Iowa,Marysville,64,17,28,4,0,0,49
Iowa,Mason City,27643,7213,10369,3549,258,1724,23113
Iowa,St. Charles,659,126,351,31,7,31,546
Iowa,Massena,342,58,142,31,7,37,275
Iowa,Rowan,178,30,84,16,1,6,137
Iowa,Roseville,0,0,0,0,0,0,0
Iowa,Riceville,811,142,372,82,12,99,707
Iowa,Richland,665,114,316,56,0,36,522
Iowa,Rickardsville,166,37,86,11,1,5,140
Iowa,Ricketts,178,33,78,12,0,4,127
Iowa,Ridgeway,283,76,113,34,1,25,249
Iowa,Rinard,65,20,31,3,0,6,60
Iowa,Ringsted,432,100,152,46,2,33,333
Iowa,Rippey,210,30,93,36,6,8,173
Iowa,Riverdale,476,89,230,51,0,21,391
Iowa,Riverside,1060,239,472,111,6,36,864
Iowa,River Sioux,119,34,54,8,0,4,100
Iowa,Riverton,331,64,137,16,4,25,246
Iowa,Rossie,54,15,19,2,1,6,43
Iowa,Robins,3357,511,2040,140,0,22,2713
Iowa,Rock Falls,168,14,99,11,0,4,128
Iowa,Rockford,824,176,348,80,15,34,653
Iowa,Rock Rapids,2592,385,1250,163,24,180,2002
Iowa,Rock Valley,3553,767,1490,157,66,206,2686
Iowa,Rockwell,1130,191,580,75,6,92,944
Iowa,Rockwell City,2155,483,783,356,22,145,1789
Iowa,Rodman,47,9,19,5,2,10,45
Iowa,Rodney,63,14,31,9,1,5,60
Iowa,Roland,1398,174,633,132,7,24,970
Iowa,Rolfe,568,128,223,47,7,60,465
Iowa,Rome,165,43,43,19,6,13,124
Iowa,Rose Hill,145,26,64,22,2,4,118
Iowa,Rochester,40,0,0,40,0,0,40
Iowa,Oxford Junction,516,88,240,68,0,25,421
Iowa,Preston,1079,237,487,101,5,47,877
Iowa,Owasa,53,17,21,7,0,4,49
Iowa,Dakota City,781,164,375,70,5,31,645
Iowa,Cylinder,72,8,39,0,0,5,52
Iowa,Cushing,195,30,100,12,0,10,152
Iowa,Curlew,71,8,35,6,2,6,57
Iowa,Cumming,435,46,257,21,0,15,339
Iowa,Cumberland,330,60,115,25,0,26,226
Iowa,Crystal Lake,185,45,80,23,0,18,166
Iowa,Cromwell,93,18,47,11,2,5,83
Iowa,Creston,7886,1881,2874,901,93,539,6288
Iowa,Cresco,3865,652,1534,390,13,283,2872
Iowa,Crescent,542,77,285,37,4,31,434
Iowa,Crawfordsville,287,48,143,22,5,11,229
Iowa,Craig,118,22,39,23,0,0,84
Iowa,Dallas Center,1734,283,795,120,4,112,1314
Iowa,Council Bluffs,62309,16435,22033,7384,851,3326,50029
Iowa,Cotter,48,5,23,7,0,8,43
Iowa,Corydon,1431,241,626,183,7,143,1200
Iowa,Corwith,234,50,126,17,3,19,215
Iowa,Correctionville,806,131,332,81,7,73,624
Iowa,Corning,1570,275,778,125,4,147,1329
Iowa,Corley,43,0,26,17,0,0,43
Iowa,Coralville,20038,5854,7770,1663,67,508,15862
Iowa,Coppock,69,3,20,9,0,12,44
Iowa,Coon Rapids,1395,168,603,138,19,129,1057
Iowa,Conway,16,5,5,4,1,1,16
Iowa,Conroy,304,97,138,22,32,9,298
Iowa,Conrad,1099,162,512,75,3,118,870
Iowa,Conesville,534,166,198,32,6,18,420
Iowa,Coulter,276,70,144,17,0,4,235
Iowa,Dana,69,12,28,7,5,5,57
Iowa,Danbury,357,66,158,29,2,41,296
Iowa,Danville,1062,150,441,114,0,69,774
Iowa,Boone,12631,2826,5147,1242,230,954,10399
Iowa,Bondurant,4555,573,1864,471,47,60,3015
Iowa,Bonaparte,398,80,119,58,13,20,290
Iowa,Bolan,37,0,0,6,7,0,13
Iowa,Bode,285,67,110,59,4,11,251
Iowa,Blue Grass,1439,251,659,134,0,80,1124
Iowa,Bloomfield,2615,553,953,307,9,327,2149
Iowa,Blockton,157,35,66,14,8,14,137
Iowa,Blencoe,239,42,100,30,0,15,187
Iowa,Blanchard,36,9,21,0,0,1,31
Iowa,Blakesburg,291,45,128,39,0,22,234
Iowa,Blairstown,757,101,313,50,27,33,524
Iowa,Blairsburg,112,12,67,9,0,13,101
Iowa,Oxford,895,189,407,74,6,36,712
Iowa,Birmingham,545,114,237,51,10,26,438
Iowa,Bevington,43,16,11,9,1,2,39
Iowa,Bettendorf,34663,6074,16599,2859,144,1751,27427
Iowa,Bertram,394,82,207,13,0,14,316
Iowa,Delhi,412,87,176,54,6,35,358
Iowa,Delaware,138,30,64,21,0,11,126
Iowa,Defiance,228,37,115,18,7,14,191
Iowa,Deep River,302,33,132,41,0,14,220
Iowa,Dedham,242,56,105,8,0,10,179
Iowa,Decorah,8009,3357,2853,518,30,509,7267
Iowa,Decatur City,202,40,83,23,2,14,162
Iowa,Dayton,785,140,336,71,10,100,657
Iowa,Dawson,197,39,76,16,1,6,138
Iowa,Davis City,252,32,82,47,15,21,197
Iowa,Davenport,101863,28673,36023,10490,1240,5125,81551
Iowa,Colwell,83,38,26,10,2,0,76
Iowa,Columbus Junction,2120,539,906,80,21,98,1644
Iowa,Camanche,4387,754,1869,619,25,244,3511
Iowa,Calumet,208,26,80,41,2,15,164
Iowa,Clive,16634,3323,8291,857,71,528,13070
Iowa,Clio,114,7,59,11,0,5,82
Iowa,Clinton,26413,6426,9887,3013,481,1708,21515
Iowa,Brandon,312,54,139,32,6,10,241
Iowa,Bradgate,67,13,36,5,0,5,59
Iowa,Bradford,78,0,70,0,0,8,78
Iowa,Braddyville,154,26,80,21,0,10,137
Iowa,Mount Union,99,13,39,18,0,1,71
Iowa,Mount Vernon,4523,1712,1412,207,71,148,3550
Iowa,Moville,1481,317,640,137,16,69,1179
Iowa,Murray,590,57,264,56,8,73,458
Iowa,Muscatine,23888,5295,9298,2264,425,1138,18420
Iowa,Mystic,410,79,162,54,6,32,333
Iowa,Nashua,1614,246,830,103,13,89,1281
Iowa,Nemaha,78,22,34,6,0,0,62
Iowa,Neola,909,134,387,61,9,50,641
Iowa,Nevada,6799,1278,2807,756,135,336,5312
Iowa,New Albin,646,121,233,77,8,46,485
Iowa,Newell,1174,219,447,68,16,99,849
Iowa,Newhall,944,181,445,81,0,55,762
Iowa,New Hampton,3510,745,1494,307,16,228,2790
Iowa,New Hartford,586,64,285,62,15,18,444
Iowa,New Haven,51,29,15,7,0,0,51
Iowa,New Liberty,148,19,71,2,0,15,107
Iowa,New London,1819,334,774,262,19,115,1504
Iowa,New Market,382,65,164,74,2,20,325
Iowa,New Providence,226,40,106,20,0,14,180
Iowa,New Sharon,1298,254,565,102,27,62,1010
Iowa,Nodaway,122,35,38,7,0,10,90
Iowa,Clutier,205,65,74,23,14,13,189
Iowa,Bouton,190,32,59,27,16,7,141
Iowa,Coalville,542,157,101,92,24,21,395
Iowa,Coggon,730,142,279,50,20,68,559
Iowa,Calmar,1049,289,382,93,27,31,822
Iowa,Callender,425,82,175,26,3,16,302
Iowa,California Junction,117,51,51,0,0,10,112
Iowa,Calamus,422,101,171,42,0,30,344
Iowa,Bussey,482,106,188,55,3,40,392
Iowa,Burt,550,157,192,34,3,41,427
Iowa,Burr Oak,306,94,131,27,0,7,259
Iowa,Burlington,25537,5948,9612,3162,305,1623,20650
Iowa,Burchinal,67,5,39,0,0,0,44
Iowa,Buffalo Center,886,111,420,43,0,111,685
Iowa,Buffalo,1217,284,557,102,31,65,1039
Iowa,Buck Grove,21,2,10,7,0,2,21
Iowa,Buckeye,88,1,38,10,4,6,59
Iowa,Brunsville,93,29,51,2,0,8,90
Iowa,Brooklyn,1476,279,569,161,10,101,1120
Iowa,Bronson,339,50,146,17,2,20,235
Iowa,Britt,1966,313,891,128,15,228,1575
Iowa,Bristow,183,35,62,19,0,12,128
Iowa,Brighton,606,105,274,62,28,34,503
Iowa,Bridgewater,141,24,73,8,0,11,116
Iowa,Breda,478,110,211,28,10,22,381
Iowa,Brayton,132,27,53,15,4,11,110
Iowa,Columbus City,405,83,206,32,2,15,338
Iowa,Colo,884,176,344,90,4,47,661
Iowa,Collins,462,93,167,55,5,18,338
Iowa,College Springs,223,38,90,31,1,18,178
Iowa,Colfax,1848,403,762,164,24,115,1468
Iowa,Colesburg,402,67,234,26,0,19,346
Iowa,Coin,213,25,97,24,2,18,166
Iowa,Coburg,47,9,17,6,0,2,34
Iowa,Boxholm,230,18,106,29,4,13,170
Iowa,Marshalltown,27770,6012,11199,2362,336,1581,21490
Iowa,Dexter,911,237,357,59,2,37,692
Iowa,Charles City,7500,1606,2723,945,133,653,6060
Iowa,Charlotte,398,79,140,53,2,16,290
Iowa,Charter Oak,601,98,303,33,3,52,489
Iowa,Chatsworth,69,22,36,3,0,4,65
Iowa,Chelsea,204,16,112,5,0,9,142
Iowa,Cherokee,5147,1065,1856,653,128,583,4285
Iowa,Chester,241,80,64,26,3,7,180
Iowa,Chillicothe,102,29,38,14,0,8,89
Iowa,Churdan,370,57,141,52,1,36,287
Iowa,Cincinnati,329,54,172,41,1,16,284
Iowa,Chariton,4240,915,1672,590,21,380,3578
Iowa,Clare,232,35,93,29,9,7,173
Iowa,Clarinda,5476,1475,2061,582,57,481,4656
Iowa,Clarion,2788,576,1015,348,24,210,2173
Iowa,Clarksville,1335,213,610,94,5,96,1018
Iowa,Delta,260,49,78,58,2,28,215
Iowa,Delphos,20,0,7,6,0,2,15
Iowa,Deloit,395,47,173,24,0,26,270
Iowa,Delmar,497,95,195,64,9,35,398
Iowa,Boyden,752,116,421,22,0,27,586
Iowa,Clayton,42,3,28,9,0,2,42
Iowa,Clearfield,378,78,169,24,7,39,317
Iowa,Clarence,945,203,349,96,13,115,776
Iowa,Chapin,153,97,28,0,11,13,149
Iowa,Centralia,133,40,62,11,1,4,118
Iowa,Central City,1373,281,560,144,16,41,1042
Iowa,Carson,845,140,366,67,7,60,640
Iowa,Carroll,10020,2233,4231,687,97,719,7967
Iowa,Carpenter,117,22,65,4,0,12,103
Iowa,Carlisle,4120,727,1822,286,12,235,3082
Iowa,Carbon,27,3,17,4,0,3,27
Iowa,Cantril,227,49,96,17,6,20,188
Iowa,Cambridge,806,110,338,70,11,30,559
Iowa,Diagonal,332,65,138,28,3,56,290
Iowa,Casey,394,95,130,55,3,24,307
Iowa,De Witt,5283,1018,2344,576,0,270,4208
Iowa,De Soto,1159,222,491,127,8,38,886
Iowa,Des Moines,208020,57545,69381,22897,3601,9376,162800
Iowa,Derby,132,19,61,10,6,8,104
Iowa,Denver,1789,321,900,82,3,108,1414
Iowa,Denmark,350,82,116,58,0,39,295
Iowa,Denison,8383,1792,3142,562,240,524,6260
Iowa,Castalia,170,33,81,21,5,15,155
Iowa,Castana,105,17,54,12,1,7,91
Iowa,Cedar Falls,40439,16016,14430,2359,234,1516,34555
Iowa,Cedar Rapids,128829,35821,48259,12174,1778,6180,104212
Iowa,Center Junction,93,12,57,9,0,8,86
Iowa,Center Point,2478,461,1119,144,74,129,1927
Iowa,Centerville,5431,1205,2097,557,92,560,4511
Iowa,Clear Lake,7675,1232,3602,599,114,526,6073
Iowa,Carter Lake,3771,844,1367,512,69,194,2986
Iowa,Cleghorn,218,22,110,27,0,17,176
Iowa,Cascade,1984,301,984,84,20,157,1546
Iowa,Oelwein,6275,1584,2310,662,75,601,5232
Iowa,Ogden,2114,422,1043,142,23,126,1756
Iowa,Okoboji,833,172,422,103,5,46,748
Iowa,Olds,200,25,91,20,0,13,149
Iowa,Olin,718,181,290,42,9,42,564
Iowa,Ollie,225,39,126,22,0,11,198
Iowa,Onawa,2921,727,1072,331,0,278,2408
Iowa,Onslow,201,45,99,13,2,14,173
Iowa,Orange City,6147,1783,2775,153,63,289,5063
Iowa,Orient,369,49,187,36,3,30,305
Iowa,Orchard,34,6,18,3,2,1,30
Iowa,Osage,3640,777,1513,400,23,347,3060
Iowa,Osceola,4985,1186,1670,466,90,406,3818
Iowa,Oskaloosa,11558,2763,4223,1463,76,903,9428
Iowa,Ossian,979,211,409,65,9,77,771
Iowa,Osterdock,68,5,38,4,6,5,58
Iowa,Otho,505,92,210,73,13,29,417
Iowa,Oto,106,22,39,12,0,8,81
Iowa,Otranto,7,0,0,0,0,7,7
Iowa,Ottosen,56,9,31,4,0,2,46
Iowa,Ottumwa,24758,5650,9468,2708,418,1561,19805
Iowa,Orleans,465,39,351,18,0,27,435
Iowa,Clemons,125,26,63,10,3,1,103
Kansas,Lyndon,1068,158,512,113,6,36,825
Kansas,Great Bend,15850,3517,5900,1698,175,998,12288
Kansas,Lyons,3731,552,1691,281,58,328,2910
Kansas,Leonardville,410,72,186,24,2,57,341
Kansas,Lowell,344,7,144,12,0,88,251
Kansas,Leoti,1502,236,625,139,13,69,1082
Kansas,LeRoy,612,114,276,75,13,37,515
Kansas,Levant,71,46,17,0,0,8,71
Kansas,Lewis,396,58,225,22,8,10,323
Kansas,Liberal,20819,5383,6946,1491,494,903,15217
Kansas,Liberty,225,62,116,14,7,5,204
Kansas,Liebenthal,117,19,62,13,0,11,105
Kansas,Lincoln Center,1312,257,537,172,5,113,1084
Kansas,Protection,502,65,265,36,0,43,409
Kansas,Lindsborg,3441,758,1390,381,28,260,2817
Kansas,Linn,471,75,219,35,1,44,374
Kansas,Linn Valley,811,75,444,107,28,43,697
Kansas,Linwood,407,105,149,49,1,16,320
Kansas,Little River,553,95,225,60,1,44,425
Kansas,Logan,498,73,251,31,6,65,426
Kansas,Lone Elm,23,10,8,4,0,1,23
Kansas,Longford,222,69,124,6,5,5,209
Kansas,Long Island,177,33,82,12,15,8,150
Kansas,Longton,340,66,146,48,1,23,284
Kansas,Lorraine,187,51,76,23,0,2,152
Kansas,Lost Springs,86,4,34,20,0,15,73
Kansas,Louisburg,4294,478,1879,578,74,168,3177
Kansas,Louisville,287,67,83,31,5,17,203
Kansas,Lucas,444,85,222,26,4,28,365
Kansas,Luray,276,29,159,21,7,9,225
Kansas,Deerfield,742,150,287,39,24,51,551
Kansas,Sterling,2313,761,930,154,20,135,2000
Kansas,Cottonwood Falls,939,197,361,114,10,92,774
Kansas,Corning,151,31,46,10,0,7,94
Kansas,Copeland,294,51,160,13,0,13,237
Kansas,Coolidge,122,18,46,12,0,19,95
Kansas,Conway Springs,1551,296,517,167,24,118,1122
Kansas,Concordia,5289,1437,1903,627,0,539,4506
Kansas,Colwich,1385,250,620,75,6,41,992
Kansas,Dresden,66,12,28,5,0,6,51
Kansas,Colony,408,65,168,56,8,34,331
Kansas,Collyer,83,29,41,8,0,2,80
Kansas,Coldwater,824,170,330,101,12,80,693
Kansas,Colby,5450,1544,2423,293,22,324,4606
Kansas,Coffeyville,9921,1955,3316,1610,233,873,7987
Kansas,Coats,169,59,66,16,3,3,147
Kansas,Clyde,782,121,330,83,6,84,624
Kansas,Climax,38,2,28,0,0,4,34
Kansas,Clifton,574,70,311,36,0,59,476
Kansas,Council Grove,2319,424,982,175,14,279,1874
Kansas,Courtland,371,57,166,34,2,22,281
Kansas,Coyville,37,12,11,5,0,2,30
Kansas,Cuba,192,12,93,36,0,12,153
Kansas,Delia,149,28,74,9,0,7,118
Kansas,Delphos,437,68,219,52,0,18,357
Kansas,Denison,183,32,66,12,1,19,130
Kansas,Denton,162,27,100,14,0,10,151
Kansas,Derby,23731,4551,10545,2056,252,965,18369
Kansas,De Soto,5941,1263,2315,597,163,239,4577
Kansas,Detroit,388,78,163,0,0,0,241
Kansas,Dexter,370,25,188,45,0,45,303
Kansas,Clearwater,2566,438,1209,181,35,144,2007
Kansas,Dighton,961,241,349,77,11,142,820
Kansas,Dorrance,184,16,97,27,0,8,148
Kansas,Douglass,1895,343,830,164,11,99,1447
Kansas,Downs,974,145,503,117,6,74,845
Kansas,Danville,50,9,22,7,2,0,40
Kansas,Damar,158,42,72,8,0,10,132
Kansas,Cunningham,416,30,187,55,4,27,303
Kansas,Culver,100,14,47,9,8,10,88
Kansas,Cullison,44,1,31,2,0,3,37
Kansas,Dodge City,28045,6082,10616,2059,560,1164,20481
Kansas,Dearing,523,94,237,40,17,34,422
Kansas,Clayton,88,18,35,14,0,5,72
Kansas,Claflin,606,101,302,63,2,46,514
Kansas,Sharon,147,29,76,14,0,14,133
Kansas,Sharon Springs,701,116,274,76,32,71,569
Kansas,Shawnee,64125,13630,28140,5139,664,2218,49791
Kansas,Silver Lake,1780,321,726,153,15,64,1279
Kansas,Simpson,59,9,30,9,4,7,59
Kansas,Smith Center,1558,242,773,115,0,155,1285
Kansas,Smolan,185,19,94,24,0,7,144
Kansas,Soldier,115,23,55,4,0,9,91
Kansas,Solomon,1173,190,497,142,5,53,887
Kansas,South Haven,287,44,128,24,9,28,233
Kansas,South Hutchinson,2392,495,946,374,27,281,2123
Kansas,Spearville,733,114,383,54,0,58,609
Kansas,Speed,49,7,18,12,0,0,37
Kansas,Spivey,45,8,25,3,0,7,43
Kansas,Spring Hill,5739,903,2528,464,82,195,4172
Kansas,Stafford,1130,229,448,96,36,113,922
Kansas,Stark,81,15,28,8,5,13,69
Kansas,Seward,38,3,25,1,0,5,34
Kansas,Severy,286,58,124,40,8,20,250
Kansas,Severance,91,20,38,6,4,4,72
Kansas,Seneca,2006,295,886,202,0,276,1659
Kansas,Circleville,160,18,86,3,0,9,116
Kansas,Cimarron,2093,307,969,62,43,89,1470
Kansas,Dunlap,15,5,3,5,2,0,15
Kansas,Chicopee,551,69,190,126,0,52,437
Kansas,Chetopa,1275,222,488,112,35,80,937
Kansas,Durham,118,17,48,15,0,11,91
Kansas,Dwight,232,30,91,23,0,29,173
Kansas,Earlton,48,4,21,4,2,7,38
Kansas,Clay Center,4240,530,1977,508,9,278,3302
Kansas,Eastborough,736,114,389,36,9,28,576
Kansas,Edgerton,1706,333,618,252,11,62,1276
Kansas,Edmond,55,22,18,3,0,2,45
Kansas,Edna,435,31,229,40,5,19,324
Kansas,Scranton,637,145,282,71,16,23,537
Kansas,Sedan,1129,163,479,151,11,127,931
Kansas,Sedgwick,1867,268,919,84,35,110,1416
Kansas,Cherryvale,2221,410,803,368,57,152,1790
Kansas,Selden,321,52,153,18,0,11,234
Kansas,Easton,352,105,111,53,7,29,305
Kansas,Columbus,3207,639,1605,351,9,195,2799
Kansas,Lincolnville,244,52,107,29,0,7,195
Kansas,Cheney,1929,224,983,136,6,98,1447
Kansas,La Crosse,1295,201,519,196,12,168,1096
Kansas,Labette,44,6,27,7,0,2,42
Kansas,Kismet,297,57,127,14,4,27,229
Kansas,Kirwin,182,27,76,18,5,11,137
Kansas,Kipp,151,24,30,27,0,0,81
Kansas,Kiowa,998,136,493,71,16,69,785
Kansas,Kinsley,1402,225,633,162,50,117,1187
Kansas,Kingman,3128,513,1214,441,25,352,2545
Kansas,Kincaid,174,19,68,11,4,4,106
Kansas,Kickapoo Tribal Center,201,29,80,38,0,7,154
Kansas,Kickapoo Site 7,43,12,8,3,2,8,33
Kansas,Kickapoo Site 6,20,6,4,3,0,2,15
Kansas,Kickapoo Site 5,67,21,20,11,4,2,58
Kansas,Kickapoo Site 2,44,17,4,7,0,2,30
Kansas,Kickapoo Site 1,93,29,13,15,0,0,57
Kansas,Kensington,468,83,221,30,0,62,396
Kansas,Kechi,2180,374,1142,160,0,46,1722
Kansas,Kansas City,148855,41994,46221,14628,2771,7218,112832
Kansas,Kanorado,141,11,82,6,6,9,114
Kansas,Abbyville,92,24,55,2,0,2,83
Kansas,Abilene,6671,1035,3005,697,21,523,5281
Kansas,Ada,53,0,27,0,0,26,53
Kansas,Admire,128,6,68,12,0,15,101
Kansas,Agenda,75,4,34,9,0,3,50
Kansas,Agra,255,61,109,33,2,10,215
Kansas,Albert,166,16,111,12,0,10,149
Kansas,Alden,96,22,55,4,0,5,86
Kansas,Alexander,31,3,21,2,0,5,31
Kansas,Allen,286,50,87,28,9,21,195
Kansas,La Cygne,1284,256,516,105,19,46,942
Kansas,La Harpe,542,119,224,73,22,25,463
Kansas,Lake Quivira,911,125,584,29,5,24,767
Kansas,Lakin,2028,287,970,109,3,120,1489
Kansas,Palco,169,39,57,21,1,15,133
Kansas,Palmer,179,23,81,5,5,8,122
Kansas,Paola,5570,1016,2173,402,139,298,4028
Kansas,Paradise,37,6,18,9,0,4,37
Kansas,Park,99,14,32,24,0,7,77
Kansas,Park City,7290,1558,2701,736,140,255,5390
Kansas,Parker,435,89,189,29,2,14,323
Kansas,Parkerfield,339,50,202,24,3,21,300
Kansas,Parkerville,70,13,26,10,0,10,59
Kansas,Parsons,10223,2799,3469,1100,88,740,8196
Kansas,Partridge,265,67,126,26,0,11,230
Kansas,Pawnee Rock,221,49,75,26,2,24,176
Kansas,Leona,51,10,29,2,0,1,42
Kansas,Leon,678,105,317,66,2,28,518
Kansas,Alma,837,161,369,89,18,67,704
Kansas,Lenora,238,26,143,13,0,21,203
Kansas,Lehigh,182,27,81,13,2,8,131
Kansas,Lecompton,598,114,254,85,0,25,478
Kansas,Lebo,886,158,407,107,7,34,713
Kansas,Lebanon,309,38,128,31,6,27,230
Kansas,Leawood,33339,4663,18245,1612,76,1221,25817
Kansas,Leavenworth,35861,8269,13083,4086,752,1344,27534
Kansas,Lawrence,91305,40824,26989,6715,354,2903,77785
Kansas,Latimer,42,8,17,6,0,0,31
Kansas,Latham,128,37,48,18,0,9,112
Kansas,Larned,4011,916,1452,659,5,263,3295
Kansas,Lansing,11623,3189,4481,1370,167,334,9541
Kansas,Langdon,30,5,14,7,0,2,28
Kansas,Lane,218,25,104,47,2,22,200
Kansas,Lancaster,315,35,138,41,0,37,251
Kansas,Lenexa,50412,11514,22313,4146,506,1713,40192
Kansas,Almena,493,119,231,47,10,32,439
Kansas,Altamont,1206,263,460,112,16,42,893
Kansas,Alta Vista,473,73,221,63,16,23,396
Kansas,Neodesha,2245,366,810,357,55,148,1736
Kansas,Neosho Falls,132,17,50,22,6,9,104
Kansas,Neosho Rapids,195,31,91,16,6,23,167
Kansas,Ness City,1520,229,764,115,11,112,1231
Kansas,Netawaka,176,39,82,14,0,5,140
Kansas,New Albany,32,8,17,3,0,4,32
Kansas,New Cambria,145,30,57,17,0,9,113
Kansas,New Strawn,388,66,212,43,0,5,326
Kansas,Peabody,1262,224,487,173,18,96,998
Kansas,Penalosa,15,2,6,0,4,3,15
Kansas,Perry,916,118,413,150,12,49,742
Kansas,Peru,161,24,84,13,2,7,130
Kansas,Phillipsburg,2525,420,1021,261,27,240,1969
Kansas,Piqua,186,72,65,12,0,8,157
Kansas,Natoma,310,37,172,27,5,22,263
Kansas,Pittsburg,20382,8022,6040,1791,234,762,16849
Kansas,Plainville,1930,261,946,167,18,151,1543
Kansas,Pleasanton,1206,167,469,139,12,164,951
Kansas,Plevna,90,18,38,15,1,7,79
Kansas,Pomona,824,164,381,64,7,58,674
Kansas,Portis,101,16,43,10,0,2,71
Kansas,Potwin,458,105,182,33,0,28,348
Kansas,Powhattan,81,12,25,9,3,4,53
Kansas,Prairie View,183,21,104,8,0,3,136
Kansas,Prairie Village,21814,4263,10048,2050,87,1171,17619
Kansas,Pratt,6887,1462,2862,674,50,554,5602
Kansas,Prescott,238,21,86,32,3,58,200
Kansas,Preston,175,16,85,24,0,9,134
Kansas,Pretty Prairie,715,154,260,82,9,51,556
Kansas,Princeton,281,50,134,20,4,9,217
Kansas,Plains,1099,202,455,128,10,48,843
Kansas,Ozawkie,757,130,383,52,0,25,590
Kansas,Nashville,67,8,30,9,1,6,54
Kansas,Muscotah,201,38,64,26,2,12,142
Kansas,Alton,141,32,56,17,3,14,122
Kansas,Altoona,418,38,184,32,17,30,301
Kansas,Americus,841,135,387,88,22,53,685
Kansas,Andale,830,139,362,52,0,20,573
Kansas,Andover,12293,2052,5588,1085,49,554,9328
Kansas,Anthony,2340,352,956,324,11,228,1871
Kansas,Arcadia,454,105,137,74,7,18,341
Kansas,Argonia,697,129,218,75,4,35,461
Kansas,Arkansas City,12253,2547,4590,1529,148,695,9509
Kansas,Arlington,524,92,199,66,6,53,416
Kansas,Paxico,309,55,95,30,14,21,215
Kansas,Hugoton,3864,698,1958,55,53,140,2904
Kansas,Humboldt,1826,393,691,198,0,234,1516
Kansas,Hunnewell,74,17,36,6,0,1,60
Kansas,Narka,113,20,47,23,1,6,97
Kansas,Hunter,68,14,41,2,2,2,61
Kansas,Hutchinson,41808,8982,16511,5340,492,2496,33821
Kansas,Independence,9179,2048,3245,1037,214,508,7052
Kansas,Ingalls,311,63,146,8,0,19,236
Kansas,Inman,1303,218,601,91,17,194,1121
Kansas,Iola,5602,1402,1819,695,135,348,4399
Kansas,Isabel,98,5,66,7,0,10,88
Kansas,Iuka,207,24,107,8,0,7,146
Kansas,Jamestown,353,105,124,22,0,14,265
Kansas,Jennings,130,30,49,19,8,13,119
Kansas,Jetmore,879,133,410,96,2,85,726
Kansas,Jewell,434,54,203,34,16,45,352
Kansas,Johnson City,1339,181,617,99,9,69,975
Kansas,Junction City,24823,4478,10610,2287,453,920,18748
Kansas,Kanopolis,415,69,239,16,5,30,359
Kansas,Huron,76,26,16,13,0,3,58
Kansas,Cherokee,846,154,368,28,6,62,618
Kansas,Oxford,1135,132,536,101,22,101,892
Kansas,Overbrook,977,167,418,104,11,109,809
Kansas,Healy,265,34,144,7,12,13,210
Kansas,Hepler,137,29,57,13,2,21,122
Kansas,Herington,2241,350,966,299,34,209,1858
Kansas,Herndon,133,27,71,14,1,8,121
Kansas,Hesston,3566,714,1890,157,0,151,2912
Kansas,Hiawatha,3132,535,1219,508,50,215,2527
Kansas,Highland,1053,661,222,48,2,48,981
Kansas,Hill City,1464,209,716,162,8,135,1230
Kansas,Hillsboro,2916,891,1141,179,33,206,2450
Kansas,Hillsdale,270,68,122,47,0,0,237
Kansas,Hoisington,2666,436,1210,180,21,155,2002
Kansas,Holcomb,2434,437,1062,150,18,22,1689
Kansas,Hollenberg,21,1,14,5,0,1,21
Kansas,Holton,3284,556,1367,428,44,271,2666
Kansas,Holyrood,400,53,177,58,10,26,324
Kansas,Home,164,17,107,22,5,0,151
Kansas,Hope,488,96,183,53,22,23,377
Kansas,Horace,152,28,77,3,0,4,112
Kansas,Horton,1746,361,694,183,30,115,1383
Kansas,Howard,741,106,358,58,4,87,613
Kansas,Hoxie,1251,166,636,78,0,150,1030
Kansas,Hoyt,639,186,266,45,0,38,535
Kansas,Hudson,137,34,70,4,0,10,118
Kansas,Scottsville,10,0,6,4,0,0,10
Kansas,Scott City,3930,589,1993,309,0,239,3130
Kansas,Schoenchen,193,43,100,14,2,7,166
Kansas,Scandia,430,106,171,51,5,31,364
Kansas,Scammon,454,83,199,45,3,29,359
Kansas,Sawyer,92,17,41,7,4,6,75
Kansas,Hazelton,144,33,60,7,10,7,117
Kansas,Haysville,11234,2093,4464,1142,117,590,8406
Kansas,Haviland,797,212,334,37,0,45,628
Kansas,Havensville,148,26,71,22,7,9,135
Kansas,Chautauqua,68,3,34,14,1,8,60
Kansas,Chase,565,117,218,54,10,29,428
Kansas,Chapman,1441,180,597,154,48,123,1102
Kansas,Chanute,9217,1741,3328,1253,148,711,7181
Kansas,Centralia,550,73,215,53,8,51,400
Kansas,Cedar Vale,527,99,191,61,3,31,385
Kansas,Cedar Point,27,0,9,7,1,3,20
Kansas,Cedar,6,0,5,0,0,1,6
Kansas,Greeley,282,78,98,34,1,13,224
Kansas,Greeley County unified government (balance),388,61,241,27,0,16,345
Kansas,Green,125,15,68,12,3,5,103
Kansas,Greenleaf,390,102,147,31,15,24,319
Kansas,Greensburg,896,201,425,71,12,54,763
Kansas,Grenola,164,8,107,13,0,11,139
Kansas,Savonburg,139,29,35,39,0,9,112
Kansas,Gridley,294,53,122,48,5,25,253
Kansas,Gypsum,378,50,183,55,5,17,310
Kansas,Haddam,64,6,36,2,0,18,62
Kansas,Halstead,2305,416,995,129,31,141,1712
Kansas,Hamilton,239,41,77,54,11,7,190
Kansas,Hamlin,48,8,22,2,0,4,36
Kansas,Hanover,586,80,259,45,0,62,446
Kansas,Hanston,265,47,130,20,7,11,215
Kansas,Hardtner,147,26,65,13,2,12,118
Kansas,Harper,1309,338,593,107,21,62,1121
Kansas,Harris,11,0,0,0,0,11,11
Kansas,Hartford,384,119,149,31,3,30,332
Kansas,Harveyville,212,39,109,17,0,9,174
Kansas,Havana,144,9,70,20,3,13,115
Kansas,Haven,1243,308,589,67,0,43,1007
Kansas,Grinnell,276,51,139,26,1,21,238
Kansas,Satanta,1019,172,419,80,25,72,768
Kansas,Salina,47840,11353,17778,5473,608,2761,37973
Kansas,St. Paul,689,140,276,57,11,60,544
Kansas,Newton,19139,3947,7875,2008,178,973,14981
Kansas,Nickerson,1181,198,549,126,13,26,912
Kansas,Niotaze,105,22,43,8,7,7,87
Kansas,Norcatur,185,26,70,35,1,14,146
Kansas,North Newton,1782,614,718,70,10,179,1591
Kansas,Norton,2856,380,1113,356,27,314,2190
Kansas,Nortonville,529,62,243,30,1,46,382
Kansas,Norwich,489,87,236,20,4,28,375
Kansas,Oak Hill,51,27,6,11,0,1,45
Kansas,Oaklawn-Sunview,2906,476,828,532,178,90,2104
Kansas,Oakley,1914,320,901,157,24,176,1578
Kansas,Oberlin,1890,270,831,263,17,199,1580
Kansas,Odin,78,8,50,8,0,0,66
Kansas,Offerle,255,41,132,9,1,7,190
Kansas,Quinter,1007,88,548,57,21,69,783
Kansas,Ogden,2010,413,675,343,0,35,1466
Kansas,Olathe,131508,26333,58094,10394,1034,3352,99207
Kansas,Olivet,84,10,33,26,0,0,69
Kansas,Olmitz,138,24,85,7,0,4,120
Kansas,Olpe,595,72,282,46,8,39,447
Kansas,Olsburg,238,34,110,26,0,8,178
Kansas,Onaga,746,128,306,83,0,88,605
Kansas,Oneida,59,7,36,9,0,2,54
Kansas,Osage City,2885,450,1087,289,55,372,2253
Kansas,Osawatomie,4373,869,1323,766,48,277,3283
Kansas,Osborne,1463,249,638,125,5,173,1190
Kansas,Oskaloosa,1338,322,573,94,17,92,1098
Kansas,Oswego,1847,336,787,177,15,127,1442
Kansas,Otis,334,64,160,33,2,20,279
Kansas,Ottawa,12487,2943,4945,1366,112,705,10071
Kansas,Oketo,69,14,37,1,0,9,61
Kansas,Overland Park,181464,40888,80010,15696,1741,7573,145908
Kansas,Radium,35,2,19,6,0,2,29
Kansas,Randall,90,1,57,2,0,9,69
Kansas,St. Marys,2797,667,1009,119,24,94,1913
Kansas,St. John,1414,235,673,99,7,70,1084
Kansas,St. George,852,142,288,89,6,23,548
Kansas,St. Francis,1239,168,616,121,5,158,1068
Kansas,Sabetha,2557,456,1144,160,26,269,2055
Kansas,Russell Springs,34,0,15,0,0,3,18
Kansas,Russell,4499,751,2001,466,67,389,3674
Kansas,Rush Center,137,16,81,3,0,19,119
Kansas,Rozel,171,27,83,11,2,9,132
Kansas,Roxbury,57,0,57,0,0,0,57
Kansas,Rossville,1177,199,509,127,15,69,919
Kansas,Roseland,64,21,23,9,0,4,57
Kansas,Rose Hill,3961,746,1891,247,17,222,3123
Kansas,Rosalia,86,15,47,7,0,3,72
Kansas,Ramona,116,19,35,15,5,7,81
Kansas,Rolla,463,119,175,48,0,16,358
Kansas,Robinson,234,27,107,17,6,11,168
Kansas,Riverton,934,92,490,166,0,31,779
Kansas,Riley,971,193,364,101,15,52,725
Kansas,Richmond,540,101,206,80,1,45,433
Kansas,Richfield,34,8,22,3,0,0,33
Kansas,Rexford,235,47,95,5,5,12,164
Kansas,Reserve,68,7,33,15,0,4,59
Kansas,Republic,86,11,40,14,0,11,76
Kansas,Redfield,81,23,33,10,0,3,69
Kansas,Reading,298,52,104,24,6,8,194
Kansas,Raymond,65,22,37,5,0,1,65
Kansas,Rantoul,121,25,56,19,6,7,113
Kansas,Ransom,295,28,152,39,0,22,241
Kansas,Randolph,166,33,79,11,0,6,129
Kansas,Roeland Park,6819,2340,2573,572,17,283,5785
Kansas,Hays,20992,7609,7012,1840,104,865,17430
Kansas,Quenemo,424,105,136,56,26,27,350
Kansas,Atchison,10858,3715,3083,1229,75,546,8648
Kansas,Wilroads Gardens,388,48,213,24,0,22,307
Kansas,Wilmore,26,6,14,3,0,3,26
Kansas,Stockton,1334,267,495,169,26,113,1070
Kansas,Strong City,495,92,219,46,18,33,408
Kansas,Sublette,1540,251,762,97,16,82,1208
Kansas,Summerfield,138,12,66,20,0,18,116
Kansas,Sun City,38,0,34,4,0,0,38
Kansas,Susank,32,4,26,2,0,0,32
Kansas,Sylvan Grove,297,45,121,47,5,14,232
Kansas,Sylvia,256,35,101,23,0,8,167
Kansas,Syracuse,1791,313,792,148,27,62,1342
Kansas,Talmage,90,11,31,3,7,11,63
Kansas,Tampa,107,28,42,6,0,13,89
Kansas,Tescott,298,84,105,36,3,14,242
Kansas,Thayer,577,64,268,48,4,17,401
Kansas,Timken,87,15,31,1,4,4,55
Kansas,Tipton,210,39,110,10,0,15,174
Kansas,Tonganoxie,4681,819,2000,430,30,413,3692
Kansas,Topeka,127672,32787,44728,16021,1750,6609,101895
Kansas,Wilsey,164,35,85,15,0,10,145
Kansas,Wilson,750,131,370,58,9,76,644
Kansas,Winchester,565,118,201,90,3,51,463
Kansas,Edwardsville,4372,938,1636,499,72,264,3409
Kansas,Esbon,147,24,74,14,1,6,119
Kansas,Erie,1092,210,468,117,16,56,867
Kansas,Enterprise,975,203,373,111,20,80,787
Kansas,Ensign,218,43,97,22,0,16,178
Kansas,Englewood,84,19,32,10,0,10,71
Kansas,Emporia,24739,8427,7947,2375,317,1129,20195
Kansas,Emmett,128,8,61,10,0,3,82
Kansas,Elwood,1027,197,430,127,23,47,824
Kansas,Elsmore,93,26,33,11,5,3,78
Kansas,Toronto,273,32,106,47,16,29,230
Kansas,Elmdale,49,19,30,0,0,0,49
Kansas,Ellis,2120,318,874,239,0,181,1612
Kansas,Ellinwood,2520,521,1151,183,55,121,2031
Kansas,Elkhart,2159,339,887,241,44,189,1700
Kansas,Elk Falls,57,3,27,11,1,5,47
Kansas,Elk City,285,60,123,19,1,18,221
Kansas,Elgin,98,16,46,10,0,13,85
Kansas,El Dorado,12910,2900,4588,1673,77,744,9982
Kansas,Elbing,285,37,156,13,2,6,214
Kansas,Effingham,621,96,263,27,0,62,448
Kansas,Ellsworth,3075,905,1085,477,56,171,2694
Kansas,Towanda,1625,357,550,173,14,71,1165
Kansas,Tribune,684,106,349,29,0,61,545
Kansas,Troy,991,206,397,112,0,71,786
Kansas,Waterville,674,57,377,51,3,41,529
Kansas,Wathena,1312,232,598,170,4,111,1115
Kansas,Waverly,607,69,238,83,7,73,470
Kansas,Webber,20,3,14,2,0,1,20
Kansas,Weir,585,108,272,64,0,27,471
Kansas,Welda,73,8,49,0,0,16,73
Kansas,Wellington,7997,1609,3264,915,55,610,6453
Kansas,Wellsville,1880,277,755,192,14,103,1341
Kansas,Weskan,207,29,97,22,0,8,156
Kansas,Washington,1166,161,514,119,12,121,927
Kansas,West Mineral,239,41,80,30,29,9,189
Kansas,Westphalia,173,29,66,29,0,10,134
Kansas,Westwood,1795,367,777,168,27,82,1421
Kansas,Westwood Hills,446,71,244,39,2,12,368
Kansas,Wetmore,345,66,148,22,0,25,261
Kansas,Wheaton,156,6,71,2,5,0,84
Kansas,White City,524,87,246,63,4,40,440
Kansas,White Cloud,242,39,68,41,1,14,163
Kansas,Whitewater,700,124,312,60,8,53,557
Kansas,Bentley,542,86,255,39,2,19,401
Kansas,Westmoreland,868,196,374,92,5,44,711
Kansas,Eskridge,531,73,247,76,4,43,443
Kansas,Wamego,4349,907,1931,289,14,237,3378
Kansas,Walnut,301,83,106,27,11,6,233
Kansas,Turon,313,33,129,45,6,32,245
Kansas,Tyro,258,38,114,38,0,18,208
Kansas,Udall,738,161,285,92,9,58,605
Kansas,Ulysses,6022,984,2657,308,147,248,4344
Kansas,Uniontown,441,69,138,37,5,35,284
Kansas,Utica,137,34,56,16,0,22,128
Kansas,Valley Center,6586,1345,2958,566,36,275,5180
Kansas,Valley Falls,1060,246,452,116,12,109,935
Kansas,Vassar,723,71,425,81,0,25,602
Kansas,Walton,255,35,132,31,10,14,222
Kansas,Vermillion,127,27,45,10,4,13,99
Kansas,Vining,45,4,9,6,5,2,26
Kansas,Viola,131,23,69,11,0,7,110
Kansas,Virgil,28,5,12,4,0,6,27
Kansas,Wakarusa,323,5,163,40,37,39,284
Kansas,WaKeeney,1889,289,905,205,5,144,1548
Kansas,Wakefield,1000,179,472,72,9,53,785
Kansas,Waldo,45,3,31,0,0,6,40
Kansas,Waldron,16,4,2,0,0,10,16
Kansas,Wallace,52,9,26,2,0,4,41
Kansas,Victoria,1357,261,628,95,16,75,1075
Kansas,Eudora,6276,1301,2664,513,39,167,4684
Kansas,Eureka,2419,434,883,395,49,198,1959
Kansas,Everest,296,57,121,19,2,50,249
Kansas,Buffalo,312,75,116,32,1,15,239
Kansas,Buhler,1400,184,700,100,4,92,1080
Kansas,Bunker Hill,113,4,54,19,0,9,86
Kansas,Burden,533,81,211,83,2,31,408
Kansas,Burdett,304,54,114,52,2,17,239
Kansas,Burlingame,886,158,350,110,18,53,689
Kansas,Burlington,2629,432,1136,355,35,207,2165
Kansas,Burns,366,91,143,24,2,25,285
Kansas,Burr Oak,166,29,92,22,0,19,162
Kansas,Bucyrus,264,74,130,21,0,11,236
Kansas,Burrton,1046,149,459,129,6,45,788
Kansas,Bushton,264,40,142,17,7,15,221
Kansas,Byers,38,4,16,7,0,2,29
Kansas,Caldwell,1085,196,474,98,31,116,915
Kansas,Cambridge,118,20,52,6,0,14,92
Kansas,Caney,2052,520,711,219,49,164,1663
Kansas,Canton,827,152,416,56,13,30,667
Kansas,Carbondale,1409,268,555,178,14,39,1054
Kansas,Carlton,14,3,9,2,0,0,14
Kansas,Cassoday,103,13,45,13,2,7,80
Kansas,Bushong,42,16,22,0,0,0,38
Kansas,Catharine,53,13,19,13,0,0,45
Kansas,Bucklin,894,104,415,88,23,44,674
Kansas,Brookville,311,59,138,24,1,10,232
Kansas,Winona,240,41,108,25,2,6,182
Kansas,Woodbine,188,33,112,4,0,0,149
Kansas,Woodston,140,33,67,9,4,12,125
Kansas,Wright,102,15,59,11,0,4,89
Kansas,Yates Center,1284,177,543,174,3,141,1038
Kansas,Yoder,242,79,116,0,0,0,195
Kansas,Zenda,97,16,45,5,0,15,81
Kansas,Zurich,104,25,37,23,3,4,92
Kansas,Benton,949,201,344,129,15,43,732
Kansas,Brownell,46,7,30,0,0,0,37
Kansas,Bern,192,13,110,11,0,10,144
Kansas,Bird City,499,99,246,32,4,30,411
Kansas,Bison,196,29,107,20,2,9,167
Kansas,Blue Mound,262,51,114,31,4,16,216
Kansas,Blue Rapids,1018,131,418,120,8,67,744
Kansas,Bluff City,74,9,27,7,7,13,63
Kansas,Bogue,298,33,127,34,5,9,208
Kansas,Bonner Springs,7498,1563,2965,794,84,416,5822
Kansas,Brewster,250,34,146,20,2,16,218
Kansas,Bronson,378,62,159,46,0,16,283
Kansas,Beverly,160,26,48,22,2,13,111
Kansas,Bennington,772,137,317,67,3,35,559
Kansas,Grantville,48,0,30,18,0,0,48
Kansas,Grainfield,329,48,170,12,7,19,256
Kansas,Galatia,14,3,2,2,0,7,14
Kansas,Fulton,137,40,53,8,0,12,113
Kansas,Frontenac,3445,617,1497,327,44,204,2689
Kansas,Freeport,0,0,0,0,0,0,0
Kansas,Fredonia,2455,505,915,338,25,194,1977
Kansas,Frederick,8,0,4,0,0,4,8
Kansas,Franklin,715,237,254,79,0,69,639
Kansas,Frankfort,746,88,404,37,2,91,622
Kansas,Fowler,441,74,190,52,1,44,361
Kansas,Galena,2988,511,1317,277,63,143,2311
Kansas,Fort Scott,7893,1685,3024,1019,100,570,6398
Kansas,Fort Dodge,215,33,4,66,0,112,215
Kansas,Formoso,111,8,42,12,1,4,67
Kansas,Ford,281,84,95,33,0,14,226
Kansas,Fontana,145,28,73,11,0,11,123
Kansas,Florence,415,69,150,80,11,31,341
Kansas,Falun,109,36,64,0,0,9,109
Kansas,Fall River,179,20,98,13,5,7,143
Kansas,Fairway,3964,884,1664,404,63,196,3211
Kansas,Fairview,261,37,121,41,0,20,219
Kansas,Fort Riley,7015,2419,2346,161,31,0,4957
Kansas,Grandview Plaza,2110,278,1009,263,76,61,1687
Kansas,Galesburg,102,11,44,7,0,15,77
Kansas,Garden City,27007,6669,9970,1940,340,1085,20004
Kansas,Gove City,96,12,39,17,0,6,74
Kansas,Gorham,351,58,150,28,5,26,267
Kansas,Goodland,4834,967,1824,486,114,398,3789
Kansas,Goff,111,28,42,10,4,2,86
Kansas,Goessel,605,111,265,42,10,57,485
Kansas,Cawker City,511,87,257,59,0,47,450
Kansas,Goddard,4256,639,1846,270,29,156,2940
Kansas,Glen Elder,507,63,228,46,0,38,375
Kansas,Glasco,460,68,185,66,2,57,378
Kansas,Galva,903,113,488,53,13,35,702
Kansas,Glade,65,21,29,6,0,7,63
Kansas,Geuda Springs,193,29,89,15,0,21,154
Kansas,Geneseo,282,78,117,22,3,24,244
Kansas,Gem,86,14,36,7,0,8,65
Kansas,Gaylord,136,41,41,14,1,9,106
Kansas,Gas,606,66,307,47,0,18,438
Kansas,Garnett,3306,374,1352,413,99,296,2534
Kansas,Garfield,243,52,100,35,5,20,212
Kansas,Gardner,20466,3272,8763,1658,298,446,14437
Kansas,Garden Plain,805,166,366,49,4,62,647
Kansas,Girard,2788,662,1186,255,19,149,2271
Kansas,Winfield,12286,2914,4383,1540,272,851,9960
Kansas,Benedict,57,5,30,4,4,9,52
Kansas,Belvue,241,44,78,24,6,14,166
Kansas,Bendena,69,18,40,0,0,11,69
Kansas,Mayetta,337,96,147,21,1,15,280
Kansas,Mayfield,94,9,48,6,0,4,67
Kansas,Meade,1702,215,772,184,0,150,1321
Kansas,Medicine Lodge,2056,343,896,238,12,132,1621
Kansas,Melvern,510,111,182,59,4,19,375
Kansas,Marysville,3301,591,1399,316,36,294,2636
Kansas,Menlo,34,0,12,1,0,0,13
Kansas,Merriam,11232,3160,4247,1514,122,515,9558
Kansas,Milan,72,11,30,6,11,2,60
Kansas,Mildred,26,0,11,1,0,0,12
Kansas,Milford,507,65,211,67,8,15,366
Kansas,Milton,46,0,31,0,0,7,38
Kansas,Miltonvale,449,86,210,44,6,45,391
Kansas,Meriden,899,166,364,132,8,53,723
Kansas,Marquette,747,137,286,85,27,54,589
Kansas,Marion,1857,268,859,165,8,190,1490
Kansas,Marienthal,16,2,4,10,0,0,16
Kansas,McCune,510,115,194,82,14,17,422
Kansas,McDonald,163,17,94,19,3,8,141
Kansas,McFarland,364,65,152,18,8,27,270
Kansas,Macksville,492,59,246,24,6,23,358
Kansas,McLouth,1282,236,492,132,26,50,936
Kansas,McPherson,13212,2498,6028,1373,46,693,10638
Kansas,Madison,917,117,339,120,32,33,641
Kansas,Mahaska,53,20,21,11,0,0,52
Kansas,Maize,4054,1010,1498,265,76,58,2907
Kansas,Manchester,162,26,55,19,9,13,122
Kansas,Manhattan,55769,27227,16668,3483,308,1235,48921
Kansas,Mankato,812,100,364,85,15,91,655
Kansas,Manter,183,44,89,5,1,19,158
Kansas,Maple Hill,700,90,298,51,0,22,461
Kansas,Mapleton,99,22,27,5,0,10,64
Kansas,Minneapolis,2099,284,980,143,16,158,1581
Kansas,McCracken,195,23,94,26,1,20,164
Kansas,Minneola,733,104,291,91,23,68,577
Kansas,Mission Hills,3572,576,2060,88,11,113,2848
Kansas,Baldwin City,4588,1540,1474,415,21,235,3685
Kansas,Baileyville,173,36,113,3,0,6,158
Kansas,Arma,1469,199,555,253,22,110,1139
Kansas,Asherville,0,0,0,0,0,0,0
Kansas,Ashland,748,107,349,93,8,49,606
Kansas,Assaria,504,82,206,59,2,21,370
Kansas,Barnard,55,6,24,11,0,9,50
Kansas,Axtell,401,52,219,19,6,29,325
Kansas,Atlanta,225,30,106,16,9,16,177
Kansas,Aurora,52,7,21,6,2,0,36
Kansas,Augusta,9242,1660,3482,1050,64,769,7025
Kansas,Auburn,1293,163,567,172,13,71,986
Kansas,Atwood,1021,193,445,90,13,124,865
Kansas,Attica,769,127,319,38,6,45,535
Kansas,Athol,50,3,39,5,0,2,49
Kansas,Munjor,198,0,122,16,0,32,170
Kansas,Munden,131,24,54,14,0,3,95
Kansas,Mulvane,5607,950,2619,692,17,204,4482
Kansas,Mission Woods,183,26,106,14,2,7,155
Kansas,Moline,333,59,150,40,0,42,291
Kansas,Montezuma,978,183,442,81,8,81,795
Kansas,Moran,545,97,217,78,0,64,456
Kansas,Morganville,160,17,72,16,4,6,115
Kansas,Morland,103,26,35,24,0,8,93
Kansas,Morrill,310,32,150,26,5,5,218
Kansas,Morrowville,159,20,95,3,0,5,123
Kansas,Moscow,322,47,152,25,0,3,227
Kansas,Mound City,742,133,345,60,17,30,585
Kansas,Moundridge,1814,306,877,144,4,165,1496
Kansas,Mound Valley,452,79,181,62,5,25,352
Kansas,Mount Hope,755,106,365,76,12,74,633
Kansas,Mulberry,485,54,208,75,13,47,397
Kansas,Mullinville,190,34,80,17,3,18,152
Kansas,Mission,9481,2946,3439,1074,82,396,7937
Kansas,McConnell AFB,1360,306,573,65,0,0,944
Kansas,Matfield Green,50,2,20,19,0,4,45
Kansas,Windom,106,8,61,12,0,5,86
Kansas,Barnes,104,12,62,2,3,8,87
Kansas,Bassett,9,1,6,0,0,1,8
Kansas,Baxter Springs,4114,933,1760,336,72,164,3265
Kansas,Bazine,389,105,141,21,8,34,309
Kansas,Beattie,223,54,113,20,0,11,198
Kansas,Bel Aire,7059,1296,3554,447,38,387,5722
Kansas,Belle Plaine,1706,375,637,151,20,88,1271
Kansas,Belleville,1902,360,754,163,20,315,1612
Kansas,Beloit,3780,768,1782,223,10,295,3078
Kansas,Whiting,217,30,81,32,7,11,161
Kansas,Wichita,387147,97993,141581,39311,5896,16562,301343
Kansas,Willard,90,9,36,12,0,1,58
Kansas,Williamsburg,318,30,154,35,4,15,238
Kansas,Willis,25,3,16,5,0,0,24
Kansas,Willowbrook,83,3,60,0,1,3,67
Kansas,Belpre,188,18,69,12,3,5,107
Kansas,Bartlett,90,23,42,11,3,4,83
Kansas,Basehor,4980,959,2327,518,11,91,3906
Kentucky,Ironville,435,0,191,0,17,107,315
Kentucky,Crestwood,4705,926,1882,491,31,109,3439
Kentucky,Irvine,2223,365,764,474,18,137,1758
Kentucky,Crittenden,3833,628,1275,522,101,136,2662
Kentucky,Frankfort,27535,8075,8403,4357,688,1436,22959
Kentucky,Francisville,9315,1368,4802,354,77,104,6705
Kentucky,Fox Chase,458,72,275,34,3,29,413
Kentucky,Fountain Run,231,32,85,17,10,39,183
Kentucky,Fort Wright,5754,1516,2487,451,91,195,4740
Kentucky,Fort Thomas,16326,3509,6887,1580,148,785,12909
Kentucky,Fort Mitchell,8247,2297,3000,668,154,457,6576
Kentucky,Crestview Hills,3320,926,1412,385,24,217,2964
Kentucky,Irvington,1030,139,406,129,42,102,818
Kentucky,Jeff,281,8,191,0,0,0,199
Kentucky,Jackson,2079,444,700,361,67,188,1760
Kentucky,Lewisburg,789,127,308,90,23,60,608
Kentucky,Leitchfield,6819,1315,2275,958,260,585,5393
Kentucky,Ledbetter,1704,266,696,217,115,84,1378
Kentucky,Lebanon Junction,1861,378,811,200,67,83,1539
Kentucky,Lebanon,5620,1467,1615,638,180,440,4340
Kentucky,Lawrenceburg,11038,1743,4468,1724,195,503,8633
Kentucky,Langdon Place,913,176,438,75,5,33,727
Kentucky,Lancaster,3814,827,1297,477,119,366,3086
Kentucky,Lakeview Heights,309,17,146,44,0,13,220
Kentucky,Lakeside Park,2757,688,1163,284,2,99,2236
Kentucky,La Grange,8387,1999,3090,926,131,464,6610
Kentucky,Island,442,101,198,34,6,28,367
Kentucky,LaFayette,150,28,67,11,4,7,117
Kentucky,Kuttawa,698,77,325,139,7,91,639
Kentucky,Kingsley,381,56,186,43,0,26,311
Kentucky,Kevil,521,92,225,45,10,63,435
Kentucky,Kenvir,359,106,143,12,0,17,278
Kentucky,Kenton Vale,86,9,53,8,2,6,78
Kentucky,Junction City,2494,519,876,453,30,100,1978
Kentucky,Jenkins,2330,558,906,263,27,134,1888
Kentucky,Jeffersonville,1761,270,760,241,54,119,1444
Kentucky,Jeffersontown,26953,6202,11170,2898,259,1221,21750
Kentucky,Fort Knox,9449,2250,3930,286,84,26,6576
Kentucky,Jamestown,2075,487,535,366,59,230,1677
Kentucky,La Center,1080,214,417,119,29,98,877
Kentucky,Fort Campbell North,13936,4247,4847,256,129,0,9479
Kentucky,Flat Lick,936,150,451,93,60,74,828
Kentucky,Fordsville,536,75,174,114,13,54,430
Kentucky,Ekron,203,66,29,14,5,33,147
Kentucky,Elizabethtown,29657,6742,10441,4304,515,1456,23458
Kentucky,Elizaville,223,46,64,10,6,53,179
Kentucky,Elk Creek,1603,285,908,46,0,87,1326
Kentucky,Elkhorn City,898,157,375,136,6,174,848
Kentucky,Elkton,2081,534,580,296,46,152,1608
Kentucky,Elsmere,8489,1932,2834,1221,78,307,6372
Kentucky,Eminence,2515,527,818,337,70,154,1906
Kentucky,Emlyn,349,109,133,38,0,18,298
Kentucky,Erlanger,18510,4137,6776,2092,364,1077,14446
Kentucky,Eubank,317,39,131,36,12,14,232
Kentucky,Edmonton,1656,270,605,304,17,160,1356
Kentucky,Evarts,905,255,272,97,43,71,738
Kentucky,Ezel,225,48,67,73,4,4,196
Kentucky,Fairfield,125,29,56,9,4,11,109
Kentucky,Fairview,235,11,108,0,0,0,119
Kentucky,Fairview,183,29,91,16,0,15,151
Kentucky,Falmouth,2349,592,819,361,34,183,1989
Kentucky,Fancy Farm,593,123,266,56,8,32,485
Kentucky,Farley,4588,947,1578,732,78,350,3685
Kentucky,Farmers,102,52,0,0,26,24,102
Kentucky,Farmington,106,40,44,9,0,6,99
Kentucky,Ferguson,1090,182,467,124,10,79,862
Kentucky,Fincastle,891,182,432,69,5,13,701
Kentucky,Ewing,259,29,120,23,4,17,193
Kentucky,Forest Hills,385,65,183,41,4,32,325
Kentucky,Edgewood,8699,1723,4374,529,71,402,7099
Kentucky,East Bernstadt,920,157,405,59,61,35,717
Kentucky,Florence,31428,6876,11662,4013,455,1767,24773
Kentucky,Flatwoods,7407,1147,3162,791,149,826,6075
Kentucky,Fleming-Neon,926,220,359,106,19,70,774
Kentucky,Crofton,778,95,287,63,20,65,530
Kentucky,Crossgate,270,36,144,15,1,13,209
Kentucky,Cumberland,2245,411,697,275,66,276,1725
Kentucky,Cunningham,200,5,139,8,0,9,161
Kentucky,Cynthiana,6380,1613,1947,952,179,629,5320
Kentucky,Danville,16542,4695,5618,2087,621,1023,14044
Kentucky,Dawson Springs,2737,526,997,410,69,227,2229
Kentucky,Dayton,5381,1572,1707,573,77,289,4218
Kentucky,Eddyville,2603,807,632,638,94,149,2320
Kentucky,Dexter,364,0,248,65,12,8,333
Kentucky,Dixon,1121,254,505,120,48,21,948
Kentucky,Doe Valley,1601,232,892,201,29,84,1438
Kentucky,Douglass Hills,5592,1121,2639,490,20,263,4533
Kentucky,Dover,232,37,102,19,5,11,174
Kentucky,Drakesboro,469,80,202,40,5,23,350
Kentucky,Druid Hills,335,51,150,31,0,15,247
Kentucky,Dry Ridge,2341,469,828,276,43,148,1764
Kentucky,Dunmor,319,66,130,40,11,9,256
Kentucky,Dwale,279,46,33,147,0,25,251
Kentucky,Dycusburg,15,15,0,0,0,0,15
Kentucky,Earlington,1547,398,480,193,62,82,1215
Kentucky,Diablock,334,63,168,0,42,20,293
Kentucky,Flemingsburg,2880,599,965,453,54,387,2458
Kentucky,South Carrollton,120,13,63,18,0,8,102
Kentucky,Somerset,11358,2831,3024,1867,372,1043,9137
Kentucky,Union,5635,996,2728,209,47,58,4038
Kentucky,Trenton,414,91,183,27,7,21,329
Kentucky,Tompkinsville,2061,311,865,319,23,243,1761
Kentucky,Tolu,212,76,67,36,7,13,199
Kentucky,Thornhill,219,35,111,12,1,6,165
Kentucky,Ten Broeck,103,20,66,6,0,7,99
Kentucky,Taylorsville,1126,317,239,206,27,97,886
Kentucky,Taylor Mill,6701,1599,2512,867,19,440,5437
Kentucky,Symsonia,596,95,256,57,0,72,480
Kentucky,Sycamore,159,31,64,38,0,10,143
Kentucky,Summersville,539,0,256,23,14,116,409
Kentucky,Summer Shade,263,55,103,27,0,50,235
Kentucky,Sturgis,2098,394,819,216,37,168,1634
Kentucky,Strathmoor Village,631,156,275,60,12,19,522
Kentucky,Uniontown,732,100,232,163,18,38,551
Kentucky,Strathmoor Manor,356,51,210,22,1,5,289
Kentucky,Stanton,2707,525,859,458,97,246,2185
Kentucky,Stanford,3680,815,1197,405,170,352,2939
Kentucky,Stamping Ground,822,202,316,89,15,43,665
Kentucky,Spring Valley,782,152,385,32,2,12,583
Kentucky,Spring Mill,286,53,149,16,5,18,241
Kentucky,Springfield,2955,870,891,318,25,216,2320
Kentucky,Spottsville,284,0,199,0,0,28,227
Kentucky,Sparta,284,49,120,40,0,9,218
Kentucky,South Williamson,628,93,296,28,26,80,523
Kentucky,South Wallins,632,78,306,43,26,48,501
Kentucky,South Shore,1196,159,462,156,36,148,961
Kentucky,South Park View,4,0,4,0,0,0,4
Kentucky,Smithland,354,63,129,64,9,12,277
Kentucky,Smithfield,79,23,41,10,0,0,74
Kentucky,Stearns,1335,130,730,124,21,20,1025
Kentucky,Slaughters,252,63,88,47,0,9,207
Kentucky,Upton,751,140,331,71,23,41,606
Kentucky,Vanceburg,1491,350,458,236,75,189,1308
Kentucky,Wildwood,277,20,143,28,6,28,225
Kentucky,Wilder,3063,1006,1133,389,47,186,2761
Kentucky,Wickliffe,705,144,267,74,21,51,557
Kentucky,Whitley City,953,365,95,262,65,131,918
Kentucky,Whitesville,473,76,206,38,1,39,360
Kentucky,Whitesburg,2053,296,927,228,59,214,1724
Kentucky,White Plains,944,109,448,105,15,70,747
Kentucky,Wheelwright,937,283,314,121,75,57,850
Kentucky,Wheatcroft,153,34,68,13,3,13,131
Kentucky,Westwood,611,117,313,23,2,27,482
Kentucky,Westwood,4783,854,1972,805,52,312,3995
Kentucky,Westport,202,52,121,5,0,19,197
Kentucky,West Point,955,243,250,124,19,37,673
Kentucky,West Liberty,3298,1125,933,682,102,207,3049
Kentucky,Utica,97,26,49,12,0,0,87
Kentucky,West Buechel,1196,459,274,143,42,45,963
Kentucky,Wayland,370,71,137,34,9,51,302
Kentucky,Waverly,296,46,118,45,8,24,241
Kentucky,Watterson Park,1409,385,384,177,62,39,1047
Kentucky,Water Valley,328,79,96,48,22,25,270
Kentucky,Warsaw,2022,412,713,340,23,132,1620
Kentucky,Warfield,318,50,115,42,15,39,261
Kentucky,Walton,4063,658,1731,357,11,123,2880
Kentucky,Wallins Creek,142,20,54,32,7,12,125
Kentucky,Virgie,269,25,178,23,0,10,236
Kentucky,Vine Grove,5534,834,2453,647,74,322,4330
Kentucky,Villa Hills,7399,2029,3563,526,12,350,6480
Kentucky,Vicco,326,42,108,35,25,20,230
Kentucky,Versailles,8985,2099,3375,1196,187,388,7245
Kentucky,Verona,1141,216,567,80,23,94,980
Kentucky,Wellington,506,100,244,42,0,36,422
Kentucky,Smiths Grove,811,179,364,40,10,47,640
Kentucky,Simpsonville,2618,445,1115,229,28,75,1892
Kentucky,Shively,15570,5009,4269,1882,524,1147,12831
Kentucky,Richmond,32574,13446,7829,3987,546,1891,27699
Kentucky,Richlawn,417,57,216,35,1,16,325
Kentucky,Reidland,4419,592,2314,210,58,148,3322
Kentucky,Raywick,137,35,54,25,0,11,125
Kentucky,Ravenna,473,67,217,66,9,43,402
Kentucky,Radcliff,22913,4978,8965,2256,657,910,17766
Kentucky,Raceland,2932,617,1214,337,107,146,2421
Kentucky,Rabbit Hash,426,117,190,22,0,0,329
Kentucky,Pryorsburg,207,33,30,78,26,5,172
Kentucky,Providence,3125,643,1277,296,23,249,2488
Kentucky,Prospect,4806,681,2871,329,16,177,4074
Kentucky,Princeton,6251,1182,2373,683,127,484,4849
Kentucky,Prestonville,107,24,42,16,2,7,91
Kentucky,Prestonsburg,3398,1022,883,662,54,333,2954
Kentucky,Rineyville,3399,571,1651,217,81,88,2608
Kentucky,Powderly,694,101,364,81,20,51,617
Kentucky,Poole,285,76,56,79,0,15,226
Kentucky,Plum Springs,472,108,201,57,8,18,392
Kentucky,Pleasureville,883,207,293,125,23,34,682
Kentucky,Pleasant View,395,113,171,42,14,23,363
Kentucky,Plantation,822,170,339,79,9,30,627
Kentucky,Plano,1194,220,680,126,0,15,1041
Kentucky,Pippa Passes,527,443,53,11,0,4,511
Kentucky,Pioneer Village,2765,525,1194,319,29,262,2329
Kentucky,Pineville,1629,328,572,238,120,176,1434
Kentucky,Pine Knot,1810,435,761,199,5,90,1490
Kentucky,Pikeville,7038,1719,2530,932,184,395,5760
Kentucky,Southgate,3821,1186,1213,519,7,174,3099
Kentucky,Lewisport,1522,337,529,187,30,118,1201
Kentucky,Sonora,638,119,284,67,5,20,495
Kentucky,Poplar Hills,439,154,97,30,11,8,300
Kentucky,Silver Grove,1154,204,357,190,4,41,796
Kentucky,River Bluff,417,55,230,21,3,16,325
Kentucky,Robards,609,111,280,59,3,26,479
Kentucky,Shepherdsville,11695,2766,4143,1348,212,405,8874
Kentucky,Shelbyville,14782,3089,5514,1701,298,556,11158
Kentucky,Sharpsburg,405,66,149,65,23,34,337
Kentucky,Seneca Gardens,621,87,379,20,0,32,518
Kentucky,Sedalia,352,64,192,59,0,14,329
Kentucky,Sebree,1556,315,566,139,48,106,1174
Kentucky,Scottsville,4335,631,1705,634,159,258,3387
Kentucky,Science Hill,610,112,224,103,23,17,479
Kentucky,Sardis,120,42,33,11,0,17,103
Kentucky,Sandy Hook,548,82,149,85,20,109,445
Kentucky,Sanders,274,94,67,43,16,19,239
Kentucky,Salyersville,1754,308,615,279,35,171,1408
Kentucky,Salvisa,562,135,208,115,0,52,510
Kentucky,Salt Lick,353,93,130,38,17,7,285
Kentucky,Riverwood,503,52,317,12,2,13,396
Kentucky,Salem,809,138,365,95,22,87,707
Kentucky,St. Matthews,17837,5521,5984,2545,275,1085,15410
Kentucky,St. Charles,293,73,98,36,12,24,243
Kentucky,Sadieville,294,49,124,30,2,10,215
Kentucky,Sacramento,406,76,171,42,16,24,329
Kentucky,Ryland Heights,1072,245,464,81,25,52,867
Kentucky,Russellville,7015,1663,2035,1394,252,522,5866
Kentucky,Russell Springs,2491,540,919,384,77,205,2125
Kentucky,Russell,3307,741,1492,290,19,214,2756
Kentucky,Rosine,40,0,40,0,0,0,40
Kentucky,Rolling Hills,832,179,324,139,20,32,694
Kentucky,Rolling Fields,743,96,371,33,6,36,542
Kentucky,Rockport,245,31,92,58,3,18,202
Kentucky,Rockholds,622,65,102,162,0,15,344
Kentucky,Rochester,275,51,71,27,0,43,192
Kentucky,St. Regis Park,1412,232,733,89,5,92,1151
Kentucky,Lexington-Fayette urban,308306,95624,109502,32062,4639,11130,252957
Kentucky,Coldstream,1238,253,543,116,12,31,955
Kentucky,Lincolnshire,147,15,76,13,1,14,119
Kentucky,Cambridge,170,32,48,26,6,17,129
Kentucky,Camargo,1297,287,458,158,19,84,1006
Kentucky,Calvert City,2543,395,984,253,41,178,1851
Kentucky,California,121,21,57,10,6,2,96
Kentucky,Calhoun,894,142,386,147,4,80,759
Kentucky,Cadiz,2618,525,912,300,81,297,2115
Kentucky,Butler,495,76,131,78,18,115,418
Kentucky,Campbellsburg,789,99,349,77,11,64,600
Kentucky,Burnside,888,116,411,116,10,60,713
Kentucky,Burlington,16892,3259,7350,1484,298,430,12821
Kentucky,Burkesville,1414,367,312,260,29,176,1144
Kentucky,Burgin,1238,271,518,127,6,119,1041
Kentucky,Buffalo,482,43,271,45,15,22,396
Kentucky,Buckner,5693,1618,1618,1238,183,138,4795
Kentucky,Buckhorn,125,40,28,14,0,6,88
Kentucky,Brownsville,857,196,302,133,20,156,807
Kentucky,Burna,351,85,214,7,7,0,313
Kentucky,Campbellsville,10983,3051,3359,1617,174,626,8827
Kentucky,Campton,574,146,172,51,37,46,452
Kentucky,Caneyville,649,120,232,87,30,50,519
Kentucky,Clay City,1283,275,248,284,61,94,962
Kentucky,Clay,1048,128,469,176,6,68,847
Kentucky,Claryville,2446,491,941,222,38,99,1791
Kentucky,Clarkson,1036,194,311,198,43,46,792
Kentucky,Chaplin,259,45,129,13,0,43,230
Kentucky,Cerulean,219,18,178,8,0,15,219
Kentucky,Central City,5918,1746,2185,619,136,246,4932
Kentucky,Centertown,367,94,136,50,19,20,319
Kentucky,Cecilia,429,22,230,29,0,16,297
Kentucky,Cayce,82,7,55,7,0,13,82
Kentucky,Cawood,703,188,360,17,33,12,610
Kentucky,Cave City,2210,493,900,172,54,223,1842
Kentucky,Catlettsburg,1959,448,681,327,91,177,1724
Kentucky,Carrsville,34,0,29,2,0,1,32
Kentucky,Carrollton,3933,858,1195,628,62,306,3049
Kentucky,Carlisle,2163,459,837,361,27,190,1874
Kentucky,Cannonsburg,658,254,212,83,0,44,593
Kentucky,Brownsboro Village,314,91,120,48,0,18,277
Kentucky,Phelps,1068,225,418,144,46,53,886
Kentucky,Brownsboro Farm,674,79,322,43,9,21,474
Kentucky,Brooks,2505,612,1059,306,0,116,2093
Kentucky,Woodlawn Park,952,241,402,82,16,35,776
Kentucky,Woodlawn,252,62,106,24,2,4,198
Kentucky,Woodland Hills,774,110,319,93,8,37,567
Kentucky,Woodbury,102,24,48,1,6,6,85
Kentucky,Woodburn,304,57,169,37,1,18,282
Kentucky,Wingo,790,165,309,101,19,58,652
Kentucky,Windy Hills,2348,371,1200,265,23,161,2020
Kentucky,Worthington,1320,217,618,140,45,99,1119
Kentucky,Winchester,18388,3951,6470,2593,597,1277,14888
Kentucky,Willisburg,360,80,134,34,3,26,277
Kentucky,Williamstown,3927,772,1711,298,93,135,3009
Kentucky,Williamsburg,5250,2156,1602,416,51,421,4646
Kentucky,Blaine,69,9,40,2,0,8,59
Kentucky,Blackey,233,69,62,12,12,14,169
Kentucky,Big Clifty,340,65,199,17,0,0,281
Kentucky,Betsy Layne,782,57,323,76,0,49,505
Kentucky,Wilmore,6057,1994,2186,333,92,373,4978
Kentucky,Worthington Hills,1597,409,613,169,16,43,1250
Kentucky,Worthville,227,47,74,46,1,10,178
Kentucky,Crab Orchard,1002,175,388,149,23,78,813
Kentucky,Bromley,790,204,250,131,26,32,643
Kentucky,Broeck Pointe,299,37,167,14,0,7,225
Kentucky,Brodhead,1324,267,443,214,74,89,1087
Kentucky,Briarwood,608,118,203,113,5,42,481
Kentucky,Bremen,137,10,95,14,0,5,124
Kentucky,Brandenburg,2855,766,843,415,96,163,2283
Kentucky,Bradfordsville,317,64,106,41,6,27,244
Kentucky,Bowling Green,61617,22930,17615,6069,1017,2918,50549
Kentucky,Boston,426,107,104,16,0,62,289
Kentucky,Booneville,82,12,44,4,2,7,69
Kentucky,Bonnieville,249,35,85,38,0,19,177
Kentucky,Blue Ridge Manor,827,201,328,123,7,68,727
Kentucky,Bloomfield,965,173,384,137,3,63,760
Kentucky,Blandville,56,10,20,10,0,8,48
Kentucky,Crescent Springs,3976,914,1400,296,60,97,2767
Kentucky,Crestview,378,111,144,29,2,9,295
Kentucky,Liberty,1862,268,744,240,55,260,1567
Kentucky,Brooksville,536,133,153,84,17,47,434
Kentucky,Berry,280,65,145,24,2,9,245
Kentucky,Pewee Valley,1615,322,793,85,21,107,1328
Kentucky,Perryville,1037,356,388,119,34,50,947
Kentucky,Meadowview Estates,340,92,113,66,4,26,301
Kentucky,Melbourne,408,160,151,35,3,15,364
Kentucky,Mentor,224,36,95,9,1,18,159
Kentucky,Middlesborough,9934,2167,3278,1491,182,904,8022
Kentucky,Middletown,7788,1616,3367,1040,35,423,6481
Kentucky,Midway,1733,536,574,176,32,98,1416
Kentucky,Millersburg,911,256,294,124,15,53,742
Kentucky,Meadow Vale,721,109,398,47,2,28,584
Kentucky,Millstone,33,0,0,9,0,24,33
Kentucky,Mockingbird Valley,149,11,95,2,0,9,117
Kentucky,Monterey,84,5,39,13,7,5,69
Kentucky,Monticello,6141,1645,2080,609,121,537,4992
Kentucky,Moorland,392,135,113,100,3,2,353
Kentucky,Morehead,6938,4021,1307,591,63,426,6408
Kentucky,Morganfield,3572,795,1383,504,63,293,3038
Kentucky,Morgantown,2681,484,727,339,177,318,2045
Kentucky,Milton,728,123,261,130,11,48,573
Kentucky,Meadowbrook Farm,99,28,32,11,0,2,73
Kentucky,Maytown,321,62,122,35,0,0,219
Kentucky,Maysville,8924,2156,3495,939,138,652,7380
Kentucky,Coxton,218,20,108,27,13,26,194
Kentucky,Covington,40845,13392,10374,5987,848,2046,32647
Kentucky,Corydon,783,137,311,82,2,53,585
Kentucky,Corinth,231,65,98,31,0,9,203
Kentucky,Corbin,6923,1230,2432,884,236,629,5411
Kentucky,Concord,16,3,9,1,0,2,15
Kentucky,Combs,266,23,148,24,27,0,222
Kentucky,Columbus,156,71,36,16,6,14,143
Kentucky,Columbia,4561,1899,1142,575,55,467,4138
Kentucky,Creekside,308,71,159,36,0,12,278
Kentucky,Cold Spring,6111,1167,2895,559,49,375,5045
Kentucky,Coldiron,137,22,59,48,0,0,129
Kentucky,Coal Run Village,1761,328,747,203,29,87,1394
Kentucky,Cloverport,1110,272,393,169,14,106,954
Kentucky,Clinton,1293,320,328,221,51,167,1087
Kentucky,Cleaton,98,28,45,12,5,3,93
Kentucky,Mays Lick,157,44,71,4,0,28,147
Kentucky,Mortons Gap,1049,197,522,82,0,97,898
Kentucky,Petersburg,462,142,161,107,0,28,438
Kentucky,Mount Olivet,397,64,145,34,0,63,306
Kentucky,Mount Vernon,2814,603,885,358,79,220,2145
Kentucky,Olive Hill,1863,287,761,229,31,181,1489
Kentucky,Oneida,203,95,48,19,5,0,167
Kentucky,Onton,28,0,17,0,0,0,17
Kentucky,Orchard Grass Hills,1836,355,747,132,16,61,1311
Kentucky,Owensboro,58350,13183,21087,7155,1096,3779,46300
Kentucky,Owenton,1688,330,532,244,30,228,1364
Kentucky,Owingsville,1776,361,553,182,68,168,1332
Kentucky,Old Brownsboro Place,393,56,209,16,4,29,314
Kentucky,Paducah,25001,6314,8213,3434,494,2281,20736
Kentucky,Paris,9831,2371,3111,1339,305,785,7911
Kentucky,Park City,475,82,227,62,0,22,393
Kentucky,Park Hills,2990,996,1056,238,78,89,2457
Kentucky,Parkway Village,662,197,242,79,3,39,560
Kentucky,Pathfork,510,110,238,38,4,56,446
Kentucky,Payne Gap,347,92,165,7,6,40,310
Kentucky,Pembroke,852,189,297,92,18,53,649
Kentucky,Paintsville,4251,881,1485,587,31,382,3366
Kentucky,Oakland,204,39,90,24,0,8,161
Kentucky,Oak Grove,7496,1142,3056,484,102,96,4880
Kentucky,Oakbrook,8749,1617,4434,579,80,386,7096
Kentucky,Mount Washington,13736,2801,5591,1589,129,731,10841
Kentucky,Muldraugh,1063,358,300,143,44,53,898
Kentucky,Munfordville,1723,446,506,276,69,148,1445
Kentucky,Murray,18515,8164,4652,1620,378,1051,15865
Kentucky,Murray Hill,556,79,257,27,5,136,504
Kentucky,Nebo,191,27,106,9,2,7,151
Kentucky,New Castle,1071,197,361,85,20,130,793
Kentucky,New Haven,669,121,219,112,14,61,527
Kentucky,New Hope,207,70,77,47,0,0,194
Kentucky,Newport,15428,5436,4252,2209,324,831,13052
Kentucky,Nicholasville,28843,5884,11599,3196,708,886,22273
Kentucky,Norbourne Estates,409,74,202,31,0,20,327
Kentucky,North Corbin,1735,323,663,144,173,119,1422
Kentucky,Northfield,1008,178,473,68,6,68,793
Kentucky,North Middletown,921,226,330,99,9,34,698
Kentucky,Nortonville,1120,208,499,85,17,94,903
Kentucky,Norwood,340,67,166,28,1,10,272
Kentucky,Mount Sterling,7078,1611,2480,1244,128,505,5968
Kentucky,Berea,14454,4475,4897,1604,163,659,11798
Kentucky,Wurtland,1073,154,383,183,15,172,907
Kentucky,Benham,529,59,319,28,4,51,461
Kentucky,Hazard,5415,1084,2271,730,58,502,4645
Kentucky,Hazel,505,93,187,70,26,35,411
Kentucky,Hazel Green,233,54,152,6,0,15,227
Kentucky,Hebron,6102,798,2725,550,114,137,4324
Kentucky,Hebron Estates,1167,187,621,112,20,70,1010
Kentucky,Henderson,28889,6801,10289,3970,697,1921,23678
Kentucky,Hendron,4760,930,2176,434,199,212,3951
Kentucky,Heritage Creek,1026,221,428,127,28,69,873
Kentucky,Hickman,2385,645,824,248,122,182,2021
Kentucky,Hickory,140,114,0,6,0,20,140
Kentucky,Hickory Hill,138,15,83,0,0,7,105
Kentucky,High Bridge,246,0,201,45,0,0,246
Kentucky,Highland Heights,7152,3234,2228,514,53,232,6261
Kentucky,Hills and Dales,167,24,104,5,0,12,145
Kentucky,Hillview,7904,1702,2893,865,216,432,6108
Kentucky,Hindman,786,173,256,55,32,68,584
Kentucky,Hiseville,167,8,119,25,8,0,160
Kentucky,Hodgenville,3226,786,811,611,69,311,2588
Kentucky,Hollow Creek,933,205,453,55,6,56,775
Kentucky,Hawesville,1033,208,403,116,23,58,808
Kentucky,Hollyvilla,424,70,181,46,4,43,344
Kentucky,Hartford,2709,502,1038,316,46,288,2190
Kentucky,Harlan,1607,349,516,186,41,181,1273
Kentucky,Glenview,460,50,319,15,2,19,405
Kentucky,Glenview Hills,392,50,191,6,0,36,283
Kentucky,Glenview Manor,175,29,92,16,1,13,151
Kentucky,Goose Creek,301,48,141,38,0,18,245
Kentucky,Goshen,1054,198,503,87,2,17,807
Kentucky,Gracey,11,0,0,11,0,0,11
Kentucky,Grand Rivers,360,27,221,40,0,21,309
Kentucky,Gratz,64,11,32,6,0,1,50
Kentucky,Benton,4379,806,1799,476,79,436,3596
Kentucky,Grayson,4097,1486,1209,376,62,393,3526
Kentucky,Greensburg,2298,429,788,325,45,283,1870
Kentucky,Green Spring,659,65,383,32,4,29,513
Kentucky,Greenup,1180,352,389,151,24,114,1030
Kentucky,Greenville,4416,775,1643,682,76,454,3630
Kentucky,Guthrie,1682,464,546,198,31,86,1325
Kentucky,Hanson,826,103,351,96,10,119,679
Kentucky,Hardin,625,106,207,98,21,25,457
Kentucky,Hardinsburg,2225,470,877,281,14,219,1861
Kentucky,Hardyville,391,91,219,0,8,6,324
Kentucky,Harrodsburg,8380,1491,2984,1132,172,624,6403
Kentucky,Glencoe,471,83,173,56,13,16,341
Kentucky,Hopkinsville,32483,7977,11513,3602,761,2196,26049
Kentucky,Houston Acres,475,131,186,57,2,33,409
Kentucky,McKinney,344,0,158,21,0,0,179
Kentucky,McKee,958,138,359,98,27,85,707
Kentucky,McHenry,418,87,141,73,7,28,336
Kentucky,Maceo,382,25,257,29,0,0,311
Kentucky,McDowell,824,162,282,99,34,95,672
Kentucky,McCarr,131,14,77,0,4,18,113
Kentucky,Lynnview,1055,237,361,147,38,100,883
Kentucky,Lyndon,11244,2682,4322,1372,198,518,9092
Kentucky,Lynch,649,112,263,93,9,80,557
Kentucky,Ludlow,4547,1653,1425,428,75,152,3733
Kentucky,Loyall,605,116,264,49,5,73,507
Kentucky,Lowes,115,40,53,22,0,0,115
Kentucky,Lovelaceville,141,16,0,49,0,17,82
Kentucky,Louisville/Jefferson County metro government (balance),608732,173874,205573,69063,12036,30796,491342
Kentucky,Louisa,2961,578,1056,308,60,278,2280
Kentucky,Loretto,734,129,304,66,12,68,579
Kentucky,London,8090,1743,2794,1063,397,536,6533
Kentucky,Livingston,121,16,55,10,10,20,111
Kentucky,Livermore,1435,324,548,161,34,79,1146
Kentucky,Mackville,246,36,131,16,0,6,189
Kentucky,Horse Cave,2238,484,804,244,79,203,1814
Kentucky,McRoberts,847,228,348,29,0,123,728
Kentucky,Magnolia,392,113,154,57,6,20,350
Kentucky,Hunters Hollow,367,96,147,52,5,6,306
Kentucky,Hurstbourne,4302,477,2719,168,22,219,3605
Kentucky,Hurstbourne Acres,1799,514,699,192,39,62,1506
Kentucky,Hustonville,602,74,218,70,7,57,426
Kentucky,Hyden,429,132,141,56,17,70,416
Kentucky,Independence,26062,4668,11252,2305,384,747,19356
Kentucky,Indian Hills,2930,389,1814,57,0,105,2365
Kentucky,Inez,657,131,233,85,15,126,590
Kentucky,Mayking,231,33,139,28,0,11,211
Kentucky,Mayfield,10101,2293,3091,1221,235,850,7690
Kentucky,Massac,3938,729,1586,430,93,254,3092
Kentucky,Masonville,1075,170,515,98,0,72,855
Kentucky,Maryhill Estates,164,34,79,6,1,3,123
Kentucky,Martin,713,169,196,122,13,70,570
Kentucky,Marrowbone,52,0,30,13,0,0,43
Kentucky,Marion,3004,569,1111,546,46,258,2530
Kentucky,Manor Creek,304,48,150,11,1,6,216
Kentucky,Manitou,114,8,97,9,0,0,114
Kentucky,Manchester,1489,312,625,173,47,133,1290
Kentucky,Madisonville,19687,4102,7209,2368,519,1342,15540
Kentucky,Glasgow,14224,2865,5029,2228,404,1149,11675
Kentucky,Graymoor-Devondale,2922,528,1299,313,12,348,2500
Kentucky,Ghent,399,83,172,51,6,14,326
Kentucky,Augusta,1102,230,394,163,14,93,894
Kentucky,Gilbertsville,187,0,83,0,0,33,116
Kentucky,Auxier,472,69,275,0,13,21,378
Kentucky,Bancroft,451,71,277,22,2,15,387
Kentucky,Bandana,147,0,131,16,0,0,147
Kentucky,Barbourmeade,1372,180,733,84,23,55,1075
Kentucky,Barbourville,3172,878,773,476,76,395,2598
Kentucky,Bardstown,12930,3401,4002,1578,154,637,9772
Kentucky,Bardwell,760,146,286,98,10,67,607
Kentucky,Barlow,675,122,223,84,32,61,522
Kentucky,Audubon Park,1445,284,842,67,7,59,1259
Kentucky,Beattyville,1501,451,358,216,60,100,1185
Kentucky,Bedford,747,198,232,58,29,33,550
Kentucky,Beech Grove,477,16,205,101,7,0,329
Kentucky,Beechmont,897,171,321,118,57,32,699
Kentucky,Beechwood Village,1302,336,519,139,11,72,1077
Kentucky,Belfry,219,7,125,23,10,0,165
Kentucky,Bellefonte,883,84,524,61,5,71,745
Kentucky,Bellemeade,807,99,396,65,0,90,650
Kentucky,Belleview,530,36,271,48,0,41,396
Kentucky,Bellevue,5921,1425,2404,815,3,335,4982
Kentucky,Bellewood,335,49,157,24,0,23,253
Kentucky,Beaver Dam,3557,818,1346,433,132,130,2859
Kentucky,Auburn,1491,211,484,217,7,153,1072
Kentucky,Crayne,144,8,75,48,0,0,131
Kentucky,Artemus,583,154,294,40,0,52,540
Kentucky,Arlington,380,87,96,73,9,48,313
Kentucky,Anthoston,140,60,61,19,0,0,140
Kentucky,Annville,694,75,372,104,0,48,599
Kentucky,Anchorage,2172,357,1108,78,13,52,1608
Kentucky,Allensville,137,14,66,0,8,9,97
Kentucky,Allen,211,71,77,13,4,12,177
Kentucky,Alexandria,8735,1842,3927,606,43,459,6877
Kentucky,Albany,1874,300,598,347,20,267,1532
Kentucky,Ages,289,53,129,15,0,6,203
Kentucky,Adairville,1048,150,424,109,13,93,789
Kentucky,Arjay,557,117,128,80,11,26,362
Kentucky,Franklin,8643,1822,3070,1133,102,578,6705
Kentucky,Germantown,149,52,49,7,7,15,130
Kentucky,Breckinridge Center,2479,1618,287,134,26,105,2170
Kentucky,Georgetown,30968,6889,12269,2871,589,1014,23632
Kentucky,Garrison,549,51,169,165,13,28,426
Kentucky,Gamaliel,406,83,159,50,1,28,321
Kentucky,Ashland,21391,4249,8228,2659,561,1504,17201
Kentucky,Fulton,2592,536,845,320,71,193,1965
Kentucky,Frenchburg,517,62,158,62,53,36,371
Kentucky,Freeburn,380,35,178,43,0,0,256
Kentucky,Fredonia,494,58,284,28,10,28,408
Louisiana,Maurice village,1498,356,579,197,61,103,1296
Louisiana,Melville,1383,425,251,134,96,94,1000
Louisiana,Meraux,6397,1806,2359,622,67,257,5111
Louisiana,Mermentau village,696,143,269,51,5,35,503
Louisiana,Morse village,890,155,362,79,11,40,647
Louisiana,Mer Rouge village,602,163,144,62,1,66,436
Louisiana,Merrydale,9008,3029,2565,884,234,389,7101
Louisiana,Merryville,1069,258,377,125,32,115,907
Louisiana,Metairie,142715,40799,53755,14357,1934,8803,119648
Louisiana,Milton,2854,531,1346,231,58,0,2166
Louisiana,Morganza village,932,216,286,91,30,64,687
Louisiana,Minden,12887,4074,3475,1125,428,1139,10241
Louisiana,Minorca,1942,503,807,131,49,96,1586
Louisiana,Montegut,1560,498,582,141,0,57,1278
Louisiana,Monterey,693,85,328,42,19,25,499
Louisiana,Montgomery,631,121,263,67,9,40,500
Louisiana,Monticello,5260,1586,1746,540,120,246,4238
Louisiana,Montpelier village,299,40,119,22,13,16,210
Louisiana,Mathews,2387,423,1041,288,16,81,1849
Louisiana,Midway,1458,429,373,103,26,58,989
Louisiana,Monroe,49529,18318,11053,4580,1466,2821,38238
Louisiana,Marrero,31738,9526,9253,3195,722,2285,24981
Louisiana,Moss Bluff,12595,2445,5522,1042,156,615,9780
Louisiana,Mansfield,4995,1863,1083,518,106,313,3883
Louisiana,Mangham,711,192,193,75,2,43,505
Louisiana,Mandeville,12187,2959,5065,1286,132,741,10183
Louisiana,Mamou,3209,773,538,406,126,473,2316
Louisiana,Madisonville,756,134,357,99,17,22,629
Louisiana,McNary village,181,29,80,30,2,9,150
Louisiana,Lydia,611,80,322,18,8,37,465
Louisiana,Lutcher,3415,1070,1265,336,50,282,3003
Louisiana,Mansura,1702,374,448,139,59,192,1212
Louisiana,Montz,2033,416,945,101,21,74,1557
Louisiana,Lucky village,281,85,97,19,14,22,237
Louisiana,Loreauville village,722,173,254,64,29,43,563
Louisiana,Longville,663,208,184,0,0,15,407
Louisiana,Longstreet village,99,19,56,9,4,3,91
Louisiana,Logansport,1937,554,464,163,118,92,1391
Louisiana,Lockport Heights,1386,219,639,187,17,41,1103
Louisiana,Lockport,2556,528,928,361,77,189,2083
Louisiana,Livonia,1619,311,704,149,14,106,1284
Louisiana,Luling,12825,3301,5070,984,95,567,10017
Louisiana,Martin village,595,120,341,23,5,22,511
Louisiana,Many,2810,905,562,373,145,193,2178
Louisiana,Marion,823,289,226,79,12,80,686
Louisiana,Mound village,14,0,6,0,0,2,8
Louisiana,Mount Lebanon,45,6,20,0,3,12,41
Louisiana,Napoleonville village,653,258,126,51,47,31,513
Louisiana,Natalbany,2587,1194,678,195,91,40,2198
Louisiana,Natchez village,486,228,82,56,21,12,399
Louisiana,Natchitoches,18460,7955,4145,1180,387,1120,14787
Louisiana,Newellton,1331,488,230,157,17,86,978
Louisiana,New Iberia,30782,8187,9465,3012,766,1888,23318
Louisiana,Maringouin,871,343,290,65,4,83,785
Louisiana,New Llano,2443,437,932,304,59,93,1825
Louisiana,New Roads,4754,1590,1272,472,101,411,3846
Louisiana,Noble village,280,58,127,16,2,23,226
Louisiana,Norco,2994,692,1388,202,20,167,2469
Louisiana,North Hodge village,507,102,169,52,13,33,369
Louisiana,North Vacherie,2462,666,919,239,9,142,1975
Louisiana,Mooringsport,740,133,279,103,17,57,589
Louisiana,Moonshine,130,43,6,20,0,8,77
Louisiana,Marksville,5594,1658,1582,456,263,369,4328
Louisiana,New Orleans,376738,151366,93343,37848,9407,18903,310867
Louisiana,New Sarpy,1453,457,453,144,37,101,1192
Louisiana,Varnado village,355,73,143,36,2,34,288
Louisiana,Waggaman,9334,2848,2791,1061,193,568,7461
Louisiana,Spokane,266,61,147,11,0,27,246
Louisiana,Spearsville village,122,11,54,13,11,9,98
Louisiana,South Vacherie,3577,843,1618,300,16,232,3009
Louisiana,South Mansfield village,371,163,51,11,21,29,275
Louisiana,Sorrento,1457,339,525,172,30,115,1181
Louisiana,Sorrel,620,120,299,52,0,34,505
Louisiana,Slidell,27567,6498,10828,2718,606,1529,22179
Louisiana,Slaughter,1297,218,628,99,3,51,999
Louisiana,Siracusaville,463,68,136,69,17,19,309
Louisiana,Singer,632,171,134,116,25,92,538
Louisiana,Simsboro village,1239,496,365,92,20,47,1020
Louisiana,Simpson village,706,159,361,22,3,35,580
Louisiana,Simmesport,2003,626,392,146,58,240,1462
Louisiana,Sikes village,146,28,76,6,2,12,124
Louisiana,Sicily Island village,470,135,118,23,28,44,348
Louisiana,Sibley,1358,317,488,165,18,124,1112
Louisiana,Shreveport,200015,64515,56082,20457,5258,12453,158765
Louisiana,St. Francisville,1960,504,628,202,49,89,1472
Louisiana,Moreauville village,927,261,274,123,17,103,778
Louisiana,St. Gabriel,6872,3344,1663,836,156,291,6290
Louisiana,St. James,877,235,331,80,8,31,685
Louisiana,St. Joseph,978,365,157,81,54,100,757
Louisiana,St. Martinville,6105,1952,1503,699,246,435,4835
Louisiana,Springfield,418,107,144,81,0,39,371
Louisiana,St. Maurice,439,201,129,0,32,0,362
Louisiana,Saline village,348,88,94,37,7,16,242
Louisiana,Sarepta,944,161,427,93,9,34,724
Louisiana,Schriever,7142,2219,2360,603,81,413,5676
Louisiana,Scott,8865,2299,3623,845,123,565,7455
Louisiana,Shenandoah,18874,3812,9297,1387,273,620,15389
Louisiana,Shongaloo village,175,11,95,9,0,7,122
Louisiana,St. Rose,8868,2122,2722,1142,58,308,6352
Louisiana,Gretna,17827,5373,5128,2178,637,1042,14358
Louisiana,Springhill,5194,1627,1685,513,157,355,4337
Louisiana,Starks,601,126,196,131,10,54,517
Louisiana,Vivian,3664,1196,870,494,213,323,3096
Louisiana,Violet,6119,1567,2053,594,131,318,4663
Louisiana,Vinton,3379,906,1096,414,151,332,2899
Louisiana,Ville Platte,7327,1993,1861,958,366,546,5724
Louisiana,Village St. George,7294,1848,2888,645,184,215,5780
Louisiana,Vienna Bend,1335,475,391,54,0,32,952
Louisiana,Vienna,480,40,282,29,2,9,362
Louisiana,Vidalia,4195,861,1678,326,92,353,3310
Louisiana,Ventress,1121,321,335,135,0,140,931
Louisiana,Venice,257,57,107,27,0,22,213
Louisiana,Urania,1130,491,344,141,19,42,1037
Louisiana,Union,1051,457,182,83,0,61,783
Louisiana,Turkey Creek village,357,65,127,62,5,19,278
Louisiana,Tullos,435,87,146,41,13,35,322
Louisiana,Triumph,215,34,91,40,0,0,165
Louisiana,Timberlane,10996,2679,3625,1248,204,823,8579
Louisiana,Tickfaw village,646,149,209,39,10,41,448
Louisiana,Start,1041,159,470,82,43,11,765
Louisiana,Sterlington,1873,415,768,183,13,52,1431
Louisiana,Stonewall,2236,313,1029,235,50,141,1768
Louisiana,Sugartown,0,0,0,0,0,0,0
Louisiana,Sulphur,20199,4117,7881,2092,690,1003,15783
Louisiana,Sun village,323,52,129,41,16,20,258
Louisiana,Stanley village,182,47,51,44,0,22,164
Louisiana,Sunset,2919,746,1001,222,31,202,2202
Louisiana,Swartz,4936,1419,1950,416,70,318,4173
Louisiana,Taft,78,16,62,0,0,0,78
Louisiana,Tallulah,7187,2614,1733,710,189,418,5664
Louisiana,Tangipahoa village,607,251,121,95,16,36,519
Louisiana,Terrytown,24910,7379,7886,1887,619,958,18729
Louisiana,Thibodaux,14579,4880,4518,1534,416,1014,12362
Louisiana,Supreme,1036,336,273,55,22,47,733
Louisiana,Morgan City,12019,3234,4005,1119,417,704,9479
Louisiana,Greenwood,3223,470,1330,396,190,169,2555
Louisiana,Iota,1707,399,608,162,31,111,1311
Louisiana,Amite City,4283,1583,1037,485,283,306,3694
Louisiana,Amelia,2408,794,782,213,46,72,1907
Louisiana,Ama,1241,283,456,151,85,79,1054
Louisiana,Alexandria,47985,14140,13301,5279,1622,3227,37569
Louisiana,Albany village,1481,324,509,173,40,63,1109
Louisiana,Addis,4194,786,1658,380,0,123,2947
Louisiana,Abita Springs,2529,496,1059,376,30,180,2141
Louisiana,Abbeville,12381,3172,3349,1557,258,797,9133
Louisiana,Hackberry,1211,121,690,59,5,59,934
Louisiana,Ruston,22185,10746,5117,1447,321,1022,18653
Louisiana,Rosepine,1979,447,647,275,61,144,1574
Louisiana,Roseland,1027,306,236,112,37,91,782
Louisiana,Rosedale village,982,269,347,113,25,50,804
Louisiana,Romeville,257,131,15,15,19,10,190
Louisiana,Rodessa village,241,35,118,16,15,8,192
Louisiana,Rock Hill,216,24,133,39,0,8,204
Louisiana,Robeline village,100,28,43,3,2,16,92
Louisiana,Anacoco village,1046,179,501,79,26,75,860
Louisiana,Roanoke,441,42,316,22,0,38,418
Louisiana,Angie village,252,64,108,26,0,15,213
Louisiana,Arcadia,2897,1059,608,370,82,292,2411
Louisiana,Bayou Cane,21067,4809,8139,2301,264,1135,16648
Louisiana,Bayou Blue,12574,2229,4884,1188,191,530,9022
Louisiana,Bawcomville,3404,577,983,587,159,302,2608
Louisiana,Baton Rouge,229186,90602,57170,22786,5013,12392,187963
Louisiana,Bastrop,10949,4121,2253,942,296,619,8231
Louisiana,Baskin village,310,65,64,33,16,41,219
Louisiana,Basile,1852,516,589,176,93,59,1433
Louisiana,Barataria,859,250,346,70,8,116,790
Louisiana,Banks Springs,1568,496,273,156,41,124,1090
Louisiana,Ball,4000,863,1652,417,157,251,3340
Louisiana,Baldwin,2236,721,649,180,96,202,1848
Louisiana,Baker,13800,4675,3746,1291,373,803,10888
Louisiana,Avondale,5117,1262,1460,584,77,359,3742
Louisiana,Atlanta village,99,15,49,15,1,2,82
Louisiana,Athens village,298,54,123,24,4,26,231
Louisiana,Ashland village,245,41,120,13,0,11,185
Louisiana,Arnaudville,1267,348,453,62,19,89,971
Louisiana,Arabi,4544,1126,1470,545,45,226,3412
Louisiana,River Ridge,13636,2889,6117,1312,253,914,11485
Louisiana,Ringgold,1536,467,283,197,42,151,1140
Louisiana,Ridgecrest,616,123,206,85,21,65,500
Louisiana,Cut Off,5857,1044,2927,217,27,390,4605
Louisiana,Cullen,873,280,242,91,21,92,726
Louisiana,Crowley,13193,3884,3690,1684,245,938,10441
Louisiana,Raceland,10556,2913,3788,1081,268,576,8626
Louisiana,Quitman village,156,21,74,6,2,19,122
Louisiana,Provencal village,632,170,260,47,7,28,512
Louisiana,Prospect,525,107,216,10,0,13,346
Louisiana,Prien,8114,1553,3859,571,77,332,6392
Louisiana,Presquille,1730,297,967,108,0,13,1385
Louisiana,Prairieville,29721,5574,13326,2117,433,862,22312
Louisiana,Poydras,2271,566,893,225,16,177,1877
Louisiana,Powhatan village,126,49,29,3,7,26,114
Louisiana,Port Vincent village,871,156,385,139,17,51,748
Louisiana,Port Sulphur,2053,697,426,134,50,169,1476
Louisiana,Port Barre,1848,420,527,129,95,127,1298
Louisiana,Port Allen,5137,1714,1522,686,98,399,4419
Louisiana,Ponchatoula,6845,1627,2144,478,305,389,4943
Louisiana,Delcambre,2232,522,715,303,64,118,1722
Louisiana,Delhi,2954,772,1054,202,114,176,2318
Louisiana,Delta village,191,39,84,30,0,17,170
Louisiana,Denham Springs,10126,2570,3486,1435,90,564,8145
Louisiana,Richwood,5993,3918,701,701,157,202,5679
Louisiana,Richmond village,544,128,192,60,2,83,465
Louisiana,Reserve,9615,2524,3220,969,173,532,7418
Louisiana,Reeves village,266,44,107,11,0,23,185
Louisiana,Reddell,628,191,186,16,40,64,497
Louisiana,Red Chute,6206,1426,2743,591,147,137,5044
Louisiana,Rayville,3724,1389,813,249,183,258,2892
Louisiana,Rayne,7988,2378,2351,916,252,412,6309
Louisiana,Bayou Corne,132,11,95,11,0,0,117
Louisiana,Doyline village,894,210,334,76,26,59,705
Louisiana,Donaldsonville,7577,2949,1768,582,215,464,5978
Louisiana,Dodson village,403,62,135,35,4,6,242
Louisiana,Dixie Inn village,240,48,62,60,7,17,194
Louisiana,Deville,1577,244,847,19,0,116,1226
Louisiana,Destrehan,10994,2630,4398,1049,150,608,8835
Louisiana,Des Allemands,2054,654,970,175,0,88,1887
Louisiana,DeRidder,10861,2654,3579,1088,455,492,8268
Louisiana,DeQuincy,3179,497,1127,338,196,366,2524
Louisiana,Downsville village,131,28,65,6,3,12,114
Louisiana,Pollock,425,104,132,52,4,33,325
Louisiana,Bayou Country Club,1375,257,696,90,51,71,1165
Louisiana,Bayou Goula,553,314,76,70,0,50,510
Louisiana,Kinder,2870,606,763,314,48,206,1937
Louisiana,Killona,747,373,66,106,8,25,578
Louisiana,Killian,1030,106,534,110,19,34,803
Louisiana,Kilbourne village,427,85,160,53,9,48,355
Louisiana,Kentwood,2213,584,370,366,144,297,1761
Louisiana,Kenner,66993,18731,24261,6681,1409,3768,54850
Louisiana,Keachi,403,82,197,25,4,12,320
Louisiana,Kaplan,4599,1330,1532,530,161,329,3882
Louisiana,Junction City village,409,152,157,38,0,19,366
Louisiana,Joyce,212,15,169,0,0,15,199
Louisiana,Jordan Hill,115,0,95,0,0,0,95
Louisiana,Jonesville,2342,700,619,217,87,165,1788
Louisiana,Jonesboro,4653,1745,887,495,181,435,3743
Louisiana,Jennings,10226,2909,2889,1095,429,868,8190
Louisiana,Jena,3401,566,1687,213,155,340,2961
Louisiana,Jefferson,11061,3702,3265,1545,295,882,9689
Louisiana,Jean Lafitte,2055,483,840,136,35,99,1593
Louisiana,Kraemer,954,175,479,54,8,62,778
Louisiana,Jeanerette,5549,1847,1756,440,195,276,4514
Louisiana,Krotz Springs,1028,227,415,115,28,79,864
Louisiana,Lacassine,431,141,160,36,0,31,368
Louisiana,Lillie village,165,38,71,13,0,28,150
Louisiana,Leonville,845,254,315,69,36,35,709
Louisiana,Lemannville,795,525,79,65,51,15,735
Louisiana,Leesville,6608,1912,2021,756,221,366,5276
Louisiana,Lecompte,972,278,322,102,15,109,826
Louisiana,Lawtell,1744,397,804,99,0,64,1364
Louisiana,Larose,7217,1620,3049,554,93,555,5871
Louisiana,Laplace,28640,7926,10262,2418,709,1457,22772
Louisiana,Lakeview,1072,141,515,138,17,46,857
Louisiana,Lakeshore,1717,327,626,97,100,194,1344
Louisiana,Lake Providence,3830,1309,791,274,67,383,2824
Louisiana,Lake Charles,74190,22958,21277,8031,2257,4651,59174
Louisiana,Lake Arthur,2732,583,892,242,79,195,1991
Louisiana,Lafourche Crossing,2035,455,1066,141,23,38,1723
Louisiana,Lafitte,878,142,419,29,0,71,661
Louisiana,Lafayette,124982,43179,39769,11615,2311,5542,102416
Louisiana,Lacombe,8038,1765,3322,998,102,502,6689
Louisiana,Labadieville,2149,574,953,106,26,70,1729
Louisiana,Jamestown village,218,33,76,44,20,13,186
Louisiana,Jackson,3794,1926,730,561,112,182,3511
Louisiana,Iowa,3110,871,1025,315,99,137,2447
Louisiana,Bourg,2444,457,888,328,32,56,1761
Louisiana,Bossier City,66093,17155,23323,5933,1810,3571,51792
Louisiana,Bordelonville,711,224,126,32,70,65,517
Louisiana,Boothville,883,194,363,62,0,81,700
Louisiana,Bonita village,178,75,69,3,4,8,159
Louisiana,Bogalusa,12006,3136,3341,1350,528,976,9331
Louisiana,Blanchard,2920,467,1406,287,29,151,2340
Louisiana,Bienville village,219,32,111,19,10,9,181
Louisiana,Berwick,4830,1082,1992,444,53,132,3703
Louisiana,Bernice,1270,371,387,78,32,65,933
Louisiana,Benton,1864,508,541,278,32,94,1453
Louisiana,Belmont,489,38,277,46,0,37,398
Louisiana,Belle Rose,1722,639,535,74,46,149,1443
Louisiana,Belle Chasse,13610,2571,6022,1061,99,578,10331
Louisiana,Belcher village,288,57,144,21,5,11,238
Louisiana,Bayou Vista,5103,1295,1772,660,51,254,4032
Louisiana,Bayou L'Ourse,1563,345,673,84,10,70,1182
Louisiana,Boutte,2450,759,934,155,100,70,2018
Louisiana,Hahnville,3540,1154,1402,218,62,172,3008
Louisiana,Hall Summit village,377,82,130,47,4,13,276
Louisiana,Hammond,20272,8843,5059,1532,494,1159,17087
Louisiana,Inniswold,6583,1644,2499,595,85,245,5068
Louisiana,Independence,1613,428,481,207,36,72,1224
Louisiana,Ida village,181,19,106,20,0,21,166
Louisiana,Houma,33982,8924,11934,3568,365,1732,26523
Louisiana,Hosston village,310,49,126,37,6,24,242
Louisiana,Hornbeck,424,97,195,21,8,30,351
Louisiana,Homer,3092,1109,722,289,148,203,2471
Louisiana,Hodge village,352,45,160,46,4,45,300
Louisiana,Bayou Gauche,2154,225,1029,123,0,237,1614
Louisiana,Hester,308,51,177,17,5,11,261
Louisiana,Henderson,1877,485,706,196,45,111,1543
Louisiana,Heflin village,220,43,109,8,0,12,172
Louisiana,Haynesville,2506,623,772,240,93,215,1943
Louisiana,Hayes,886,276,321,58,0,0,655
Louisiana,Haughton,3439,566,1163,734,139,102,2704
Louisiana,Harvey,21085,6675,6763,2009,418,1187,17052
Louisiana,Harrisonburg village,380,134,82,36,17,24,293
Louisiana,Harahan,9328,2245,3377,1096,145,813,7676
Louisiana,Hessmer village,838,144,362,125,15,58,704
Louisiana,Lisbon village,194,47,91,12,8,19,177
Louisiana,Point Place,365,90,198,32,0,9,329
Louisiana,Pleasure Bend,376,25,164,47,24,11,271
Louisiana,Duson,1950,491,505,237,98,63,1394
Louisiana,East Hodge village,322,86,82,15,16,39,238
Louisiana,Eastwood,4986,715,2314,240,74,223,3566
Louisiana,Eden Isle,7183,982,3771,643,236,429,6061
Louisiana,Edgard,2531,762,748,402,48,76,2036
Louisiana,Edgefield village,191,34,70,31,6,8,149
Louisiana,Egan,559,198,230,39,26,38,531
Louisiana,Elizabeth,555,96,218,63,2,10,389
Louisiana,Elmwood,4552,1614,1148,924,111,159,3956
Louisiana,Elton,1278,312,369,118,47,172,1018
Louisiana,Empire,999,216,430,134,23,41,844
Louisiana,Epps village,1221,653,244,101,78,68,1144
Louisiana,Erath,2144,550,775,243,34,189,1791
Louisiana,Eros,173,39,71,14,3,9,136
Louisiana,Erwinville,2010,372,1060,106,64,96,1698
Louisiana,Estelle,15355,4098,5920,1189,193,742,12142
Louisiana,Estherwood village,1025,242,379,76,11,40,748
Louisiana,Dulac,1088,225,488,43,0,235,991
Louisiana,Eunice,10252,3022,2838,1241,340,616,8057
Louisiana,Dubberly village,209,48,94,31,4,23,200
Louisiana,Dry Prong village,520,104,206,25,8,33,376
Louisiana,Cameron,392,52,188,48,0,27,315
Louisiana,Calvin village,230,49,76,30,1,19,175
Louisiana,Calhoun,621,72,266,120,0,0,458
Louisiana,Cade,1428,253,711,149,42,48,1203
Louisiana,Buras,1001,191,407,120,0,76,794
Louisiana,Bunkie,4099,1268,1109,368,43,334,3122
Louisiana,Bryceland village,89,10,36,8,3,8,65
Louisiana,Brusly,2653,512,1295,227,11,85,2130
Louisiana,Brownsville,4193,1189,1256,379,189,197,3210
Louisiana,Brownfields,5456,1367,1678,567,116,331,4059
Louisiana,Broussard,9637,1991,3850,1023,207,297,7368
Louisiana,Bridge City,7027,2318,1813,780,211,289,5411
Louisiana,Breaux Bridge,8286,2181,2601,698,34,572,6086
Louisiana,Branch,255,81,91,54,0,11,237
Louisiana,Boyce,1441,447,413,117,26,99,1102
Louisiana,Gueydan,1559,360,575,172,31,172,1310
Louisiana,Grosse Tete village,738,218,280,40,7,40,585
Louisiana,Dubach,929,225,257,128,40,53,703
Louisiana,Campti,862,328,92,75,23,77,595
Louisiana,Evergreen,262,67,79,34,17,47,244
Louisiana,Fenton village,434,125,94,63,11,56,349
Louisiana,Gilliam village,119,20,59,8,7,10,104
Louisiana,Gillis,495,132,275,32,41,15,495
Louisiana,Glencoe,313,225,22,18,0,12,277
Louisiana,Glenmora,1272,273,393,100,35,111,912
Louisiana,Gloster,101,0,75,0,0,0,75
Louisiana,Golden Meadow,1783,467,587,295,36,126,1511
Louisiana,Goldonna village,373,55,177,39,7,34,312
Louisiana,Gonzales,10319,2723,4084,1069,155,458,8489
Louisiana,Grambling,5067,2933,625,401,120,221,4300
Louisiana,Gramercy,3493,878,1252,383,85,178,2776
Louisiana,Grand Cane village,273,90,114,22,0,19,245
Louisiana,Grand Coteau,889,344,230,90,0,70,734
Louisiana,Grand Isle,1002,221,409,128,9,28,795
Louisiana,Grand Point,2383,439,1087,188,4,114,1832
Louisiana,Gray,5515,1419,1819,503,104,249,4094
Louisiana,Grayson village,382,90,150,59,5,27,331
Louisiana,Greensburg,713,221,250,96,13,44,624
Louisiana,Gilbert village,427,69,144,52,25,31,321
Louisiana,Farmerville,3877,1435,692,309,121,322,2879
Louisiana,Gibsland,938,429,222,91,15,46,803
Louisiana,Garyville,2314,643,863,160,27,94,1787
Louisiana,Ferriday,3438,1128,687,247,107,182,2351
Louisiana,Fifth Ward,735,102,379,42,8,79,610
Louisiana,Fisher village,248,54,120,21,1,8,204
Louisiana,Florien village,420,70,126,37,7,70,310
Louisiana,Folsom village,697,182,261,60,13,39,555
Louisiana,Fordoche,917,176,461,78,20,78,813
Louisiana,Forest village,301,47,149,20,4,18,238
Louisiana,Forest Hill village,713,148,279,22,16,24,489
Louisiana,Fort Jesup,291,104,83,4,0,63,254
Louisiana,Fort Polk North,2391,60,1621,49,0,0,1730
Louisiana,Fort Polk South,9684,2020,3834,214,135,29,6232
Louisiana,Franklin,7435,2438,1924,743,289,458,5852
Louisiana,Franklinton,3793,904,1371,323,51,416,3065
Louisiana,French Settlement village,1349,305,503,211,9,61,1089
Louisiana,Frierson,530,83,203,0,0,93,379
Louisiana,Galliano,7510,1495,2922,823,108,511,5859
Louisiana,Gardere,10908,4486,2274,864,293,47,7964
Louisiana,Georgetown village,389,83,142,29,11,16,281
Louisiana,Pointe a la Hache,188,110,58,20,0,0,188
Louisiana,Cankton village,641,192,225,32,12,9,470
Louisiana,Carlyss,4896,963,1939,582,97,119,3700
Louisiana,Oil City,958,281,208,102,51,86,728
Louisiana,Oberlin,1969,492,538,261,37,173,1501
Louisiana,Oak Ridge village,118,5,61,11,0,6,83
Louisiana,Oak Hills Place,8487,1976,4041,608,146,375,7146
Louisiana,Oak Grove,1497,299,492,204,27,162,1184
Louisiana,Oakdale,7722,2191,2176,1181,395,554,6497
Louisiana,Norwood village,285,47,132,30,11,23,243
Louisiana,Crescent,409,28,167,71,29,70,365
Louisiana,Walker,6205,1486,2067,967,87,362,4969
Louisiana,Wallace,662,165,284,0,0,59,508
Louisiana,Wallace Ridge,286,27,156,14,0,38,235
Louisiana,Washington,725,232,178,40,62,66,578
Louisiana,Waterproof,854,366,95,70,42,64,637
Louisiana,Watson,905,39,489,116,0,98,742
Louisiana,Welcome,971,309,254,63,0,26,652
Louisiana,Welsh,3223,751,971,336,31,244,2333
Louisiana,Westlake,4606,991,1670,656,89,320,3726
Louisiana,Old Jefferson,6999,1561,3106,742,48,202,5659
Louisiana,Westminster,2996,505,1494,224,23,164,2410
Louisiana,Olla,1165,152,501,116,27,82,878
Louisiana,Oretta,542,48,337,7,0,17,409
Louisiana,Pleasant Hill village,704,210,211,94,2,59,576
Louisiana,Plaucheville village,178,46,60,14,6,15,141
Louisiana,Plaquemine,6993,1720,1945,767,207,601,5240
Louisiana,Plain Dealing,1009,335,257,53,44,107,796
Louisiana,Pitkin,493,59,217,99,0,41,416
Louisiana,Pioneer village,163,54,57,15,4,10,140
Louisiana,Pineville,14455,4272,4141,1739,379,863,11394
Louisiana,Pine Prairie village,1319,451,376,165,44,108,1144
Louisiana,Pierre Part,2555,537,1183,267,47,137,2171
Louisiana,Pearl River,2466,475,954,292,57,177,1955
Louisiana,Paulina,1149,234,531,52,14,43,874
Louisiana,Patterson,6106,1797,1949,549,168,357,4820
Louisiana,Parks village,668,168,279,100,12,36,595
Louisiana,Paradis,1304,299,538,97,0,36,970
Louisiana,Palmetto village,152,59,13,16,2,40,130
Louisiana,Paincourtville,1017,165,447,38,9,78,737
Louisiana,Ossun,2528,614,660,118,115,148,1655
Louisiana,Opelousas,16638,5511,3583,1467,566,1269,12396
Louisiana,Carencro,8269,2482,2610,795,232,446,6565
Louisiana,West Monroe,13032,3563,4152,1533,244,982,10474
Louisiana,White Castle,2241,780,380,246,52,218,1676
Louisiana,Clarence village,358,155,64,36,6,28,289
Louisiana,Claiborne,11760,2666,4751,816,218,638,9089
Louisiana,Church Point,4525,1151,1179,776,225,275,3606
Louisiana,Choudrant village,1200,304,526,86,13,41,970
Louisiana,Choctaw,842,174,390,53,21,62,700
Louisiana,Cheneyville,492,169,116,55,19,40,399
Louisiana,Chauvin,2945,639,1176,237,67,121,2240
Louisiana,Chatham,671,155,206,62,17,98,538
Louisiana,Chataignier village,363,112,121,29,11,24,297
Louisiana,Charenton,1731,426,535,296,17,211,1485
Louisiana,Chalmette,21311,5982,6477,2393,315,1104,16271
Louisiana,Chackbay,5162,986,2097,467,56,225,3831
Louisiana,Central,27768,4813,13676,2382,270,1465,22606
Louisiana,Center Point,332,67,59,30,11,110,277
Louisiana,Cecilia,1183,167,539,135,0,25,866
Louisiana,Catahoula,923,80,403,33,0,52,568
Louisiana,Castor village,299,33,112,13,14,16,188
Louisiana,Clarks village,995,426,252,122,15,31,846
Louisiana,Westwego,8564,2186,2445,1435,213,660,6939
Louisiana,Clayton,571,206,124,66,17,49,462
Louisiana,Colfax,1706,447,372,241,64,135,1259
Louisiana,Wilson village,548,123,142,74,20,45,404
Louisiana,Winnfield,4666,1157,1337,545,207,371,3617
Louisiana,Winnsboro,4811,1340,782,496,249,476,3343
Louisiana,Wisner,923,227,265,55,47,114,708
Louisiana,Woodmere,12161,4115,3866,1187,176,336,9680
Louisiana,Woodworth,1121,160,507,188,18,86,959
Louisiana,Youngsville,10109,1786,4467,619,45,241,7158
Louisiana,Zachary,15868,3509,6078,1247,218,864,11916
Louisiana,Clinton,1401,452,347,183,46,100,1128
Louisiana,Zwolle,2134,623,565,165,85,136,1574
Louisiana,Covington,9350,2642,3169,1120,269,497,7697
Louisiana,Coushatta,2539,906,469,246,99,142,1862
Louisiana,Cotton Valley,1055,198,317,151,50,71,787
Louisiana,Cottonport,1997,686,474,153,25,75,1413
Louisiana,Converse village,412,82,180,33,2,40,337
Louisiana,Convent,628,281,183,53,0,9,526
Louisiana,Columbia,432,147,165,26,4,30,372
Louisiana,Collinston village,216,66,74,13,12,28,193
Louisiana,Creola village,278,79,59,18,19,3,178
Louisiana,Livingston,2035,417,759,260,33,155,1624
Maine,Ashland,606,100,314,33,8,46,501
Maine,Auburn,22916,5674,8608,2858,282,1222,18644
Maine,Blaine,438,83,198,40,0,24,345
Maine,Mechanic Falls,1649,211,689,246,0,92,1238
Maine,Mexico,1574,448,433,248,29,158,1316
Maine,Milford,2239,497,1117,107,39,124,1884
Maine,Millinocket,4419,825,1951,650,42,235,3703
Maine,Milo,1923,351,649,328,92,129,1549
Maine,Naples,462,60,254,26,31,48,419
Maine,Newcastle,697,139,255,120,21,65,600
Maine,Newport,1616,320,542,376,34,67,1339
Maine,Norridgewock,1198,281,522,180,0,93,1076
Maine,North Berwick,1792,514,584,156,39,142,1435
Maine,North Windham,4671,1181,1827,515,47,189,3759
Maine,Mars Hill,956,209,428,100,15,79,831
Maine,Norway,2341,450,802,242,28,256,1778
Maine,Old Orchard Beach,8697,1958,3449,1595,189,601,7792
Maine,Old Town,7726,2546,2906,695,26,413,6586
Maine,Orono,9522,6317,1667,488,15,471,8958
Maine,Oxford,1538,245,679,233,0,125,1282
Maine,Pittsfield,3110,807,1047,416,18,180,2468
Maine,Portland,66490,24988,20839,7877,457,2775,56936
Maine,Presque Isle,9378,2546,3771,956,107,635,8015
Maine,Randolph,1792,511,628,254,21,138,1552
Maine,Richmond,1942,440,797,222,12,111,1582
Maine,Rockland,7233,1771,2527,1378,37,554,6267
Maine,Rumford,4214,1457,1308,518,101,292,3676
Maine,Oakland,2448,606,1045,374,17,226,2268
Maine,Mapleton,763,188,272,109,6,29,604
Maine,Madison,2372,566,874,141,46,312,1939
Maine,Madawaska,2623,413,1315,269,44,235,2276
Maine,Anson,791,227,295,58,0,48,628
Maine,Fryeburg,1797,485,768,222,9,74,1558
Maine,Gardiner,5697,1494,2377,576,45,239,4731
Maine,Gorham,6445,2157,2428,630,27,336,5578
Maine,Gray,1225,100,497,112,0,26,735
Maine,Greenville,1453,292,448,193,0,89,1022
Maine,Guilford,1031,218,367,188,49,60,882
Maine,Hallowell,2514,834,850,295,17,221,2217
Maine,Hartland,768,202,260,102,0,69,633
Maine,Houlton,4778,1106,1908,567,28,516,4125
Maine,Howland,1193,185,547,106,11,109,958
Maine,Kennebunk,5621,1168,2658,591,0,462,4879
Maine,Kennebunkport,1078,98,642,99,0,55,894
Maine,Kittery,4515,876,1970,783,50,282,3961
Maine,Kittery Point,1112,90,534,322,0,86,1032
Maine,Lake Arrowhead,2477,543,1059,159,5,117,1883
Maine,Lewiston,36356,10248,12477,4730,557,2083,30095
Maine,Limestone,1257,421,453,75,4,102,1055
Maine,Lincoln,2688,487,889,333,217,268,2194
Maine,Lisbon Falls,4128,1157,1521,523,21,115,3337
Maine,Little Falls,382,168,88,57,12,1,326
Maine,Littlejohn Island,78,0,40,38,0,0,78
Maine,Livermore Falls,1366,256,459,242,18,130,1105
Maine,Lubec,377,84,176,52,3,40,355
Maine,Machias,1206,300,346,233,8,101,988
Maine,Saco,18874,4810,8038,1938,311,959,16056
Maine,Alfred,658,121,275,155,7,57,615
Maine,Sanford,20864,4694,7885,2762,237,1240,16818
Maine,Searsport,1059,281,453,159,0,94,987
Maine,Cumberland Center,2664,474,1122,367,15,36,2014
Maine,Cousins Island,565,93,328,42,0,20,483
Maine,Clinton,1076,205,492,160,9,55,921
Maine,Chisholm,1209,200,553,170,10,26,959
Maine,Castine,959,730,149,19,0,33,931
Maine,Casco,646,256,243,9,0,25,533
Maine,Caribou,7960,1753,3179,1083,82,591,6688
Maine,Cape Neddick,2780,526,1531,238,0,208,2503
Maine,Camden,3304,614,1511,531,31,336,3023
Maine,Calais,3038,633,1205,425,0,274,2537
Maine,Bucksport,2481,646,831,356,50,112,1995
Maine,Damariscotta,1095,271,292,172,4,208,947
Maine,Brunswick Station,510,131,196,51,0,14,392
Maine,Bridgton,2214,616,830,358,15,95,1914
Maine,Brewer,9341,1993,4184,858,82,610,7727
Maine,Bowdoinham,520,96,230,69,0,12,407
Maine,Boothbay Harbor,922,165,371,147,0,157,840
Maine,Blue Hill,1000,151,453,192,0,116,912
Maine,Bingham,605,73,240,112,9,76,510
Maine,Biddeford,21289,7214,7073,2375,156,1128,17946
Maine,Berwick,2412,601,893,164,27,123,1808
Maine,Belfast,6668,1437,2521,798,23,506,5285
Maine,Bath,8349,1879,3184,848,175,436,6522
Maine,Bar Harbor,2585,1240,582,287,27,124,2260
Maine,Brunswick,15453,4484,6059,1886,118,870,13417
Maine,Dexter,2087,499,618,399,85,155,1756
Maine,Dixfield,1039,255,392,96,0,44,787
Maine,Dover-Foxcroft,2445,611,1018,311,22,213,2175
Maine,Skowhegan,6260,1654,1875,929,15,611,5084
Maine,South Eliot,3740,715,1699,409,13,281,3117
Maine,South Paris,2854,921,834,626,118,48,2547
Maine,South Portland,25304,7652,8874,3152,334,1252,21264
Maine,Southwest Harbor,753,234,298,98,0,77,707
Maine,South Windham,1140,528,261,261,2,60,1112
Maine,Standish,393,47,171,132,0,27,377
Maine,Steep Falls,1227,342,578,24,0,0,944
Maine,Thomaston,2031,426,738,319,51,80,1614
Maine,Topsham,6483,1530,2674,761,22,535,5522
Maine,Unity,529,133,155,69,0,66,423
Maine,Van Buren,1877,401,775,184,14,227,1601
Maine,Waldoboro,1135,283,528,78,14,101,1004
Maine,Freeport,1507,262,690,165,7,67,1191
Maine,Fort Kent,2345,742,1033,157,21,144,2097
Maine,Fort Fairfield,1763,284,731,267,0,180,1462
Maine,Farmington,3795,1979,845,422,56,273,3575
Maine,Farmingdale,1969,470,656,383,14,126,1649
Maine,Falmouth Foreside,1702,301,773,186,0,189,1449
Maine,Falmouth,2051,609,820,226,55,94,1804
Maine,Fairfield,3105,526,1295,404,92,116,2433
Maine,Ellsworth,7832,1556,3193,1159,70,542,6520
Maine,Eastport,1365,303,611,169,4,145,1232
Maine,East Millinocket,1717,373,714,205,10,126,1428
Maine,Eagle Lake,530,103,240,63,0,49,455
Maine,Scarborough,4601,883,2021,520,33,233,3690
Maine,Washburn,948,139,475,105,25,51,795
Maine,Hampden,3468,818,1667,309,0,278,3072
Maine,Wiscasset,1193,450,311,281,0,49,1091
Maine,Winthrop,2651,396,1114,465,0,141,2116
Maine,Winslow,7661,1633,3075,1128,19,484,6339
Maine,Woodland,869,189,357,140,15,35,736
Maine,Wilton,2036,450,766,308,33,50,1607
Maine,Yarmouth,5628,1214,2485,635,31,349,4714
Maine,York Harbor,3003,726,1297,431,15,199,2668
Maine,West Kennebunk,1062,171,513,62,1,61,808
Maine,Winterport,1110,273,517,121,0,72,983
Maine,Westbrook,17754,5199,6397,2148,283,1020,15047
Maine,Augusta,18772,4699,6432,3193,282,1105,15711
Maine,Waterville,15989,5716,4734,2058,146,944,13598
Maine,Bangor,32695,11226,9702,4463,380,1770,27541
Maine,Winter Harbor,398,81,169,40,2,34,326
Maryland,Peppermill Village,4785,1708,912,553,148,417,3738
Maryland,Pecktonville,170,33,53,20,12,0,118
Maryland,Pasadena,25895,5857,11106,2270,421,1088,20742
Maryland,Parsonsburg,309,0,234,15,0,0,249
Maryland,Martin's Additions village,976,162,520,34,8,19,743
Maryland,Easton,16599,3507,6842,1807,357,1312,13825
Maryland,Perry Hall,28633,6806,12547,2394,494,1661,23902
Maryland,Perryman,2811,770,682,315,135,305,2207
Maryland,Perryville,4427,1044,1775,530,89,143,3581
Maryland,Pikesville,32149,6576,14341,2805,596,2435,26753
Maryland,Pinesburg,365,46,220,43,8,8,325
Maryland,Piney Point,803,203,365,64,16,53,701
Maryland,Marlton,9391,3257,3210,688,133,283,7571
Maryland,Marlow Heights,5676,2012,1345,550,193,414,4514
Maryland,Marlboro Village,10457,4037,2677,1070,236,153,8173
Maryland,Parole,16764,3829,7154,2017,350,1602,14952
Maryland,Parkville,32163,10484,10635,2893,665,1720,26397
Maryland,Paramount-Long Meadow,2605,309,1309,229,31,199,2077
Maryland,Oxon Hill,18437,6765,5576,1806,476,958,15581
Maryland,National Harbor,3837,1718,1066,357,112,49,3302
Maryland,Naval Academy,5630,5131,343,20,0,3,5497
Maryland,Newark,329,61,165,23,0,8,257
Maryland,New Carrollton,12542,4161,3871,1059,298,445,9834
Maryland,New Market,951,129,422,68,6,19,644
Maryland,New Windsor,1145,218,478,104,7,74,881
Maryland,Nikep,88,26,32,0,10,0,68
Maryland,North Beach,2311,655,693,308,101,118,1875
Maryland,North Bethesda,48818,14095,19977,3937,590,2204,40803
Maryland,North Brentwood,518,181,139,63,21,38,442
Maryland,North Chevy Chase village,486,63,287,32,0,16,398
Maryland,North East,3700,671,1720,390,12,221,3014
Maryland,Marlboro Meadows,3657,1206,1070,451,188,219,3134
Maryland,North Kensington,9768,2547,4048,771,221,385,7972
Maryland,North Potomac,24087,4588,12593,1161,282,628,19252
Maryland,Oakland,2102,555,785,224,45,266,1875
Maryland,Ocean,10,0,0,0,0,10,10
Maryland,Ocean City,7074,1426,3374,837,63,738,6438
Maryland,Ocean Pines,11025,1568,6160,1141,114,803,9786
Maryland,Odenton,38374,8720,16076,3193,551,1897,30437
Maryland,Oldtown,114,72,28,0,0,8,108
Maryland,Olney,35090,8368,16890,2038,407,1078,28781
Maryland,Overlea,12206,3092,4573,1351,278,900,10194
Maryland,Owings,2638,603,1153,181,25,104,2066
Maryland,Owings Mills,33732,11383,10436,3131,681,1152,26783
Maryland,Oxford,545,61,305,42,11,60,479
Maryland,North Laurel,22217,5950,8686,1356,336,618,16946
Maryland,Mardela Springs,308,74,91,57,8,13,243
Maryland,Lutherville,6600,1475,3033,412,70,417,5407
Maryland,Manchester,4814,935,2209,345,33,237,3759
Maryland,Langley Park,21049,9832,5149,716,504,284,16485
Maryland,Landover Hills,1903,540,652,157,76,29,1454
Maryland,Landover,23218,9130,4995,1840,1080,899,17944
Maryland,Lake Shore,19375,3793,9981,1257,84,726,15841
Maryland,Lake Arbor,10414,3615,3083,1306,276,378,8658
Maryland,Konterra,2416,479,1079,261,21,102,1942
Maryland,Klondike,132,52,33,0,0,16,101
Maryland,Kitzmiller,275,70,128,27,6,14,245
Maryland,Kingsville,4387,802,2375,199,59,332,3767
Maryland,Kingstown,1923,398,764,229,63,116,1570
Maryland,Kettering,13195,4221,4477,1452,282,734,11166
Maryland,Kent Narrows,441,53,239,98,0,51,441
Maryland,Kensington,1990,315,907,174,14,83,1493
Maryland,Kennedyville,177,10,51,26,0,8,95
Maryland,Kemps Mill,107,43,32,0,32,0,107
Maryland,Kemp Mill,12285,2467,5732,836,80,565,9680
Maryland,Keedysville,1185,178,584,83,19,44,908
Maryland,Jugtown,212,51,129,19,0,0,199
Maryland,Joppatowne,12684,2777,5505,1241,298,614,10435
Maryland,Jesterville,323,18,120,64,121,0,323
Maryland,Jessup,7671,4119,1558,1022,299,262,7260
Maryland,Lanham,10967,3296,3769,653,256,317,8291
Maryland,Mapleville,229,31,126,0,0,38,195
Maryland,Lansdowne,8490,2713,2240,682,248,498,6381
Maryland,Largo,11015,4585,3072,1027,284,372,9340
Maryland,Madison,204,39,120,7,0,24,190
Maryland,McCoole,355,50,204,15,0,36,305
Maryland,National,58,0,24,0,0,11,35
Maryland,Lusby,1632,352,544,197,1,129,1223
Maryland,Luke,97,27,46,2,1,5,81
Maryland,Long Beach,2219,666,936,139,47,103,1891
Maryland,Lonaconing,1088,230,425,120,9,141,925
Maryland,Loch Lynn Heights,681,157,268,38,17,35,515
Maryland,Lochearn,26070,8530,8652,2292,807,1667,21948
Maryland,Little Orleans,28,0,18,0,0,10,28
Maryland,Linthicum,10699,2253,4785,963,146,698,8845
Maryland,Linganore,9082,1397,4497,657,101,224,6876
Maryland,Libertytown,1261,283,527,198,19,25,1052
Maryland,Lexington Park,12642,3202,4201,1253,377,148,9181
Maryland,Leonardtown,3392,702,1284,301,21,346,2654
Maryland,Leitersburg,621,145,269,73,51,40,578
Maryland,Leisure World,9227,1346,3986,1156,98,2440,9026
Maryland,Laytonsville,337,80,163,35,0,12,290
Maryland,Layhill,5051,1487,1989,367,133,296,4272
Maryland,La Vale,3265,642,1560,279,71,192,2744
Maryland,Laurel,25849,8389,8010,2426,595,837,20257
Maryland,La Plata,8994,2372,3138,886,79,477,6952
Maryland,Nanticoke Acres,228,114,35,39,0,0,188
Maryland,Mount Airy,9353,1890,4127,649,99,377,7142
Maryland,Myersville,1812,322,935,71,8,20,1356
Maryland,Crofton,27934,5889,12273,1859,603,891,21515
Maryland,Crisfield,2685,812,620,298,8,250,1988
Maryland,Cresaptown,6127,2921,1717,703,67,280,5688
Maryland,Crellin,203,53,21,50,16,46,186
Maryland,Cottage City,1151,360,309,139,69,88,965
Maryland,Corriganville,424,106,172,39,0,43,360
Maryland,Cordova,682,100,337,64,19,26,546
Maryland,Coral Hills,9842,3999,1956,898,486,575,7914
Maryland,Mercersville,61,10,0,42,0,9,61
Maryland,Croom,3107,590,1606,359,51,109,2715
Maryland,Melwood,2763,612,1135,315,80,173,2315
Maryland,Mays Chapel,11774,2138,5975,838,160,441,9552
Maryland,Jennings,110,17,57,6,0,16,96
Maryland,East Riverdale,16242,5736,4360,869,489,492,11946
Maryland,Eckhart Mines,891,81,519,116,0,51,767
Maryland,Eden,670,155,98,112,106,89,560
Maryland,Edesville,182,65,54,19,0,44,182
Maryland,Edgemere,8443,2088,3418,871,238,706,7321
Maryland,Edgemont,178,25,117,0,0,36,178
Maryland,Edgewater,9583,2097,3912,1276,166,267,7718
Maryland,Mechanicsville,1937,329,946,153,11,9,1448
Maryland,Crownsville,1967,403,994,117,0,44,1558
Maryland,Cumberland,20449,5462,6501,2684,396,1640,16683
Maryland,Damascus,15267,3326,7082,799,202,463,11872
Maryland,East New Market,458,134,155,35,5,24,353
Maryland,Eakles Mill,0,0,0,0,0,0,0
Maryland,Eagle Harbor,41,15,13,2,2,0,32
Maryland,Dunkirk,2303,417,1037,214,40,121,1829
Maryland,Dundalk,62349,17685,20319,6407,1861,4648,50920
Maryland,Drum Point,3149,728,1519,258,75,58,2638
Maryland,Downsville,347,40,152,66,0,9,267
Maryland,District Heights,6036,2088,1495,620,162,373,4738
Maryland,Detmold,36,0,36,0,0,0,36
Maryland,Derwood,2169,451,994,111,15,56,1627
Maryland,Denton,4357,1207,1340,358,97,333,3335
Maryland,Delmar,3026,832,1042,293,51,144,2362
Maryland,Deer Park,474,86,213,37,7,29,372
Maryland,Deal Island,353,47,202,30,0,41,320
Maryland,Deale,5095,957,2511,459,129,133,4189
Maryland,Dawson,143,47,75,0,0,9,131
Maryland,Darnestown,6784,1259,3806,177,20,197,5459
Maryland,Darlington,481,110,252,42,9,14,427
Maryland,Dargan,157,44,78,18,0,0,140
Maryland,Danville,364,156,183,0,0,25,364
Maryland,Dames Quarter,152,22,49,3,25,13,112
Maryland,Edgewood,26060,7181,8857,2626,622,753,20039
Maryland,Edmonston,1445,602,416,104,30,28,1180
Maryland,Eldersburg,31494,6338,14992,2102,461,1382,25275
Maryland,Eldorado,57,8,22,6,1,1,38
Maryland,Maugansville,3573,742,1585,83,59,199,2668
Maryland,Maryland City,17060,4580,6242,2357,338,155,13672
Maryland,Marydel,204,62,60,20,8,0,150
Maryland,Middle River,25816,6906,9006,2435,531,1299,20177
Maryland,Middletown,4432,907,2293,175,16,157,3548
Maryland,Midland,651,147,259,91,11,59,567
Maryland,Midlothian,344,116,99,20,0,22,257
Maryland,Milford Mill,30085,10593,8322,2846,773,1445,23979
Maryland,Millington,620,185,216,84,29,27,541
Maryland,Mitchellville,10475,3335,4000,923,191,483,8932
Maryland,Monrovia,285,70,165,29,0,0,264
Maryland,Montgomery Village,33337,9255,12658,2761,675,1082,26431
Maryland,Morningside,1525,822,292,144,40,64,1362
Maryland,Moscow,232,64,152,0,0,8,224
Maryland,Mount Aetna,650,180,342,14,0,10,546
Maryland,Mountain Lake Park,2641,625,1026,329,55,117,2152
Maryland,Mount Briar,234,105,80,0,0,16,201
Maryland,Mount Lena,523,147,223,34,13,14,431
Maryland,Mount Rainier,8329,3213,2092,619,442,187,6553
Maryland,Mount Savage,776,228,364,24,15,68,699
Maryland,Mount Vernon,810,117,360,98,0,16,591
Maryland,Mayo,8779,1664,4333,784,38,405,7224
Maryland,Nanticoke,302,38,203,12,0,0,253
Maryland,Middleburg,15,0,0,15,0,0,15
Maryland,Forest Glen,7374,1934,2720,857,31,341,5883
Maryland,Elkridge,17550,3997,7726,1354,318,407,13802
Maryland,Elkton,15718,4206,5428,1939,253,715,12541
Maryland,Ellerslie,485,105,218,30,0,68,421
Maryland,Ellicott City,68513,12557,35042,3562,609,2563,54333
Maryland,Elliott,20,0,9,6,5,0,20
Maryland,Emmitsburg,2951,903,1078,145,29,173,2328
Maryland,Ernstville,14,0,14,0,0,0,14
Maryland,Essex,38256,10363,12444,4041,1282,2526,30656
Maryland,Fairland,23673,7178,8962,1770,516,621,19047
Maryland,Fairlee,338,142,59,56,0,0,257
Maryland,Fairmount,272,58,99,34,9,58,258
Maryland,Fairmount Heights,1602,630,360,177,28,130,1325
Maryland,Fairplay,467,60,270,57,0,12,399
Maryland,Fairview,0,0,0,0,0,0,0
Maryland,Fairwood,5707,1361,2434,428,47,123,4393
Maryland,Fallston,9418,2128,5045,422,47,298,7940
Maryland,Federalsburg,2676,820,691,237,94,126,1968
Maryland,Ferndale,18612,4938,7315,1846,331,724,15154
Maryland,Finzel,699,156,316,20,0,61,553
Maryland,Fishing Creek,136,17,119,0,0,0,136
Maryland,Flintstone,83,0,53,0,0,24,77
Maryland,Forest Heights,2530,850,678,221,126,187,2062
Maryland,Jefferson,2143,418,1027,137,48,160,1790
Maryland,Hillcrest Heights,15383,6321,3305,1737,578,889,12830
Maryland,Indian Springs,49,9,31,0,0,0,40
Maryland,San Mar,219,38,59,41,3,74,215
Maryland,Savage,6058,1401,2724,411,150,222,4908
Maryland,Scaggsville,9348,1854,4660,654,66,258,7492
Maryland,Seabrook,17839,5994,5095,1641,630,711,14071
Maryland,Seat Pleasant,4699,1932,1054,350,110,257,3703
Maryland,Secretary,759,98,341,66,32,22,559
Maryland,Severn,47432,12186,19899,3425,870,1494,37874
Maryland,Severna Park,38364,6665,18778,2618,245,1729,30035
Maryland,Shady Side,6440,1442,2564,698,68,173,4945
Maryland,Shaft,426,67,183,35,0,21,306
Maryland,Sharpsburg,811,178,325,96,11,35,645
Maryland,Sharptown,959,238,348,87,11,48,732
Maryland,Silver Hill,5182,2195,919,566,197,210,4087
Maryland,Silver Spring,77460,26193,27775,5101,1583,2112,62764
Maryland,Smith Island,180,5,116,18,0,16,155
Maryland,Smithsburg,3010,501,1259,279,52,101,2192
Maryland,Snow Hill,2343,816,650,186,38,210,1900
Maryland,Solomons,1833,306,711,158,99,466,1740
Maryland,Ilchester,26304,6572,11083,1902,273,565,20395
Maryland,Hyattsville,18225,7065,5228,1291,544,580,14708
Maryland,Hutton,60,0,46,0,0,0,46
Maryland,Sandy Hook,205,32,82,17,0,11,142
Maryland,Hurlock,1958,446,634,273,16,110,1479
Maryland,Salisbury,31883,12775,7677,2386,883,1679,25400
Maryland,St. Leonard,458,92,182,17,22,36,349
Maryland,Reisterstown,27637,7886,9778,2367,586,1327,21944
Maryland,Ridgely,1379,272,567,122,26,83,1070
Maryland,Ringgold,165,9,91,19,0,17,136
Maryland,Rising Sun,2869,538,1101,255,38,144,2076
Maryland,Pittsville,1426,340,493,160,21,62,1076
Maryland,Riva,3817,604,2058,314,29,171,3176
Maryland,Riverdale Park,7169,2588,2130,399,139,195,5451
Maryland,Riverside,6799,1791,2495,600,117,249,5252
Maryland,Riviera Beach,13466,2861,5709,1219,329,450,10568
Maryland,Robinwood,7769,1920,3028,719,70,602,6339
Maryland,Rock Hall,1157,252,454,161,27,143,1037
Maryland,Rock Point,127,22,83,15,0,7,127
Maryland,Rockville,64331,16103,28272,4341,1171,2983,52870
Maryland,Rohrersville,18,0,0,18,0,0,18
Maryland,Rosaryville,11348,3431,4515,996,182,388,9512
Maryland,Rosedale,19029,5521,7004,1471,377,1353,15726
Maryland,Rosemont village,360,80,162,26,11,14,293
Maryland,Rossville,15368,5013,4771,1704,385,865,12738
Maryland,Sabillasville,264,86,102,27,0,20,235
Maryland,St. George Island,297,44,175,53,0,0,272
Maryland,St. James,3160,905,1338,173,75,165,2656
Maryland,St. Michaels,1084,222,448,122,21,93,906
Maryland,Reid,60,31,15,0,0,0,46
Maryland,Huntingtown,4025,1074,1611,197,65,211,3158
Maryland,Friendship Heights Village,4872,1529,1836,456,37,619,4477
Maryland,Goldsboro,221,65,72,21,2,14,174
Maryland,Gorman,31,0,31,0,0,0,31
Maryland,Grahamtown,388,108,244,14,8,0,374
Maryland,Grantsville,819,180,305,134,10,73,702
Maryland,Grasonville,3349,743,1298,289,40,157,2527
Maryland,Greenbelt,23827,8635,6584,2263,833,570,18885
Maryland,Greensboro,2020,513,576,231,23,101,1444
Maryland,Greensburg,329,55,166,43,0,9,273
Maryland,Hagerstown,40210,10866,12196,4325,1099,2338,30824
Maryland,Halfway,10596,2234,4364,914,335,591,8438
Maryland,Hampstead,6351,1199,2702,542,69,274,4786
Maryland,Hampton,4897,802,2771,270,43,254,4140
Maryland,Hancock,1649,331,592,186,43,120,1272
Maryland,Havre de Grace,13445,3168,5773,1299,282,767,11289
Maryland,Hebron,1046,276,345,151,4,24,800
Maryland,Henderson,172,77,41,26,8,6,158
Maryland,Herald Harbor,2726,399,1432,183,16,76,2106
Maryland,Highfield-Cascade,897,167,406,82,23,57,735
Maryland,Highland,1113,218,678,8,0,35,939
Maryland,Highland Beach,110,27,66,4,0,3,100
Maryland,Hillandale,5936,1316,2668,359,119,367,4829
Maryland,Golden Beach,3380,544,1697,202,82,198,2723
Maryland,Hughesville,2206,525,1259,129,46,9,1968
Maryland,Glenn Dale,13108,3394,5747,1237,95,446,10919
Maryland,Glen Echo,286,45,150,11,1,8,215
Maryland,Friendsville,582,174,196,38,16,29,453
Maryland,Frostburg,8759,4331,2165,579,133,470,7678
Maryland,Fruitland,5110,1649,1774,379,42,370,4214
Maryland,Fulton,2758,477,1246,176,36,158,2093
Maryland,Funkstown,863,264,290,133,0,81,768
Maryland,Gaithersburg,64945,16358,25548,5038,1508,2228,50680
Maryland,Galena,835,162,377,73,6,26,644
Maryland,Galestown,155,54,14,19,14,28,129
Maryland,Galesville,574,159,221,140,34,20,574
Maryland,Gambrills,2583,374,1432,179,15,135,2135
Maryland,Gapland,111,49,14,33,0,15,111
Maryland,Garrett Park,998,161,472,66,11,47,757
Maryland,Garretts Mill,460,36,199,27,0,33,295
Maryland,Garrison,8549,2634,2826,841,183,265,6749
Maryland,Georgetown,148,48,44,0,0,36,128
Maryland,Germantown,89826,22227,36610,6587,1672,2120,69216
Maryland,Gilmore,190,15,84,73,0,11,183
Maryland,Girdletree,142,15,37,21,0,10,83
Maryland,Glassmanor,17552,7607,3623,1581,489,614,13914
Maryland,Glenarden,6212,2092,1674,614,131,460,4971
Maryland,Glen Burnie,68550,19563,23249,7451,2259,3463,55985
Maryland,Glenmont,15716,4660,5841,1244,197,755,12697
Maryland,Redland,17175,4627,7562,923,377,480,13969
Maryland,Rawlings,605,172,300,33,0,26,531
Maryland,Randallstown,34088,9981,11741,2844,983,2229,27778
Maryland,Waterview,14,0,0,0,0,14,14
Maryland,Washington Grove,636,139,292,58,11,33,533
Maryland,Walkersville,5965,1209,2673,569,65,266,4782
Maryland,Walker Mill,11293,4393,2524,1311,477,665,9370
Maryland,Waldorf,71399,20500,25377,6462,1236,2241,55816
Maryland,Vienna,284,71,116,34,6,16,243
Maryland,Vale Summit,74,18,25,11,0,0,54
Maryland,Urbana,10750,1380,5083,670,89,166,7388
Maryland,Upper Marlboro,699,194,206,141,12,32,585
Maryland,University Park,2624,596,1167,258,6,128,2155
Maryland,Union Bridge,894,192,351,61,33,57,694
Maryland,Tyaskin,244,56,140,0,0,48,244
Maryland,Trego-Rohrersville Station,116,0,116,0,0,0,116
Maryland,Travilah,12106,2083,6422,390,155,303,9353
Maryland,Trappe,1228,295,467,123,68,45,998
Maryland,Towson,57725,22106,19543,3865,869,3103,49486
Maryland,Tolchester,268,32,185,21,0,17,255
Maryland,Timonium,10436,2427,4720,547,134,1187,9015
Maryland,Tilghmanton,683,191,242,54,9,81,577
Maryland,Tilghman Island,952,175,536,77,12,38,838
Maryland,Thurmont,6392,1342,2985,489,114,255,5185
Maryland,West Denton,107,49,0,27,0,0,76
Maryland,Templeville,159,66,51,6,5,4,132
Maryland,Westernport,2059,411,880,140,47,205,1683
Maryland,Westminster,18646,5686,6100,1546,422,1113,14867
Maryland,Indian Head,3903,1317,1149,262,110,153,2991
Maryland,Zihlman,328,83,178,43,0,11,315
Maryland,Yarrowsburg,15,0,0,0,0,15,15
Maryland,Worton,94,8,44,10,0,16,78
Maryland,Woodsboro,1168,253,525,107,18,59,962
Maryland,Woodmore,3911,1024,1698,263,65,101,3151
Maryland,Woodlawn CDP (Prince George's County),7973,2689,2627,524,186,232,6258
Maryland,Woodlawn CDP (Baltimore County),40390,12157,13949,3477,774,1710,32067
Maryland,Woodland,52,0,39,0,13,0,52
Maryland,Wilson-Conococheague,2144,529,1042,239,87,82,1979
Maryland,Williston,98,10,78,0,0,10,98
Maryland,Williamsport,2218,490,677,391,61,245,1864
Maryland,Willards,999,263,330,72,47,43,755
Maryland,White Oak,17975,5915,5845,1815,461,489,14525
Maryland,White Marsh,9797,2754,4114,702,139,434,8143
Maryland,Whitehaven,107,12,21,0,16,23,72
Maryland,Wheaton,50688,16640,18646,2880,1010,1340,40516
Maryland,Whaleyville,129,39,31,12,0,47,129
Maryland,West Pocomoke,473,49,162,66,33,52,362
Maryland,Westphalia,7349,2122,2940,655,142,254,6113
Maryland,West Ocean City,4554,1329,1833,436,78,289,3965
Maryland,West Laurel,4388,941,2214,296,18,239,3708
Maryland,Temple Hills,8023,2972,1726,981,231,397,6307
Maryland,Taylors Island,195,41,116,20,0,0,177
Maryland,Taneytown,6740,1616,2939,474,222,250,5501
Maryland,Queensland,1812,415,888,86,0,84,1473
Maryland,Stevensville,6372,1609,2809,472,53,170,5113
Maryland,Spring Ridge,5899,1025,2620,414,103,203,4365
Maryland,Spring Gap,67,16,51,0,0,0,67
Maryland,Springdale,2992,1122,1008,237,35,77,2479
Maryland,Spencerville,1746,436,842,36,59,37,1410
Maryland,South Laurel,26394,7537,8990,2034,666,753,19980
Maryland,South Kensington,8394,1275,4115,438,70,465,6363
Maryland,Somerset,1215,177,656,43,6,45,927
Maryland,Forestville,11298,3554,3530,986,423,587,9080
Maryland,Fort Meade,10137,1818,4276,263,161,30,6548
Maryland,Fort Ritchie,278,56,112,9,0,4,181
Maryland,Fort Washington,23611,6035,10552,2000,561,1279,20427
Maryland,Fountainhead-Orchard Hills,5737,1222,2500,738,37,232,4729
Maryland,Four Corners,8421,1792,3857,529,94,273,6545
Maryland,Franklin,297,44,87,41,19,70,261
Maryland,Frederick,67421,19061,24002,6818,1105,2886,53872
Maryland,Frenchtown-Rumbly,94,17,53,0,0,0,70
Maryland,Friendly,9708,2460,3834,1000,229,584,8107
Maryland,Friendship,311,55,182,35,0,19,291
Maryland,Queenstown,620,130,235,89,14,35,503
Maryland,Queen Anne,328,51,134,17,0,35,237
Maryland,Queen Anne,1132,156,536,107,56,42,897
Maryland,Quantico,43,0,43,0,0,0,43
Maryland,Pylesville,872,175,477,36,13,26,727
Maryland,Tall Timbers,245,14,206,0,0,0,220
Maryland,Takoma Park,17478,4999,6658,1260,359,711,13987
Maryland,Sykesville,4429,1138,1619,442,67,276,3542
Maryland,Swanton,52,0,45,7,0,0,52
Maryland,Hillsboro,105,11,41,11,1,12,76
Maryland,Summerfield,12403,4323,3035,1536,389,518,9801
Maryland,Suitland,23824,10022,4787,2405,823,874,18911
Maryland,Sudlersville,464,105,144,66,20,30,365
Maryland,Stockton,107,57,31,10,0,0,98
Maryland,Point of Rocks,1582,384,678,79,19,60,1220
Maryland,Jarrettsville,3258,629,1761,106,39,85,2620
Maryland,Pomfret,549,179,190,56,0,9,434
Maryland,Poolesville,5100,1153,2464,252,25,75,3969
Maryland,Port Deposit,560,185,165,86,23,22,481
Maryland,Port Tobacco Village,2,0,2,0,0,0,2
Maryland,Potomac,45945,8520,24616,2146,431,1605,37318
Maryland,Potomac Heights,1258,235,301,245,50,81,912
Maryland,Potomac Park,927,100,431,128,25,62,746
Maryland,Powellville,80,43,0,10,19,8,80
Maryland,Preston,936,165,413,44,18,45,685
Maryland,Prince Frederick,3240,843,972,365,53,369,2602
Maryland,Princess Anne,3325,1549,697,303,80,144,2773
Maryland,Pondsville,82,11,43,11,0,17,82
Maryland,Pleasant Grove,341,69,128,128,0,0,325
Maryland,Pleasant Hills,3555,758,1952,79,54,188,3031
Maryland,Capitol Heights,4482,1788,950,423,104,263,3528
Maryland,Charlestown,1152,214,481,139,29,58,921
Maryland,Columbia,103055,24801,44452,7971,1873,3802,82899
Maryland,Colmar Manor,1693,523,520,108,40,68,1259
Maryland,College Park,31730,22098,5629,976,263,566,29532
Maryland,Colesville,14190,3091,6822,834,192,1014,11953
Maryland,Cockeysville,20603,6506,7624,1511,463,960,17064
Maryland,Cobb Island,731,164,262,43,42,82,593
Maryland,Cloverly,15485,3582,7816,577,190,581,12746
Maryland,Clinton,39336,11279,14977,3492,829,2007,32584
Maryland,Clear Spring,378,109,125,57,2,25,318
Maryland,Clarysville,56,14,29,13,0,0,56
Maryland,Clarksburg,18709,2875,8880,868,150,309,13082
Maryland,Church Hill,858,171,352,54,14,36,627
Maryland,Church Creek,149,20,74,17,0,4,115
Maryland,Choptank,210,54,85,36,0,9,184
Maryland,Chillum,37150,15404,9128,3048,1075,1344,29999
Maryland,Chewsville,127,6,71,31,0,0,108
Maryland,Chevy Chase Village,1993,312,1143,60,18,48,1581
Maryland,Chevy Chase View,978,216,511,23,3,29,782
Maryland,Chevy Chase Section Three village,787,118,427,26,4,26,601
Maryland,Chevy Chase Section Five village,628,86,356,16,10,15,483
Maryland,Chance,283,23,153,33,0,58,267
Maryland,Centreville,4507,960,2024,388,31,212,3615
Maryland,Cedarville,633,187,192,217,0,30,626
Maryland,Cecilton,883,193,282,152,13,73,713
Maryland,Broomes Island,460,89,239,22,0,42,392
Maryland,Brownsville,199,0,98,0,0,0,98
Maryland,Brunswick,6055,1218,2205,796,63,346,4628
Maryland,Bryans Road,7458,2019,2717,811,90,293,5930
Maryland,Bryantown,759,200,329,49,0,42,620
Maryland,Buckeystown,1069,106,563,31,0,241,941
Maryland,Burkittsville,150,16,71,22,8,7,124
Maryland,Burtonsville,9488,2598,3736,602,189,361,7486
Maryland,Butlertown,387,80,142,40,0,17,279
Maryland,Cabin John,2174,478,967,212,12,53,1722
Maryland,Chevy Chase,9450,1618,4552,518,108,636,7432
Maryland,California,12228,2572,5201,1029,290,364,9456
Maryland,Calverton,18747,4842,6860,1797,187,1821,15507
Maryland,Cambridge,12534,4241,3206,1349,254,802,9852
Maryland,Camp Springs,20339,6466,6559,1995,601,1167,16788
Maryland,Cape St. Claire,8862,1878,3880,731,153,276,6918
Maryland,Charlton,163,26,75,7,0,0,108
Maryland,Carlos,142,22,94,9,0,0,125
Maryland,Carney,29196,7608,10739,2645,459,2764,24215
Maryland,Catonsville,42265,12756,16324,2704,768,2733,35285
Maryland,Cavetown,1529,248,877,25,0,110,1260
Maryland,Cearfoss,71,0,57,0,0,0,57
Maryland,Calvert Beach,701,154,355,95,0,13,617
Maryland,Brookview,42,11,18,2,2,2,35
Maryland,Chevy Chase,2927,331,1672,75,19,98,2195
Maryland,Chestertown,5186,2248,1263,493,73,648,4725
Maryland,Bartonsville,1448,347,633,161,45,29,1215
Maryland,Barton,532,131,222,22,14,23,412
Maryland,Barrelville,91,25,40,5,0,13,83
Maryland,Barnesville,164,17,90,20,5,1,133
Maryland,Barclay,65,13,38,4,0,8,63
Maryland,Baltimore Highlands,7703,2319,2457,695,68,271,5810
Maryland,Baltimore,622454,265233,135803,56225,19540,33734,510535
Maryland,Ballenger Creek,18490,4848,6537,1847,326,804,14362
Maryland,Bakersville,74,11,42,0,0,0,53
Maryland,Bagtown,276,88,149,25,0,0,262
Maryland,Baden,2034,673,709,179,61,175,1797
Maryland,Aspen Hill,52607,15977,20225,3104,1139,1960,42405
Maryland,Ashton-Sandy Spring,5684,1567,2351,333,32,501,4784
Maryland,Arnold,22574,5035,10291,2115,217,665,18323
Maryland,Arden on the Severn,2473,477,1274,132,76,51,2010
Maryland,Arbutus,21662,6019,7988,2009,533,875,17424
Maryland,Aquasco,833,207,341,105,11,67,731
Maryland,Antietam,165,32,111,8,0,0,151
Maryland,Chesapeake Ranch Estates,10111,2881,3767,734,152,303,7837
Maryland,Chesapeake City,714,167,280,115,40,44,646
Maryland,Chesapeake Beach,5847,1342,2048,576,143,148,4257
Maryland,Beaver Creek,94,16,18,43,0,0,77
Maryland,Bel Air,1488,325,438,226,0,95,1084
Maryland,Bel Air,10247,2149,4377,898,149,596,8169
Maryland,Bel Air North,31871,6713,14957,2032,271,1513,25486
Maryland,Chester,4952,998,2324,386,97,340,4145
Maryland,Braddock Heights,2831,519,1410,170,55,187,2341
Maryland,Bowmans Addition,622,116,269,87,7,15,494
Maryland,Bowling Green,1109,293,441,98,16,75,923
Maryland,Bowleys Quarters,6124,1561,2621,538,116,370,5206
Maryland,Bowie,56885,14982,22277,4824,804,2984,45871
Maryland,Boonsboro,3456,583,1539,409,47,212,2790
Maryland,Bloomington,235,67,123,8,0,16,214
Maryland,Bladensburg,9461,3422,2067,909,434,471,7303
Maryland,Bivalve,271,0,109,30,0,26,165
Maryland,Cheverly,6368,1777,2435,403,273,199,5087
Maryland,Bishopville,494,185,225,0,0,60,470
Maryland,Big Pool,50,15,26,0,0,9,50
Maryland,Bier,87,0,34,0,21,12,67
Maryland,Betterton,320,53,118,48,15,27,261
Maryland,Bethesda,62102,13477,29496,3789,562,2991,50315
Maryland,Berwyn Heights,3223,1009,1201,232,36,129,2607
Maryland,Berlin,4520,1053,1819,367,100,246,3585
Maryland,Bensville,12292,2534,5548,769,178,430,9459
Maryland,Benedict,473,140,206,0,0,127,473
Maryland,Beltsville,18306,4888,7335,1020,425,638,14306
Maryland,Bel Air South,46955,9972,21420,3524,640,2210,37766
Maryland,Big Spring,120,10,89,14,0,0,113
Maryland,Brookmont,3767,742,1721,289,48,212,3012
Maryland,Charlotte Hall,1344,254,396,89,52,347,1138
Maryland,Annapolis Neck,11084,1858,5848,901,191,522,9320
Maryland,Pocomoke City,4162,1301,981,581,58,308,3229
Maryland,Aberdeen,15238,4344,5482,1571,324,676,12397
Maryland,Aberdeen Proving Ground,2351,771,721,161,39,48,1740
Maryland,Accident,265,40,121,25,11,25,222
Maryland,Accokeek,11617,2867,5046,998,152,363,9426
Maryland,Adamstown,2692,323,1439,99,19,46,1926
Maryland,Algonquin,1518,256,814,95,8,75,1248
Maryland,Allen,106,52,0,54,0,0,106
Maryland,Adelphi,15547,5595,5052,1263,465,483,12858
Maryland,Annapolis,38841,13042,12871,3548,670,1792,31923
Maryland,Brandywine,9309,2478,3799,634,82,220,7213
Maryland,Breathedsville,270,73,30,71,0,32,206
Maryland,Brentwood,3139,1186,961,172,78,109,2506
Maryland,Brock Hall,10635,2645,4688,741,156,226,8456
Maryland,Brookeville,167,40,84,8,0,6,138
Maryland,Andrews AFB,3226,349,1442,24,27,0,1842
Maryland,Brooklyn Park,14042,3771,5263,1354,319,862,11569
Massachusetts,Palmer Town,12168,3032,4743,1289,337,769,10170
Massachusetts,Pinehurst,7441,1548,3532,531,141,294,6046
Massachusetts,Petersham,252,43,129,22,0,35,229
Massachusetts,Pepperell,2245,530,821,325,14,128,1818
Massachusetts,West Falmouth,2018,323,1230,92,17,47,1709
Massachusetts,Peabody,52065,13410,22023,4335,804,3849,44421
Massachusetts,Oxford,6108,1312,2627,628,112,287,4966
Massachusetts,Orange,4160,1119,1429,487,67,240,3342
Massachusetts,Provincetown,2744,1282,623,405,53,234,2597
Massachusetts,Stoneham,21752,5476,9407,1953,317,1529,18682
Massachusetts,Sturbridge,2515,602,1169,179,4,43,1997
Massachusetts,Swampscott,14036,2962,6672,912,129,700,11375
Massachusetts,Taunton,56276,15649,20631,6183,986,3079,46528
Massachusetts,West Brookfield,1333,284,599,141,13,164,1201
Massachusetts,West Chatham,1337,202,762,120,24,36,1144
Massachusetts,West Concord,7320,1736,3157,630,222,372,6117
Massachusetts,Northfield,1170,288,427,173,0,63,951
Massachusetts,North Lakeville,2464,587,1005,293,45,205,2135
Massachusetts,North Pembroke,3257,810,1468,216,27,76,2597
Massachusetts,North Plymouth,3803,998,1417,447,59,191,3112
Massachusetts,North Scituate,5077,825,2478,310,77,220,3910
Massachusetts,North Seekonk,2703,572,1260,347,22,104,2305
Massachusetts,Northwest Harwich,3950,889,1901,215,16,369,3390
Massachusetts,North Westport,4585,954,2096,481,35,315,3881
Massachusetts,Norton Center,2868,1946,610,111,33,15,2715
Massachusetts,Norwood,28962,7825,11854,2140,349,1757,23925
Massachusetts,Ocean Bluff-Brant Rock,5420,1211,2406,488,46,223,4374
Massachusetts,Ocean Grove,2667,719,972,458,14,137,2300
Massachusetts,Onset,1062,480,351,98,0,24,953
Massachusetts,Orleans,1669,436,638,268,36,209,1587
Massachusetts,Pittsfield,43926,12440,15482,5038,808,2731,36499
Massachusetts,Blandford,382,90,208,45,0,9,352
Massachusetts,Pocasset,3045,660,1407,316,74,341,2798
Massachusetts,Quincy,93177,31038,35883,7375,1315,4585,80196
Massachusetts,Randolph,33409,10462,11788,2795,1062,1866,27973
Massachusetts,Raynham Center,4534,1118,2030,160,53,126,3487
Massachusetts,Reading,25357,5492,11953,1424,190,1022,20081
Massachusetts,Revere,53095,17052,17821,5501,1223,2934,44531
Massachusetts,Rockport,4846,950,2336,453,69,486,4294
Massachusetts,Rowley,1511,248,644,309,0,122,1323
Massachusetts,Russell,485,109,253,56,0,32,450
Massachusetts,Rutland,2433,525,1102,228,69,49,1973
Massachusetts,Sagamore,3660,810,1777,417,0,236,3240
Massachusetts,Salem,42499,15852,13579,3611,968,2088,36098
Massachusetts,Salisbury,4595,1355,1874,683,49,229,4190
Massachusetts,Sandwich,2988,683,1432,368,45,160,2688
Massachusetts,Saugus,27620,6768,12608,2159,310,1706,23551
Massachusetts,Plymouth,7532,2439,2642,917,123,481,6602
Massachusetts,Scituate,5355,980,2356,432,23,466,4257
Massachusetts,Seconsett Island,23,0,16,0,0,7,23
Massachusetts,Sharon,5932,1017,2861,311,100,91,4380
Massachusetts,Shelburne Falls,1674,459,658,277,35,96,1525
Massachusetts,Shirley,1283,334,474,258,56,28,1150
Massachusetts,Siasconset,203,60,70,13,0,7,150
Massachusetts,Smith Mills,4534,1207,1600,542,46,364,3759
Massachusetts,Somerset,18271,4461,8452,1363,199,1083,15558
Massachusetts,Somerville,78595,39977,22488,4158,1118,2562,70303
Massachusetts,South Amherst,5071,2898,1214,256,71,51,4490
Massachusetts,South Ashburnham,908,161,331,65,15,32,604
Massachusetts,Southbridge Town,16802,5007,5528,1565,231,1280,13611
Massachusetts,Hatfield,1506,318,729,153,32,66,1298
Massachusetts,Popponesset,208,16,123,26,0,43,208
Massachusetts,Spencer,5578,1584,1929,425,126,393,4457
Massachusetts,Seabrook,461,142,209,55,0,39,445
Massachusetts,Beverly,40670,12944,15330,3634,408,2249,34565
Massachusetts,South Yarmouth,11532,2996,4936,993,149,1021,10095
Massachusetts,Southfield,0,0,0,0,0,0,0
Massachusetts,Athol,8427,2570,2605,990,104,535,6804
Massachusetts,Arlington,44128,11093,19992,2844,335,1982,36246
Massachusetts,Andover,8783,2692,3120,1030,69,589,7500
Massachusetts,Amherst Center,19543,16706,1622,374,120,259,19081
Massachusetts,Amesbury Town,16907,4373,7032,1899,281,714,14299
Massachusetts,Agawam Town,28688,6931,12139,2697,487,1837,24091
Massachusetts,Adams,5475,1454,2178,608,97,378,4715
Massachusetts,Acushnet Center,2859,781,989,308,114,185,2377
Massachusetts,Westfield,41480,13468,14903,3320,583,2396,34670
Massachusetts,West Springfield Town,28600,8649,10285,2715,587,1618,23854
Massachusetts,West Wareham,2850,753,864,395,10,224,2246
Massachusetts,Newburyport,17766,3846,7686,2120,169,1072,14893
Massachusetts,New Seabury,867,103,433,107,9,93,745
Massachusetts,Newton,87675,23363,39512,4564,655,3467,71561
Massachusetts,North Adams,13459,4182,4452,1937,293,824,11688
Massachusetts,North Amherst,7500,5122,1579,163,64,76,7004
Massachusetts,Northampton,28602,10812,8981,3119,596,1238,24746
Massachusetts,Attleboro,43953,11243,18071,3658,420,2175,35567
Massachusetts,Northborough,6528,1244,2986,500,101,262,5093
Massachusetts,Ayer,3103,664,1285,406,31,244,2630
Massachusetts,Barnstable Town,44591,10109,19955,5169,540,2549,38322
Massachusetts,Bliss Corner,5757,1121,2660,623,90,581,5075
Massachusetts,Boston,650281,315208,162508,43011,15910,23329,559966
Massachusetts,Bourne,1202,250,581,136,0,74,1041
Massachusetts,Boxford,2366,290,1301,150,18,111,1870
Massachusetts,Braintree Town,36905,9619,15010,2516,394,2547,30086
Massachusetts,Brewster,2280,718,1065,164,16,186,2149
Massachusetts,Bridgewater,8516,4975,1855,445,51,334,7660
Massachusetts,Brockton,94532,30568,27415,9242,2393,4741,74359
Massachusetts,Brookfield,786,282,325,48,7,58,720
Massachusetts,Brookline,59132,21387,22973,3028,684,2025,50097
Massachusetts,Burlington,25467,5987,12063,1444,227,1562,21283
Massachusetts,Buzzards Bay,3057,903,1054,454,90,241,2742
Massachusetts,Cambridge,107916,55175,30967,6624,1255,2837,96858
Massachusetts,Belmont,25337,5810,11916,1365,133,996,20220
Massachusetts,Bellingham,5396,1325,2254,503,97,351,4530
Massachusetts,Belchertown,3289,1003,1139,351,36,91,2620
Massachusetts,Barre,1075,262,278,204,0,67,811
Massachusetts,Baldwinville,2174,532,927,216,18,217,1910
Massachusetts,South Lancaster,1862,673,738,181,35,40,1667
Massachusetts,North Brookfield,2132,559,885,133,37,127,1741
Massachusetts,North Falmouth,2800,537,1529,82,21,246,2415
Massachusetts,East Harwich,4573,817,2538,232,99,248,3934
Massachusetts,East Pepperell,1999,421,804,344,14,64,1647
Massachusetts,East Sandwich,3840,551,2141,261,0,196,3149
Massachusetts,Edgartown,681,152,261,112,3,106,634
Massachusetts,Essex,1613,379,821,63,0,111,1374
Massachusetts,Everett,43885,14673,14585,3604,1486,1651,35999
Massachusetts,Fall River,88727,27959,27296,9831,2202,6164,73452
Massachusetts,Falmouth,3487,812,1296,652,18,436,3214
Massachusetts,Fiskdale,2361,401,1144,189,39,143,1916
Massachusetts,Fitchburg,40462,13186,13351,3516,697,2042,32792
Massachusetts,Forestdale,4443,886,2164,275,55,76,3456
Massachusetts,Foxborough,5326,1307,1944,746,65,419,4481
Massachusetts,Framingham,70443,20081,28347,5330,1087,3053,57898
Massachusetts,Abington,16112,4232,6994,1309,214,682,13431
Massachusetts,South Deerfield,1715,439,715,192,31,125,1502
Massachusetts,South Dennis,3428,684,1502,473,35,342,3036
Massachusetts,South Duxbury,3594,615,2004,106,0,92,2817
Massachusetts,Easthampton Town,16060,4190,6637,1783,334,1040,13984
Massachusetts,North Eastham,1821,298,951,227,10,132,1618
Massachusetts,East Falmouth,6091,1261,2800,725,90,337,5213
Massachusetts,East Dennis,2849,616,1405,221,36,226,2504
Massachusetts,Chatham,1516,314,684,201,13,87,1299
Massachusetts,Chelsea,37581,13947,9791,2613,1340,1378,29069
Massachusetts,Cheshire,593,158,146,74,22,45,445
Massachusetts,Chester,754,199,319,44,11,16,589
Massachusetts,Chicopee,56186,16951,19607,5903,1327,3384,47172
Massachusetts,Clinton,7386,2340,2504,832,75,336,6087
Massachusetts,Cochituate,6893,1161,3536,380,53,377,5507
Massachusetts,Cordaville,2594,406,1296,136,17,42,1897
Massachusetts,Danvers,27400,5768,12130,2499,271,1785,22453
Massachusetts,Dedham,25224,6276,10541,2023,409,1804,21053
Massachusetts,Deerfield,900,255,285,151,0,10,701
Massachusetts,Dennis,2551,345,1489,292,39,171,2336
Massachusetts,Dennis Port,2888,675,1046,567,45,271,2604
Massachusetts,Devens,1733,677,447,367,90,0,1581
Massachusetts,Dover,2441,300,1333,93,30,42,1798
Massachusetts,Duxbury,1375,169,742,96,7,95,1109
Massachusetts,East Brookfield,1169,281,515,78,42,60,976
Massachusetts,East Douglas,2821,620,894,396,119,92,2121
Massachusetts,Harwich Port,1969,464,953,175,9,240,1841
Massachusetts,Springfield,153947,57161,37997,13601,4509,6859,120127
Massachusetts,Popponesset Island,26,9,17,0,0,0,26
Massachusetts,Medford,57136,20184,22104,3911,657,2795,49651
Massachusetts,Melrose,27681,6432,13009,1624,421,1070,22556
Massachusetts,Methuen Town,48607,13054,20295,3283,683,2245,39560
Massachusetts,Middleborough Center,7257,2080,2464,863,123,345,5875
Massachusetts,Milford,25729,6377,10261,2329,434,923,20324
Massachusetts,Millers Falls,974,293,358,56,21,146,874
Massachusetts,Millis-Clicquot,4089,959,1841,336,44,232,3412
Massachusetts,Milton,27303,7888,11334,1228,264,1304,22018
Massachusetts,Monomoscoy Island,169,15,130,0,0,8,153
Massachusetts,Monson Center,1677,514,451,307,28,132,1432
Massachusetts,Monument Beach,2903,880,1205,339,34,153,2611
Massachusetts,Nahant,3454,802,1377,443,54,293,2969
Massachusetts,Nantucket,7475,2250,2801,816,51,313,6231
Massachusetts,Needham,29853,5580,14573,1435,214,1612,23414
Massachusetts,New Bedford,94909,31527,28203,9026,2778,5933,77467
Massachusetts,Malden,60612,19997,23590,3861,1137,2569,51154
Massachusetts,Teaticket,1440,282,685,212,10,150,1339
Massachusetts,West Yarmouth,5639,1222,2684,462,73,503,4944
Massachusetts,Weweantic,1938,548,584,306,30,60,1528
Massachusetts,Weymouth Town,55304,15665,21746,4821,733,3508,46473
Massachusetts,White Island Shores,1636,591,423,247,0,26,1287
Massachusetts,Whitinsville,6690,1474,2372,801,69,377,5093
Massachusetts,Wilbraham,3892,659,2047,364,10,278,3358
Massachusetts,Williamstown,4437,2670,973,202,42,140,4027
Massachusetts,Wilmington,23141,5291,11014,1251,121,1090,18767
Massachusetts,Winchendon,3369,749,1011,820,18,327,2925
Massachusetts,Winchester,22075,3289,11296,966,45,1014,16610
Massachusetts,Winthrop Town,17962,4662,7244,1680,377,918,14881
Massachusetts,Woburn,39104,11112,16251,2624,539,2201,32727
Massachusetts,Medfield,6322,1124,2970,515,37,221,4867
Massachusetts,Maynard,10459,2075,4773,931,151,543,8473
Massachusetts,Mattapoisett Center,3429,810,1438,371,38,161,2818
Massachusetts,Mashpee Neck,774,94,456,42,0,35,627
Massachusetts,Mansfield Center,7806,2395,2853,708,0,351,6307
Massachusetts,Marblehead,20270,3313,10069,1574,191,1014,16161
Massachusetts,Marion Center,1388,422,583,94,0,97,1196
Massachusetts,Marlborough,39425,10542,16213,3569,496,1610,32430
Massachusetts,Marshfield,4362,973,1952,350,44,270,3589
Massachusetts,Marshfield Hills,2277,306,1117,297,27,111,1858
Massachusetts,Lynnfield,12270,2501,6491,491,76,591,10150
Massachusetts,Lynn,91626,29830,28215,7321,2451,4092,71909
Massachusetts,Lunenburg,1798,271,769,219,56,163,1478
Massachusetts,Lowell,109349,39314,33311,9242,2125,5113,89105
Massachusetts,Longmeadow,15877,2955,8017,848,88,1010,12918
Massachusetts,Littleton Common,2701,632,1117,225,91,130,2195
Massachusetts,Lexington,32700,6184,16610,1561,101,1561,26017
Massachusetts,Leominster,41176,11263,15764,4208,494,2252,33981
Massachusetts,Woods Hole,963,251,427,97,8,58,841
Massachusetts,Lenox,1599,413,591,133,15,268,1420
Massachusetts,Lawrence,78804,29283,20440,6181,2384,2726,61014
Massachusetts,Kingston,6211,1322,2926,418,173,174,5013
Massachusetts,Ipswich,4235,1142,1607,461,47,267,3524
Massachusetts,Huntington,679,197,282,77,12,48,616
Massachusetts,Hull,10403,2725,4242,1318,176,737,9198
Massachusetts,Hudson,15340,3718,6734,1444,267,834,12997
Massachusetts,Housatonic,854,210,287,32,39,111,679
Massachusetts,Hopkinton,2656,664,1045,225,56,154,2144
Massachusetts,Hopedale,3875,875,1485,478,14,197,3049
Massachusetts,Holyoke,40342,15169,10687,3303,1117,2001,32277
Massachusetts,Holland,1433,392,642,153,10,39,1236
Massachusetts,Holbrook,10975,3284,4788,899,96,485,9552
Massachusetts,Hingham,5416,964,2624,360,15,253,4216
Massachusetts,Haverhill,62079,18181,22056,6287,1063,2807,50394
Massachusetts,Lee,1773,519,574,302,0,103,1498
Massachusetts,Worcester,183382,66828,53509,17538,3921,9320,151116
Massachusetts,Madaket,296,29,166,40,0,3,238
Massachusetts,Turners Falls,4356,1209,1344,651,62,254,3520
Massachusetts,The Pinehills,1033,97,795,29,0,103,1024
Massachusetts,Topsfield,3029,406,1705,190,0,176,2477
Massachusetts,Townsend,1294,149,477,210,21,57,914
Massachusetts,Upton,3028,722,1343,290,66,107,2528
Massachusetts,Vineyard Haven,2223,926,490,136,138,137,1827
Massachusetts,Wakefield,26157,6465,11736,2122,191,1221,21735
Massachusetts,Walpole,5881,1377,2591,388,65,316,4737
Massachusetts,Waltham,62438,26111,21074,4362,783,2718,55048
Massachusetts,Ware,5772,1863,1810,672,130,274,4749
Massachusetts,Wareham Center,3506,994,1040,289,124,193,2640
Massachusetts,Warren,1271,424,349,202,15,133,1123
Massachusetts,Watertown Town,33350,10875,13234,2952,300,1305,28666
Massachusetts,Webster,12522,3564,3951,1429,340,948,10232
Massachusetts,Yarmouth Port,4792,968,2293,487,49,619,4416
Massachusetts,Westborough,4158,963,1963,434,60,113,3533
Massachusetts,Wellesley,28832,7871,12319,1211,172,883,22456
Massachusetts,Harwich Center,1705,470,657,244,0,127,1498
Massachusetts,Hanson,1772,291,973,106,0,47,1417
Massachusetts,Groton,1081,210,597,119,6,33,965
Massachusetts,Green Harbor-Cedar Crest,2873,473,1534,270,35,62,2374
Massachusetts,Greenfield Town,17514,5158,6480,1926,195,1114,14873
Massachusetts,Hanscom AFB,2074,174,903,72,14,0,1163
Massachusetts,Granby,1431,466,432,287,11,109,1305
Massachusetts,Gloucester,29399,7438,12868,2804,476,1789,25375
Massachusetts,Gardner,20306,6306,6658,2246,453,1112,16775
Massachusetts,Franklin Town,32731,6922,15627,1800,289,965,25603
Massachusetts,West Dennis,2347,632,1020,197,25,280,2154
Massachusetts,Great Barrington,2344,795,818,278,3,207,2101
Michigan,Madison Heights,30123,8658,10768,3672,236,1728,25062
Michigan,Luna Pier,1341,272,531,196,16,76,1091
Michigan,Mackinaw City village,702,168,288,120,5,35,616
Michigan,Mackinac Island,710,296,221,46,19,37,619
Michigan,McBride village,164,23,83,14,1,7,128
Michigan,McBain,671,159,237,62,11,88,557
Michigan,Lyons village,903,207,322,144,5,31,709
Michigan,Luther village,365,81,108,59,2,24,274
Michigan,Lupton,255,63,124,16,3,31,237
Michigan,Ludington,8055,1763,3062,1036,94,704,6659
Michigan,Lincoln Park,37362,10675,12057,4372,649,2080,29833
Michigan,Lost Lake Woods,344,13,252,25,3,34,327
Michigan,Loomis,194,61,77,17,0,14,169
Michigan,Livonia,95312,22481,43889,8214,495,5397,80476
Michigan,Litchfield,1281,276,556,141,32,46,1051
Michigan,Linden,3886,495,1810,429,17,264,3015
Michigan,Lincoln village,300,72,109,54,0,32,267
Michigan,Lexington village,1167,261,432,153,9,144,999
Michigan,Galien village,562,156,193,72,8,16,445
Michigan,Galesburg,1953,495,584,336,19,131,1565
Michigan,Mancelona village,1466,298,527,208,12,74,1119
Michigan,Lowell,3859,790,1334,562,66,234,2986
Michigan,Douglas,1113,204,452,201,0,92,949
Michigan,Manchester village,2124,529,771,286,6,106,1698
Michigan,Manistee Lake,345,46,148,89,0,32,315
Michigan,Marine City,4172,946,1661,594,51,226,3478
Michigan,Marion village,721,126,306,87,18,38,575
Michigan,Marlette,1565,378,512,222,48,115,1275
Michigan,Marquette,21444,10420,5808,2046,162,925,19361
Michigan,Greenville,8443,1771,2741,1222,67,609,6410
Michigan,Martin village,417,86,147,34,8,30,305
Michigan,Marysville,9797,1759,4398,1117,34,638,7946
Michigan,Greilickville,1834,235,1143,143,0,129,1650
Michigan,Mason,8317,2281,2951,1022,179,322,6755
Michigan,Grosse Pointe,5295,1136,2231,538,41,251,4197
Michigan,Marenisco,194,33,86,26,3,17,165
Michigan,Grosse Pointe Farms,9307,1508,4599,409,28,488,7032
Michigan,Grosse Pointe Woods,15859,3419,7852,969,104,830,13174
Michigan,Gwinn,1987,538,857,235,0,123,1753
Michigan,Hamtramck,22150,6437,7221,1047,370,1017,16092
Michigan,Hancock,4601,1602,1526,447,26,418,4019
Michigan,Hanover village,363,84,118,49,8,9,268
Michigan,Harbor Beach,1802,341,736,195,23,122,1417
Michigan,Harbor Springs,1044,202,442,141,3,163,951
Michigan,Hardwood Acres,613,176,197,91,0,0,464
Michigan,Dowling,394,68,205,31,14,7,325
Michigan,Dowagiac,5866,1620,1578,769,42,289,4298
Michigan,Grosse Pointe Park,11343,2661,5217,815,60,347,9100
Michigan,Marcellus village,1052,214,369,158,17,68,826
Michigan,Maple Rapids village,688,189,286,73,10,28,586
Michigan,Maple Grove,32,0,32,0,0,0,32
Michigan,Manistique,3035,859,893,369,99,274,2494
Michigan,Manitou Beach-Devils Lake,2050,400,1041,383,13,78,1915
Michigan,Garden village,183,29,95,15,0,28,167
Michigan,Garden City,27161,7573,10039,3130,250,1676,22668
Michigan,Gaylord,3640,968,1269,422,49,339,3047
Michigan,Gibraltar,4566,1040,1909,641,7,218,3815
Michigan,Gladstone,4902,962,2081,529,45,302,3919
Michigan,Gladwin,2904,733,899,391,84,234,2341
Michigan,Glen Arbor,237,45,141,20,0,19,225
Michigan,Gobles,816,193,286,125,12,44,660
Michigan,Goodrich village,1823,375,709,199,17,80,1380
Michigan,Grand Beach village,280,23,186,19,0,24,252
Michigan,Grand Blanc,8088,2035,2899,859,225,514,6532
Michigan,Grand Haven,10819,2135,5129,1181,73,642,9160
Michigan,Grand Ledge,7792,2092,2928,952,75,508,6555
Michigan,Grand Rapids,192416,68972,55508,16391,3325,8321,152517
Michigan,Grandville,15739,3805,6515,1409,111,737,12577
Michigan,Grant,859,183,286,119,33,58,679
Michigan,Grass Lake village,1285,353,564,110,6,35,1068
Michigan,Grawn,727,99,293,44,23,26,485
Michigan,Grayling,1834,475,557,242,28,176,1478
Michigan,Manton,1240,316,373,178,8,89,964
Michigan,Maple City,202,39,72,31,0,4,146
Michigan,Manistee,6136,1517,2313,790,33,384,5037
Michigan,Marshall,7038,1484,2717,1003,116,505,5825
Michigan,Saline,9020,2114,3694,935,80,630,7453
Michigan,Levering,204,31,105,22,0,8,166
Michigan,Shepherd village,1525,369,614,216,10,61,1270
Michigan,Shelby village,1908,431,710,129,81,97,1448
Michigan,Sebewaing village,1703,396,809,173,27,109,1514
Michigan,Scottville,1283,290,385,188,35,48,946
Michigan,Schoolcraft village,1496,363,605,184,7,112,1271
Michigan,Sault Ste. Marie,14048,4516,4301,1465,123,963,11368
Michigan,Saugatuck,842,157,389,108,14,34,702
Michigan,Saranac village,1312,224,477,167,39,85,992
Michigan,Sanford village,952,187,386,154,21,35,783
Michigan,Sandusky,2618,616,827,412,68,258,2181
Michigan,Sand Lake village,569,130,166,66,8,30,400
Michigan,Sand Lake,1370,202,787,130,18,142,1279
Michigan,Lake City,1071,324,335,100,25,72,856
Michigan,Lake Ann village,272,34,134,49,0,7,224
Michigan,Comstock Park,10431,3487,3218,1146,119,348,8318
Michigan,Concord village,1127,226,522,58,13,52,871
Michigan,Constantine village,1736,384,660,244,26,78,1392
Michigan,Conway,327,50,90,88,0,22,250
Michigan,Coopersville,4329,1063,1637,328,81,227,3336
Michigan,Copemish village,134,37,64,14,4,7,126
Michigan,Copper City village,246,70,82,26,6,10,194
Michigan,Sheridan village,586,68,286,64,24,52,494
Michigan,Sherwood village,336,73,105,63,2,12,255
Michigan,Shields,6192,1294,2667,615,36,683,5295
Michigan,Shoreham village,888,141,460,78,7,40,726
Michigan,Sterling village,523,83,227,74,1,54,439
Michigan,Stephenson,964,169,383,121,30,100,803
Michigan,Stanwood village,200,36,91,21,6,5,159
Michigan,Stanton,1543,392,483,211,24,81,1191
Michigan,Standish,1701,491,498,223,39,119,1370
Michigan,Springport village,740,157,275,101,5,23,561
Michigan,Spring Lake village,2438,368,1241,249,13,153,2024
Michigan,Springfield,5216,1594,1647,531,133,252,4157
Michigan,Spring Arbor,2928,1475,842,178,18,224,2737
Michigan,Sparta village,4235,1104,1357,491,71,309,3332
Michigan,Copper Harbor,80,9,31,28,0,12,80
Michigan,South Rockwood village,1978,553,776,239,6,96,1670
Michigan,South Monroe,6177,1453,2318,872,61,507,5211
Michigan,South Lyon,11616,2405,4944,1253,55,601,9258
Michigan,South Haven,4357,866,1750,547,100,445,3708
Michigan,South Gull Lake,1363,338,676,126,0,94,1234
Michigan,Southgate,29518,8572,11072,3576,341,2012,25573
Michigan,Southfield,72859,22325,22828,9280,1304,4970,60707
Michigan,South Boardman,572,132,216,71,9,7,435
Michigan,Snover,451,60,174,59,3,34,330
Michigan,Skidway Lake,3340,824,996,478,14,393,2705
Michigan,Shorewood-Tower Hills-Harbert,1199,241,769,84,17,48,1159
Michigan,South Range village,858,257,255,101,4,46,663
Michigan,Lewiston,1342,254,498,227,0,133,1112
Michigan,Corunna,3415,932,1171,454,48,248,2853
Michigan,Croswell,2578,552,911,344,30,154,1991
Michigan,St. Ignace,2548,586,784,390,50,280,2090
Michigan,St. Helen,2786,536,1131,506,64,242,2479
Michigan,St. Clair Shores,59888,15465,23764,6612,454,4297,50592
Michigan,St. Clair,5394,1102,2424,405,82,327,4340
Michigan,St. Charles village,1971,445,809,235,17,133,1639
Michigan,Saginaw,50288,18346,10676,6338,1307,2809,39476
Michigan,Royal Oak,58689,19696,22095,5944,380,2669,50784
Michigan,Rothbury village,335,96,137,23,1,20,277
Michigan,Roseville,47529,14844,14567,5908,518,2970,38807
Michigan,Rose City,612,142,155,95,13,72,477
Michigan,Rosebush village,358,89,117,31,1,36,274
Michigan,Roscommon village,1179,365,268,139,27,105,904
Michigan,Roosevelt Park,3819,997,1276,506,65,277,3121
Michigan,Romulus,23557,7256,7094,2401,333,1160,18244
Michigan,Romeo village,3799,952,1490,440,21,291,3194
Michigan,Rogers City,2751,593,1200,297,58,253,2401
Michigan,Rockwood,3227,851,1393,351,19,167,2781
Michigan,Rockford,5956,1138,2405,574,50,227,4394
Michigan,Rochester Hills,72643,15632,34790,5063,296,3543,59324
Michigan,Rochester,12909,3053,5715,1141,27,465,10401
Michigan,Robin Glen-Indiantown,1045,329,280,108,24,47,788
Michigan,St. James,226,44,84,23,0,34,185
Michigan,St. Johns,7954,2016,2860,709,154,571,6310
Michigan,St. Joseph,8311,2249,3197,1276,122,503,7347
Michigan,St. Louis,7355,3360,1785,937,152,367,6601
Michigan,Crystal Downs Country Club,71,3,44,4,0,14,65
Michigan,Crystal Falls,1683,407,620,192,16,103,1338
Michigan,Crystal Mountain,42,2,33,5,0,0,40
Michigan,Custer village,281,45,131,23,3,17,219
Michigan,Cutlerville,15142,4059,5616,1461,295,634,12065
Michigan,Daggett village,196,32,93,19,3,15,162
Michigan,Dansville village,526,88,225,54,7,22,396
Michigan,Davison,5029,1188,1635,871,120,248,4062
Michigan,Dearborn,96069,23259,36892,6606,932,4569,72258
Michigan,Dearborn Heights,56656,14837,21292,5023,692,3318,45162
Michigan,Cross Village,93,9,60,5,0,3,77
Michigan,Decatur village,2063,501,682,221,54,121,1579
Michigan,Deerfield village,841,191,341,101,7,35,675
Michigan,Delton,1022,180,447,135,23,36,821
Michigan,De Tour Village village,236,35,144,16,2,24,221
Michigan,Detroit,690074,297563,124222,65515,19202,40081,546583
Michigan,Detroit Beach,2007,413,889,230,9,74,1615
Michigan,DeWitt,4631,776,2045,384,56,215,3476
Michigan,Dexter village,4682,636,1862,432,68,287,3285
Michigan,Dimondale village,1162,199,612,90,2,59,962
Michigan,Dollar Bay,788,156,298,75,25,26,580
Michigan,Gaines village,374,100,158,38,6,18,320
Michigan,Deckerville village,850,195,276,117,11,94,693
Michigan,Gagetown village,357,68,150,58,7,22,305
Michigan,Pearl Beach,2895,377,1716,354,24,192,2663
Michigan,Fruitport village,1345,252,597,165,8,52,1074
Michigan,Woodhaven,12645,3002,5253,1262,208,713,10438
Michigan,Woodland village,409,88,176,50,9,16,339
Michigan,Woodland Beach,1896,354,757,227,13,102,1453
Michigan,Wyandotte,25376,6900,9595,3034,197,1550,21276
Michigan,Wyoming,74105,19994,27656,6404,1153,2643,57850
Michigan,Yale,1931,428,666,268,39,161,1562
Michigan,Ypsilanti,19874,11523,3609,1436,224,710,17502
Michigan,Zeba,314,37,142,56,0,20,255
Michigan,Zeeland,5591,916,2429,450,64,584,4443
Michigan,Zilwaukee,1922,583,780,149,8,95,1615
Michigan,Wolverine Lake village,4372,1021,1987,486,18,167,3679
Michigan,Riverview,12266,2709,4591,1515,142,1217,10174
Michigan,Richmond,5825,1360,2600,557,0,169,4686
Michigan,Richland village,845,141,405,68,10,59,683
Michigan,Republic,401,84,147,66,10,50,357
Michigan,Reese village,1690,348,736,122,40,109,1355
Michigan,Reed City,2828,834,622,486,44,179,2165
Michigan,Reading,1215,280,371,191,31,34,907
Michigan,Ravenna village,1190,236,475,113,0,42,866
Michigan,Rapid City,1473,324,694,157,0,76,1251
Michigan,Quinnesec,999,190,566,92,0,29,877
Michigan,Quincy village,1647,354,600,166,17,88,1225
Michigan,River Rouge,7673,3018,1737,758,228,370,6111
Michigan,Prudenville,1578,221,655,283,21,214,1394
Michigan,Wolverine village,242,81,82,21,6,18,208
Michigan,Wixom,13690,4051,5218,1323,113,274,10979
Michigan,Ironwood,5153,1229,1888,708,101,492,4418
Michigan,Ishpeming,6517,1471,2444,948,6,364,5233
Michigan,Ithaca,2856,828,1103,295,65,113,2404
Michigan,Jackson,33255,10020,8667,3983,633,1511,24814
Michigan,Jasper,326,62,129,64,0,25,280
Michigan,Jenison,17004,3017,8224,866,112,1238,13457
Michigan,Jennings,207,35,72,66,0,12,185
Michigan,Jonesville,2173,499,892,229,34,136,1790
Michigan,Kalamazoo,75499,36446,15814,7241,939,2506,62946
Michigan,Kaleva village,467,77,233,51,14,27,402
Michigan,Wolf Lake,4475,1181,1542,418,123,178,3442
Michigan,Kalkaska village,2113,426,695,385,20,179,1705
Michigan,Kent City village,1156,269,372,136,7,62,846
Michigan,Kentwood,50286,15152,18625,4376,639,1817,40609
Michigan,Kinde village,490,88,180,93,2,33,396
Michigan,Kingsford,5104,1034,2152,585,85,450,4306
Michigan,Kingsley village,1605,403,655,146,25,37,1266
Michigan,Kingston village,432,107,173,43,2,21,346
Michigan,K. I. Sawyer,3114,744,897,473,42,68,2224
Michigan,Laingsburg,1296,369,503,94,0,50,1016
Michigan,Lake Angelus,269,14,200,5,0,23,242
Michigan,Williamston,3855,849,1502,367,0,204,2922
Michigan,Keego Harbor,3016,795,1131,377,78,89,2470
Michigan,Presque Isle Harbor,567,78,360,46,4,54,542
Michigan,Prescott village,296,98,108,42,5,8,261
Michigan,Powers village,484,85,149,75,6,101,416
Michigan,Omer,315,50,142,26,9,25,252
Michigan,Onaway,791,218,295,87,19,49,668
Michigan,Onekama village,448,115,175,42,3,38,373
Michigan,Onsted village,935,134,447,106,5,39,731
Michigan,Ontonagon village,1399,271,669,149,0,173,1262
Michigan,Orchard Lake Village,2488,637,1328,162,4,46,2177
Michigan,Ortonville village,1635,426,537,173,22,67,1225
Michigan,Oscoda,803,150,290,177,8,73,698
Michigan,Ossineke,977,145,422,120,32,43,762
Michigan,Otisville village,920,182,353,166,21,68,790
Michigan,Omena,198,43,109,3,4,0,159
Michigan,Otsego,3975,785,1530,527,31,279,3152
Michigan,Ovid village,1596,354,507,210,30,151,1252
Michigan,Owendale village,210,27,90,18,0,16,151
Michigan,Owosso,14826,4249,5259,1541,169,634,11852
Michigan,Oxford village,3495,739,1502,559,0,102,2902
Michigan,Palmer,417,68,190,39,0,24,321
Michigan,Parchment,2016,587,635,258,18,80,1578
Michigan,Parkdale,640,127,302,84,2,99,614
Michigan,Parma village,870,185,348,92,0,7,632
Michigan,Paw Paw village,3445,1284,806,523,80,275,2968
Michigan,Paw Paw Lake,4037,1268,1429,441,47,321,3506
Michigan,Otter Lake village,398,102,155,49,1,18,325
Michigan,Olivet,1570,830,322,148,14,50,1364
Michigan,Pellston village,861,138,302,146,44,24,654
Michigan,Pentwater village,881,113,491,74,5,50,733
Michigan,Potterville,2612,610,1006,342,25,67,2050
Michigan,Posen village,222,57,63,32,4,16,172
Michigan,Port Sanilac village,546,149,240,59,5,36,489
Michigan,Portland,3910,817,1570,292,35,143,2857
Michigan,Port Huron,29508,8124,9385,3989,446,1646,23590
Michigan,Port Hope village,251,41,128,37,0,24,230
Michigan,Port Austin village,712,140,276,110,0,92,618
Michigan,Portage,47496,10844,20022,4255,534,2122,37777
Michigan,Pontiac,59928,22052,13385,6830,1269,2931,46467
Michigan,Ponshewaing,43,4,23,7,9,0,43
Michigan,Plymouth,8952,2458,3531,903,68,365,7325
Michigan,Pleasant Ridge,2555,613,1229,210,15,87,2154
Michigan,Plainwell,3810,850,1575,577,16,184,3202
Michigan,Pinconning,1348,381,432,160,4,113,1090
Michigan,Pinckney village,2672,593,1055,266,37,83,2034
Michigan,Pilgrim,50,7,41,0,0,2,50
Michigan,Pigeon village,1262,238,560,113,0,144,1055
Michigan,Pierson village,190,60,44,28,1,8,141
Michigan,Pewamo village,515,138,216,31,3,28,416
Michigan,Petoskey,5725,1787,2204,673,37,375,5076
Michigan,Petersburg,1315,349,523,138,11,51,1072
Michigan,Perry,1994,379,798,215,46,112,1550
Michigan,Perrinton village,575,112,151,99,3,22,387
Michigan,Ironton,162,29,73,23,0,17,142
Michigan,Gaastra,352,73,172,23,0,24,292
Michigan,Iron River,2944,531,1091,467,54,401,2544
Michigan,Ionia,11384,4813,2612,1703,183,455,9766
Michigan,Fair Plain,7706,1731,2965,807,118,410,6031
Michigan,Fairgrove village,529,111,201,74,0,36,422
Michigan,Haring,515,122,62,154,0,0,338
Michigan,Harper Woods,13964,4786,3877,1546,238,691,11138
Michigan,Harrietta village,134,18,73,9,1,7,108
Michigan,Peck village,683,213,214,86,8,45,566
Michigan,Harrisville,380,85,160,60,12,39,356
Michigan,Hart,2105,448,670,256,47,175,1596
Michigan,Hartford,2634,736,748,249,35,137,1905
Michigan,Harvey,1734,621,581,189,5,92,1488
Michigan,Farmington,10509,2508,4727,896,104,562,8797
Michigan,Haslett,20057,5676,8079,1781,193,1197,16926
Michigan,Hazel Park,16600,5497,4345,2012,182,1177,13213
Michigan,Hemlock,1625,325,603,263,22,100,1313
Michigan,Henderson,410,71,157,36,12,27,303
Michigan,Hersey village,355,80,125,51,2,13,271
Michigan,Hesperia village,893,189,296,164,7,45,701
Michigan,Hickory Corners,187,60,76,19,0,0,155
Michigan,Dryden village,1198,262,537,134,3,28,964
Michigan,Dundee village,3950,693,1556,730,79,170,3228
Michigan,Durand,3369,742,1212,507,24,327,2812
Michigan,Eagle village,93,26,39,3,1,4,73
Michigan,Hastings,7304,1720,2637,988,9,509,5863
Michigan,Eagle Harbor,128,5,96,7,0,17,125
Michigan,Farmington Hills,80971,18287,36465,7337,907,4431,67427
Michigan,Fennville,1777,454,469,150,61,59,1193
Michigan,Fremont,4051,816,1599,490,24,241,3170
Michigan,Free Soil village,143,30,67,21,4,9,131
Michigan,Freeport village,512,108,194,53,2,24,381
Michigan,Freeland,7241,1685,2974,619,49,220,5547
Michigan,Fraser,14582,3373,5937,1556,167,1064,12097
Michigan,Franklin village,3198,407,1798,138,23,91,2457
Michigan,Frankfort,1396,258,587,167,19,173,1204
Michigan,Frankenmuth,4947,853,2231,509,18,643,4254
Michigan,Fowlerville village,2887,759,940,401,7,132,2239
Michigan,Fowler village,1229,223,587,69,9,66,954
Michigan,Farwell village,816,211,293,111,12,78,705
Michigan,Fountain village,146,24,59,22,2,10,117
Michigan,Forestville village,71,7,41,5,0,2,55
Michigan,Forest Hills,27415,4229,15134,989,52,716,21120
Michigan,Flushing,8199,1459,3737,889,113,384,6582
Michigan,Flint,99802,38589,19893,13122,2238,4452,78294
Michigan,Flat Rock,9879,2494,3924,840,51,448,7757
Michigan,Filer City,133,58,47,4,0,0,109
Michigan,Fife Lake village,318,64,127,62,2,14,269
Michigan,Ferrysburg,2955,484,1475,440,7,219,2625
Michigan,Ferndale,20160,8437,5589,2263,452,520,17261
Michigan,Fenton,11538,2839,4347,1166,170,773,9295
Michigan,Fostoria,600,133,337,28,0,30,528
Michigan,Eagle River,69,10,35,14,0,7,66
Michigan,East Grand Rapids,11128,1573,5781,728,7,236,8325
Michigan,East Jordan,2474,572,857,302,64,144,1939
Michigan,Hillsdale,8203,3101,2113,818,181,550,6763
Michigan,Holland,33526,10755,11288,2594,396,1609,26642
Michigan,Holly village,6171,1539,2366,692,78,218,4893
Michigan,Holt,24289,5231,10222,2398,295,965,19111
Michigan,Homer village,1857,392,642,212,21,75,1342
Michigan,Honor village,235,41,96,29,9,11,186
Michigan,Hopkins village,661,118,272,48,6,23,467
Michigan,Horton Bay,462,116,250,35,10,23,434
Michigan,Houghton,7942,4776,1843,312,19,334,7284
Michigan,Houghton Lake,3236,533,1403,591,24,328,2879
Michigan,Hillman village,703,216,210,118,4,91,639
Michigan,Howard City village,1724,359,568,182,33,105,1247
Michigan,Hubbard Lake,868,92,583,71,0,87,833
Michigan,Hubbardston village,338,63,147,22,1,32,265
Michigan,Hubbell,1012,231,382,77,5,114,809
Michigan,Hudson,2413,532,883,288,30,103,1836
Michigan,Hudsonville,7271,1680,3248,455,0,277,5660
Michigan,Huntington Woods,6333,1070,3249,417,0,246,4982
Michigan,Imlay City,3582,957,1175,316,64,322,2834
Michigan,Indian River,1771,264,968,156,26,133,1547
Michigan,Inkster,24897,9181,5128,2836,506,1327,18978
Michigan,Interlochen,471,64,141,131,0,0,336
Michigan,Howell,9502,2234,3140,1331,137,586,7428
Michigan,Highland Park,11102,4728,1294,1356,483,973,8834
Michigan,Whittemore,444,94,147,61,10,42,354
Michigan,Whitmore Lake,6653,1708,2520,757,100,294,5379
Michigan,Eastlake village,490,67,250,55,11,32,415
Michigan,East Lansing,48669,35004,7654,1575,153,1119,45505
Michigan,Eastpointe,32585,10975,8927,3615,633,1690,25840
Michigan,Eastport,212,8,117,32,0,36,193
Michigan,East Tawas,2761,579,1166,399,12,174,2330
Michigan,Eastwood,6254,1844,1925,901,71,195,4936
Michigan,Eaton Rapids,5221,1114,1876,581,26,390,3987
Michigan,Eau Claire village,602,147,181,68,13,27,436
Michigan,Ecorse,9338,3082,2051,1030,263,794,7220
Michigan,Edgemont Park,2199,699,871,173,0,73,1816
Michigan,Edmore village,1287,354,388,137,23,88,990
Michigan,Edwardsburg village,1161,315,309,158,13,78,873
Michigan,Elberta village,208,50,102,23,0,19,194
Michigan,Elk Rapids village,1541,225,836,149,7,142,1359
Michigan,Elkton village,862,162,315,66,35,39,617
Michigan,Ellsworth village,399,117,195,21,4,21,358
Michigan,Elsie village,1080,262,423,118,27,78,908
Michigan,Emmett village,299,70,112,21,2,15,220
Michigan,Empire village,358,71,172,45,8,33,329
Michigan,Escanaba,12468,3046,4154,1881,192,1076,10349
Michigan,Essexville,3432,874,1331,325,46,195,2771
Michigan,Estral Beach village,397,80,190,45,10,26,351
Michigan,Evart,1515,331,426,257,34,107,1155
Michigan,Iron Mountain,7571,1673,2995,813,59,437,5977
Michigan,Harrison,2011,543,710,247,62,152,1714
Michigan,Sterling Heights,131139,32948,58388,9032,1120,7812,109300
Michigan,Mendon village,896,178,337,118,9,28,670
Michigan,Taylor,62021,17353,20425,7330,848,3415,49371
Michigan,Tecumseh,8393,1620,3681,1071,120,474,6966
Michigan,Tekonsha village,648,129,241,105,6,36,517
Michigan,Thompsonville village,576,165,180,79,9,35,468
Michigan,Three Oaks village,1598,379,612,169,24,54,1238
Michigan,Three Rivers,7787,1893,2319,1066,152,405,5835
Michigan,Traverse City,15168,4258,5653,2027,140,750,12828
Michigan,Trenton,18522,4006,7845,2056,158,1425,15490
Michigan,Trowbridge Park,2291,845,858,170,24,142,2039
Michigan,Troy,82542,17517,41470,4925,214,3575,67701
Michigan,Turner village,82,14,30,11,6,9,70
Michigan,Tustin village,242,65,111,22,0,3,201
Michigan,Twining village,171,46,56,25,0,11,138
Michigan,Twin Lake,1928,326,1145,56,17,117,1661
Michigan,Ubly village,755,183,290,81,3,66,623
Michigan,Tawas City,1888,426,762,243,29,202,1662
Michigan,Sylvan Lake,1701,428,798,179,12,49,1466
Michigan,Swartz Creek,5632,1308,2207,715,22,363,4615
Michigan,Suttons Bay village,584,87,290,43,2,77,499
Michigan,Mesick village,407,67,146,44,26,22,305
Michigan,Merrill village,706,173,255,68,7,41,544
Michigan,Menominee,8456,2078,2849,1211,191,615,6944
Michigan,Memphis,1230,308,480,136,8,44,976
Michigan,Melvindale,10510,3000,3169,1105,189,620,8083
Michigan,Melvin village,187,36,69,15,0,30,150
Michigan,Mecosta village,620,204,179,72,11,27,493
Michigan,Union City village,1618,360,564,215,37,78,1254
Michigan,Mayville village,962,282,276,135,34,78,805
Michigan,Mattawan village,2081,408,721,342,5,94,1570
Michigan,Stevensville village,1282,225,606,120,12,122,1085
Michigan,Stockbridge village,1043,166,469,125,22,88,870
Michigan,Stony Point,1498,239,754,153,0,79,1225
Michigan,Stronach,211,34,60,6,6,10,116
Michigan,Sturgis,10916,2205,3921,1134,254,602,8116
Michigan,Sunfield village,588,95,271,46,7,16,435
Michigan,Maybee village,516,92,270,36,2,21,421
Michigan,Metamora village,597,113,232,68,0,23,436
Michigan,Unionville village,423,55,201,70,6,30,362
Michigan,Vandalia village,406,159,106,36,3,41,345
Michigan,Wayland,4109,816,1578,440,66,197,3097
Michigan,Wayne,17251,5248,5301,2423,307,855,14134
Michigan,Webberville village,1308,313,520,205,8,51,1097
Michigan,Lakeview village,1073,197,373,128,16,85,799
Michigan,Lake Odessa village,1746,428,578,244,62,151,1463
Michigan,Lake Michigan Beach,1167,152,544,176,27,56,955
Michigan,Lake Linden village,1120,282,453,127,5,70,937
Michigan,Lake Leelanau,176,51,64,26,0,22,163
Michigan,Lake Isabella village,1883,277,999,133,13,71,1493
Michigan,Lake Fenton,5512,949,2716,627,85,258,4635
Michigan,Lakewood Club village,1230,259,511,163,18,68,1019
Michigan,Lambertville,9731,1790,4830,941,70,507,8138
Michigan,L'Anse village,2129,466,748,285,8,238,1745
Michigan,Lansing,114485,40859,31505,13098,1780,4548,91790
Michigan,Lapeer,8790,2651,2570,1234,248,540,7243
Michigan,Waverly,24535,6645,9573,2937,375,1337,20867
Michigan,Watervliet,1773,438,608,184,23,93,1346
Michigan,Watersmeet,415,69,155,68,4,32,328
Michigan,Warren,134857,39200,47647,12754,1581,9004,110186
Michigan,Vanderbilt village,583,110,201,117,17,44,489
Michigan,Vandercook Lake,4681,888,1969,473,91,267,3688
Michigan,Vassar,2648,680,1004,248,7,124,2063
Michigan,Vermontville village,828,165,262,106,12,33,578
Michigan,Vernon village,973,272,426,70,0,59,827
Michigan,Vicksburg village,3089,739,1188,391,36,92,2446
Michigan,Village of Clarkston,922,152,461,80,12,53,758
Michigan,Utica,4794,1358,1750,518,33,441,4100
Michigan,Village of Grosse Pointe Shores,2995,616,1576,179,0,235,2606
Michigan,Wacousta,1342,331,812,49,0,51,1243
Michigan,Wakefield,1729,361,767,174,17,210,1529
Michigan,Waldron village,594,135,230,42,7,21,435
Michigan,Walker,24242,6948,9655,2144,82,1054,19883
Michigan,Walkerville village,175,17,97,15,0,7,136
Michigan,Walled Lake,7091,1947,2440,1146,50,469,6052
Michigan,Walloon Lake,378,107,180,52,0,27,366
Michigan,Vineyard Lake,875,213,366,146,31,72,828
Michigan,Michiana village,198,18,139,17,0,17,191
Michigan,Michigamme,275,48,137,34,1,25,245
Michigan,Michigan Center,4704,1190,1778,781,21,138,3908
Michigan,Boyne City,3766,758,1573,434,40,215,3020
Michigan,Boyne Falls village,340,75,117,44,5,21,262
Michigan,Breckenridge village,1180,206,467,149,27,93,942
Michigan,Okemos,22073,6613,9378,1624,29,870,18514
Michigan,Oden,454,55,232,31,0,20,338
Michigan,Oak Park,29727,9942,9302,2849,392,1685,24170
Michigan,Oakley village,196,35,95,39,0,9,178
Michigan,Oak Hill,741,173,333,39,0,37,582
Michigan,Novi,57577,11969,26992,3938,388,2708,45995
Michigan,Norwood,156,19,93,6,2,2,122
Michigan,Norway,2820,620,1263,367,0,245,2495
Michigan,Norton Shores,23982,4836,10987,2659,259,1352,20093
Michigan,Northville,5990,1274,2986,494,28,272,5054
Michigan,Northview,15278,3729,6259,1593,158,862,12601
Michigan,Northport village,633,111,322,65,1,42,541
Michigan,Boon,241,47,117,9,0,16,189
Michigan,Bloomingdale village,655,155,196,95,13,23,482
Michigan,Bloomfield Hills,3956,780,2041,190,48,182,3241
Michigan,Blissfield village,3154,706,1107,502,39,148,2502
Michigan,Addison village,573,110,221,61,2,34,428
Michigan,Adrian,20878,7800,5718,2274,375,1003,17170
Michigan,Advance,269,19,168,50,4,14,255
Michigan,Ahmeek village,109,36,19,25,0,14,94
Michigan,Akron village,413,137,145,27,11,16,336
Michigan,Alanson village,675,129,282,123,9,28,571
Michigan,Alba,337,76,142,41,7,25,291
Michigan,North Muskegon,3778,739,1798,369,17,235,3158
Michigan,Albion,8316,3317,2149,740,187,449,6842
Michigan,Algonac,4063,983,1602,638,73,203,3499
Michigan,Allegan,5036,1133,1861,576,65,394,4029
Michigan,Allen village,243,48,103,30,0,19,200
Michigan,Big Rapids,10532,6435,1647,910,106,414,9512
Michigan,Bingham Farms village,1158,215,580,88,2,115,1000
Michigan,Birch Run village,1558,315,591,240,28,67,1241
Michigan,Birmingham,20489,4090,9425,1831,78,715,16139
Michigan,Alden,112,12,54,17,0,17,100
Michigan,North Branch village,1003,223,332,141,8,88,792
Michigan,North Adams village,574,105,243,52,9,14,423
Michigan,Niles,11450,2652,3622,1427,232,628,8561
Michigan,Morrice village,1172,233,462,97,24,60,876
Michigan,Morley village,729,219,235,75,7,38,574
Michigan,Morenci,2512,680,812,312,31,105,1940
Michigan,Montrose,1659,368,606,153,45,101,1273
Michigan,Montgomery village,300,77,110,19,5,17,228
Michigan,Montague,2408,473,936,304,40,125,1878
Michigan,Monroe,20335,5065,7372,2337,267,1119,16160
Michigan,Mount Clemens,16381,6051,4098,2305,362,923,13739
Michigan,Mio,1740,421,646,264,24,97,1452
Michigan,Millington village,886,207,308,140,13,70,738
Michigan,Millersburg village,182,31,77,20,9,19,156
Michigan,Milford village,6390,1257,2970,705,21,262,5215
Michigan,Milan,5929,1377,2435,638,40,184,4674
Michigan,Midland,41995,9966,17805,3773,429,2325,34298
Michigan,Middleville village,3304,606,1256,258,31,169,2320
Michigan,Middletown,689,285,255,55,8,67,670
Michigan,Minden City village,216,40,87,9,2,11,149
Michigan,Lathrup Village,4137,902,1920,402,111,86,3421
Michigan,Mount Morris,3003,1008,854,295,64,135,2356
Michigan,Muir village,672,124,196,78,27,46,471
Michigan,New Troy,627,135,208,83,18,47,491
Michigan,New Lothrop village,516,106,256,32,3,29,426
Michigan,New Haven village,4679,1169,1717,306,12,167,3371
Michigan,New Era village,486,79,255,34,3,19,390
Michigan,New Buffalo,1893,522,627,264,6,184,1603
Michigan,Newberry village,1729,320,640,178,44,176,1358
Michigan,New Baltimore,12212,2061,5773,1037,66,436,9373
Michigan,Mount Pleasant,26134,16009,4799,1859,172,848,23687
Michigan,Newaygo,1870,468,567,185,29,142,1391
Michigan,Negaunee,4609,1050,1976,430,4,341,3801
Michigan,Nashville village,1761,435,616,205,20,71,1347
Michigan,Napoleon,1103,262,412,120,0,47,841
Michigan,Muskegon Heights,10809,3894,1897,1115,300,577,7783
Michigan,Muskegon,37861,14154,8993,4955,634,2061,30797
Michigan,Munising,2303,549,881,333,36,182,1981
Michigan,Mulliken village,588,120,275,35,2,14,446
Michigan,Nessen City,161,50,31,41,2,7,131
Michigan,Laurium village,1906,428,690,213,6,137,1474
Michigan,Temperance,9369,1430,4584,676,89,573,7352
Michigan,Lawton village,1712,357,622,216,24,146,1365
Michigan,Columbiaville village,800,189,262,74,33,62,620
Michigan,Comstock Northwest,5140,1485,1680,667,32,303,4167
Michigan,Berrien Springs village,1318,307,515,127,24,79,1052
Michigan,Berkley,15178,4292,5989,1447,110,667,12505
Michigan,Benzonia village,431,118,100,68,16,32,334
Michigan,Benton Heights,4235,1396,766,442,96,235,2935
Michigan,Benton Harbor,10014,4012,1450,1016,255,448,7181
Michigan,Colon village,1136,149,492,141,9,102,893
Michigan,Bendon,191,17,116,34,0,0,167
Michigan,Belleville,3919,912,1267,522,138,217,3056
Michigan,Bellaire village,917,237,393,94,25,45,794
Michigan,Belding,5771,1522,2174,501,118,315,4630
Michigan,Beechwood,2839,645,979,491,12,103,2230
Michigan,Beecher,10184,3746,2183,1001,251,426,7607
Michigan,Beaverton,1019,274,316,151,30,88,859
Michigan,Bear Lake village,275,52,86,47,11,16,212
Michigan,Bellevue village,1382,369,472,198,34,74,1147
Michigan,Bear Lake,370,48,213,31,4,26,322
Michigan,Coloma,1600,362,568,182,15,95,1222
Michigan,Coldwater,10866,2555,3513,1412,192,760,8432
Michigan,Centreville village,1582,382,626,186,58,116,1368
Michigan,Charlevoix,2523,497,1098,385,47,179,2206
Michigan,Charlotte,9057,2350,3178,971,245,624,7368
Michigan,Chatham village,204,41,55,42,4,32,174
Michigan,Cheboygan,4783,969,1747,721,72,367,3876
Michigan,Chelsea,5126,873,2217,490,30,554,4164
Michigan,Chesaning village,2471,415,998,333,0,147,1893
Michigan,Coleman,1291,336,458,187,16,69,1066
Michigan,Chums Corner,1072,388,294,109,0,16,807
Michigan,Clarksville village,402,87,168,37,6,23,321
Michigan,Lawrence village,980,211,257,181,37,39,725
Michigan,Clayton village,360,95,127,21,4,15,262
Michigan,Clifford village,329,74,147,47,2,18,288
Michigan,Climax village,736,145,376,62,4,22,609
Michigan,Clinton village,2237,402,990,196,34,100,1722
Michigan,Clio,2582,664,805,325,88,202,2084
Michigan,Clare,3042,801,968,438,97,184,2488
Michigan,Beal City,438,95,217,8,0,24,344
Michigan,Bay View,221,8,206,0,0,0,214
Michigan,Bay Shore,841,158,309,115,0,37,619
Michigan,Ashley village,494,121,177,70,7,59,434
Michigan,Armada village,1998,337,833,195,11,178,1554
Michigan,Argentine,2567,460,1182,362,34,106,2144
Michigan,Arcadia,236,17,151,22,9,16,215
Michigan,Applegate village,308,101,104,24,5,10,244
Michigan,Ann Arbor,116194,56508,34453,8038,712,3285,102996
Michigan,Amasa,299,63,131,14,10,30,248
Michigan,Athens village,1109,268,441,100,24,49,882
Michigan,Alpha village,75,9,31,22,0,9,71
Michigan,Almont village,2685,543,1197,268,18,175,2201
Michigan,Alma,9264,3061,3005,1006,75,470,7617
Michigan,Allen Park,27676,7046,11738,2317,173,1805,23079
Michigan,Allendale,18456,9894,4900,564,42,294,15694
Michigan,Lake Orion village,3038,637,1424,295,28,166,2550
Michigan,Lakes of the North,716,66,459,28,0,51,604
Michigan,Lake Victoria,885,205,416,90,0,21,732
Michigan,Alpena,10273,2723,3709,1302,166,612,8512
Michigan,Atlanta,776,223,228,172,36,68,727
Michigan,Attica,671,142,422,21,0,16,601
Michigan,Auburn,2175,591,887,233,5,106,1822
Michigan,Bay Port,403,80,152,84,3,38,357
Michigan,Bay City,34402,10127,10654,4387,415,1958,27541
Michigan,Battle Creek,51830,13458,16691,6728,970,2906,40753
Michigan,Bath,2142,287,945,298,0,73,1603
Michigan,Barton Hills village,289,61,161,20,4,11,257
Michigan,Barryton village,404,76,105,66,11,51,309
Michigan,Baroda village,871,171,326,143,10,61,711
Michigan,Barnes Lake-Millers Lake,921,52,451,81,0,80,664
Michigan,Baraga village,3031,2023,469,233,31,89,2845
Michigan,Bangor,1849,435,592,247,14,130,1418
Michigan,Bancroft village,635,105,258,66,10,25,464
Michigan,Baldwin village,1497,596,291,250,52,107,1296
Michigan,Bad Axe,3052,837,1120,436,34,208,2635
Michigan,Au Sable,1401,289,556,206,32,161,1244
Michigan,Augusta village,878,199,313,116,12,55,695
Michigan,Au Gres,832,130,349,119,3,79,680
Michigan,Auburn Hills,22085,8312,7439,2144,232,752,18879
Michigan,Central Lake village,1068,217,424,119,21,64,845
Michigan,Center Line,8306,2582,2370,1099,210,500,6761
Michigan,Clawson,11988,3460,4542,1470,164,733,10369
Michigan,Byron Center,6391,1065,2894,405,0,311,4675
Michigan,Caspian,723,188,268,109,0,87,652
Michigan,Cass City village,2542,508,1094,224,27,178,2031
Michigan,Cassopolis village,1901,634,456,202,76,114,1482
Michigan,Wedgewood,198,16,129,11,7,0,163
Michigan,Weidman,934,208,283,152,22,39,704
Michigan,Wellston,304,79,128,56,3,17,283
Michigan,West Branch,2300,443,662,437,30,308,1880
Michigan,West Ishpeming,2873,528,1474,347,4,145,2498
Michigan,Westland,82642,24681,27496,9844,1371,5183,68575
Michigan,West Monroe,3345,1124,961,361,41,315,2802
Michigan,Westphalia village,933,155,495,26,9,39,724
Michigan,Westwood,9372,2908,3392,969,210,459,7938
Michigan,White Cloud,1351,378,367,251,16,78,1090
Michigan,Whitehall,2701,606,930,381,10,241,2168
Michigan,White Pigeon village,1519,356,553,232,40,56,1237
Michigan,White Pine,395,68,196,57,5,33,359
Michigan,Brownlee Park,2016,567,550,306,104,102,1629
Michigan,Beverly Hills village,10403,1837,5321,689,32,397,8276
Michigan,Beulah village,236,57,112,46,0,12,227
Michigan,Bessemer,1935,531,801,189,13,153,1687
Michigan,Cedar,80,6,41,18,5,0,70
Michigan,Casnovia village,457,126,197,19,2,9,353
Michigan,Caseville,773,107,328,133,10,87,665
Michigan,Carsonville village,462,79,138,60,6,29,312
Michigan,Carson City,1124,267,414,133,17,73,904
Michigan,Brutus,174,31,65,21,3,27,147
Michigan,Buchanan,4401,962,1660,557,29,333,3541
Michigan,Buckley village,774,111,297,68,0,15,491
Michigan,Brooklyn village,1309,223,476,159,20,131,1009
Michigan,Buena Vista,6192,2035,1218,694,268,582,4797
Michigan,Burlington village,263,49,115,34,3,9,210
Michigan,Burr Oak village,870,178,286,121,9,35,629
Michigan,Burt,1103,171,469,131,25,64,860
Michigan,Burton,29223,7531,10805,3324,333,1592,23585
Michigan,Byron village,576,120,224,51,11,12,418
Michigan,Cedar Springs,3570,1016,1113,490,48,112,2779
Michigan,Caberfae,20,1,8,5,0,6,20
Michigan,Caledonia village,1509,312,586,130,12,47,1087
Michigan,Calumet village,684,256,153,99,14,38,560
Michigan,Camden village,573,128,218,62,4,20,432
Michigan,Canada Creek Ranch,302,23,226,11,0,11,271
Michigan,Canadian Lakes,2768,325,1794,134,39,178,2470
Michigan,Capac village,1909,432,676,220,10,89,1427
Michigan,Carleton village,2447,532,824,342,37,157,1892
Michigan,Carney village,237,55,112,37,0,8,212
Michigan,Caro,4142,1174,1467,504,73,333,3551
Michigan,Carp Lake,454,45,205,121,6,25,402
Michigan,Cadillac,10327,1944,4098,1406,126,677,8251
Michigan,Cement City village,466,128,197,56,11,14,406
Michigan,Big Bay,187,42,65,39,0,34,180
Michigan,Brown City,1193,332,495,105,6,64,1002
Michigan,Leland,511,72,213,127,0,43,455
Michigan,Lennon village,458,85,219,44,2,15,365
Michigan,Leonard village,390,64,172,44,1,18,299
Michigan,Le Roy village,309,90,134,21,3,13,261
Michigan,Level Park-Oak Park,3595,786,1513,539,48,170,3056
Michigan,Breedsville village,249,44,97,51,3,1,196
Michigan,Brethren,349,59,147,39,6,24,275
Michigan,Bridgeport,6574,1448,2605,801,132,391,5377
Michigan,Bridgman,1997,393,824,194,8,229,1648
Michigan,Brighton,7555,1915,2986,870,53,716,6540
Michigan,Leslie,1720,297,720,219,23,64,1323
Michigan,Bronson,2437,649,782,342,15,100,1888
Michigan,Britton village,666,155,255,73,7,24,514
Minnesota,Wheaton,1526,258,744,102,6,133,1243
Minnesota,Whipholt,97,6,58,11,1,0,76
Minnesota,White Bear Lake,24709,5480,10222,2351,233,1581,19867
Minnesota,White Earth,567,208,49,64,7,56,384
Minnesota,Wilder,45,4,18,5,1,7,35
Minnesota,Willernie,576,170,139,76,2,21,408
Minnesota,Ironton,799,190,188,145,7,30,560
Minnesota,Isanti,5415,1489,1884,449,124,149,4095
Minnesota,Isle,762,193,249,118,17,77,654
Minnesota,Ivanhoe,535,118,259,54,2,58,491
Minnesota,Jackson,3268,740,1488,242,58,244,2772
Minnesota,Janesville,2667,527,1303,137,7,138,2112
Minnesota,Wilmont,387,78,145,39,9,17,288
Minnesota,Willow River,381,83,147,34,1,20,285
Minnesota,Willmar,19685,5259,7385,1705,181,1099,15629
Minnesota,Williams,197,61,61,22,0,15,159
Minnesota,Iron Junction,104,22,41,19,0,6,88
Minnesota,Kandiyohi,581,94,231,48,11,16,400
Minnesota,Jordan,5900,1471,2353,402,0,182,4408
Minnesota,Johnson,3,0,0,3,0,0,3
Minnesota,Jenkins,448,46,193,32,1,13,285
Minnesota,Jeffers,419,117,138,30,2,24,311
Minnesota,Jasper,598,83,275,56,2,71,487
Minnesota,Whalan,82,23,23,13,0,9,68
Minnesota,International Falls,6270,1468,2427,615,138,525,5173
Minnesota,West St. Paul,19709,5776,7043,1725,275,1170,15989
Minnesota,Inger,251,124,53,19,0,2,198
Minnesota,Independence,3671,576,2203,144,0,114,3037
Minnesota,Ihlen,44,7,23,9,0,5,44
Minnesota,Hutchinson,13941,3199,5627,1134,145,1085,11190
Minnesota,Humboldt,18,5,7,4,1,0,17
Minnesota,Hugo,14053,2919,6083,1284,126,230,10642
Minnesota,Hoyt Lakes,2002,306,1061,188,0,132,1687
Minnesota,Howard Lake,2115,452,815,192,22,112,1593
Minnesota,Iona,128,17,62,4,2,14,99
Minnesota,Viking,130,15,54,23,0,1,93
Minnesota,Victoria,8103,1303,4279,234,13,92,5921
Minnesota,Vesta,322,77,137,7,8,24,253
Minnesota,Vernon Center,338,59,166,20,0,12,257
Minnesota,Verndale,733,152,285,102,8,20,567
Minnesota,Vermillion,471,112,251,13,3,13,392
Minnesota,Vergas,308,52,142,35,2,38,269
Minnesota,Vadnais Heights,12968,3123,5759,1232,95,524,10733
Minnesota,Utica,308,61,119,39,1,2,222
Minnesota,Inver Grove Heights,34417,8515,14100,3305,388,1488,27796
Minnesota,Westbrook,756,118,351,75,0,93,637
Minnesota,West Concord,812,154,329,67,3,41,594
Minnesota,Westport,37,7,13,5,0,6,31
Minnesota,West Roy Lake,52,23,9,11,0,4,47
Minnesota,West Union,142,41,51,9,0,0,101
Minnesota,Urbank,68,8,27,2,6,4,47
Minnesota,Waltham,167,34,69,13,4,11,131
Minnesota,Kasota,820,190,389,45,7,20,651
Minnesota,Lafayette,479,81,207,51,0,25,364
Minnesota,Lake Benton,685,138,256,89,5,70,558
Minnesota,Lake Bronson,228,69,70,44,6,13,202
Minnesota,Lake City,5111,978,2572,395,28,398,4371
Minnesota,Lake Crystal,2545,452,1109,183,0,160,1904
Minnesota,Lake Elmo,8199,1630,4307,331,27,234,6529
Minnesota,Lakefield,1527,269,631,183,13,149,1245
Minnesota,Lake George,186,33,104,16,4,14,171
Minnesota,Lake Henry,78,18,39,6,0,3,66
Minnesota,Lakeland,1741,277,881,140,11,93,1402
Minnesota,Lakeland Shores,304,60,161,25,0,11,257
Minnesota,Lake Lillian,271,60,107,26,0,16,209
Minnesota,Lake Park,725,143,300,63,6,33,545
Minnesota,Lake St. Croix Beach,1135,326,513,106,14,35,994
Minnesota,Lake Shore,1025,128,612,87,4,47,878
Minnesota,Lakeville,58592,11428,27887,3257,346,1205,44123
Minnesota,Lake Wilson,253,49,126,26,4,23,228
Minnesota,Lamberton,844,168,337,104,6,50,665
Minnesota,Lancaster,372,58,171,22,0,25,276
Minnesota,Landfall,752,251,206,99,9,14,579
Minnesota,Lanesboro,755,128,384,92,2,43,649
Minnesota,Lansing,184,29,81,17,0,6,133
Minnesota,Waseca,9324,2404,3553,947,164,474,7542
Minnesota,Warsaw,764,147,410,37,3,22,619
Minnesota,Warroad,1862,464,651,156,3,151,1425
Minnesota,Warren,1576,298,701,129,4,145,1277
Minnesota,Warba,108,21,51,15,0,4,91
Minnesota,Wanda,59,20,31,2,0,5,58
Minnesota,Wanamingo,1179,186,476,120,14,77,873
Minnesota,La Crescent,4815,993,2167,314,24,294,3792
Minnesota,Kinney,160,22,82,12,0,13,129
Minnesota,Kingston,157,24,61,7,0,11,103
Minnesota,Kinbrae,2,0,2,0,0,0,2
Minnesota,Kasson,6049,1229,2674,428,20,244,4595
Minnesota,Keewatin,1080,222,477,131,3,53,886
Minnesota,Kelliher,303,62,118,52,3,12,247
Minnesota,Kellogg,385,58,186,47,0,28,319
Minnesota,Kennedy,241,68,107,23,4,8,210
Minnesota,Kenneth,69,11,32,7,2,2,54
Minnesota,Kensington,298,55,123,40,0,24,242
Minnesota,Kent,69,14,36,2,0,11,63
Minnesota,Kenyon,1724,305,795,143,12,160,1415
Minnesota,Kerkhoven,793,136,361,60,10,44,611
Minnesota,Kerrick,52,17,19,2,0,3,41
Minnesota,Walters,121,39,38,5,0,3,85
Minnesota,Wilton,184,66,73,11,0,4,154
Minnesota,Villard,216,45,97,26,1,18,187
Minnesota,Karlstad,783,211,216,80,13,93,613
Minnesota,Vineland,962,329,177,73,9,32,620
Minnesota,Virginia,8658,2183,2943,1254,120,626,7126
Minnesota,Wabasha,2659,592,1199,231,21,257,2300
Minnesota,Wabasso,636,148,241,68,0,61,518
Minnesota,Kettle River,156,41,56,24,3,11,135
Minnesota,Waconia,11494,1926,5444,569,88,463,8490
Minnesota,Wadena,4056,1005,1267,485,77,411,3245
Minnesota,Wahkon,205,49,61,46,5,23,184
Minnesota,Waite Park,7429,2641,2130,837,50,316,5974
Minnesota,Waldorf,192,39,95,22,0,8,164
Minnesota,Walker,1036,304,335,128,15,94,876
Minnesota,Walnut Grove,821,195,287,22,35,70,609
Minnesota,Kiester,449,98,197,59,8,46,408
Minnesota,Kilkenny,327,101,107,10,0,2,220
Minnesota,Kimball,884,232,373,81,6,24,716
Minnesota,Vining,41,9,15,3,0,7,34
Minnesota,Windom,4601,803,2014,521,27,271,3636
Minnesota,Lastrup,151,19,78,21,0,3,121
Minnesota,Winnebago,1432,300,622,135,2,125,1184
Minnesota,Arden Hills,9797,3651,3847,540,85,518,8641
Minnesota,Arco,116,12,34,14,0,16,76
Minnesota,Apple Valley,50309,11231,22911,4028,283,1720,40173
Minnesota,Appleton,1540,389,589,148,0,138,1264
Minnesota,Anoka,17244,4532,5996,2258,290,991,14067
Minnesota,Annandale,3296,747,1239,200,71,243,2500
Minnesota,Argyle,569,101,295,41,2,43,482
Minnesota,Angle Inlet,22,0,0,22,0,0,22
Minnesota,Amboy,520,100,257,34,8,27,426
Minnesota,Alvarado,444,98,200,21,0,11,330
Minnesota,Altura,474,89,235,28,0,16,368
Minnesota,Alpha,269,88,56,13,2,6,165
Minnesota,Alexandria,11614,3518,3958,1011,174,965,9626
Minnesota,Aldrich,68,17,23,3,0,3,46
Minnesota,Andover,31553,6825,14784,1829,148,690,24276
Minnesota,Alden,643,182,281,40,6,31,540
Minnesota,Arlington,2181,522,802,165,11,171,1671
Minnesota,Ashby,473,60,206,39,5,36,346
Minnesota,Balaton,524,139,230,47,6,39,461
Minnesota,Baker,66,7,35,2,0,3,47
Minnesota,Bagley,1410,286,430,195,0,213,1124
Minnesota,Badger,425,79,174,54,1,17,325
Minnesota,Backus,319,89,93,52,0,27,261
Minnesota,Babbitt,1537,336,602,186,19,169,1312
Minnesota,Arnold,3071,763,1339,308,10,134,2554
Minnesota,Upsala,480,102,181,29,13,31,356
Minnesota,Avoca,89,18,56,5,0,4,83
Minnesota,Austin,24687,6326,9341,2124,240,1405,19436
Minnesota,Aurora,1724,347,639,279,39,148,1452
Minnesota,Audubon,593,175,196,43,7,9,430
Minnesota,Atwater,1071,284,389,109,4,30,816
Minnesota,Askov,370,90,140,52,7,23,312
Minnesota,Avon,1592,270,727,127,3,58,1185
Minnesota,Ball Club,247,79,69,36,7,5,196
Minnesota,Albertville,7226,990,3309,312,31,134,4776
Minnesota,Alberta,122,16,71,4,0,4,95
Minnesota,Danube,596,143,242,25,8,21,439
Minnesota,Dalton,292,56,105,29,2,6,198
Minnesota,Dakota,336,63,151,41,0,8,263
Minnesota,Cyrus,341,85,137,37,0,17,276
Minnesota,Wendell,116,14,73,18,0,8,113
Minnesota,Wells,2358,455,1119,120,18,212,1924
Minnesota,Danvers,140,26,55,8,1,9,99
Minnesota,Welcome,774,131,341,71,3,44,590
Minnesota,Waverly,1565,310,691,88,23,28,1140
Minnesota,Waubun,511,190,121,39,2,24,376
Minnesota,Watson,176,34,81,21,3,12,151
Minnesota,Watkins,864,250,231,89,13,97,680
Minnesota,Waterville,1731,411,699,213,9,145,1477
Minnesota,Watertown,4257,921,1807,326,18,261,3333
Minnesota,Wayzata,4166,802,1989,491,69,257,3608
Minnesota,Albert Lea,17843,4241,6912,2025,214,1426,14818
Minnesota,Darfur,115,33,44,1,0,10,88
Minnesota,Dassel,1447,212,629,160,9,97,1107
Minnesota,Albany,2618,439,1050,258,41,313,2101
Minnesota,Akeley,397,69,176,39,9,23,316
Minnesota,Aitkin,2279,565,648,328,32,253,1826
Minnesota,Afton,2932,460,1739,203,6,119,2527
Minnesota,Adrian,1278,233,599,84,5,101,1022
Minnesota,Adams,742,144,314,78,4,65,605
Minnesota,Darwin,350,94,130,45,1,10,280
Minnesota,Ada,1681,333,668,196,13,143,1353
Minnesota,Deerwood,455,64,221,59,0,27,371
Minnesota,Deer River,1027,260,357,100,3,81,801
Minnesota,Deer Creek,232,37,111,30,0,13,191
Minnesota,Deephaven,3769,476,1995,244,18,88,2821
Minnesota,Dayton,4857,871,2589,303,30,99,3892
Minnesota,Dawson,1518,308,643,122,27,147,1247
Minnesota,De Graff,126,29,50,16,0,4,99
Minnesota,Winger,261,66,84,24,3,11,188
Minnesota,Barnesville,2571,424,1075,225,6,197,1927
Minnesota,Barrett,339,59,135,29,3,42,268
Minnesota,Zumbrota,3325,458,1325,273,56,288,2400
Minnesota,St. Leo,91,12,37,17,4,9,79
Minnesota,St. Joseph,6749,3664,1753,247,44,89,5797
Minnesota,St. James,4508,1146,1643,320,48,265,3422
Minnesota,St. Hilaire,283,77,112,52,1,5,247
Minnesota,St. Francis,7340,1675,3045,681,121,136,5658
Minnesota,Zumbro Falls,176,27,67,31,2,2,129
Minnesota,St. Cloud,66298,26453,20107,5749,437,2433,55179
Minnesota,St. Charles,3710,812,1457,283,41,195,2788
Minnesota,St. Bonifacius,2472,413,1195,219,21,95,1943
Minnesota,St. Augusta,3486,495,1940,143,8,103,2689
Minnesota,St. Anthony city (Stearns County),106,19,53,0,0,2,74
Minnesota,St. Anthony city (Hennepin and Ramsey Counties),8662,2293,3337,771,131,608,7140
Minnesota,Sacred Heart,613,102,210,61,13,44,430
Minnesota,St. Clair,896,234,356,70,0,11,671
Minnesota,Sabin,582,130,267,30,0,13,440
Minnesota,Zimmerman,5280,927,2016,589,22,124,3678
Minnesota,Wyoming,7755,1752,3489,606,30,286,6163
Minnesota,Winona,27437,12886,8467,1753,145,1387,24638
Minnesota,Winsted,2377,572,878,201,14,168,1833
Minnesota,Winthrop,1370,324,555,79,0,123,1081
Minnesota,Winton,105,20,57,18,4,2,101
Minnesota,Wolf Lake,57,4,20,9,0,4,37
Minnesota,Wolverton,93,15,56,4,0,7,82
Minnesota,Zemple,92,18,42,4,1,10,75
Minnesota,Woodbury,65667,12849,30956,4402,296,1684,50187
Minnesota,Woodland,443,52,284,21,5,2,364
Minnesota,Woodstock,149,46,44,18,6,6,120
Minnesota,Worthington,12990,3679,4660,721,183,578,9821
Minnesota,Wrenshall,489,74,189,74,0,38,375
Minnesota,Wright,148,31,44,16,0,8,99
Minnesota,Wykoff,418,108,182,39,3,18,350
Minnesota,Wood Lake,388,90,163,41,2,21,317
Minnesota,Barnum,664,144,228,98,8,30,508
Minnesota,Rutledge,194,49,82,16,0,8,155
Minnesota,Russell,404,84,156,21,10,24,295
Minnesota,Rockford,4218,1111,1599,405,58,60,3233
Minnesota,Rock Creek,1653,288,816,165,3,69,1341
Minnesota,Rochester,110275,27579,45334,9168,996,4272,87349
Minnesota,Robbinsdale,14289,4340,5187,1497,116,603,11743
Minnesota,Riverton,116,46,38,17,0,3,104
Minnesota,Riverland,271,78,42,10,2,2,134
Minnesota,Rockville,2481,574,1227,67,23,78,1969
Minnesota,Richville,75,17,33,4,2,9,65
Minnesota,Beardsley,170,39,71,17,0,16,143
Minnesota,Bayport,3648,1561,1069,354,56,204,3244
Minnesota,Baxter,7768,1696,3394,652,40,387,6169
Minnesota,Baudette,1096,254,392,104,10,97,857
Minnesota,Battle Lake,868,156,357,82,28,102,725
Minnesota,Barry,9,1,6,0,0,1,8
Minnesota,Richmond,1498,374,653,123,0,88,1238
Minnesota,Ruthton,258,61,114,24,0,14,213
Minnesota,Rogers,12002,2049,5643,686,77,395,8850
Minnesota,Ronneby,32,10,20,0,0,0,30
Minnesota,Rushmore,288,72,117,19,6,23,237
Minnesota,Rushford Village,946,136,524,66,0,45,771
Minnesota,Rushford,1916,388,813,116,26,157,1500
Minnesota,Rush City,3068,1238,800,338,61,190,2627
Minnesota,Roy Lake,15,2,7,0,0,6,15
Minnesota,Royalton,1230,236,504,54,17,68,879
Minnesota,Rollingstone,615,131,289,52,5,27,504
Minnesota,Round Lake,398,89,166,42,3,30,330
Minnesota,Roseville,34948,9950,14258,2778,223,2311,29520
Minnesota,Rosemount,22741,4326,9973,1815,267,662,17043
Minnesota,Rose Creek,382,51,189,37,2,21,300
Minnesota,Roseau,2647,586,1184,254,4,113,2141
Minnesota,Roscoe,132,33,42,28,0,10,113
Minnesota,Roosevelt,131,18,54,21,3,12,108
Minnesota,Rothsay,461,57,227,64,3,27,378
Minnesota,Underwood,384,55,177,44,1,21,298
Minnesota,Beaver Creek,304,46,166,20,4,9,245
Minnesota,Tyler,1244,225,519,115,4,111,974
Minnesota,St. Marys Point,351,76,169,28,0,24,297
Minnesota,St. Michael,16911,3201,8085,847,105,309,12547
Minnesota,St. Paul,295043,104495,88406,24821,4717,9653,232092
Minnesota,St. Paul Park,5341,1456,1987,622,64,133,4262
Minnesota,St. Peter,11492,4665,3532,722,96,533,9548
Minnesota,St. Rosa,74,22,30,5,0,4,61
Minnesota,Dexter,288,61,136,45,0,12,254
Minnesota,Detroit Lakes,8897,2223,3283,1015,54,668,7243
Minnesota,Dent,162,16,70,27,7,14,134
Minnesota,St. Stephen,953,180,470,44,6,23,723
Minnesota,St. Vincent,35,9,16,3,0,5,33
Minnesota,Sanborn,337,44,181,24,6,30,285
Minnesota,Sandstone,2780,970,575,509,162,178,2394
Minnesota,Sargeant,60,23,18,13,2,2,58
Minnesota,Sartell,16274,3314,7017,1097,29,617,12074
Minnesota,Sauk Centre,4331,963,1806,260,0,392,3421
Minnesota,Sauk Rapids,13196,3327,4863,1039,223,586,10038
Minnesota,Savage,28713,5585,13305,1667,222,660,21439
Minnesota,Scandia,3995,868,2249,229,22,103,3471
Minnesota,Scanlon,1209,271,441,128,9,90,939
Minnesota,Seaforth,89,10,33,7,0,0,50
Minnesota,St. Martin,364,73,158,16,7,12,266
Minnesota,St. Louis Park,47043,15455,17111,4283,603,2054,39506
Minnesota,Dilworth,4166,740,1729,365,24,167,3025
Minnesota,Dodge Center,2680,685,844,251,34,96,1910
Minnesota,Edgerton,1217,105,670,60,4,129,968
Minnesota,Eden Valley,957,241,260,153,11,75,740
Minnesota,Eden Prairie,62626,12952,30204,4271,605,1677,49709
Minnesota,Echo,299,80,108,23,4,15,230
Minnesota,Ebro,103,26,26,13,4,2,71
Minnesota,Easton,230,25,124,21,6,8,184
Minnesota,East Gull Lake,992,175,601,41,2,21,840
Minnesota,East Grand Forks,8611,2037,3497,600,70,533,6737
Minnesota,East Bethel,11625,2398,5899,867,64,240,9468
Minnesota,Eagle Lake,2612,577,1115,166,5,48,1911
Minnesota,Searles,196,33,101,9,0,7,150
Minnesota,Eagle Bend,450,82,188,38,10,55,373
Minnesota,Dunnell,173,35,93,15,0,15,158
Minnesota,Dundee,123,23,57,10,0,8,98
Minnesota,Dundas,1647,285,713,122,17,57,1194
Minnesota,Dumont,98,26,49,1,3,1,80
Minnesota,Duluth,86178,31663,28728,7919,735,4042,73087
Minnesota,Dovray,69,1,45,9,1,7,63
Minnesota,Dover,811,96,390,47,10,11,554
Minnesota,Doran,31,4,17,5,0,1,27
Minnesota,Donnelly,245,58,122,13,1,6,200
Minnesota,Donaldson,19,4,3,10,0,2,19
Minnesota,Eagan,65424,15344,29269,5601,477,1582,52273
Minnesota,Sebeka,688,157,276,62,3,46,544
Minnesota,Sedan,42,20,10,7,0,2,39
Minnesota,Fertile,931,220,290,112,3,118,743
Minnesota,Garfield,251,62,98,38,2,17,217
Minnesota,Dennison,137,26,67,10,0,4,107
Minnesota,Denham,37,4,15,13,0,1,33
Minnesota,Dellwood,1164,175,686,44,5,29,939
Minnesota,Delhi,44,7,18,11,0,7,43
Minnesota,Delavan,245,33,118,22,0,10,183
Minnesota,Garrison,225,48,102,36,4,12,202
Minnesota,Garvin,120,32,50,9,4,5,100
Minnesota,Gary,266,52,113,22,2,12,201
Minnesota,Gaylord,2080,407,936,146,40,183,1712
Minnesota,Garden City,373,59,190,20,0,9,278
Minnesota,Gem Lake,465,97,235,37,0,11,380
Minnesota,Genola,73,11,44,2,0,2,59
Minnesota,Georgetown,113,5,64,4,0,0,73
Minnesota,Ghent,344,59,157,21,1,11,249
Minnesota,Gibbon,825,202,321,50,0,40,613
Minnesota,Gilbert,1809,438,780,240,0,95,1553
Minnesota,Gilman,183,28,74,24,1,7,134
Minnesota,Glencoe,5557,1133,2219,621,36,432,4441
Minnesota,Taconite,634,132,295,43,2,33,505
Minnesota,Tamarack,54,15,16,18,0,1,50
Minnesota,Taopi,54,11,32,2,0,0,45
Minnesota,Geneva,411,46,198,26,16,17,303
Minnesota,Edina,49373,9147,23175,4040,272,2875,39509
Minnesota,Funkley,5,2,0,3,0,0,5
Minnesota,Frost,227,45,102,23,9,12,191
Minnesota,Fifty Lakes,318,47,185,47,10,11,300
Minnesota,Finland,165,52,79,5,0,16,152
Minnesota,Finlayson,261,70,96,41,2,14,223
Minnesota,Fisher,464,93,188,23,5,21,330
Minnesota,Fish Lake,82,14,53,2,0,0,69
Minnesota,Flensburg,193,50,90,8,0,7,155
Minnesota,Floodwood,472,101,131,88,9,69,398
Minnesota,Florence,14,1,8,3,0,0,12
Minnesota,Foley,2636,584,962,265,2,187,2000
Minnesota,Forada,211,39,115,20,0,16,190
Minnesota,Fulda,1296,264,503,146,21,162,1096
Minnesota,Forest Lake,19170,4191,7906,1675,374,655,14801
Minnesota,Fort Ripley,103,4,51,3,0,7,65
Minnesota,Fosston,1624,376,563,194,18,155,1306
Minnesota,Fountain,421,73,201,24,0,26,324
Minnesota,Foxhome,127,42,42,12,4,7,107
Minnesota,Franklin,636,142,205,96,0,31,474
Minnesota,Frazee,1320,320,466,169,12,91,1058
Minnesota,Freeborn,333,67,148,23,2,14,254
Minnesota,Freeport,607,110,331,10,0,38,489
Minnesota,Fridley,27592,7915,10260,2344,569,1072,22160
Minnesota,Frontenac,197,11,109,19,0,32,171
Minnesota,Foreston,643,157,252,47,5,11,472
Minnesota,Taunton,161,21,55,28,4,3,111
Minnesota,Effie,83,22,38,9,0,1,70
Minnesota,Elba,139,31,62,14,0,7,114
Minnesota,Loretto,709,105,351,46,10,21,533
Minnesota,Louisburg,35,2,16,13,0,2,33
Minnesota,Lowry,339,47,150,23,0,25,245
Minnesota,Lucan,175,25,82,12,2,13,134
Minnesota,Lutsen,437,146,194,8,25,1,374
Minnesota,Luverne,4665,764,2033,436,71,383,3687
Minnesota,Lyle,504,122,196,65,1,33,417
Minnesota,Lynd,563,159,249,31,3,23,465
Minnesota,Mabel,741,173,295,55,4,83,610
Minnesota,McGrath,82,34,30,5,0,2,71
Minnesota,McGregor,456,169,121,54,1,29,374
Minnesota,McIntosh,537,96,139,97,13,84,429
Minnesota,McKinley,159,28,67,18,0,6,119
Minnesota,Madelia,2368,455,972,194,43,165,1829
Minnesota,Madison,1558,281,703,147,12,179,1322
Minnesota,Madison Lake,985,219,411,83,22,38,773
Minnesota,Magnolia,212,55,103,27,0,8,193
Minnesota,Mahnomen,1275,318,435,124,9,96,982
Minnesota,Mahnomen,266,96,21,27,3,3,150
Minnesota,Mahtomedi,7999,1508,3932,563,30,287,6320
Minnesota,Mahtowa,428,74,199,26,4,9,312
Minnesota,Lonsdale,3781,601,1699,175,49,86,2610
Minnesota,Longville,92,16,41,10,2,21,90
Minnesota,Long Prairie,3392,715,1346,228,18,256,2563
Minnesota,Long Lake,1803,403,745,241,11,56,1456
Minnesota,Lauderdale,2468,955,928,120,66,122,2191
Minnesota,Le Center,2370,469,832,212,55,161,1729
Minnesota,Lengby,63,10,25,7,0,8,50
Minnesota,Leonard,42,8,21,1,0,2,32
Minnesota,Leonidas,39,2,19,5,0,7,33
Minnesota,Leota,192,29,111,7,0,20,167
Minnesota,Le Roy,819,169,335,88,0,78,670
Minnesota,Lester Prairie,1737,352,690,94,0,109,1245
Minnesota,Le Sueur,4020,958,1617,383,28,335,3321
Minnesota,Lewiston,1562,386,701,123,11,48,1269
Minnesota,Manchester,39,5,23,7,0,3,38
Minnesota,Lewisville,222,30,94,40,0,7,171
Minnesota,Lilydale,750,104,445,62,10,107,728
Minnesota,Lindstrom,4417,804,2183,383,10,209,3589
Minnesota,Lino Lakes,20819,4764,9964,1336,155,359,16578
Minnesota,Lismore,250,43,118,14,0,15,190
Minnesota,Litchfield,6691,1351,2980,547,14,416,5308
Minnesota,Little Canada,10120,3090,3607,957,189,596,8439
Minnesota,Little Falls,8721,2002,3472,863,122,748,7207
Minnesota,Littlefork,671,95,299,59,0,93,546
Minnesota,Little Rock,1170,461,111,112,21,47,752
Minnesota,Long Beach,334,17,244,25,0,13,299
Minnesota,Lexington,1969,550,571,321,65,56,1563
Minnesota,Manhattan Beach,69,2,41,4,0,4,51
Minnesota,Mankato,40557,19045,11846,2221,196,1443,34751
Minnesota,Mantorville,1153,229,572,86,14,46,947
Minnesota,Farmington,22159,3858,9959,1608,110,356,15891
Minnesota,Farwell,55,10,20,13,4,2,49
Minnesota,Federal Dam,94,20,42,11,0,3,76
Minnesota,Felton,150,37,40,41,7,7,132
Minnesota,Fergus Falls,13266,3511,5570,1067,70,953,11171
Minnesota,Erhard,117,18,59,13,2,11,103
Minnesota,Emmons,413,66,164,56,8,19,313
Minnesota,Emily,746,94,402,102,5,60,663
Minnesota,Elysian,604,108,349,27,2,24,510
Minnesota,Ely,3445,895,1381,372,60,290,2998
Minnesota,Faribault,23509,6277,8346,2471,354,1299,18747
Minnesota,Elrosa,174,34,89,6,0,18,147
Minnesota,Elmdale,84,17,41,2,0,10,70
Minnesota,Ellsworth,470,105,199,30,0,60,394
Minnesota,Ellendale,685,102,284,63,6,56,511
Minnesota,Elkton,111,5,50,9,5,3,72
Minnesota,Elk River,23563,4624,10516,1866,207,888,18101
Minnesota,Elko New Market,4529,386,2392,261,0,48,3087
Minnesota,Elizabeth,172,23,76,13,6,15,133
Minnesota,Elgin,1184,211,555,79,0,30,875
Minnesota,Elbow Lake,1191,281,486,108,17,83,975
Minnesota,Elbow Lake,113,26,54,8,0,9,97
Minnesota,Elmore,614,108,257,89,10,23,487
Minnesota,Eitzen,229,50,96,20,2,25,193
Minnesota,Falcon Heights,5484,1728,2382,222,48,237,4617
Minnesota,Fairhaven,356,43,177,37,0,3,260
Minnesota,Maple Grove,65687,11728,32901,4869,436,1617,51551
Minnesota,Maple Lake,2103,468,836,152,16,87,1559
Minnesota,Maple Plain,1851,403,763,163,23,108,1460
Minnesota,Mapleton,1759,361,684,158,29,121,1353
Minnesota,Mapleview,209,41,65,38,0,11,155
Minnesota,Maplewood,39775,9865,15779,3826,321,2222,32013
Minnesota,Marble,567,133,227,61,6,39,466
Minnesota,Marietta,139,30,64,19,3,14,130
Minnesota,Marine on St. Croix,722,130,401,45,0,37,613
Minnesota,Marshall,13608,4684,4731,744,114,723,10996
Minnesota,Fairmont,10387,2321,4121,1100,44,1006,8592
Minnesota,Martin Lake,1013,202,489,63,20,10,784
Minnesota,La Prairie,791,146,356,60,2,24,588
Minnesota,Laporte,178,66,52,25,0,2,145
Minnesota,Erskine,511,108,203,49,4,32,396
Minnesota,Esko,1638,269,842,159,15,43,1328
Minnesota,Evan,51,8,16,13,0,10,47
Minnesota,Evansville,603,113,261,58,7,64,503
Minnesota,Eveleth,3692,930,1252,371,71,313,2937
Minnesota,Excelsior,2146,696,690,310,31,95,1822
Minnesota,Eyota,2092,326,932,202,11,63,1534
Minnesota,Fairfax,955,176,422,138,2,94,832
Minnesota,Mayer,1754,306,866,53,8,23,1256
Minnesota,Ulen,550,81,241,54,0,79,455
Minnesota,Taylors Falls,1019,219,382,124,13,47,785
Minnesota,The Lakes,687,64,455,42,5,31,597
Minnesota,Comfrey,359,62,157,32,0,30,281
Minnesota,Shafer,991,196,371,116,10,10,703
Minnesota,Shakopee,39137,8773,16021,3249,325,853,29221
Minnesota,Shelly,199,44,73,27,0,18,162
Minnesota,Sherburn,1027,177,436,88,18,88,807
Minnesota,Shevlin,177,43,63,26,3,4,139
Minnesota,Shoreview,25951,5517,12629,2249,104,1029,21528
Minnesota,Shorewood,7509,1343,3918,428,20,233,5942
Minnesota,Silver Bay,1745,305,821,186,11,193,1516
Minnesota,Silver Creek,267,62,138,30,0,4,234
Minnesota,Silver Lake,964,191,347,79,9,49,675
Minnesota,Skyline,340,88,158,22,0,31,299
Minnesota,Slayton,2070,380,919,235,9,196,1739
Minnesota,Sleepy Eye,3498,858,1299,265,28,249,2699
Minnesota,Sobieski,185,44,84,9,0,15,152
Minnesota,Solway,115,33,48,5,0,6,92
Minnesota,Soudan,435,84,210,69,0,19,382
Minnesota,South End,21,5,5,0,2,3,15
Minnesota,South Haven,236,57,66,23,0,6,152
Minnesota,South St. Paul,20413,5984,7519,1764,149,929,16345
Minnesota,Spicer,1294,276,566,113,34,46,1035
Minnesota,Beaulieu,54,25,16,1,3,5,50
Minnesota,Beaver Bay,126,26,65,13,1,9,114
Minnesota,La Salle,48,21,9,4,1,1,36
Minnesota,Becker,4647,956,1858,427,60,57,3358
Minnesota,Biwabik,933,249,304,121,12,107,793
Minnesota,Biscay,68,12,43,1,1,4,61
Minnesota,Bird Island,849,137,379,130,0,69,715
Minnesota,Birchwood Village,867,167,492,74,11,25,769
Minnesota,Bingham Lake,123,35,43,15,0,7,100
Minnesota,Big Lake,10285,2260,4117,729,55,383,7544
Minnesota,Big Lake,382,123,164,29,6,29,351
Minnesota,Bigfork,412,87,161,50,8,74,380
Minnesota,Big Falls,228,26,118,31,4,20,199
Minnesota,Bigelow,224,32,103,26,0,7,168
Minnesota,Springfield,2039,267,884,232,23,211,1617
Minnesota,Bethel,423,87,173,43,3,9,315
Minnesota,Benson,3139,659,1298,216,12,386,2571
Minnesota,Bena,141,42,34,8,1,11,96
Minnesota,Bemidji,14417,5845,3810,1620,62,972,12309
Minnesota,Belview,412,97,161,49,0,53,360
Minnesota,Beltrami,120,15,71,5,0,8,99
Minnesota,Bellingham,144,15,83,19,0,12,129
Minnesota,Belle Plaine,6838,1191,2997,525,35,298,5046
Minnesota,Bellechester,217,58,79,26,2,6,171
Minnesota,Belgrade,714,178,242,72,11,66,569
Minnesota,Bejou,97,17,39,0,4,14,74
Minnesota,Bertha,512,129,201,48,9,36,423
Minnesota,Spring Grove,1241,214,506,119,11,164,1014
Minnesota,Spring Hill,50,16,22,6,0,3,47
Minnesota,Spring Lake Park,6504,1570,2290,949,97,417,5323
Minnesota,Courtland,714,124,372,41,2,17,556
Minnesota,Cromwell,246,58,85,34,2,29,208
Minnesota,Crookston,7847,2668,2694,585,85,524,6556
Minnesota,Crosby,2324,483,875,256,12,307,1933
Minnesota,Crosslake,2030,267,1247,213,5,105,1837
Minnesota,Crystal,22607,6075,8378,2413,248,1021,18135
Minnesota,Sunburg,82,20,47,3,0,5,75
Minnesota,Currie,209,34,112,29,2,9,186
Minnesota,Cuyuna,283,45,120,45,1,11,222
Minnesota,Tonka Bay,1481,266,790,73,0,48,1177
Minnesota,Cottonwood,1257,299,447,131,2,88,967
Minnesota,Tower,620,252,208,24,17,41,542
Minnesota,Trail,69,27,23,8,0,1,59
Minnesota,Trimont,755,161,295,68,16,67,607
Minnesota,Trommald,92,13,41,20,0,0,74
Minnesota,Trosky,102,7,46,15,0,9,77
Minnesota,Truman,1145,257,506,92,18,101,974
Minnesota,Turtle River,107,5,61,13,0,0,79
Minnesota,Twin Lakes,176,45,56,28,7,5,141
Minnesota,Twin Lakes,176,35,73,14,0,9,131
Minnesota,Twin Valley,752,141,256,87,9,79,572
Minnesota,Two Harbors,3643,682,1655,318,28,265,2948
Minnesota,Tracy,2110,389,787,249,13,175,1613
Minnesota,Blackduck,812,158,276,94,9,56,593
Minnesota,Cottage Grove,35405,8005,15934,2135,313,994,27381
Minnesota,Correll,22,5,7,4,2,1,19
Minnesota,Spring Park,1731,445,618,282,9,289,1643
Minnesota,Spring Valley,2555,548,1009,213,48,211,2029
Minnesota,Squaw Lake,111,44,6,23,0,6,79
Minnesota,Stacy,1517,346,640,150,13,49,1198
Minnesota,Stanchfield,104,11,49,20,0,3,83
Minnesota,Staples,2848,610,1076,280,51,208,2225
Minnesota,Starbuck,1197,216,447,168,3,143,977
Minnesota,Steen,226,59,66,19,11,9,164
Minnesota,Stephen,788,144,355,70,13,40,622
Minnesota,Stewart,518,109,216,56,14,18,413
Minnesota,Cosmos,494,100,223,65,0,37,425
Minnesota,Stewartville,6006,1010,2457,582,98,276,4423
Minnesota,Stockton,690,122,316,49,7,32,526
Minnesota,Storden,248,33,107,36,5,7,188
Minnesota,Strandquist,90,32,33,11,0,1,77
Minnesota,Strathcona,30,3,21,2,0,4,30
Minnesota,Sturgeon Lake,441,106,183,35,4,21,349
Minnesota,Comstock,124,25,51,15,5,4,100
Minnesota,Conger,176,24,73,13,3,7,120
Minnesota,Cook,606,156,166,95,5,94,516
Minnesota,Coon Rapids,61946,15481,25548,6004,801,2423,50257
Minnesota,Corcoran,5521,996,2982,364,39,77,4458
Minnesota,Stillwater,18677,4113,7997,2009,109,532,14760
Minnesota,Tenstrike,187,22,88,18,0,14,142
Minnesota,Blaine,60224,12585,27197,4268,517,1891,46458
Minnesota,Blooming Prairie,1897,408,805,150,21,163,1547
Minnesota,Chokio,379,67,159,48,0,32,306
Minnesota,Circle Pines,4931,1222,2055,634,0,205,4116
Minnesota,Clara City,1381,179,619,131,3,151,1083
Minnesota,Claremont,551,143,197,53,2,30,425
Minnesota,Clarissa,834,154,358,58,12,81,663
Minnesota,Clarkfield,824,170,328,57,6,116,677
Minnesota,Clarks Grove,606,150,252,65,12,32,511
Minnesota,Clearbrook,503,111,177,41,0,61,390
Minnesota,Clear Lake,581,78,276,31,12,11,408
Minnesota,Clearwater,1783,325,865,100,13,23,1326
Minnesota,Clements,185,32,78,10,17,3,140
Minnesota,Cleveland,635,116,327,42,7,20,512
Minnesota,Climax,290,47,99,43,7,15,211
Minnesota,Clinton,364,83,140,48,0,45,316
Minnesota,Clitherall,76,28,24,13,1,9,75
Minnesota,Clontarf,125,19,72,9,0,5,105
Minnesota,Cloquet,12071,3075,4212,1365,57,729,9438
Minnesota,Coates,139,28,62,21,2,3,116
Minnesota,Cobden,23,11,5,5,0,2,23
Minnesota,Cohasset,2737,425,1408,299,29,101,2262
Minnesota,Cokato,2724,476,1138,197,29,178,2018
Minnesota,Chisholm,5006,1223,1786,528,15,370,3922
Minnesota,Chisago City,4930,934,2351,458,37,347,4127
Minnesota,Chickamaw Beach,128,11,72,16,4,9,112
Minnesota,Chatfield,2935,565,1250,246,24,172,2257
Minnesota,The Ranch,1,0,0,1,0,0,1
Minnesota,Thief River Falls,8711,2688,3080,811,54,587,7220
Minnesota,Tintah,49,1,17,12,0,4,34
Minnesota,Callaway,207,59,69,20,2,6,156
Minnesota,Delano,5671,964,2389,363,80,330,4126
Minnesota,Cambridge,8300,2117,2660,1003,109,649,6538
Minnesota,Campbell,188,23,101,9,2,6,141
Minnesota,Canby,1696,392,755,108,18,173,1446
Minnesota,Cannon Falls,4075,908,1519,520,49,249,3245
Minnesota,Canton,295,56,116,44,2,30,248
Minnesota,Cold Spring,4034,799,1522,304,46,348,3019
Minnesota,Carlos,506,105,200,74,0,10,389
Minnesota,Carver,4136,617,2046,126,10,61,2860
Minnesota,Cass Lake,586,197,103,108,2,45,455
Minnesota,Cedar Mills,47,7,20,5,0,8,40
Minnesota,Center City,679,178,302,99,0,12,591
Minnesota,Centerville,3865,801,1716,203,5,160,2885
Minnesota,Ceylon,322,59,137,26,7,29,258
Minnesota,Champlin,23731,5033,11209,1692,191,600,18725
Minnesota,Chandler,313,69,147,11,0,18,245
Minnesota,Chanhassen,24437,4584,12201,1381,170,544,18880
Minnesota,Chaska,24524,5239,10606,2300,223,555,18923
Minnesota,Carlton,1025,278,378,104,0,130,890
Minnesota,Coleraine,1881,373,814,200,24,83,1494
Minnesota,Cologne,1631,283,740,88,9,34,1154
Minnesota,Columbia Heights,19632,6320,6381,2273,423,998,16395
Minnesota,Brooten,644,116,245,62,5,76,504
Minnesota,Brookston,140,61,35,24,0,12,132
Minnesota,Brooks,120,30,41,20,2,17,110
Minnesota,Brook Park,102,44,30,12,0,5,91
Minnesota,Brooklyn Park,78195,21616,28804,5431,1243,2361,59455
Minnesota,Brooklyn Center,30684,8999,10103,2525,463,1474,23564
Minnesota,Bricelyn,315,85,133,19,1,19,257
Minnesota,Brewster,461,113,164,40,2,26,345
Minnesota,Breezy Point,2197,264,1136,152,21,37,1610
Minnesota,Breckenridge,3360,664,1278,374,43,312,2671
Minnesota,Browerville,742,200,256,87,0,35,578
Minnesota,Brandon,496,81,279,25,0,12,397
Minnesota,Braham,1944,508,609,205,6,95,1423
Minnesota,Boy River,31,4,12,8,1,1,26
Minnesota,Boyd,109,31,40,10,3,15,99
Minnesota,Bowlus,345,83,108,24,6,22,243
Minnesota,Bovey,830,216,265,145,5,32,663
Minnesota,Borup,83,26,44,2,1,7,80
Minnesota,Bock,89,25,28,16,2,8,79
Minnesota,Bluffton,223,36,97,15,2,6,156
Minnesota,Blue Earth,3279,770,1221,408,44,317,2760
Minnesota,Bloomington,85826,22643,35938,8039,910,4757,72287
Minnesota,Brainerd,13462,4308,3535,1592,196,956,10587
Minnesota,Blomkest,98,16,67,2,0,7,92
Minnesota,Brownsdale,782,156,318,90,15,79,658
Minnesota,Brownsville,473,150,176,64,3,14,407
Minnesota,Columbus,3967,728,2200,321,17,167,3433
Minnesota,Glenville,586,110,287,55,0,37,489
Minnesota,Glenwood,2536,369,1096,313,40,259,2077
Minnesota,Glyndon,1446,259,624,92,12,28,1015
Minnesota,Golden Valley,20866,4724,9068,1942,349,1302,17385
Minnesota,Gonvick,220,38,83,24,2,29,176
Minnesota,Goodhue,1253,234,549,39,21,39,882
Minnesota,Goodridge,129,47,20,23,0,15,105
Minnesota,Good Thunder,518,127,232,44,8,23,434
Minnesota,Goodview,4052,1082,1798,292,7,112,3291
Minnesota,Browns Valley,518,99,208,65,9,67,448
Minnesota,Graceville,607,64,300,53,16,64,497
Minnesota,Byron,5105,1072,2183,309,23,87,3674
Minnesota,Butterfield,633,163,238,66,14,28,509
Minnesota,Burtrum,128,16,58,21,0,5,100
Minnesota,Burnsville,61255,16210,24520,5943,883,2222,49778
Minnesota,Buhl,1144,270,411,135,11,109,936
Minnesota,Buffalo Lake,723,127,257,71,0,67,522
Minnesota,Buffalo,15825,3220,6406,1397,168,681,11872
Minnesota,Buckman,234,39,102,10,0,8,159
Minnesota,Bruno,89,7,37,12,2,5,63
Minnesota,Brownton,797,163,374,46,7,41,631
Minnesota,Caledonia,2806,637,1140,225,29,224,2255
Minnesota,Calumet,425,92,142,53,15,18,320
Minnesota,Swanville,328,78,126,19,3,34,260
Minnesota,Hazel Run,24,1,16,1,0,6,24
Minnesota,Hayfield,1336,202,542,125,20,121,1010
Minnesota,Hawley,1905,323,777,97,14,139,1350
Minnesota,Hatfield,39,7,18,2,0,7,34
Minnesota,Hastings,22423,5501,8904,2466,121,1258,18250
Minnesota,Hartland,343,60,154,26,5,17,262
Minnesota,Harris,997,170,478,103,0,43,794
Minnesota,Hayward,269,56,104,50,1,29,240
Minnesota,Harmony,1013,209,439,101,8,137,894
Minnesota,Harding,152,41,45,14,5,6,111
Minnesota,Hanska,378,94,140,59,0,25,318
Minnesota,Hanover,3006,443,1593,169,0,52,2257
Minnesota,Hanley Falls,398,62,180,22,5,8,277
Minnesota,Hancock,835,241,331,46,2,15,635
Minnesota,Hampton,742,158,293,47,9,11,518
Minnesota,Hardwick,184,52,87,17,1,10,167
Minnesota,Nassau,49,12,18,9,0,2,41
Minnesota,Hector,1042,194,539,84,0,76,893
Minnesota,Heidelberg,130,23,69,6,0,6,104
Minnesota,Hinckley,1688,516,452,213,25,118,1324
Minnesota,Hilltop,847,301,170,135,31,54,691
Minnesota,Hills,741,91,327,42,7,72,539
Minnesota,Hillman,26,7,7,2,0,4,20
Minnesota,Hill City,554,145,144,100,31,42,462
Minnesota,Hibbing,16284,4016,6133,1848,83,1125,13205
Minnesota,Hewitt,248,45,99,33,5,12,194
Minnesota,Heron Lake,610,114,233,65,8,53,473
Minnesota,Hermantown,9627,2107,4455,879,152,483,8076
Minnesota,Herman,371,57,161,71,0,35,324
Minnesota,Henriette,68,22,24,8,2,2,58
Minnesota,Henning,857,141,330,118,9,90,688
Minnesota,Hendrum,352,68,168,11,0,12,259
Minnesota,Hendricks,667,139,280,30,11,118,578
Minnesota,Henderson,842,179,351,88,15,55,688
Minnesota,Hammond,80,29,11,21,0,9,70
Minnesota,Ham Lake,15714,3371,7699,1059,74,368,12571
Minnesota,Hamburg,471,137,217,24,16,17,411
Minnesota,Halstad,611,115,220,73,12,70,490
Minnesota,Granada,299,87,122,27,2,10,248
Minnesota,Naytahwaush,505,173,51,37,2,21,284
Minnesota,Nelson,159,32,81,10,0,8,131
Minnesota,Nerstrand,269,41,149,17,0,11,218
Minnesota,Nett Lake,355,173,62,29,3,22,289
Minnesota,Nevis,415,50,192,40,3,27,312
Minnesota,New Auburn,500,110,229,41,0,24,404
Minnesota,New Brighton,22080,5859,8933,1625,221,1148,17786
Minnesota,Newfolden,368,117,158,24,0,4,303
Minnesota,New Germany,392,106,152,26,5,15,304
Minnesota,New Hope,20775,5211,7948,1651,268,1490,16568
Minnesota,New London,1317,216,562,73,19,192,1062
Minnesota,New Munich,363,66,156,26,3,35,286
Minnesota,Newport,3470,970,1303,421,11,150,2855
Minnesota,New Prague,7500,1628,2992,501,81,357,5559
Minnesota,Grand Marais,1039,175,469,160,6,72,882
Minnesota,Hitterdal,184,34,106,13,0,4,157
Minnesota,Grand Meadow,1170,193,457,131,7,71,859
Minnesota,Granite Falls,2471,544,1032,261,42,169,2048
Minnesota,Halma,50,8,26,5,3,2,44
Minnesota,Hallock,1026,209,459,87,2,119,876
Minnesota,Hadley,43,9,22,4,0,1,36
Minnesota,Hackensack,360,151,115,24,9,10,309
Minnesota,Gully,101,35,17,19,0,6,77
Minnesota,Grygla,187,38,74,29,0,9,150
Minnesota,Grove City,624,108,233,57,5,47,450
Minnesota,Grey Eagle,349,60,156,24,4,23,267
Minnesota,Greenwood,790,80,499,83,3,14,679
Minnesota,Greenwald,242,69,127,7,2,8,213
Minnesota,Green Isle,555,124,233,40,3,22,422
Minnesota,Greenfield,2863,459,1576,132,5,60,2232
Minnesota,Greenbush,819,199,311,79,6,58,653
Minnesota,Grasston,223,50,77,21,2,5,155
Minnesota,Grant,4126,837,2403,147,6,121,3514
Minnesota,Grand Rapids,10996,2352,4273,1039,118,1053,8835
Minnesota,Hoffman,710,148,279,66,10,51,554
Minnesota,Hokah,551,91,240,66,3,26,426
Minnesota,Nashwauk,869,205,356,95,23,84,763
Minnesota,Mendota,230,87,71,16,0,6,180
Minnesota,Menahga,1346,246,480,149,0,200,1075
Minnesota,Melrose,3604,629,1651,251,62,186,2779
Minnesota,Meire Grove,212,57,78,19,0,12,166
Minnesota,Medina,5378,860,2898,196,63,167,4184
Minnesota,Medicine Lake,345,94,141,48,1,16,300
Minnesota,Medford,1401,298,578,72,4,40,992
Minnesota,Meadowlands,84,25,17,9,3,18,72
Minnesota,Mazeppa,835,117,411,81,9,19,637
Minnesota,Maynard,347,85,154,28,0,15,282
Minnesota,Preston,1423,223,592,141,25,100,1081
Minnesota,Princeton,4728,1266,1548,557,34,372,3777
Minnesota,Prinsburg,496,56,287,13,0,38,394
Minnesota,Prior Lake,24402,4589,11315,1902,80,692,18578
Minnesota,Proctor,3060,677,1308,367,14,143,2509
Minnesota,Mendota Heights,11172,2407,5771,682,101,511,9472
Minnesota,Quamba,131,44,51,13,0,1,109
Minnesota,Mentor,191,41,62,34,4,16,157
Minnesota,Middle River,289,47,97,56,0,19,219
Minnesota,Minnetonka Beach,570,81,308,33,2,11,435
Minnesota,Minnetonka,51249,11059,24103,4861,353,2511,42887
Minnesota,Minnesota Lake,620,92,333,56,2,38,521
Minnesota,Minnesota City,217,54,84,12,0,6,156
Minnesota,Minneota,1407,209,702,93,7,86,1097
Minnesota,Minneiska,98,15,68,10,0,0,93
Minnesota,Minneapolis,399950,168499,112355,32639,5497,10755,329745
Minnesota,Miltona,372,60,141,48,4,21,274
Minnesota,Milroy,231,69,82,22,4,14,191
Minnesota,Millville,131,32,72,10,1,5,120
Minnesota,Millerville,95,17,43,4,0,2,66
Minnesota,Milan,362,104,136,24,3,18,285
Minnesota,Milaca,2895,592,944,434,8,266,2244
Minnesota,Miesville,147,32,66,5,5,11,119
Minnesota,Midway,12,5,0,2,1,0,8
Minnesota,Merrifield,94,0,77,8,0,4,89
Minnesota,New Richland,1174,179,534,125,7,88,933
Minnesota,Racine,440,63,195,53,3,11,325
Minnesota,Randall,662,118,238,80,6,46,488
Minnesota,Moorhead,40935,14440,14804,2689,255,1561,33749
Minnesota,Moose Lake,2763,1164,605,556,37,230,2592
Minnesota,Mora,3507,906,1300,331,64,274,2875
Minnesota,Morgan,916,190,358,66,2,75,691
Minnesota,Morris,5349,2024,1892,321,33,336,4606
Minnesota,Morristown,950,172,427,100,9,55,763
Minnesota,Morton,341,96,125,43,2,25,291
Minnesota,Motley,688,205,189,107,9,40,550
Minnesota,Mound,9249,2386,3893,1180,134,298,7891
Minnesota,Mounds View,12584,3507,4914,1023,150,390,9984
Minnesota,Mountain Iron,2873,705,1264,309,0,157,2435
Minnesota,Mountain Lake,2076,561,713,143,15,185,1617
Minnesota,Murdock,312,76,134,16,0,7,233
Minnesota,Myrtle,54,10,9,10,5,3,37
Minnesota,Nashua,29,8,10,2,0,0,20
Minnesota,Montrose,2999,559,1075,299,44,44,2021
Minnesota,Ramsey,24846,5284,11679,1747,151,467,19328
Minnesota,Monticello,13065,2859,5177,1150,156,514,9856
Minnesota,Montevideo,5240,1177,2138,554,15,420,4304
Minnesota,Randolph,432,71,206,40,1,11,329
Minnesota,Ranier,521,63,212,75,14,88,452
Minnesota,Raymond,695,139,307,52,15,35,548
Minnesota,Redby,1578,632,177,137,9,45,1000
Minnesota,Red Lake,1508,666,236,86,5,63,1056
Minnesota,Red Lake Falls,1229,231,542,94,11,99,977
Minnesota,Red Wing,16484,3599,6917,1988,127,1071,13702
Minnesota,Redwood Falls,5128,1132,1964,654,51,351,4152
Minnesota,Regal,46,10,25,4,3,0,42
Minnesota,Remer,391,83,171,46,2,23,325
Minnesota,Renville,1487,346,620,59,34,123,1182
Minnesota,Revere,100,33,41,9,0,2,85
Minnesota,Rice,1491,274,640,111,3,39,1067
Minnesota,Rice Lake,299,107,45,16,2,6,176
Minnesota,Richfield,36059,10787,13203,3258,417,1854,29519
Minnesota,Montgomery,2934,821,1148,175,42,129,2315
Minnesota,Minnetrista,6810,1020,3562,366,33,127,5108
Minnesota,Mizpah,99,32,22,20,1,6,81
Minnesota,Pine Bend,20,6,9,2,0,1,18
Minnesota,Paynesville,2423,548,1017,182,20,269,2036
Minnesota,Park Rapids,3907,1012,1553,416,11,257,3249
Minnesota,Parkers Prairie,1035,220,332,104,23,118,797
Minnesota,Palisade,168,16,110,10,0,20,156
Minnesota,Owatonna,25552,5407,10614,2298,279,1543,20141
Minnesota,Ottertail,436,77,218,69,3,33,400
Minnesota,Otsego,14634,2565,7287,681,67,268,10868
Minnesota,Ostrander,207,33,90,31,2,38,194
Minnesota,Osseo,2555,573,1079,252,10,267,2181
Minnesota,Oslo,227,51,101,23,0,18,193
Minnesota,Osakis,1669,292,689,187,5,136,1309
Minnesota,Osage,247,33,161,4,0,16,214
Minnesota,Ortonville,2020,330,1023,198,10,160,1721
Minnesota,Orr,256,89,79,37,4,9,218
Minnesota,Oronoco,1522,189,799,56,0,15,1059
Minnesota,Pease,276,69,97,14,11,13,204
Minnesota,Pelican Rapids,2510,587,1074,176,13,113,1963
Minnesota,Pemberton,297,83,125,28,2,7,245
Minnesota,Pennock,631,100,261,30,6,9,406
Minnesota,Peterson,192,24,113,19,0,6,162
Minnesota,Pine City,3093,716,1066,576,67,196,2621
Minnesota,Pine Island,3375,829,1261,326,0,178,2594
Minnesota,Pine Point,245,87,27,13,6,5,138
Minnesota,Pine River,713,155,204,128,16,103,606
Minnesota,Pine Springs,407,85,235,19,0,11,350
Minnesota,Pipestone,4186,817,1650,447,46,360,3320
Minnesota,Orono,7795,1487,3917,607,52,286,6349
Minnesota,Plainview,3269,643,1345,225,0,232,2445
Minnesota,Plummer,436,73,151,40,5,25,294
Minnesota,Plymouth,73896,15778,35741,5653,426,2585,60183
Minnesota,Ponemah,791,323,34,93,0,32,482
Minnesota,Porter,183,34,95,8,1,12,150
Minnesota,Perley,92,22,53,5,4,2,86
Minnesota,Perham,3106,687,1164,366,0,301,2518
Minnesota,Pequot Lakes,2445,641,778,332,4,175,1930
Minnesota,Plato,313,64,166,17,0,15,262
Minnesota,Pillager,450,116,178,34,2,21,351
Minnesota,Ormsby,118,20,59,11,0,9,99
Minnesota,Holland,183,45,76,23,0,13,157
Minnesota,Northrop,276,45,118,24,6,15,208
Minnesota,Northome,229,50,94,22,0,14,180
Minnesota,North Oaks,4715,680,2906,104,2,275,3967
Minnesota,North Mankato,13438,3288,5699,1272,148,521,10928
Minnesota,Northfield,20309,8375,6662,1283,136,838,17294
Minnesota,North Branch,10104,2504,4144,865,39,341,7893
Minnesota,Norcross,46,0,32,0,0,5,37
Minnesota,Nisswa,2068,272,1291,186,0,50,1799
Minnesota,Nimrod,89,9,55,8,0,5,77
Minnesota,Nielsville,106,8,51,14,0,5,78
Minnesota,Nicollet,1136,199,532,106,17,13,867
Minnesota,New York Mills,1383,409,433,140,15,110,1107
Minnesota,New Ulm,13287,3439,5630,1209,34,788,11100
Minnesota,New Trier,142,22,57,12,0,1,92
Minnesota,Sunfish Lake,518,76,319,16,0,17,428
Minnesota,North St. Paul,11966,3730,4624,1029,73,428,9884
Minnesota,Norwood Young America,3630,664,1611,267,20,196,2758
Minnesota,Nowthen,4522,889,2270,266,29,80,3534
Minnesota,Oakdale,27850,7773,10658,2869,262,1104,22666
Minnesota,Hollandale,297,42,139,16,5,14,216
Minnesota,Holloway,95,19,58,6,0,4,87
Minnesota,Holt,111,23,52,6,0,4,85
Minnesota,Homer,155,6,113,9,0,0,128
Minnesota,Hopkins,17992,5481,5965,1774,271,758,14249
Minnesota,Houston,1074,232,457,85,2,95,871
Minnesota,Onamia,905,239,294,115,10,109,767
Minnesota,Holdingford,593,108,254,78,1,28,469
Minnesota,Olivia,2327,529,1021,175,13,183,1921
Minnesota,Okabena,170,21,89,15,2,8,135
Minnesota,Ogilvie,427,97,89,87,7,36,316
Minnesota,Ogema,182,66,40,13,2,5,126
Minnesota,Odin,109,15,49,10,0,15,89
Minnesota,Odessa,157,40,53,13,0,18,124
Minnesota,Oak Park Heights,4737,1277,1773,520,40,625,4235
Minnesota,Oak Grove,8215,1522,4358,431,60,212,6583
Minnesota,Oklee,463,71,190,40,0,51,352
Minnesota,Pierz,1429,250,632,116,3,149,1150
Mississippi,Anguilla,542,146,187,55,15,15,418
Mississippi,Bassfield,272,71,88,33,0,15,207
Mississippi,Mize,305,38,134,26,0,21,219
Mississippi,Monticello,1559,346,417,203,43,94,1103
Mississippi,Mooreville,822,158,300,117,13,65,653
Mississippi,Moorhead,1975,883,324,129,127,118,1581
Mississippi,Morgan City,264,119,35,25,0,10,189
Mississippi,Morgantown,1502,408,456,70,74,84,1092
Mississippi,Morton,3456,1140,828,308,118,275,2669
Mississippi,Moss Point,13685,4405,4279,1468,554,985,11691
Mississippi,Mound Bayou,1863,729,228,130,66,103,1256
Mississippi,Mount Olive,981,267,228,129,38,66,728
Mississippi,Myrtle,493,87,178,57,20,36,378
Mississippi,Natchez,15474,4755,4305,1932,361,1144,12497
Mississippi,Nellieburg,1317,372,450,274,26,112,1234
Mississippi,Nettleton,1665,386,659,245,35,108,1433
Mississippi,New Albany,8466,1993,3032,705,306,542,6578
Mississippi,New Augusta,835,257,224,95,7,35,618
Mississippi,New Hamilton,457,44,285,43,0,14,386
Mississippi,Baldwyn,3139,1058,743,563,87,271,2722
Mississippi,Ashland,524,69,199,63,11,83,425
Mississippi,Artesia,380,144,82,26,19,30,301
Mississippi,Arnold Line,2609,1037,762,222,52,159,2232
Mississippi,Arcola,274,116,54,17,6,20,213
Mississippi,Bay St. Louis,10861,2356,3985,1264,333,804,8742
Mississippi,Batesville,7413,2050,2242,539,285,414,5530
Mississippi,Amory,7151,1587,2766,660,92,514,5619
Mississippi,Algoma,677,105,296,35,13,30,479
Mississippi,Alcorn State University,774,688,43,0,0,12,743
Mississippi,Ackerman,1861,514,553,153,48,224,1492
Mississippi,Aberdeen,5466,1826,1409,513,247,389,4384
Mississippi,Abbeville,447,62,227,47,10,21,367
Mississippi,New Hebron,526,89,206,56,8,29,388
Mississippi,Alligator,328,75,101,10,0,16,202
Mississippi,Bay Springs,1738,527,572,154,78,171,1502
Mississippi,Union,1826,431,562,234,81,161,1469
Mississippi,Beauregard village,328,76,110,20,33,12,251
Mississippi,Waynesboro,4974,1489,1307,479,194,352,3821
Mississippi,Waveland,6449,1729,1735,1031,448,365,5308
Mississippi,Water Valley,3344,822,1224,271,90,326,2733
Mississippi,Walthall village,133,13,59,3,2,7,84
Mississippi,Walnut Grove,913,551,130,67,25,37,810
Mississippi,Walnut,827,186,300,107,28,59,680
Mississippi,Walls,1247,337,396,80,16,22,851
Mississippi,Wade,887,47,406,141,0,32,626
Mississippi,Vicksburg,23439,8217,5787,2084,635,1448,18171
Mississippi,Verona,3062,1045,606,480,123,210,2464
Mississippi,Vardaman,1316,401,397,72,66,66,1002
Mississippi,Vancleave,5783,1042,2673,316,99,162,4292
Mississippi,Vaiden,802,284,207,94,12,64,661
Mississippi,Utica,830,335,216,38,30,43,662
Mississippi,University,4619,4565,0,39,0,5,4609
Mississippi,Webb,250,78,43,27,17,32,197
Mississippi,Beaumont,1110,380,276,150,22,102,930
Mississippi,Weir,507,130,170,61,22,25,408
Mississippi,West,177,46,54,11,9,17,137
Mississippi,Tylertown,1641,388,579,127,29,196,1319
Mississippi,Beechwood,4528,1213,1575,328,149,242,3507
Mississippi,Belmont,2119,333,709,210,33,197,1482
Mississippi,Belzoni,2325,946,505,156,49,127,1783
Mississippi,Benoit,462,202,97,31,10,17,357
Mississippi,Bentonia,521,165,131,59,18,35,408
Mississippi,Beulah,359,129,80,30,25,7,271
Mississippi,Big Creek village,265,69,93,10,18,15,205
Mississippi,Big Point,841,96,431,33,46,17,623
Mississippi,Winstonville,223,74,35,26,25,34,194
Mississippi,Winona,4704,1258,1452,403,212,295,3620
Mississippi,Wiggins,4487,1388,1089,578,261,292,3608
Mississippi,White Oak,660,232,150,83,0,15,480
Mississippi,West Point,11122,3210,3698,1062,254,577,8801
Mississippi,West Hattiesburg,6674,1964,2125,605,82,242,5018
Mississippi,Wesson,2134,769,744,85,63,90,1751
Mississippi,Tutwiler,3516,1013,931,292,188,355,2779
Mississippi,Isola,1003,359,230,66,30,45,730
Mississippi,Tunica Resorts,1514,610,493,143,0,8,1254
Mississippi,Columbus,23360,7546,6598,2230,870,1998,19242
Mississippi,Columbia,6367,1701,1571,747,390,524,4933
Mississippi,Collinsville,1663,100,919,137,0,103,1259
Mississippi,Collins,2557,534,796,253,135,268,1986
Mississippi,Coldwater,1251,429,319,126,44,91,1009
Mississippi,Coffeeville,1044,247,290,142,19,45,743
Mississippi,Coahoma,390,181,71,12,22,27,313
Mississippi,Cloverdale,772,314,152,82,28,63,639
Mississippi,Clinton,25475,6377,10074,2207,347,1344,20349
Mississippi,Cleveland,12339,4540,3241,1054,393,828,10056
Mississippi,Cleary,1090,145,543,161,0,128,977
Mississippi,Clarksdale,17314,5858,3770,1097,797,1313,12835
Mississippi,Clara,589,122,239,45,0,85,491
Mississippi,Chunky,406,58,179,57,5,19,318
Mississippi,Charleston,1164,308,288,166,33,139,934
Mississippi,Centreville,1765,589,398,137,77,172,1373
Mississippi,Cary,348,110,81,33,21,39,284
Mississippi,Carthage,4966,1476,1067,506,150,319,3518
Mississippi,Carrollton,146,16,52,13,18,19,118
Mississippi,Canton,13413,4678,3789,954,204,1002,10627
Mississippi,Calhoun City,1850,413,561,179,45,193,1391
Mississippi,Caledonia,1332,174,589,155,2,60,980
Mississippi,Byram,11592,3125,3996,1315,254,386,9076
Mississippi,Columbus AFB,1443,180,824,47,0,9,1060
Mississippi,Como,1374,505,250,99,150,141,1145
Mississippi,Conehatta,1124,322,317,61,15,0,715
Mississippi,Corinth,14839,3194,5303,1837,463,1081,11878
Mississippi,Durant,2978,1020,461,245,153,192,2071
Mississippi,Duncan,435,153,83,46,23,28,333
Mississippi,Dumas,470,91,209,33,8,32,373
Mississippi,Duck Hill,1000,289,303,71,39,98,800
Mississippi,Drew,1941,739,355,116,71,120,1401
Mississippi,Doddsville,339,129,25,6,76,7,243
Mississippi,D'Lo,432,78,147,79,25,57,386
Mississippi,D'Iberville,10532,2640,3590,1521,132,398,8281
Mississippi,Diamondhead,8246,1148,4658,550,26,368,6750
Mississippi,Derma,1056,275,336,42,74,64,791
Mississippi,DeLisle,1121,429,279,145,53,80,986
Mississippi,Byhalia,1358,332,426,125,44,155,1082
Mississippi,De Kalb,1082,282,333,101,29,134,879
Mississippi,Darling,284,139,52,34,0,10,235
Mississippi,Crystal Springs,4970,1580,1559,234,124,473,3970
Mississippi,Cruger,336,143,66,21,10,33,273
Mississippi,Crowder,701,245,171,50,15,54,535
Mississippi,Crosby,413,157,97,17,22,35,328
Mississippi,Crenshaw,975,304,310,57,27,89,787
Mississippi,Crawford,569,241,133,24,8,40,446
Mississippi,Yazoo City,11421,4591,2094,550,384,707,8326
Mississippi,Woodville,1245,404,423,94,62,84,1067
Mississippi,Woodland village,170,52,29,19,2,8,110
Mississippi,Courtland,725,193,211,35,15,24,478
Mississippi,Decatur,2100,910,545,150,45,98,1748
Mississippi,Burnsville,1089,246,387,144,22,48,847
Mississippi,Bude,905,285,281,69,14,28,677
Mississippi,Buckatunna,464,183,144,0,0,16,343
Mississippi,Southaven,51090,10803,19815,5222,1095,2109,39044
Mississippi,Standing Pine,363,53,83,14,14,0,164
Mississippi,Starkville,24754,11127,7006,1307,207,948,20595
Mississippi,State Line,677,253,188,41,27,53,562
Mississippi,Stonewall,1315,206,558,102,12,109,987
Mississippi,Mississippi Valley State University,1296,1044,73,0,0,12,1129
Mississippi,Sturgis,438,84,162,28,7,13,294
Mississippi,Summit,2307,798,531,141,97,108,1675
Mississippi,Sumner,252,62,104,23,1,24,214
Mississippi,Sumrall,1714,206,707,186,13,140,1252
Mississippi,Sunflower,1047,429,148,43,50,72,742
Mississippi,Soso,472,89,218,35,4,33,379
Mississippi,Sylvarena village,101,18,47,14,3,4,86
Mississippi,Taylorsville,1348,284,529,88,36,85,1022
Mississippi,Tchula,1885,905,190,103,64,96,1358
Mississippi,Terry,1477,379,505,158,36,80,1158
Mississippi,Thaxton,996,153,398,71,54,55,731
Mississippi,Tillatoba,264,35,84,0,0,0,119
Mississippi,Tishomingo,489,78,135,92,45,43,393
Mississippi,Toccopola,219,48,105,13,0,16,182
Mississippi,Toomsuba,1180,398,344,29,0,25,796
Mississippi,Tremont,477,84,170,65,26,31,376
Mississippi,Tucker,497,152,128,15,17,6,318
Mississippi,Tunica,1233,285,483,144,24,81,1017
Mississippi,Taylor village,304,44,149,24,3,14,234
Mississippi,Tupelo,35561,8623,11774,4195,771,2055,27418
Mississippi,Snow Lake Shores,354,56,154,95,6,28,339
Mississippi,Sledge,476,166,101,28,34,48,377
Mississippi,Bruce,1660,436,564,154,67,138,1359
Mississippi,Brooksville,914,315,182,64,47,52,660
Mississippi,Brookhaven,12465,3861,3538,1103,343,681,9526
Mississippi,Bridgetown,1937,278,1142,191,17,70,1698
Mississippi,Braxton village,207,37,76,31,6,25,175
Mississippi,Brandon,22897,4206,10407,1829,464,942,17848
Mississippi,Boyle,1053,339,254,81,36,21,731
Mississippi,Booneville,8780,2325,2978,656,239,476,6674
Mississippi,Bolton,423,131,135,48,25,25,364
Mississippi,Bogue Chitto CDP (Lincoln County),631,217,114,99,15,94,539
Mississippi,Bogue Chitto CDP (Kemper and Neshoba Counties),673,366,46,110,37,35,594
Mississippi,Smithville,695,107,291,84,27,53,562
Mississippi,Blue Springs village,282,74,79,33,20,14,220
Mississippi,Biloxi,44825,12907,15404,4922,947,2153,36333
Mississippi,Sharon,1306,331,706,64,29,12,1142
Mississippi,Shaw,1672,604,312,128,86,196,1326
Mississippi,Shelby,2381,943,319,173,112,225,1772
Mississippi,Sherman,784,214,245,62,6,10,537
Mississippi,Shubuta,342,121,95,33,11,30,290
Mississippi,Shuqualak,453,215,47,55,9,58,384
Mississippi,Sidon,489,273,42,17,13,19,364
Mississippi,Silver City,343,105,57,26,25,34,247
Mississippi,Silver Creek,206,45,59,19,26,14,163
Mississippi,Slate Springs village,101,20,59,6,6,4,95
Mississippi,Blue Mountain,937,321,300,73,32,21,747
Mississippi,Mississippi State,3797,3651,113,0,0,5,3769
Mississippi,Montrose,108,16,45,6,3,17,87
Mississippi,Merigold,468,133,156,51,13,18,371
Mississippi,Gulfport,70642,20072,21181,8626,2130,3848,55857
Mississippi,Gunnison,305,161,21,36,4,26,248
Mississippi,Guntown,2412,434,1004,230,29,101,1798
Mississippi,Hamilton,396,87,178,27,0,34,326
Mississippi,Hatley,494,87,213,51,5,31,387
Mississippi,Hattiesburg,46762,20237,10687,4431,1147,2377,38879
Mississippi,Hazlehurst,3942,1256,881,483,160,327,3107
Mississippi,Heidelberg,702,154,295,56,32,84,621
Mississippi,Helena,1049,215,607,77,28,91,1018
Mississippi,Henderson Point,112,9,45,27,8,16,105
Mississippi,Hernando,14984,3055,6038,1442,322,784,11641
Mississippi,Hickory,604,197,179,56,12,19,463
Mississippi,Hickory Flat,729,241,217,75,20,35,588
Mississippi,Hide-A-Way Lake,1555,170,887,335,16,49,1457
Mississippi,Hillsboro,1022,340,345,59,25,68,837
Mississippi,Metcalfe,1120,448,145,34,71,80,778
Mississippi,Hollandale,2621,932,446,246,121,229,1974
Mississippi,Holly Springs,7572,3396,1314,598,324,507,6139
Mississippi,Horn Lake,26662,6592,8670,3198,688,942,20090
Mississippi,Houston,3566,1127,1070,323,43,183,2746
Mississippi,Hurley,1166,295,567,60,29,138,1089
Mississippi,Indianola,10281,3907,2476,626,461,570,8040
Mississippi,Inverness,934,302,289,75,13,61,740
Mississippi,Shannon,1780,504,420,260,65,71,1320
Mississippi,Senatobia,8017,3179,2399,569,62,497,6706
Mississippi,Seminary,447,109,188,26,4,20,347
Mississippi,Sebastopol,314,46,130,26,6,19,227
Mississippi,Scooba,1052,549,164,42,38,26,819
Mississippi,Schlater,374,120,130,11,6,38,305
Mississippi,Gulf Park Estates,6113,795,2688,525,40,256,4304
Mississippi,Gulf Hills,8493,1747,3154,1083,273,441,6698
Mississippi,Grenada,12908,4259,3351,1286,448,1153,10497
Mississippi,Greenwood,15734,5842,3304,1291,525,954,11916
Mississippi,Edwards,1177,468,235,75,61,55,894
Mississippi,Elliott,1430,159,601,66,52,37,915
Mississippi,Ellisville,4566,1993,1056,401,77,309,3836
Mississippi,Enterprise,716,109,236,58,41,53,497
Mississippi,Escatawpa,3825,917,1634,460,164,169,3344
Mississippi,Ethel,505,149,125,49,40,42,405
Mississippi,Eupora,2191,664,597,217,121,173,1772
Mississippi,Falcon,192,83,36,9,8,12,148
Mississippi,Falkner,551,51,228,80,22,35,416
Mississippi,Farmington,2333,398,1003,252,46,78,1777
Mississippi,Farrell,440,240,122,19,0,40,421
Mississippi,Fayette,1563,703,191,147,25,155,1221
Mississippi,Flora,1954,585,553,116,17,96,1367
Mississippi,Florence,4279,881,1647,452,35,195,3210
Mississippi,Saucier,1060,192,436,97,38,27,790
Mississippi,Flowood,8385,2073,3299,1037,223,378,7010
Mississippi,Foxworth,389,146,92,36,6,32,312
Mississippi,French Camp,216,63,51,7,33,5,159
Mississippi,Friars Point,870,308,241,88,11,41,689
Mississippi,Fulton,4014,1284,1089,442,83,362,3260
Mississippi,Gattman village,113,6,52,30,0,19,107
Mississippi,Gautier,18563,4560,6872,1863,490,707,14492
Mississippi,Georgetown,294,52,136,22,11,24,245
Mississippi,Glen,461,75,203,38,6,22,344
Mississippi,Glendale,1833,358,615,272,70,39,1354
Mississippi,Glendora village,78,17,10,9,2,4,42
Mississippi,Gloster,972,168,210,172,83,105,738
Mississippi,Golden,188,23,64,27,0,29,143
Mississippi,Goodman,1288,781,171,47,55,65,1119
Mississippi,Greenville,33119,11154,8531,3012,1130,2082,25909
Mississippi,Forest,5713,1395,1860,584,251,278,4368
Mississippi,Eden village,104,36,18,7,17,6,84
Mississippi,Satartia village,11,2,3,0,0,4,9
Mississippi,Sandersville,685,124,369,35,6,57,591
Mississippi,Polkville,820,156,311,80,33,71,651
Mississippi,Plantersville,1010,238,376,140,27,71,852
Mississippi,Pittsboro village,188,48,70,26,2,12,158
Mississippi,Pickens,818,282,175,96,33,54,640
Mississippi,Picayune,10784,2891,3555,1052,245,694,8437
Mississippi,Philadelphia,7433,2111,1966,859,171,537,5644
Mississippi,Petal,10723,1786,4198,1199,222,689,8094
Mississippi,Pelahatchie,1340,263,465,115,55,73,971
Mississippi,Pearl River,4040,1194,857,399,112,228,2790
Mississippi,Pearlington,1397,345,432,174,55,116,1122
Mississippi,Pearl,26222,7013,8988,2987,451,1284,20723
Mississippi,Pass Christian,5130,1310,1942,590,97,222,4161
Mississippi,Pascagoula,22230,6734,6774,2546,679,1160,17893
Mississippi,Paden village,93,20,39,16,2,3,80
Mississippi,Pachuta,286,51,103,43,8,32,237
Mississippi,Pace,174,75,46,8,9,20,158
Mississippi,Oxford,20769,10019,5284,1698,109,885,17995
Mississippi,Osyka,425,102,122,41,21,24,310
Mississippi,Olive Branch,35018,8215,14330,3308,561,1437,27851
Mississippi,Okolona,2658,905,551,306,131,280,2173
Mississippi,Ocean Springs,17528,3700,6711,2349,193,1026,13979
Mississippi,Oakland,702,178,229,47,12,38,504
Mississippi,Noxapater,374,78,154,51,0,26,309
Mississippi,North Tunica,1060,391,211,79,3,33,717
Mississippi,North Carrollton,498,156,123,110,0,34,423
Mississippi,Nicholson,2636,631,964,289,14,102,2000
Mississippi,Newton,3347,903,920,451,176,326,2776
Mississippi,New Houlka,813,253,209,101,33,46,642
Mississippi,New Hope,3083,474,1340,375,22,153,2364
Mississippi,Pontotoc,5808,1338,1724,666,65,510,4303
Mississippi,Pope village,231,13,81,27,8,30,159
Mississippi,Poplarville,2919,1146,735,220,20,211,2332
Mississippi,Port Gibson,1607,670,291,101,42,199,1303
Mississippi,Saltillo,4958,724,2540,551,32,247,4094
Mississippi,Sallis,147,21,78,17,1,16,133
Mississippi,St. Martin,7728,2172,2432,838,198,308,5948
Mississippi,Ruleville,2877,901,531,260,183,247,2122
Mississippi,Roxie,551,178,198,20,18,22,436
Mississippi,Rosedale,1743,751,265,127,103,101,1347
Mississippi,Rolling Fork,2491,1019,593,130,132,205,2079
Mississippi,Robinhood,1443,264,585,177,34,85,1145
Mississippi,Ripley,5350,932,2068,620,100,357,4077
Mississippi,Rienzi,343,41,164,51,5,53,314
Mississippi,Ridgeland,24276,6785,8725,2359,413,1081,19363
Mississippi,Richton,928,322,227,125,7,108,789
Mississippi,Richland,7055,1441,2907,659,136,258,5401
Mississippi,Renova,820,249,265,42,43,42,641
Mississippi,Sardis,1953,595,463,203,42,173,1476
Mississippi,Redwater,603,175,257,5,14,26,477
Mississippi,Kilmichael,869,261,307,35,39,78,720
Mississippi,Kearney Park,1402,579,460,22,70,40,1171
Mississippi,Jumpertown,653,87,328,11,4,42,472
Mississippi,Jonestown,1436,597,233,51,99,52,1032
Mississippi,Jackson,173212,66388,38434,16484,5479,8286,135071
Mississippi,Iuka,3005,389,1114,504,49,349,2405
Mississippi,Itta Bena,2103,989,338,126,109,196,1758
Mississippi,Rawls Springs,1214,185,321,206,43,121,876
Mississippi,Raleigh,1454,358,474,119,26,156,1133
Mississippi,Quitman,2147,507,843,197,66,166,1779
Mississippi,Purvis,2160,565,759,200,72,150,1746
Mississippi,Puckett village,350,50,165,46,0,19,280
Mississippi,Prentiss,1193,356,388,132,10,144,1030
Mississippi,Potts Camp,525,150,176,48,11,19,404
Mississippi,Raymond,1995,1412,269,91,28,102,1902
Mississippi,Ecru,1379,251,548,82,16,39,936
Mississippi,Holcomb,462,100,129,24,0,59,312
Mississippi,Maben,677,206,146,56,44,42,494
Mississippi,Lucedale,2993,715,954,244,89,237,2239
Mississippi,Louisville,6407,2185,1557,496,145,526,4909
Mississippi,Louise,150,51,49,17,13,11,141
Mississippi,Meridian Station,636,478,103,23,0,0,604
Mississippi,Long Beach,15369,3424,6028,1897,212,611,12172
Mississippi,Liberty,771,82,306,57,12,123,580
Mississippi,Lexington,2106,828,483,137,67,100,1615
Mississippi,Lena,200,23,113,20,0,20,176
Mississippi,Leland,4318,1582,1135,357,134,219,3427
Mississippi,Learned,44,7,27,5,0,2,41
Mississippi,Leakesville,802,177,296,96,33,77,679
Mississippi,Laurel,18770,5755,4767,1894,784,1101,14301
Mississippi,Lauderdale,686,104,291,17,0,75,487
Mississippi,Latimer,7009,1664,3053,477,89,272,5555
Mississippi,Lambert,1302,464,266,94,101,64,989
Mississippi,Lake,435,98,153,37,7,18,313
Mississippi,Kossuth village,263,40,149,17,0,15,221
Mississippi,Lula,292,111,72,21,18,27,249
Mississippi,Lumberton,2080,538,515,255,79,95,1482
Mississippi,Lyman,2136,350,950,246,160,159,1865
Mississippi,Lynchburg,2307,417,1157,203,6,93,1876
Mississippi,Meridian,40507,12750,11250,4128,1142,2652,31922
Mississippi,Mendenhall,2511,539,811,318,115,253,2036
Mississippi,Meadville,454,66,181,65,9,69,390
Mississippi,Mayersville,634,311,136,33,48,21,549
Mississippi,Mathiston,760,148,279,97,30,61,615
Mississippi,Marks,1630,553,419,144,72,147,1335
Mississippi,Marion,1547,439,411,179,85,82,1196
Mississippi,Marietta,333,38,161,24,6,32,261
Mississippi,Kosciusko,7242,1693,2124,739,219,677,5452
Mississippi,Mantee village,331,21,196,7,4,16,244
Mississippi,Magnolia,2021,755,449,168,105,198,1675
Mississippi,Magee,4399,1207,831,506,78,356,2978
Mississippi,Madison,25167,3771,12478,1739,112,1133,19233
Mississippi,Macon,2659,1249,390,143,58,168,2008
Mississippi,McLain,428,116,119,60,19,29,343
Mississippi,McCool,148,37,60,22,0,16,135
Mississippi,McComb,12723,3794,3311,1392,439,1039,9975
Mississippi,Lyon,320,25,179,46,4,20,274
Mississippi,Mantachie,1403,255,538,175,43,120,1131
Mississippi,Kiln,2169,411,995,365,0,181,1952
Mississippi,Louin,237,43,110,21,7,21,202
Missouri,Bogard,181,24,95,17,0,12,148
Missouri,Fillmore,197,96,39,29,4,6,174
Missouri,Fidelity,240,29,112,32,13,7,193
Missouri,Festus,11839,2630,4324,1506,237,856,9553
Missouri,Ferrelview village,403,146,115,61,2,22,346
Missouri,Ferguson,21120,6888,5762,2420,476,987,16533
Missouri,Fenton,4033,753,2134,272,0,148,3307
Missouri,Fayette,2708,1128,835,213,0,166,2342
Missouri,Farmington,17570,4686,6102,2618,475,1032,14913
Missouri,Farley village,229,22,133,14,0,7,176
Missouri,Farber,315,62,123,58,2,34,279
Missouri,Fairview,336,51,158,32,8,26,275
Missouri,Fair Play,480,62,200,48,2,25,337
Missouri,Fisk,464,69,178,70,13,41,371
Missouri,Fair Grove,1612,209,620,184,23,85,1121
Missouri,Fairdealing,1151,273,581,25,62,40,981
Missouri,Exeter,786,136,355,67,15,72,645
Missouri,Excelsior Springs,11512,2810,4003,1279,122,753,8967
Missouri,Excelsior Estates village,175,20,85,22,2,5,134
Missouri,Excello,102,52,10,0,0,40,102
Missouri,Ewing,358,39,163,43,3,32,280
Missouri,Everton,338,61,159,33,4,11,268
Missouri,Evergreen village,35,13,9,7,1,1,31
Missouri,Eureka,10450,2114,4741,646,108,351,7960
Missouri,Ethel,51,13,27,4,4,0,48
Missouri,Essex,546,112,167,71,23,57,430
Missouri,Eolia village,511,111,209,46,3,35,404
Missouri,Fairfax,664,139,300,73,3,48,563
Missouri,Fleming,130,14,60,21,2,7,104
Missouri,Flemington village,116,23,37,15,0,8,83
Missouri,Flint Hill,548,103,304,10,4,12,433
Missouri,Pleasant Valley,3032,739,1140,481,42,180,2582
Missouri,Pleasant Hope,652,103,276,85,8,21,493
Missouri,Fort Leonard Wood,17576,9919,4203,295,84,25,14526
Missouri,Pleasant Hill,8216,1414,3422,949,74,262,6121
Missouri,Plattsburg,2383,485,896,249,39,188,1857
Missouri,Platte Woods,468,88,212,74,2,33,409
Missouri,Platte City,4793,1082,1729,485,161,278,3735
Missouri,Plato village,134,34,46,16,1,4,101
Missouri,Pinhook village,9,0,0,6,0,3,9
Missouri,Pineville,883,193,346,91,4,69,703
Missouri,Pine Lawn,3363,1541,598,356,128,112,2735
Missouri,Pilot Knob,699,129,317,80,24,36,586
Missouri,Pilot Grove,713,118,315,81,5,75,594
Missouri,Pierpont village,87,18,50,3,0,2,73
Missouri,Pierce City,1261,180,499,194,14,61,948
Missouri,Piedmont,2246,506,682,346,80,233,1847
Missouri,Pickering,174,27,99,8,3,4,141
Missouri,Phillipsburg village,160,9,87,16,4,17,133
Missouri,Fortescue,5,0,0,5,0,0,5
Missouri,Forsyth,2068,368,955,277,75,212,1887
Missouri,Foristell,473,80,268,36,3,14,401
Missouri,Forest City,273,37,110,58,14,13,232
Missouri,Fordland,897,180,280,112,8,55,635
Missouri,Foley,127,38,27,33,4,3,105
Missouri,Florissant,52356,14170,18588,5180,682,3293,41913
Missouri,Florida village,0,0,0,0,0,0,0
Missouri,Flordell Hills,843,327,162,90,33,34,646
Missouri,Emma,247,31,133,19,0,19,202
Missouri,Bolckow,220,41,108,24,2,11,186
Missouri,Eminence,604,153,188,94,9,85,529
Missouri,Blanchard,42,21,10,6,0,0,37
Missouri,Bosworth,235,61,91,44,3,9,208
Missouri,Boonville,8350,2264,2750,1176,231,471,6892
Missouri,Bonne Terre,7064,3293,1458,1068,244,276,6339
Missouri,Bolivar,10507,3235,3659,1139,121,627,8781
Missouri,Edmundson,898,270,269,119,27,34,719
Missouri,Edinburg,132,23,40,20,0,5,88
Missouri,Edina,1187,253,479,120,18,108,978
Missouri,Edgerton,607,127,277,48,0,24,476
Missouri,Edgar Springs,216,8,76,33,3,15,135
Missouri,East Prairie,3178,629,964,250,60,297,2200
Missouri,Easton,254,52,126,28,1,8,215
Missouri,Aullville village,99,16,46,3,3,3,71
Missouri,Bourbon,1458,345,521,176,38,96,1176
Missouri,Eagleville,264,48,92,36,2,22,200
Missouri,Dutchtown village,34,2,22,5,0,1,30
Missouri,Duquesne village,1747,405,715,220,16,90,1446
Missouri,Duenweg,1218,186,486,192,29,30,923
Missouri,Dudley,158,29,54,37,5,9,134
Missouri,Drexel,911,189,409,108,16,29,751
Missouri,Downing,278,38,144,37,5,14,238
Missouri,Blodgett village,233,43,62,53,5,5,168
Missouri,Bloomfield,1952,302,887,296,30,153,1668
Missouri,Bloomsdale,631,150,234,49,9,57,499
Missouri,Blue Eye,220,42,85,47,0,19,193
Missouri,Blue Springs,53364,10235,22475,5191,893,1722,40516
Missouri,Blythedale village,164,19,70,20,1,16,126
Missouri,Eagle Rock,124,40,50,0,19,0,109
Missouri,Bowling Green,5465,1828,1468,979,156,259,4690
Missouri,Bragg City,127,36,33,13,7,10,99
Missouri,Brandsville,109,9,53,15,6,4,87
Missouri,Bland,478,133,118,66,42,36,395
Missouri,Emerald Beach village,279,34,174,9,0,27,244
Missouri,Elsberry,1930,461,683,280,35,93,1552
Missouri,Elmo,180,34,81,14,2,6,137
Missouri,Elmira village,60,6,26,5,0,4,41
Missouri,Phelps City,0,0,0,0,0,0,0
Missouri,Pevely,5596,1515,1849,579,146,271,4360
Missouri,Perryville,8333,1408,3444,682,188,619,6341
Missouri,Perry,656,91,338,68,8,56,561
Missouri,Penermon village,91,17,14,14,1,6,52
Missouri,Pendleton village,23,8,4,4,2,3,21
Missouri,Elmer,89,10,46,2,0,2,60
Missouri,Ellsinore,502,84,139,56,0,54,333
Missouri,Ellisville,9181,1723,4018,814,108,668,7331
Missouri,Ellington,1119,200,350,136,57,117,860
Missouri,El Dorado Springs,3553,377,1202,625,104,331,2639
Missouri,Eldon,4617,882,1574,738,55,259,3508
Missouri,Peculiar,4808,905,2181,358,74,159,3677
Missouri,Peaceful Village village,8,3,3,0,0,2,8
Missouri,Paynesville village,58,6,28,10,0,6,50
Missouri,Pattonsburg,379,113,111,57,28,11,320
Missouri,Passaic,38,7,23,6,2,0,38
Missouri,Pascola village,111,43,18,19,6,10,96
Missouri,Braymer,684,120,267,94,7,69,557
Missouri,Brashear,226,49,82,44,5,10,190
Missouri,Branson West,434,102,171,45,4,25,347
Missouri,Branson,11084,2622,4006,1657,183,864,9332
Missouri,Blairstown,125,17,47,19,4,8,95
Missouri,Blackwater,141,16,53,21,1,5,96
Missouri,Verona,591,84,249,43,5,24,405
Missouri,Blackburn,299,72,137,22,2,14,247
Missouri,Warsaw,2362,434,731,446,47,259,1917
Missouri,Warson Woods,1758,211,984,92,12,71,1370
Missouri,Washburn,533,103,247,52,6,35,443
Missouri,Washington,13993,3099,5953,1341,148,968,11509
Missouri,Wasola,36,0,0,36,0,0,36
Missouri,Clearmont,194,31,104,25,0,12,172
Missouri,Clayton,15900,6471,5969,1036,82,418,13976
Missouri,Claycomo village,1457,315,477,314,18,128,1252
Missouri,Clarkton,1228,190,414,164,28,103,899
Missouri,Clarksville,444,96,152,92,9,52,401
Missouri,Clarkson Valley,2634,405,1648,50,13,53,2169
Missouri,Clarksdale,271,47,108,35,17,14,221
Missouri,Watson village,47,11,24,2,1,5,43
Missouri,Waverly,823,218,267,61,5,82,633
Missouri,Wayland,537,100,195,83,0,48,426
Missouri,Waynesville,5250,1013,1905,902,87,249,4156
Missouri,Weatherby,101,12,38,18,0,8,76
Missouri,Weatherby Lake,1834,271,1151,97,0,73,1592
Missouri,Weaubleau,443,86,165,47,0,42,340
Missouri,Webb City,11035,2549,3936,1258,255,541,8539
Missouri,Webster Groves,23120,4662,10727,1443,172,1256,18260
Missouri,Weingarten,68,0,33,25,0,10,68
Missouri,Cleveland,609,126,301,57,0,32,516
Missouri,Clever,2381,393,1037,242,9,50,1731
Missouri,Cliff Village village,30,0,16,1,0,1,18
Missouri,Bel-Nor village,1486,450,598,128,24,88,1288
Missouri,Bel-Ridge village,2726,1023,471,254,101,74,1923
Missouri,Warrenton,8025,1950,2516,873,102,430,5871
Missouri,Belton,23209,4870,9256,2354,513,780,17773
Missouri,Warrensburg,19739,9192,5416,1411,240,571,16830
Missouri,Wardell,349,69,98,62,17,41,287
Missouri,Velda Village Hills village,905,320,167,94,17,114,712
Missouri,Velda City,1315,475,216,169,62,135,1057
Missouri,Vanduser village,128,28,60,11,7,11,117
Missouri,Vandiver village,97,12,50,0,0,7,69
Missouri,Vandalia,4126,1225,1229,677,169,274,3574
Missouri,Van Buren,1044,125,341,141,16,100,723
Missouri,Valley Park,6970,1726,2564,847,68,520,5725
Missouri,Utica village,272,58,122,49,4,13,246
Missouri,Urich,453,62,177,77,12,28,356
Missouri,Urbana,376,64,120,65,0,50,299
Missouri,Uplands Park village,384,144,120,41,4,24,333
Missouri,University City,35172,11540,12454,3201,625,1956,29776
Missouri,Unity Village village,114,58,17,31,0,4,110
Missouri,Unionville,1989,376,776,276,42,174,1644
Missouri,Union Star,344,78,140,45,2,27,292
Missouri,Union,10644,1867,4333,1371,146,445,8162
Missouri,Umber View Heights village,71,2,57,4,0,4,67
Missouri,Viburnum,721,175,284,77,26,40,602
Missouri,Vienna,721,121,235,93,3,89,541
Missouri,Village of Four Seasons village,2218,314,1132,210,21,70,1747
Missouri,Villa Ridge,2800,288,1442,257,93,95,2175
Missouri,Vinita Park,1940,546,589,207,67,91,1500
Missouri,Vinita Terrace village,220,43,119,23,3,2,190
Missouri,Vista village,48,10,24,2,0,2,38
Missouri,Waco,52,1,20,9,3,2,35
Missouri,Walker,275,45,111,25,15,12,208
Missouri,Walnut Grove,689,107,258,79,32,38,514
Missouri,Wardsville village,1890,291,878,90,8,40,1307
Missouri,Black Jack,6938,2053,1792,815,133,890,5683
Missouri,Bennett Springs,114,25,75,0,0,14,114
Missouri,Benton City village,176,23,66,24,1,11,125
Missouri,Baker village,0,0,0,0,0,0,0
Missouri,Bakersfield village,289,84,100,36,0,19,239
Missouri,Baldwin Park village,66,4,25,17,5,5,56
Missouri,Ballwin,30484,5583,15331,2029,253,1249,24445
Missouri,Baring,153,21,73,19,2,11,126
Missouri,Barnard,268,64,121,25,0,12,222
Missouri,Barnett,163,22,51,63,4,7,147
Missouri,Barnhart,5858,1502,2536,443,174,120,4775
Missouri,Bates City,235,41,85,29,6,21,182
Missouri,Battlefield,5844,985,2703,618,83,129,4518
Missouri,Bella Villa,756,164,350,57,5,52,628
Missouri,Bell City,491,110,182,55,10,20,377
Missouri,Belle,1738,413,542,248,69,162,1434
Missouri,Bellefontaine Neighbors,10814,3758,2455,1324,321,602,8460
Missouri,Bellerive village,183,31,111,9,2,13,166
Missouri,Bellflower,337,71,133,41,11,24,280
Missouri,Westphalia,381,116,156,15,2,57,346
Missouri,Weston,1673,327,682,240,14,94,1357
Missouri,West Line village,89,26,41,7,1,5,80
Missouri,Westboro,181,41,73,15,4,3,136
Missouri,West Alton,545,122,247,76,2,27,474
Missouri,Wentzville,32827,5761,14868,2012,240,988,23869
Missouri,Wentworth village,103,21,55,12,0,8,96
Missouri,Wellsville,1138,212,416,114,15,138,895
Missouri,Wellston,1949,941,182,150,75,62,1410
Missouri,Versailles,2826,707,755,570,131,165,2328
Missouri,Plevna,15,0,0,9,0,6,15
Missouri,Bagnell,52,25,12,4,0,8,49
Missouri,Benton,937,237,328,145,9,36,755
Missouri,Avondale,392,92,144,68,13,8,325
Missouri,Ava,2961,465,1147,312,45,268,2237
Missouri,Weldon Spring,5517,665,3136,330,15,467,4613
Missouri,Weldon Spring Heights,92,10,68,0,0,11,89
Missouri,Wellington,850,177,324,75,44,42,662
Missouri,Twin Oaks village,332,65,153,39,0,14,271
Missouri,Tuscumbia,252,49,106,34,14,14,217
Missouri,Turney village,111,14,57,18,5,7,101
Missouri,Truxton village,90,17,27,7,0,4,55
Missouri,Truesdale,869,261,223,54,32,44,614
Missouri,Troy,11175,2093,4023,1301,221,479,8117
Missouri,Berger,168,35,69,16,2,12,134
Missouri,Berkeley,9083,3313,1882,1052,175,494,6916
Missouri,Bernie,1992,334,744,252,56,163,1549
Missouri,Bertrand,807,106,303,134,36,118,697
Missouri,Bethany,3080,599,1289,303,95,299,2585
Missouri,Marshfield,6860,1295,2571,712,191,416,5185
Missouri,Beverly Hills,450,172,99,56,16,42,385
Missouri,Bevier,642,177,258,56,0,59,550
Missouri,Biehle,0,0,0,0,0,0,0
Missouri,Bigelow village,8,0,0,5,0,3,8
Missouri,Big Lake village,102,0,91,0,0,2,93
Missouri,Big Spring,29,0,0,20,0,9,29
Missouri,Billings,921,160,434,119,19,59,791
Missouri,Birch Tree,559,90,256,66,18,49,479
Missouri,Birmingham village,212,25,123,17,2,6,173
Missouri,Bismarck,1336,250,614,131,9,93,1097
Missouri,Aurora,7473,1426,3071,702,165,498,5862
Missouri,Auxvasse,1298,276,523,108,22,62,991
Missouri,Avilla,100,12,44,4,4,3,67
Missouri,Pocahontas,124,19,42,11,5,3,80
Missouri,Harwood village,106,36,20,23,7,0,86
Missouri,Polo,606,147,179,83,7,50,466
Missouri,Dadeville village,259,60,100,39,0,9,208
Missouri,Dalton,15,2,6,2,0,2,12
Missouri,Danville,71,9,0,0,13,22,44
Missouri,Dardenne Prairie,12383,2449,6313,443,75,356,9636
Missouri,Darlington village,75,9,30,8,0,10,57
Missouri,Dawn,111,23,40,12,0,7,82
Missouri,Dearborn,412,93,173,43,4,37,350
Missouri,Deepwater,427,46,165,66,5,30,312
Missouri,Deerfield village,70,15,19,18,3,2,57
Missouri,Defiance,161,21,103,8,10,10,152
Missouri,De Kalb,202,37,102,19,1,12,171
Missouri,Dellwood,5011,1947,1304,494,74,189,4008
Missouri,Delta,422,112,157,59,10,32,370
Missouri,Dennis Acres village,45,5,17,0,1,5,28
Missouri,Denver village,47,7,27,2,0,1,37
Missouri,Des Arc village,170,29,60,16,16,17,138
Missouri,Desloge,4966,1027,2009,585,87,466,4174
Missouri,De Soto,6469,1160,2062,863,195,817,5097
Missouri,Des Peres,8480,1542,4655,431,23,291,6942
Missouri,De Witt,101,27,41,14,0,6,88
Missouri,Dexter,7920,1358,2896,1239,208,736,6437
Missouri,Diamond,921,105,411,100,27,86,729
Missouri,Diehlstadt village,184,38,81,27,0,4,150
Missouri,Curryville,240,56,87,25,2,18,188
Missouri,Diggins village,280,50,145,29,4,20,248
Missouri,Cuba,3377,857,925,442,82,216,2522
Missouri,Crystal Lake Park,494,87,237,38,2,30,394
Missouri,Conception Junction,210,38,95,9,0,6,148
Missouri,Concord,16953,3632,7454,1639,84,1483,14292
Missouri,Concordia,2373,524,965,188,32,212,1921
Missouri,Coney Island village,68,3,49,7,0,9,68
Missouri,Conway,918,228,252,135,30,52,697
Missouri,Cool Valley,1167,426,331,139,17,57,970
Missouri,Cooter,428,76,175,26,21,35,333
Missouri,Corder,337,83,123,41,8,13,268
Missouri,Corning,4,0,2,0,2,0,4
Missouri,Cosby village,151,25,82,0,0,13,120
Missouri,Cottleville,3836,682,2004,221,12,133,3052
Missouri,Country Club village,2833,380,1407,285,42,86,2200
Missouri,Country Club Hills,1398,605,111,106,47,38,907
Missouri,Country Life Acres village,138,26,77,8,0,0,111
Missouri,Cowgill,139,32,58,16,2,7,115
Missouri,Craig,208,39,94,24,3,13,173
Missouri,Crane,2022,395,630,269,71,114,1479
Missouri,Creighton,320,75,130,43,7,19,274
Missouri,Crestwood,11961,2413,5426,1082,150,717,9788
Missouri,Creve Coeur,17944,4024,8631,998,128,1274,15055
Missouri,Crocker,997,205,249,153,13,75,695
Missouri,Cross Timbers,239,42,73,32,12,11,170
Missouri,Crystal City,4829,1131,1915,419,50,325,3840
Missouri,Crystal Lakes,322,52,180,33,0,11,276
Missouri,Conception,262,182,47,6,4,4,243
Missouri,Dixon,1443,286,432,173,38,101,1030
Missouri,Doniphan,2337,470,764,257,56,218,1765
Missouri,Sedalia,21457,5238,7790,2681,343,1066,17118
Missouri,Sedgewickville village,255,58,119,9,11,3,200
Missouri,Seligman,1021,171,416,124,26,63,800
Missouri,Senath,1813,362,720,142,40,153,1417
Missouri,Seneca,2285,381,925,204,46,215,1771
Missouri,Seymour,1789,291,660,301,45,145,1442
Missouri,Shelbina,1583,237,697,152,10,185,1281
Missouri,Shelbyville,546,88,259,48,9,43,447
Missouri,Sheldon,672,159,240,96,20,32,547
Missouri,Shell Knob,1475,124,960,24,38,64,1210
Missouri,Zalma village,146,46,50,20,4,3,123
Missouri,Wyatt,443,124,154,30,6,37,351
Missouri,Wyaconda,199,28,68,52,0,14,162
Missouri,Wright City,3355,637,1255,517,34,67,2510
Missouri,Worthington village,96,47,24,7,0,0,78
Missouri,Wortham,226,97,36,8,70,0,211
Missouri,Worth village,53,14,16,5,2,2,39
Missouri,Wooldridge village,35,13,10,9,0,2,34
Missouri,Woodson Terrace,4072,1164,1345,431,169,256,3365
Missouri,Wood Heights,748,119,389,56,12,20,596
Missouri,Winston village,226,52,67,30,5,22,176
Missouri,Winona,1202,262,463,126,49,59,959
Missouri,Winigan,61,6,32,0,0,14,52
Missouri,Scott City,4527,1036,1534,568,71,363,3572
Missouri,Doe Run,1096,155,411,149,49,101,865
Missouri,Scotsdale,228,47,101,31,0,7,186
Missouri,Savannah,5092,1102,2002,514,15,411,4044
Missouri,Doolittle,658,148,301,59,8,24,540
Missouri,Dover,115,21,58,3,0,15,97
Missouri,St. Charles,67479,20175,25480,6518,769,3478,56420
Missouri,St. Clair,4706,743,1800,629,81,424,3677
Missouri,St. Clement,108,21,66,0,7,0,94
Missouri,St. Cloud village,64,3,37,0,0,3,43
Missouri,Ste. Genevieve,4437,742,1783,369,103,430,3427
Missouri,St. Elizabeth village,319,35,176,5,1,32,249
Missouri,St. Francisville,102,30,35,11,0,9,85
Missouri,St. James,4172,716,1655,395,91,345,3202
Missouri,St. John,6491,1838,2086,854,188,479,5445
Missouri,St. Joseph,77037,20768,26080,8969,1673,4314,61804
Missouri,St. Louis,317850,130520,75220,32538,8229,16248,262755
Missouri,St. Martins,1223,225,583,105,11,28,952
Missouri,St. Mary,407,124,104,47,18,37,330
Missouri,St. Paul,1863,392,1120,74,4,40,1630
Missouri,St. Peters,55135,11217,25619,4827,555,2519,44737
Missouri,St. Robert,5151,1127,1913,542,66,61,3709
Missouri,St. Thomas,225,48,96,14,0,9,167
Missouri,Salem,4976,1001,1528,877,120,515,4041
Missouri,Salisbury,1667,283,607,197,76,111,1274
Missouri,Sappington,7113,1116,3045,874,74,698,5807
Missouri,Sarcoxie,1181,199,438,188,25,85,935
Missouri,Schell City,241,49,74,43,5,21,192
Missouri,Commerce village,44,18,13,6,0,2,39
Missouri,Columbia,115391,47881,36398,8420,986,3202,96887
Missouri,Collins village,132,29,54,11,4,19,117
Missouri,Mine La Motte,225,11,152,26,0,15,204
Missouri,Miner,963,131,460,90,22,124,827
Missouri,Mineral Point,389,66,153,44,18,19,300
Missouri,Miramiguoa Park village,112,12,45,15,3,2,77
Missouri,Missouri City,311,75,110,52,4,21,262
Missouri,Moberly,13879,3944,4245,2070,198,675,11132
Missouri,Mokane,156,31,45,30,0,8,114
Missouri,Moline Acres,2377,876,535,289,56,150,1906
Missouri,Monett,8957,1917,3656,689,341,353,6956
Missouri,Monroe City,2439,472,966,327,40,156,1961
Missouri,Montgomery City,2795,529,987,341,68,160,2085
Missouri,Monticello village,139,42,64,16,0,10,132
Missouri,Montier,51,51,0,0,0,0,51
Missouri,Montreal,55,0,0,27,0,0,27
Missouri,Montrose,355,53,150,58,0,40,301
Missouri,Mooresville village,122,22,30,25,0,12,89
Missouri,Morehouse,826,186,338,80,26,76,706
Missouri,Morley,728,144,205,75,19,78,521
Missouri,Morrison,91,13,45,5,0,12,75
Missouri,Morrisville,378,85,167,30,10,10,302
Missouri,Mosby,206,38,85,29,20,6,178
Missouri,Moscow Mills,2550,658,676,256,71,76,1737
Missouri,Mound City,1265,189,560,105,21,170,1045
Missouri,Mindenmines,270,32,134,31,8,25,230
Missouri,Moundville,132,30,59,16,4,13,122
Missouri,Milo village,108,24,52,9,0,0,85
Missouri,Miller,732,101,273,148,19,28,569
Missouri,Marston,417,141,113,34,24,21,333
Missouri,Marthasville,1273,212,547,102,29,49,939
Missouri,Martinsburg,325,47,118,59,11,23,258
Missouri,Maryland Heights,27401,7737,10682,2515,364,1380,22678
Missouri,Maryville,11997,6409,2996,935,114,415,10869
Missouri,Matthews,736,130,265,102,4,97,598
Missouri,Maysville,1115,279,394,203,5,91,972
Missouri,Mayview,335,79,100,28,8,8,223
Missouri,Meadville,415,61,196,29,9,17,312
Missouri,Mehlville,29953,8366,11058,3357,439,2252,25472
Missouri,Memphis,1938,319,664,233,55,207,1478
Missouri,Mendon,156,32,67,10,4,11,124
Missouri,Mercer,413,67,139,73,10,42,331
Missouri,Merriam Woods village,1668,366,567,268,30,92,1323
Missouri,Merwin village,37,6,15,9,3,0,33
Missouri,Meta,244,45,113,21,0,12,191
Missouri,Metz,36,1,18,3,2,5,29
Missouri,Mexico,11588,2464,4303,1384,195,771,9117
Missouri,Miami,142,35,46,5,1,26,113
Missouri,Middletown,232,61,72,31,5,9,178
Missouri,Milan,2110,476,696,271,64,139,1646
Missouri,Milford village,31,2,16,3,6,4,31
Missouri,Millard village,66,13,19,0,15,8,55
Missouri,Mill Spring village,160,56,39,20,7,21,143
Missouri,Mountain Grove,4712,967,1576,640,185,390,3758
Missouri,Mountain View,2701,404,1039,296,39,270,2048
Missouri,Mount Leonard,83,5,40,12,0,7,64
Missouri,Rock Hill,4638,1480,1636,489,47,169,3821
Missouri,Rock Port,1359,247,580,190,23,92,1132
Missouri,Rockville,140,21,46,17,3,14,101
Missouri,Rogersville,3453,582,1434,369,14,114,2513
Missouri,Rolla,19910,7535,6086,1712,337,986,16656
Missouri,Roscoe village,111,8,79,7,0,3,97
Missouri,Rosebud,436,86,155,59,15,30,345
Missouri,Rosendale,129,14,44,16,0,13,87
Missouri,Rothville village,131,25,33,15,2,1,76
Missouri,Rush Hill village,137,35,67,8,5,6,121
Missouri,Rushville,258,69,102,16,0,19,206
Missouri,Russellville,837,211,267,106,21,19,624
Missouri,Rutledge,72,9,26,8,1,8,52
Missouri,Saddlebrooke village,284,35,214,0,0,4,253
Missouri,Saginaw village,338,72,108,72,6,14,272
Missouri,St. Ann,12973,3871,3855,1591,202,902,10421
Missouri,Clifton Hill,105,10,56,12,0,2,80
Missouri,Climax Springs village,166,65,34,17,21,1,138
Missouri,Clinton,9012,1779,3267,1373,113,826,7358
Missouri,Clyde village,90,12,33,8,3,0,56
Missouri,Cobalt village,256,73,67,51,3,21,215
Missouri,Coffey,135,19,71,7,8,3,108
Missouri,Cole Camp,1443,290,616,143,15,144,1208
Missouri,Rockaway Beach,832,108,370,155,15,31,679
Missouri,Rocheport,243,47,100,47,3,17,214
Missouri,Rives,56,10,22,18,0,3,53
Missouri,Riverview Estates village,120,23,70,1,0,4,98
Missouri,Mount Moriah,124,27,35,20,4,10,96
Missouri,Mount Vernon,4531,728,1606,848,100,440,3722
Missouri,Murphy,8745,1982,3348,1137,143,359,6969
Missouri,Napoleon,243,37,127,15,0,9,188
Missouri,Naylor,756,124,304,85,19,50,582
Missouri,Neck City,139,19,52,17,10,16,114
Missouri,Neelyville,529,88,145,75,21,18,347
Missouri,Nelson,158,33,60,17,2,12,124
Missouri,Neosho,12102,2668,4594,1360,230,664,9516
Missouri,Nevada,8454,1902,2473,1204,295,745,6619
Missouri,Newark village,68,14,31,13,1,2,61
Missouri,Winfield,1698,328,585,179,21,35,1148
Missouri,New Bloomfield,806,253,286,55,18,29,641
Missouri,Rich Hill,1446,224,574,135,27,100,1060
Missouri,Richland,1678,503,379,217,57,131,1287
Missouri,Richmond,5654,1254,2010,727,69,473,4533
Missouri,Richmond Heights,8510,2554,3331,884,51,323,7143
Missouri,Ridgely village,106,26,55,3,0,5,89
Missouri,Ridgeway,479,86,183,77,10,39,395
Missouri,Risco,362,82,168,24,6,10,290
Missouri,Ritchey,78,6,39,9,0,8,62
Missouri,River Bend village,6,0,2,2,0,2,6
Missouri,Riverside,3056,903,826,363,157,249,2498
Missouri,Riverview village,2849,1029,746,260,51,71,2157
Missouri,Richards,115,25,46,11,0,3,85
Missouri,Windsor Place village,383,52,191,26,10,16,295
Missouri,Windsor,2753,449,1407,161,5,246,2268
Missouri,Winchester,1612,330,597,203,17,119,1266
Missouri,Clark,261,76,106,14,0,15,211
Missouri,Clarksburg,256,52,98,38,6,6,200
Missouri,Adrian,1953,226,738,229,90,173,1456
Missouri,Advance,1449,285,471,174,23,160,1113
Missouri,Affton,21345,5783,8838,2131,109,1015,17876
Missouri,Agency village,907,190,374,113,9,21,707
Missouri,Airport Drive village,877,171,405,80,10,44,710
Missouri,Alba,503,64,257,36,2,32,391
Missouri,Albany,2178,422,948,203,18,173,1764
Missouri,Aldrich village,76,24,27,4,0,11,66
Missouri,Alexandria,142,43,59,10,0,21,133
Missouri,Allendale village,44,8,29,1,0,3,41
Missouri,Allenville village,68,10,39,4,0,1,54
Missouri,Alma,387,91,188,23,1,34,337
Missouri,Altamont village,175,31,47,26,1,19,124
Missouri,Altenburg,477,75,250,20,2,27,374
Missouri,Alton,1087,224,356,193,2,113,888
Missouri,Amazonia village,253,65,112,26,0,15,218
Missouri,Amity,18,3,8,3,0,3,17
Missouri,Amoret,140,36,60,17,0,10,123
Missouri,Amsterdam,231,57,97,18,7,21,200
Missouri,Anderson,2435,396,1000,240,47,124,1807
Missouri,Annada village,42,17,10,7,0,0,34
Missouri,Clarence,918,147,301,136,22,79,685
Missouri,Annapolis,466,133,156,60,25,19,393
Missouri,Chula,245,36,117,22,6,5,186
Missouri,Chilhowee,272,28,97,55,9,36,225
Missouri,Carytown,282,43,137,8,3,8,199
Missouri,Cassville,3286,602,1276,177,79,444,2578
Missouri,Castle Point,3368,1235,637,199,181,185,2437
Missouri,Catron,82,25,32,4,0,12,73
Missouri,Cave,1,1,0,0,0,0,1
Missouri,Cedar Hill,1694,418,764,153,9,47,1391
Missouri,Cedar Hill Lakes village,205,37,91,41,6,11,186
Missouri,Center,382,91,128,62,8,38,327
Missouri,Centertown,288,39,122,45,3,16,225
Missouri,Centerview,253,33,92,25,3,12,165
Missouri,Centerville,244,50,92,59,4,12,217
Missouri,Centralia,4159,697,1760,401,36,429,3323
Missouri,Chaffee,2943,604,1188,367,20,211,2390
Missouri,Chain of Rocks village,133,30,56,14,0,1,101
Missouri,Chain-O-Lakes village,122,28,42,13,0,9,92
Missouri,Chamois,396,71,123,65,8,36,303
Missouri,Champ village,10,0,10,0,0,0,10
Missouri,Charlack,1483,540,489,107,33,33,1202
Missouri,Charleston,5877,2152,1488,907,224,286,5057
Missouri,Charmwood,24,0,14,2,0,0,16
Missouri,Cherokee Pass,242,28,194,0,0,0,222
Missouri,Chesapeake,116,0,78,15,0,0,93
Missouri,Chesterfield,47706,8275,24430,3478,316,2692,39191
Missouri,Chillicothe,9025,1858,3331,1286,206,712,7393
Missouri,Anniston,215,38,94,29,4,18,183
Missouri,Appleton City,1322,232,392,169,40,201,1034
Missouri,Arbela,19,4,2,9,0,3,18
Missouri,Raymore,19813,3219,9308,1971,152,1039,15689
Missouri,Raymondville,406,74,141,55,11,33,314
Missouri,Ravenwood,436,79,190,56,1,22,348
Missouri,Ravanna,44,2,23,7,0,12,44
Missouri,Randolph village,28,8,9,2,0,5,24
Missouri,Qulin,446,126,104,67,21,38,356
Missouri,Quitman,45,7,14,4,2,2,29
Missouri,Queen City,686,92,239,129,20,63,543
Missouri,Puxico,782,143,324,93,17,74,651
Missouri,Purdy,1416,391,552,98,15,76,1132
Missouri,Purdin,194,38,77,21,9,14,159
Missouri,Purcell,399,57,168,18,14,14,271
Missouri,Princeton,1080,188,419,132,17,123,879
Missouri,Preston village,273,63,110,20,18,11,222
Missouri,Prathersville village,111,13,55,20,1,12,101
Missouri,Prairie Home,328,36,129,43,7,21,236
Missouri,Powersville village,79,6,42,5,3,14,70
Missouri,Potosi,2666,593,872,333,71,236,2105
Missouri,Portageville,3168,870,1079,406,33,190,2578
Missouri,Portage Des Sioux,403,105,137,44,10,24,320
Missouri,Poplar Bluff,17195,3752,6074,2319,442,1170,13757
Missouri,Pontiac,278,34,148,0,0,44,226
Missouri,Pomona,306,17,260,9,0,9,295
Missouri,Raytown,29486,7440,10597,3452,226,1602,23317
Missouri,Rayville,201,55,72,12,7,7,153
Missouri,Rea,53,4,30,4,2,5,45
Missouri,Redings Mill village,197,25,82,51,4,12,174
Missouri,Arbyrd,531,112,166,63,20,28,389
Missouri,Arcadia,831,157,329,120,16,59,681
Missouri,Archie,1359,195,549,107,33,76,960
Missouri,Arcola village,61,9,33,9,1,2,54
Missouri,Argyle,163,33,79,5,0,14,131
Missouri,Arkoe,75,10,27,7,0,0,44
Missouri,Armstrong,364,58,154,30,10,4,256
Missouri,Arnold,21123,4466,8929,2423,317,1113,17248
Missouri,Arrow Point village,125,10,62,17,1,10,100
Missouri,Arrow Rock,37,0,24,4,0,9,37
Missouri,Asbury,171,28,85,34,1,8,156
Missouri,Caruthersville,6026,1545,1817,615,190,573,4740
Missouri,Ashburn,40,40,0,0,0,0,40
Missouri,Ashland,3828,711,1584,292,53,289,2929
Missouri,Ashley,75,19,49,0,0,7,75
Missouri,Atlanta,512,124,152,78,15,22,391
Missouri,Augusta,284,48,114,45,10,22,239
Missouri,Rhineland,156,40,70,13,5,13,141
Missouri,Revere,83,19,37,10,0,0,66
Missouri,Republic,15594,2445,6809,1638,179,495,11566
Missouri,Rensselaer village,243,36,104,42,0,8,190
Missouri,Renick village,193,41,79,35,7,7,169
Missouri,Reeds Spring,905,190,357,76,39,34,696
Missouri,Reeds,71,38,15,1,7,10,71
Missouri,Ash Grove,1567,293,663,170,22,153,1301
Missouri,Pollock village,40,4,23,13,0,0,40
Missouri,Carthage,14278,2896,5333,1196,174,1046,10645
Missouri,Carrollton,3734,657,1354,541,47,338,2937
Missouri,Humphreys village,108,18,49,12,1,0,80
Missouri,Hume,373,62,149,36,7,13,267
Missouri,Humansville,1140,201,355,180,33,97,866
Missouri,Hughesville village,160,25,78,20,0,11,134
Missouri,Howardville,286,98,63,38,14,13,226
Missouri,Houston Lake,347,122,115,42,7,22,308
Missouri,Houstonia,207,38,88,14,2,17,159
Missouri,Houston,2354,489,670,347,79,214,1799
Missouri,Hornersville,803,168,253,64,19,55,559
Missouri,Horine,1332,410,495,71,45,14,1035
Missouri,Hopkins,485,52,266,30,8,26,382
Missouri,Homestown,169,71,34,8,8,1,122
Missouri,Homestead village,175,19,72,31,3,18,143
Missouri,Holts Summit,3447,863,1324,388,0,244,2819
Missouri,Holt,474,84,184,41,6,26,341
Missouri,Hollister,4441,977,1433,670,118,361,3559
Missouri,Holliday village,102,20,37,12,2,9,80
Missouri,Holland,199,43,77,17,12,20,169
Missouri,Holden,2284,411,960,241,44,139,1795
Missouri,Holcomb,749,161,270,54,15,51,551
Missouri,Hoberg village,47,14,22,0,0,2,38
Missouri,Hillsdale village,1327,555,263,136,36,39,1029
Missouri,Hillsboro,2980,878,944,268,109,115,2314
Missouri,Hunnewell,136,30,59,21,2,20,132
Missouri,High Ridge,3553,687,1606,377,53,192,2915
Missouri,Hunter,106,0,23,36,0,37,96
Missouri,Huntsdale,25,3,16,5,1,0,25
Missouri,Wilson City village,55,20,2,11,0,18,51
Missouri,Willow Springs,2294,495,855,243,69,88,1750
Missouri,Williamsville,390,103,157,49,2,20,331
Missouri,Willard,5429,841,2463,546,42,187,4079
Missouri,Wildwood,35776,6285,19157,1783,179,757,28161
Missouri,Wilbur Park village,505,158,205,29,14,25,431
Missouri,Whitewater,99,17,31,21,0,14,83
Missouri,Whiteside village,56,6,14,15,3,4,42
Missouri,Whiteman AFB,3893,1316,1497,20,21,0,2854
Missouri,Wheeling,280,30,144,34,4,9,221
Missouri,Wheaton,689,133,242,61,2,40,478
Missouri,Wheatland,289,44,96,71,9,35,255
Missouri,Westwood village,298,56,176,11,1,17,261
Missouri,West Sullivan,59,8,23,5,0,8,44
Missouri,West Plains,12230,2405,4579,1710,298,760,9752
Missouri,Indian Point village,541,67,272,52,18,48,457
Missouri,Independence,117192,26949,43333,15278,2047,7187,94794
Missouri,Imperial,4807,1039,2181,420,12,197,3849
Missouri,Iberia,693,133,252,108,8,57,558
Missouri,Iatan village,41,8,23,2,0,1,34
Missouri,Hurley,220,20,120,25,0,4,169
Missouri,Hurdland,118,22,66,10,2,8,108
Missouri,Huntsville,1570,355,601,166,29,127,1278
Missouri,Huntleigh,372,49,219,10,0,22,300
Missouri,Highlandville,1040,140,465,108,15,29,757
Missouri,High Hill,196,34,105,18,0,12,169
Missouri,Higginsville,4706,999,2002,316,110,297,3724
Missouri,Burgess,59,9,31,2,0,6,48
Missouri,Burlington Junction,468,61,184,71,5,24,345
Missouri,Butler,4153,758,1414,684,83,330,3269
Missouri,Butterfield village,483,87,189,91,3,16,386
Missouri,Byrnes Mill,2822,515,1306,285,48,158,2312
Missouri,Cabool,2309,287,815,356,36,202,1696
Missouri,Cainsville,240,34,108,21,4,18,185
Missouri,Cairo village,314,56,118,34,5,11,224
Missouri,Caledonia village,173,56,60,14,6,5,141
Missouri,Calhoun,414,85,126,59,15,31,316
Missouri,California,4351,668,1682,448,62,399,3259
Missouri,Callao,436,132,153,22,9,28,344
Missouri,Calverton Park village,1289,454,379,103,20,102,1058
Missouri,Camden,242,49,96,15,3,19,182
Missouri,Camden Point,502,81,238,39,22,15,395
Missouri,Camdenton,3822,796,1051,629,78,229,2783
Missouri,Cameron,10167,3169,2861,1418,296,717,8461
Missouri,Campbell,1997,333,513,368,135,177,1526
Missouri,Canalou,278,21,114,36,15,5,191
Missouri,Canton,2522,925,746,208,12,146,2037
Missouri,Cape Girardeau,38959,13366,13092,3257,780,2146,32641
Missouri,Cardwell,698,196,207,90,20,34,547
Missouri,Carl Junction,7577,891,3562,688,88,273,5502
Missouri,Gunn City village,79,26,39,4,0,0,69
Missouri,Hale,459,106,184,67,3,16,376
Missouri,Halfway village,126,21,44,22,5,15,107
Missouri,Hallsville,1593,303,654,149,31,66,1203
Missouri,Higbee,589,87,251,56,38,50,482
Missouri,Hermitage,801,120,253,106,52,79,610
Missouri,Hermann,2461,458,1064,219,41,269,2051
Missouri,Herculaneum,3762,590,1663,342,7,256,2858
Missouri,Henrietta,303,107,112,39,0,9,267
Missouri,Hazelwood,25686,8102,8343,2994,420,1088,20947
Missouri,Haywood City village,151,54,41,21,7,9,132
Missouri,Hayward,130,0,37,27,0,6,70
Missouri,Hayti Heights,557,175,58,24,55,33,345
Missouri,Hayti,2840,729,788,406,60,221,2204
Missouri,Hawk Point,796,143,278,90,8,38,557
Missouri,Carterville,1795,414,707,226,18,47,1412
Missouri,Breckenridge,277,66,82,41,4,28,221
Missouri,Hartwell,0,0,0,0,0,0,0
Missouri,Hartville,588,127,176,73,22,71,469
Missouri,Hartsburg,100,22,24,30,0,11,87
Missouri,Harrisonville,10003,2214,3677,1092,196,768,7947
Missouri,Harrisburg,347,44,129,39,1,13,226
Missouri,Harris,46,4,15,17,5,4,45
Missouri,Hardin,555,98,276,31,32,7,444
Missouri,Hannibal,17717,4633,5855,2026,268,1427,14209
Missouri,Hanley Hills village,2194,818,523,252,49,83,1725
Missouri,Hamilton,1663,338,607,237,41,156,1379
Missouri,Halltown village,109,11,40,17,3,13,84
Missouri,Harviell,163,81,0,0,0,0,81
Missouri,Breckenridge Hills,4728,1905,1188,454,13,173,3733
Missouri,East Lynne,248,59,63,41,5,19,187
Missouri,Brewer,419,61,224,21,14,9,329
Missouri,Granby,2170,344,870,245,39,94,1592
Missouri,Grain Valley,13134,2667,5190,1070,242,477,9646
Missouri,Graham,214,22,90,20,5,15,152
Missouri,Gower,1588,302,659,150,14,106,1231
Missouri,Goss,0,0,0,0,0,0,0
Missouri,Gordonville village,416,102,257,11,3,21,394
Missouri,Goodnight village,12,0,7,0,0,0,7
Missouri,Goodman,1141,166,512,123,2,84,887
Missouri,Golden City,578,149,198,68,8,71,494
Missouri,Golden,491,74,291,82,0,24,471
Missouri,Glenwood village,175,19,78,2,3,27,129
Missouri,Glen Echo Park village,126,12,60,9,5,10,96
Missouri,Glendale,5928,786,3020,343,14,188,4351
Missouri,Glen Allen,100,20,33,10,5,5,73
Missouri,Glenaire,440,56,222,62,4,26,370
Missouri,Brentwood,8052,2547,3206,700,0,322,6775
Missouri,Marshall,13048,3703,4181,1195,284,989,10352
Missouri,Grand Falls Plaza,111,1,57,29,1,8,96
Missouri,Marquand,318,97,110,21,8,23,259
Missouri,Grandin,175,38,42,28,5,16,129
Missouri,Grandview,24997,7140,7766,3079,416,1070,19471
Missouri,Guilford,54,2,31,10,0,2,45
Missouri,Greenwood,5400,997,2384,446,22,98,3947
Missouri,Greenville,530,94,186,60,4,60,404
Missouri,Greentop,446,73,211,52,5,19,360
Missouri,Green Ridge,467,77,196,50,2,17,342
Missouri,Green Park,2630,587,1064,321,7,241,2220
Missouri,Greenfield,1325,231,485,198,28,131,1073
Missouri,Greendale,636,215,217,80,12,29,553
Missouri,Green City,695,147,287,98,6,47,585
Missouri,Greencastle,330,42,152,34,28,20,276
Missouri,Gray Summit,2943,391,1487,201,6,68,2153
Missouri,Grayridge,68,20,35,6,0,7,68
Missouri,Grayhawk,536,78,278,95,0,27,478
Missouri,Gravois Mills,154,52,21,15,9,13,110
Missouri,Grantwood Village,962,142,586,29,2,40,799
Missouri,Grant City,835,111,357,126,2,109,705
Missouri,Granger village,28,7,3,2,0,9,21
Missouri,Grand Pass village,73,24,41,0,0,4,69
Missouri,Innsbrook village,786,63,470,26,9,93,661
Missouri,Marlborough village,2006,1010,487,184,66,107,1854
Missouri,Triplett,18,2,5,5,3,3,18
Missouri,Sunset Hills,8533,1480,4066,583,52,671,6852
Missouri,Sunrise Beach village,421,95,183,57,17,25,377
Missouri,Sundown,27,4,14,0,0,9,27
Missouri,Sumner,106,21,29,12,6,6,74
Missouri,Summersville,636,153,162,50,8,53,426
Missouri,Sullivan,6998,1474,2408,948,186,476,5492
Missouri,Sugar Creek,3339,597,1101,672,38,201,2609
Missouri,Sturgeon,778,134,362,64,18,57,635
Missouri,Strasburg,143,26,49,31,0,5,111
Missouri,Strafford,2137,324,959,199,31,125,1638
Missouri,Stover,1204,252,389,113,35,117,906
Missouri,Stoutsville village,53,9,19,10,2,4,44
Missouri,Stoutland,171,37,57,19,12,39,164
Missouri,Stotts City,152,18,54,12,2,23,109
Missouri,Stotesbury,14,0,14,0,0,0,14
Missouri,Stockton,1849,361,752,188,31,181,1513
Missouri,Stewartsville,767,125,367,100,1,48,641
Missouri,Sweet Springs,1521,371,605,206,10,108,1300
Missouri,Marionville,2153,434,774,294,33,171,1706
Missouri,Sycamore Hills village,623,185,252,61,2,59,559
Missouri,Tallapoosa,205,32,60,40,3,18,153
Missouri,Trimble,680,145,245,90,36,18,534
Missouri,Trenton,6042,1243,2452,591,105,561,4952
Missouri,Tracy,214,33,94,11,24,9,171
Missouri,Town and Country,10960,1947,6282,320,49,785,9383
Missouri,Tipton,3303,1160,1124,464,73,153,2974
Missouri,Tindall,78,17,28,4,4,7,60
Missouri,Tina village,93,6,57,6,0,9,78
Missouri,Tightwad village,62,4,42,9,0,0,55
Missouri,Three Creeks village,4,0,4,0,0,0,4
Missouri,Thomasville,38,0,16,0,0,22,38
Missouri,Theodosia village,231,52,100,23,10,17,202
Missouri,Thayer,2236,432,792,300,104,145,1773
Missouri,Terre du Lac,2401,246,1313,201,18,143,1921
Missouri,Tarrants village,0,0,0,0,0,0,0
Missouri,Tarkio,1420,287,604,207,14,122,1234
Missouri,Taos,1233,132,583,113,16,62,906
Missouri,Taneyville village,327,52,141,46,13,7,259
Missouri,Syracuse,178,22,75,37,4,12,150
Missouri,Stella,124,39,30,23,0,15,107
Missouri,Ionia,119,21,43,31,3,6,104
Missouri,Irondale,451,68,173,31,8,38,318
Missouri,Lamar,4457,620,2211,356,107,237,3531
Missouri,Lake Winnebago,1287,115,843,36,12,51,1057
Missouri,Lake Waukomis,885,152,481,96,18,37,784
Missouri,Lake Viking,360,24,286,32,0,8,350
Missouri,Lake Tekakwitha village,235,67,99,28,0,13,207
Missouri,Lake Tapawingo,689,122,379,78,9,36,624
Missouri,Lakeside,0,0,0,0,0,0,0
Missouri,Lakeshire,1579,430,508,316,6,72,1332
Missouri,Lake St. Louis,14933,2673,7255,1486,23,410,11847
Missouri,Lake Ozark,1626,300,726,189,20,106,1341
Missouri,Lake Mykee Town village,491,83,229,32,2,29,375
Missouri,Lake Lotawana,2100,424,1073,167,12,93,1769
Missouri,Lake Lafayette,332,72,145,42,3,15,277
Missouri,Lake Annette,136,24,41,38,8,6,117
Missouri,La Grange,950,233,376,70,20,57,756
Missouri,Ladue,8559,1399,4838,223,32,268,6760
Missouri,La Due village,55,11,26,18,0,0,55
Missouri,Lamar Heights,200,47,89,10,13,11,170
Missouri,Laddonia,556,153,187,71,11,46,468
Missouri,Lambert village,0,0,0,0,0,0,0
Missouri,Northwoods,4208,1660,734,804,45,466,3709
Missouri,New Florence,794,153,309,101,38,83,684
Missouri,New Franklin,1242,295,398,210,24,83,1010
Missouri,New Hampton,270,32,118,27,2,20,199
Missouri,New Haven,2194,439,811,182,26,126,1584
Missouri,New London,959,271,354,101,10,49,785
Missouri,New Madrid,3042,632,1027,449,44,229,2381
Missouri,New Melle,448,60,299,24,2,14,399
Missouri,Newtonia,258,57,106,13,0,20,196
Missouri,Newtown,218,42,73,37,6,26,184
Missouri,Niangua,396,63,175,51,3,34,326
Missouri,Nixa,20177,3511,8478,1890,177,882,14938
Missouri,Noel,1877,462,560,178,16,92,1308
Missouri,Norborne,739,166,306,67,10,58,607
Missouri,Normandy,4985,2211,1154,408,68,247,4088
Missouri,North Kansas City,4298,1731,854,933,69,335,3922
Missouri,North Lilbourn village,37,8,13,6,0,10,37
Missouri,Northmoor,380,83,131,79,3,19,315
Missouri,La Monte,1406,264,555,116,14,46,995
Missouri,Irena village,23,7,14,2,0,0,23
Missouri,Laclede,326,75,150,27,7,16,275
Missouri,LaBarque Creek,1857,283,965,129,33,39,1449
Missouri,Junction City village,474,177,81,51,7,37,353
Missouri,Josephville village,399,75,212,20,2,30,339
Missouri,Joplin,51042,13148,18596,6157,886,2976,41763
Missouri,Jonesburg,754,99,328,60,18,97,602
Missouri,Jerico Springs village,180,47,62,29,8,20,166
Missouri,Jennings,14755,5955,2955,1313,747,630,11600
Missouri,Jefferson City,43186,12552,14868,5226,683,2265,35594
Missouri,Jasper,987,138,431,117,25,55,766
Missouri,Jane,460,57,240,26,1,7,331
Missouri,Jamestown,351,61,120,55,6,19,261
Missouri,Jamesport,543,160,153,44,4,63,424
Missouri,Jameson,82,17,36,18,0,5,76
Missouri,Jacksonville village,159,50,59,25,0,3,137
Missouri,Jackson,14439,2529,6367,1156,207,785,11044
Missouri,Irwin,35,0,16,0,0,19,35
Missouri,Ironton,1571,401,519,170,55,86,1231
Missouri,Iron Mountain Lake,826,132,364,90,11,44,641
Missouri,Kahoka,1969,389,700,190,64,208,1551
Missouri,La Belle,647,121,239,76,14,92,542
Missouri,Kansas City,467990,147435,148951,49187,8258,21165,374996
Missouri,Kelso village,588,90,314,27,0,29,460
Missouri,Koshkonong,248,43,85,53,7,15,203
Missouri,Knox City,261,55,89,39,0,11,194
Missouri,Knob Noster,2779,897,924,354,96,70,2341
Missouri,Kissee Mills,998,117,414,278,3,64,876
Missouri,Kirkwood,27612,5328,12406,2617,244,1672,22267
Missouri,Kirksville,17574,8460,4336,1467,196,835,15294
Missouri,Kirbyville village,244,48,107,37,0,8,200
Missouri,Kinloch,267,142,36,31,18,7,234
Missouri,Kingsville,233,44,99,20,8,12,183
Missouri,Kingston,332,99,126,48,3,22,298
Missouri,Kingdom City village,135,50,59,9,4,4,126
Missouri,King City,1006,181,449,90,2,72,794
Missouri,Kimmswick,143,23,71,6,0,7,107
Missouri,Kimberling City,2687,289,1495,240,25,263,2312
Missouri,Kidder,215,39,108,26,2,13,188
Missouri,Keytesville,515,99,177,103,5,48,432
Missouri,Kennett,10678,2246,3778,1429,414,603,8470
Missouri,Kearney,9039,1572,3834,803,111,278,6598
Missouri,Steelville,2225,494,708,205,53,217,1677
Missouri,Steele,2237,561,673,225,127,158,1744
Missouri,Stark City,138,37,65,16,0,10,128
Missouri,Paris,1215,209,431,167,22,155,984
Missouri,Parkdale village,197,32,110,14,0,6,162
Missouri,Park Hills,8695,1592,3846,687,247,336,6708
Missouri,Parkville,5946,1485,2827,430,70,152,4964
Missouri,Parkway village,355,36,150,46,11,32,275
Missouri,Parma,649,128,227,37,35,49,476
Missouri,Parnell,137,38,34,14,1,9,96
Missouri,Pasadena Hills,935,251,433,80,18,57,839
Missouri,Pasadena Park village,555,177,195,54,5,32,463
Missouri,McCord Bend village,280,42,100,58,16,20,236
Missouri,McBaine,6,6,0,0,0,0,6
Missouri,Luray village,61,3,32,8,0,5,48
Missouri,Lupus,30,4,12,14,0,0,30
Missouri,Ludlow,119,33,46,15,4,6,104
Missouri,Lucerne village,93,10,37,12,0,15,74
Missouri,Lowry City,522,129,175,72,9,65,450
Missouri,Louisiana,3322,830,1251,271,30,189,2571
Missouri,Palmyra,3622,901,1238,359,67,325,2890
Missouri,Louisburg village,146,17,63,7,0,20,107
Missouri,Pagedale,3309,1233,758,330,148,166,2635
Missouri,Ozora,159,29,106,11,0,1,147
Missouri,Old Monroe,243,52,89,38,13,14,206
Missouri,Olean,99,29,12,14,12,13,80
Missouri,Olivette,7843,1483,3647,631,77,387,6225
Missouri,Olympian Village,651,143,243,61,3,41,491
Missouri,Oran,1313,239,578,178,22,56,1073
Missouri,Oregon,933,103,514,64,9,83,773
Missouri,Oronogo,2568,413,1110,267,16,53,1859
Missouri,Orrick,785,177,313,96,9,34,629
Missouri,Osage Beach,4477,693,2066,528,53,366,3706
Missouri,Osborn,514,118,219,77,1,32,447
Missouri,Osceola,904,202,304,145,42,116,809
Missouri,Osgood village,19,0,8,0,0,2,10
Missouri,Otterville,498,104,204,38,6,37,389
Missouri,Overland,16011,4715,5255,1871,375,867,13083
Missouri,Owensville,2648,625,872,284,50,264,2095
Missouri,Oxly,113,29,71,4,0,3,107
Missouri,Ozark,18608,3401,7743,1801,288,1090,14323
Missouri,Pacific,6305,1922,1925,678,175,439,5139
Missouri,Old Jamestown,19239,4766,8864,1437,187,1000,16254
Missouri,Longtown,128,37,54,7,2,6,106
Missouri,Loma Linda,804,123,510,53,7,26,719
Missouri,Leisure Lake,205,23,101,21,0,14,159
Missouri,Leeton,678,80,304,62,15,41,502
Missouri,Lee's Summit,93618,17657,42827,7362,816,3624,72286
Missouri,Lebanon,14637,2728,5376,1908,460,1183,11655
Missouri,Leawood village,652,73,333,49,9,24,488
Missouri,Leasburg village,466,87,151,62,12,17,329
Missouri,Leadwood,1543,387,506,142,61,65,1161
Missouri,Leadington,360,96,150,30,15,15,306
Missouri,Lawson,2319,316,915,310,32,202,1775
Missouri,Laurie,960,153,349,162,28,168,860
Missouri,La Tour,62,15,0,25,0,22,62
Missouri,Lathrop,2215,469,858,228,33,106,1694
Missouri,La Russell,235,68,58,8,0,14,148
Missouri,Laredo,209,35,99,16,8,8,166
Missouri,La Plata,1323,236,510,177,17,157,1097
Missouri,Lancaster,726,109,310,62,14,60,555
Missouri,Lanagan,428,87,134,56,38,17,332
Missouri,Lemay,16603,4456,5247,2173,305,1384,13565
Missouri,Lone Jack,1076,120,509,87,17,36,769
Missouri,Leonard village,59,5,26,3,0,8,42
Missouri,Levasy,75,14,40,3,0,0,57
Missouri,Lohman,192,17,115,7,0,10,149
Missouri,Lockwood,1054,161,383,131,21,153,849
Missouri,Lock Springs village,64,4,30,2,0,2,38
Missouri,Loch Lloyd village,656,85,438,33,4,29,589
Missouri,Livonia village,82,24,25,1,7,14,71
Missouri,Lithium village,38,4,24,0,0,6,34
Missouri,Linneus,350,82,145,35,6,19,287
Missouri,Linn Creek,218,76,81,11,5,15,188
Missouri,Linn,1567,490,471,173,11,76,1221
Missouri,Lincoln,1141,199,394,178,35,124,930
Missouri,Lilbourn,1202,266,330,124,92,80,892
Missouri,Licking,3066,1125,653,664,117,169,2728
Missouri,Liberty,30035,6928,12165,3374,475,1129,24071
Missouri,Liberal,739,163,299,68,18,48,596
Missouri,Lexington,4633,928,1892,467,155,436,3878
Missouri,Lewistown,533,65,229,68,4,57,423
Missouri,Lewis and Clark Village,122,20,63,5,0,5,93
Missouri,Leslie village,138,29,44,21,1,2,97
Missouri,Old Appleton,19,3,15,1,0,0,19
Missouri,O'Fallon,83053,16075,36857,6667,662,2879,63140
Missouri,Odessa,5222,862,2197,525,0,286,3870
Missouri,Shoal Creek Drive village,303,46,118,37,11,29,241
Missouri,Sheridan,234,17,110,31,1,17,176
Missouri,Glasgow Village,5178,2225,713,427,86,180,3631
Missouri,Glasgow,1135,253,401,160,21,80,915
Missouri,Gladstone,26309,6124,10400,2919,526,1796,21765
Missouri,Ginger Blue village,35,17,11,5,0,2,35
Missouri,Gilman City,394,49,193,42,10,28,322
Missouri,Gilliam,188,37,86,28,5,7,163
Missouri,Gideon,1150,253,366,155,35,112,921
Missouri,Gibbs village,126,42,38,14,0,1,95
Missouri,Gerster,22,1,13,2,0,4,20
Missouri,Gerald,1374,179,517,147,44,73,960
Missouri,Gentry village,54,19,22,5,0,2,48
Missouri,Gasconade,222,50,83,39,0,12,184
Missouri,Garden City,1534,273,633,208,44,65,1223
Missouri,Galt,206,44,69,40,4,20,177
Missouri,Gallatin,1784,307,695,204,22,189,1417
Missouri,Shoal Creek Estates village,126,7,72,6,5,7,97
Missouri,Galena,556,83,187,66,4,31,371
Missouri,Shrewsbury,6208,1943,2230,559,35,604,5371
Missouri,Sikeston,16436,3710,6094,1867,318,1050,13039
Missouri,Stanberry,1359,194,593,74,17,110,988
Missouri,Springfield,163763,53727,51823,20521,3006,9891,138968
Missouri,Spokane,181,0,147,0,0,0,147
Missouri,Spickard,334,53,107,43,12,15,230
Missouri,Sparta,1943,315,775,225,33,87,1435
Missouri,Spanish Lake,19218,6020,4706,2057,515,738,14036
Missouri,Southwest City,1020,257,324,61,18,48,708
Missouri,South Lineville,25,4,9,0,0,9,22
Missouri,South Greenfield village,149,18,86,10,0,15,129
Missouri,South Gorin,108,30,57,7,4,2,100
Missouri,South Gifford village,49,8,15,13,0,5,41
Missouri,South Fork,190,28,116,27,7,0,178
Missouri,Smithville,8911,1344,3976,856,67,449,6692
Missouri,Smithton,483,86,209,57,1,24,377
Missouri,Slater,2065,374,825,241,43,113,1596
Missouri,Skidmore,269,35,110,27,12,14,198
Missouri,Silex village,71,39,12,17,0,1,69
Missouri,Sibley village,302,76,127,22,13,13,251
Missouri,Gainesville,799,110,247,152,22,79,610
Missouri,Fulton,12812,4669,3462,1802,272,724,10929
Missouri,Frontenac,3523,740,2066,103,0,80,2989
Missouri,Macks Creek,516,75,210,63,16,25,389
Missouri,McKittrick,68,17,24,9,1,8,59
Missouri,Mackenzie village,123,69,37,8,0,1,115
Missouri,McFall,106,21,37,16,0,2,76
Missouri,Norwood,675,146,191,64,30,38,469
Missouri,Norwood Court,868,398,133,119,45,34,729
Missouri,Novelty village,164,31,86,18,1,8,144
Missouri,Novinger,456,80,224,49,0,28,381
Missouri,Oak Grove,7839,1464,2906,875,122,363,5730
Missouri,Oak Grove Village village,406,51,176,62,20,28,337
Missouri,Oakland,1506,306,658,107,4,209,1284
Missouri,Oak Ridge,235,54,77,44,4,12,191
Missouri,Oaks village,128,11,63,11,0,6,91
Missouri,Oakview village,512,112,174,64,22,12,384
Missouri,Oakville,36663,8011,18525,2277,317,1938,31068
Missouri,Oakwood village,153,16,96,4,1,6,123
Missouri,Oakwood Park village,185,49,68,29,3,10,159
Missouri,Macon,5468,932,2096,636,44,516,4224
Missouri,Madison,635,112,247,47,10,50,466
Missouri,Maitland,294,50,118,38,9,11,226
Missouri,Malden,4407,941,1265,613,110,414,3343
Missouri,Frohna,243,40,120,10,3,14,187
Missouri,Fremont Hills,894,75,622,43,9,29,778
Missouri,Fremont,64,19,10,0,18,10,57
Missouri,Freistatt village,131,25,58,14,1,19,117
Missouri,Freeman,511,84,219,42,13,34,392
Missouri,Freeburg village,447,119,208,19,0,20,366
Missouri,Fredericktown,4054,728,1744,342,92,378,3284
Missouri,Franklin,70,20,31,8,5,4,68
Missouri,New Cambria,164,22,89,33,0,5,149
Missouri,Frankford,441,105,181,49,5,28,368
Missouri,Fountain N' Lakes village,332,114,59,52,4,10,239
Missouri,Foster village,188,19,139,6,2,1,167
Missouri,Marceline,2154,447,797,237,18,161,1660
Missouri,Marble Hill,1613,348,530,159,54,119,1210
Missouri,Maplewood,7960,3346,2280,920,116,284,6946
Missouri,Mansfield,1191,200,373,229,36,91,929
Missouri,Manchester,18187,4614,8104,1821,74,570,15183
Missouri,Malta Bend,330,97,100,46,5,11,259
Missouri,Frankclay,120,0,80,10,16,14,120
Missouri,Newburg,657,139,203,57,6,115,520
Missouri,Bethel village,103,22,48,11,1,11,93
Missouri,Brumley,65,21,22,7,0,9,59
Missouri,Brooklyn Heights,123,23,54,19,8,3,107
Missouri,Browning,241,68,83,25,5,13,194
Missouri,Brownington,88,11,34,13,0,10,68
Missouri,Brimson village,63,6,23,13,5,6,53
Missouri,Brunswick,858,130,293,96,11,116,646
Missouri,Bucklin,511,58,261,48,12,59,438
Missouri,Buckner,3077,561,1178,343,69,183,2334
Missouri,Buffalo,3066,578,767,581,132,257,2315
Missouri,Bull Creek village,522,65,144,84,16,4,313
Missouri,Bunceton,339,89,104,68,6,28,295
Missouri,Bunker,412,114,136,39,11,39,339
Missouri,Bridgeton,11699,3207,4515,1066,202,701,9691
Missouri,Brookfield,4391,893,1557,460,103,469,3482
Missouri,Bronaugh,219,25,90,19,9,2,145
Montana,Old Agency,117,27,24,21,4,0,76
Montana,Noxon,257,54,117,32,0,0,203
Montana,North Browning,2444,789,538,197,6,73,1603
Montana,Niarada,11,0,8,0,0,3,11
Montana,Neihart,36,9,21,2,0,4,36
Montana,Nashua,305,57,137,38,7,22,261
Montana,Musselshell,65,12,41,2,4,6,65
Montana,Alder,87,7,45,13,0,6,71
Montana,Moore,177,26,83,35,0,5,149
Montana,Montana City,2793,418,1489,212,6,107,2232
Montana,Missoula,69190,25595,22663,6998,809,2674,58739
Montana,Muddy,616,178,142,34,3,22,379
Montana,Olney,201,33,100,18,12,10,173
Montana,Opheim,76,34,26,6,0,2,68
Montana,Orchard Homes,5576,1167,2512,716,27,147,4569
Montana,Outlook,79,2,44,5,0,2,53
Montana,Ovando,81,5,60,12,0,0,77
Montana,Pablo,2725,786,661,303,36,97,1883
Montana,Paradise,204,36,91,25,1,20,173
Montana,Park City,1014,196,427,132,0,12,767
Montana,Parker School,606,201,170,21,13,14,419
Montana,Philipsburg,666,91,345,118,5,48,607
Montana,Piltzville,408,168,134,76,0,5,383
Montana,Sun River,101,17,36,34,0,9,96
Montana,Miles City,8627,1922,3498,914,29,616,6979
Montana,Midvale,330,80,72,0,0,15,167
Montana,Manhattan,1191,174,622,119,3,54,972
Montana,Medicine Lake,314,64,119,32,0,25,240
Montana,Lewistown,5883,1081,2469,760,82,473,4865
Montana,Lewistown Heights,736,174,273,55,0,11,513
Montana,Libby,2671,646,739,438,64,286,2173
Montana,Lima,185,20,98,25,6,13,162
Montana,Lincoln,829,181,375,153,0,32,741
Montana,Lindisfarne,283,39,241,0,0,3,283
Montana,Little Bitterroot Lake,207,55,102,43,0,7,207
Montana,Little Browning,277,90,89,8,0,0,187
Montana,Livingston,7136,1427,2952,1022,101,410,5912
Montana,Lockwood,7437,1660,2858,866,135,318,5837
Montana,Lodge Grass,325,90,84,22,5,23,224
Montana,Melstone,82,21,28,13,0,20,82
Montana,Lodge Pole,274,87,92,20,0,11,210
Montana,Lolo,4125,866,1933,300,17,105,3221
Montana,Loma,36,0,25,0,7,4,36
Montana,Lonepine,164,20,87,15,0,2,124
Montana,Malmstrom AFB,3651,712,1771,52,4,0,2539
Montana,Malta,1867,356,812,173,22,212,1575
Montana,Superior,804,157,228,145,3,66,599
Montana,Marion,852,100,506,68,0,49,723
Montana,Martin City,380,74,123,116,0,67,380
Montana,Martinsdale,81,26,31,13,0,3,73
Montana,Marysville,95,31,55,6,0,3,95
Montana,Maxville,109,0,69,40,0,0,109
Montana,Logan,41,0,33,8,0,0,41
Montana,Swan Lake,114,8,91,3,1,5,108
Montana,Townsend,1970,326,845,158,12,143,1484
Montana,Sylvanite,116,12,70,0,2,10,94
Montana,Whitehall,926,190,316,214,33,65,818
Montana,White Haven,602,79,229,40,0,60,408
Montana,White Sulphur Springs,979,174,364,160,14,80,792
Montana,Whitewater,43,4,23,0,0,5,32
Montana,Wibaux,522,139,174,82,3,63,461
Montana,Willow Creek,180,41,59,39,0,14,153
Montana,Wilsall,198,4,121,0,0,12,137
Montana,Wineglass,386,126,154,9,15,0,304
Montana,Winifred,179,36,99,7,0,10,152
Montana,Winnett,177,29,69,42,3,19,162
Montana,Winston,0,0,0,0,0,0,0
Montana,Wisdom,87,24,32,14,0,10,80
Montana,Wolf Point,2755,745,783,267,5,186,1986
Montana,Woods Bay,626,102,386,36,0,8,532
Montana,Worden,749,95,255,120,0,84,554
Montana,Wye,482,59,277,15,18,0,369
Montana,Wyola,142,43,54,13,3,8,121
Montana,Yaak,260,22,140,66,4,3,235
Montana,Zortman,23,0,17,0,0,6,23
Montana,Crow Agency,1890,603,466,128,48,67,1312
Montana,Culbertson,826,138,315,50,0,80,583
Montana,Custer,146,33,57,21,0,14,125
Montana,Cut Bank,2985,618,978,308,15,173,2092
Montana,Whitefish,6692,1323,3364,597,23,333,5640
Montana,Wheatland,447,36,322,0,0,26,384
Montana,West Yellowstone,1279,384,452,220,27,29,1112
Montana,West Kootenai,89,0,62,27,0,0,89
Montana,Terry,838,91,393,52,5,98,639
Montana,The Silos,640,116,317,99,10,0,542
Montana,Thompson Falls,941,124,475,145,18,60,822
Montana,Three Forks,1888,322,846,222,29,111,1530
Montana,Toston,237,8,143,0,0,7,158
Montana,Lavina,194,17,97,18,14,6,152
Montana,Trego,644,82,261,92,10,34,479
Montana,Trout Creek,189,27,87,51,2,3,170
Montana,Troy,710,147,320,115,10,64,656
Montana,Turah,431,64,226,17,7,17,331
Montana,Turner,85,18,42,4,0,6,70
Montana,Sweet Grass,85,6,42,19,0,8,75
Montana,Turtle Lake,304,0,165,20,0,0,185
Montana,Ulm,559,62,379,18,0,20,479
Montana,Valier,577,96,230,52,7,56,441
Montana,Vaughn,863,149,405,93,0,23,670
Montana,Victor,829,144,195,116,62,54,571
Montana,Virginia City,239,51,97,29,2,40,219
Montana,Walkerville,878,186,290,111,4,45,636
Montana,Weeksville,79,16,42,12,0,9,79
Montana,Westby,170,29,82,11,8,13,143
Montana,West Glacier,311,84,137,37,0,13,271
Montana,West Glendive,2067,228,1273,88,16,72,1677
Montana,West Havre,167,13,55,30,0,0,98
Montana,Twin Bridges,260,38,124,26,8,18,214
Montana,Laurel,6933,1103,3039,734,89,446,5411
Montana,Lame Deer,2106,684,521,165,57,96,1523
Montana,Lakeside,2918,410,1312,466,109,139,2436
Montana,Boneau,364,139,78,13,0,0,230
Montana,Bonner-West Riverside,1600,421,565,196,14,80,1276
Montana,Evergreen,6955,1503,2761,727,57,386,5434
Montana,Evaro,339,83,139,41,6,8,277
Montana,Eureka,1254,161,502,204,4,120,991
Montana,Ennis,864,216,364,150,3,65,798
Montana,Emigrant,358,99,120,87,0,28,334
Montana,Elmo,195,30,86,18,0,5,139
Montana,Elliston,286,42,155,44,9,5,255
Montana,Elkhorn,18,0,18,0,0,0,18
Montana,Ekalaka,297,41,123,34,9,59,266
Montana,Edgar,134,19,48,27,0,30,124
Montana,East Missoula,2359,1015,622,354,25,71,2087
Montana,East Helena,2306,470,926,273,18,72,1759
Montana,East Glacier Park Village,486,113,143,78,14,40,388
Montana,Dutton,326,60,161,22,2,27,272
Montana,Dupuyer,87,20,48,11,0,8,87
Montana,Drummond,377,39,196,33,0,23,291
Montana,Kremlin,76,0,62,0,3,9,74
Montana,Lake Mary Ronan,86,23,40,9,0,5,77
Montana,Sun Prairie,1258,172,564,146,46,67,995
Montana,Sunburst,254,47,147,14,0,8,216
Montana,Sula,70,8,7,51,0,4,70
Montana,Stryker,35,3,24,8,0,0,35
Montana,Stockett,204,44,54,29,0,8,135
Montana,Stevensville,2048,521,653,239,0,173,1586
Montana,Starr School,90,73,0,11,0,6,90
Montana,Black Eagle,1151,415,326,155,0,102,998
Montana,Birney,92,27,15,0,9,0,51
Montana,Billings,108134,26510,40756,12770,1354,5702,87092
Montana,Big Timber,1517,275,598,134,27,158,1192
Montana,Alberton,479,68,97,100,37,49,351
Montana,Absarokee,1068,93,614,141,16,58,922
Montana,Amsterdam,155,26,76,10,0,0,112
Montana,Anaconda-Deer Lodge,9211,2121,4003,1233,92,572,8021
Montana,Antelope,57,0,23,0,0,11,34
Montana,Arlee,651,126,252,71,4,41,494
Montana,Ashland,981,242,231,70,9,63,615
Montana,Augusta,267,43,157,13,0,30,243
Montana,Avon,128,28,54,0,0,4,86
Montana,Azure,180,38,52,12,0,18,120
Montana,Babb,149,16,97,10,0,4,127
Montana,Bainville,276,54,99,20,0,19,192
Montana,Baker,1838,276,806,217,13,129,1441
Montana,Stanford,375,65,190,49,4,26,334
Montana,Ballantine,195,9,123,10,10,43,195
Montana,Batavia,367,103,84,52,5,38,282
Montana,Bearcreek,138,15,84,1,4,5,109
Montana,Bear Dance,261,12,208,24,12,5,261
Montana,Beaver Creek,378,111,146,47,0,4,308
Montana,Belfry,197,56,53,28,16,17,170
Montana,Belgrade,7738,1918,2960,734,64,152,5828
Montana,Belknap,189,0,124,0,0,65,189
Montana,Belt,683,120,290,80,6,57,553
Montana,Biddle,20,0,9,6,0,5,20
Montana,Big Arm,230,31,155,3,0,0,189
Montana,Bigfork,4621,755,2352,289,34,272,3702
Montana,Big Sandy,677,171,256,68,19,43,557
Montana,Big Sky,2767,955,1112,137,19,32,2255
Montana,Basin,227,52,98,25,8,7,190
Montana,Darby,673,166,221,105,13,35,540
Montana,Springhill,58,8,34,0,0,6,48
Montana,Spokane Creek,306,76,163,0,0,39,278
Montana,Ronan,1858,455,587,263,32,93,1430
Montana,Rollins,284,63,91,32,0,44,230
Montana,Rocky Point,91,0,34,25,0,32,91
Montana,Rocky Boy West,975,402,180,54,15,37,688
Montana,Rocky Boy's Agency,474,136,134,18,6,3,297
Montana,Roberts,301,39,162,36,4,7,248
Montana,Riverbend,420,151,175,21,0,73,420
Montana,Richey,165,38,80,8,3,11,140
Montana,Rexford,89,0,66,5,2,7,80
Montana,Reserve,32,4,19,0,0,0,23
Montana,Reed Point,232,54,94,45,0,30,223
Montana,Red Lodge,2236,533,816,362,21,174,1906
Montana,Ravalli,61,8,22,31,0,0,61
Montana,Radersburg,208,0,157,0,9,9,175
Montana,Rader Creek,195,0,118,44,0,23,185
Montana,Pryor,630,203,178,17,17,35,450
Montana,Pray,599,94,303,50,0,66,513
Montana,Power,172,25,93,17,3,10,148
Montana,Poplar,830,308,172,72,2,45,599
Montana,Pony,154,23,96,22,0,9,150
Montana,Ponderosa Pines,464,24,253,66,14,0,357
Montana,Polson,4643,1184,1442,603,63,333,3625
Montana,Plevna,142,8,64,3,5,13,93
Montana,Plentywood,1891,406,837,163,20,172,1598
Montana,Plains,758,138,288,111,8,102,647
Montana,Pioneer Junction,794,38,447,145,0,17,647
Montana,Pinesdale,985,272,269,34,12,21,608
Montana,Roscoe,53,22,31,0,0,0,53
Montana,Rosebud,119,8,59,11,0,7,85
Montana,Roundup,1900,381,756,216,22,178,1553
Montana,Roy,140,39,64,9,0,8,120
Montana,South Hills,504,75,257,12,0,9,353
Montana,South Glastonbury,284,151,115,0,0,0,266
Montana,South Browning,1852,592,407,187,0,54,1240
Montana,Somers,1000,149,530,91,0,14,784
Montana,Simms,427,59,216,50,10,4,339
Montana,Silver Gate,20,6,14,0,0,0,20
Montana,Silesia,111,17,19,24,0,26,86
Montana,Sidney,6216,1331,2566,597,70,291,4855
Montana,Sheridan,706,165,299,71,2,62,599
Montana,Shepherd,564,71,242,145,13,0,471
Montana,Shelby,3272,879,1261,389,21,189,2739
Montana,Shawmut,47,8,29,0,2,4,43
Montana,Seeley Lake,1081,176,532,170,8,34,920
Montana,Springdale,43,4,21,0,0,2,27
Montana,Sedan,121,3,67,15,0,16,101
Montana,Savage,339,86,114,51,0,17,268
Montana,Santa Rita,89,16,22,0,0,0,38
Montana,Sangrey,444,187,72,26,7,12,304
Montana,Sand Coulee,245,61,124,13,12,8,218
Montana,St. Xavier,4,0,0,4,0,0,4
Montana,St. Regis,261,44,100,35,0,0,179
Montana,St. Pierre,498,192,102,21,11,16,342
Montana,St. Marie,619,35,350,54,4,44,487
Montana,St. Ignatius,850,220,237,124,24,53,658
Montana,Saddle Butte,175,0,38,44,4,0,86
Montana,Saco,202,50,74,20,2,17,163
Montana,Ryegate,196,13,106,38,0,22,179
Montana,Rudyard,201,24,107,20,0,8,159
Montana,Scobey,1129,187,476,100,4,172,939
Montana,Dayton,89,10,61,13,0,2,86
Montana,Alzada,21,1,0,16,0,4,21
Montana,Deer Lodge,3056,493,1203,466,38,287,2487
Montana,Gardiner,1099,336,451,74,16,46,923
Montana,Garrison,57,11,30,12,0,3,56
Montana,Geraldine,259,31,99,34,0,24,188
Montana,Boulder,1287,332,540,172,0,58,1102
Montana,Box Elder,83,43,18,8,0,1,70
Montana,Boyd,20,9,11,0,0,0,20
Montana,Bozeman,40319,18620,12157,2726,268,1168,34939
Montana,Gallatin River Ranch,74,4,70,0,0,0,74
Montana,Brady,174,56,31,30,0,38,155
Montana,Bridger,11,0,11,0,0,0,11
Montana,Broadus,477,107,160,60,14,41,382
Montana,Broadview,163,27,67,24,0,13,131
Montana,Brockton,173,64,38,13,0,8,123
Montana,Browning,1108,334,289,133,10,111,877
Montana,Busby,690,189,121,41,20,20,391
Montana,Butte-Silver Bow (balance),33671,8816,12576,3645,549,2472,28058
Montana,Bridger,894,146,449,91,0,47,733
Montana,Gallatin Gateway,933,217,406,127,26,23,799
Montana,Fromberg,388,63,177,44,6,32,322
Montana,Froid,148,47,65,13,0,12,137
Montana,Herron,35,20,7,4,0,4,35
Montana,Heron,222,49,143,14,0,16,222
Montana,Helena West Side,1365,327,645,204,22,59,1257
Montana,Helena Valley West Central,8564,1514,4167,651,91,227,6650
Montana,Helena Valley Southeast,7383,1785,2857,976,92,182,5892
Montana,Cooke City,35,1,21,13,0,0,35
Montana,Conrad,2604,515,940,236,47,288,2026
Montana,Conner,90,14,38,12,0,16,80
Montana,Condon,431,75,179,103,10,10,377
Montana,Columbus,2181,314,983,241,44,174,1756
Montana,Fortine,465,74,240,49,0,17,380
Montana,Fort Peck,197,15,142,0,0,15,172
Montana,Fort Shaw,161,33,91,5,15,0,144
Montana,Fort Smith,37,21,0,9,0,0,30
Montana,Fox Lake,100,22,60,2,0,2,86
Montana,Frazer,244,93,45,27,1,14,180
Montana,Frenchtown,1657,360,870,92,14,17,1353
Montana,Bynum,39,9,28,2,0,0,39
Montana,Camas,37,14,13,3,0,0,30
Montana,Camp Three,101,7,59,9,0,7,82
Montana,Cardwell,40,10,9,8,0,4,31
Montana,Hamilton,4501,1043,1548,802,123,396,3912
Montana,Choteau,1685,258,789,219,0,137,1403
Montana,Churchill,997,106,536,31,0,77,750
Montana,Circle,607,126,285,29,0,81,521
Montana,Clancy,1563,193,862,218,7,29,1309
Montana,Clinton,1127,250,360,248,5,47,910
Montana,Clyde Park,230,45,104,41,0,16,206
Montana,Colstrip,2289,309,1132,172,16,54,1683
Montana,Columbia Falls,4856,935,2051,744,36,190,3956
Montana,Geyser,96,19,43,17,0,3,82
Montana,Gibson Flats,162,23,104,0,0,0,127
Montana,Gildford,76,7,39,7,0,14,67
Montana,Glasgow,3376,632,1458,319,5,267,2681
Montana,Glendive,5284,1307,2125,421,102,324,4279
Montana,Grass Range,115,19,50,27,3,7,106
Montana,Great Falls,59563,13869,23355,6704,753,3660,48341
Montana,Greycliff,68,7,36,0,4,12,59
Montana,Happys Inn,70,13,32,0,0,25,70
Montana,Highwood,224,76,85,29,1,8,199
Montana,Hardin,3754,759,1202,265,46,341,2613
Montana,Harlowton,899,194,397,118,9,71,789
Montana,Carlton,647,102,323,53,0,60,538
Montana,Carter,77,8,38,11,0,7,64
Montana,Cascade,648,97,294,79,4,49,523
Montana,Charlo,386,71,134,52,10,18,285
Montana,Charlos Heights,148,0,88,31,0,0,119
Montana,Chester,884,130,400,78,8,126,742
Montana,Chinook,1058,216,492,95,20,106,929
Montana,Helena Valley Northwest,3990,593,1953,261,11,100,2918
Montana,Helena Valley Northeast,3238,404,1318,451,0,324,2497
Montana,Helena Flats,916,121,474,50,5,58,708
Montana,Helena,29600,8074,10945,4054,196,1692,24961
Montana,Hebgen Lake Estates,148,24,97,0,0,5,126
Montana,Heart Butte,567,177,130,32,10,13,362
Montana,Hays,1088,310,265,76,12,57,720
Montana,Havre North,714,225,207,51,0,60,543
Montana,Havre,9790,2181,3892,943,93,602,7711
Montana,Harrison,237,68,76,57,0,17,218
Montana,Harlem,865,278,248,42,4,69,641
Montana,Hingham,108,22,50,9,0,13,94
Montana,Four Corners,3406,528,1632,209,29,118,2516
Montana,Hobson,264,38,124,33,0,13,208
Montana,Fort Belknap Agency,1300,407,254,80,27,83,851
Montana,Jette,211,0,168,27,0,16,211
Montana,Joliet,532,109,244,65,5,48,471
Montana,Fairfield,749,118,301,53,19,63,554
Montana,Fairview,792,204,286,89,24,68,671
Montana,Fallon,149,51,72,0,0,12,135
Montana,Finley Point,688,25,557,44,0,62,688
Montana,Flaxville,95,17,37,10,4,1,69
Montana,Florence,644,118,377,51,0,36,582
Montana,Forest Hill Village,210,93,53,17,0,5,168
Montana,Forsyth,1874,358,830,142,29,160,1519
Montana,Crane,197,6,105,19,0,0,130
Montana,Hinsdale,167,38,91,7,1,15,152
Montana,Jordan,332,49,192,37,0,19,297
Montana,Judith Gap,86,2,54,14,0,5,75
Montana,De Borgia,0,0,0,0,0,0,0
Montana,Kalispell,21142,4659,7872,2706,328,1185,16750
Montana,Kerr,164,19,137,0,0,0,156
Montana,Klein,248,10,173,19,0,0,202
Montana,Kings Point,122,0,57,39,0,26,122
Montana,King Arthur Park,1009,237,493,31,0,56,817
Montana,Kila,387,45,230,28,7,19,329
Montana,Kicking Horse,167,44,73,15,0,21,153
Montana,Kevin,110,25,48,18,1,6,98
Montana,Joplin,220,0,123,22,0,35,180
Montana,Dillon,4193,1627,1281,425,7,237,3577
Montana,Fort Benton,1349,220,680,75,13,180,1168
Montana,Corwin Springs,106,23,48,16,0,4,91
Montana,Craig,31,9,8,2,0,6,25
Montana,Denton,246,66,99,26,1,18,210
Montana,Jefferson City,715,120,291,42,0,30,483
Montana,Ismay,18,2,8,0,0,2,12
Montana,Inverness,104,7,58,0,0,8,73
Montana,Indian Springs,124,39,69,0,0,16,124
Montana,Hysham,363,84,171,17,7,24,303
Montana,Huson,11,11,0,0,0,0,11
Montana,Jardine,22,3,14,0,5,0,22
Montana,Hungry Horse,757,177,210,181,0,37,605
Montana,Hot Springs,544,123,183,111,3,62,482
Montana,Corvallis,1047,261,268,277,0,68,874
Montana,Dodson,166,44,45,25,0,4,118
Montana,Dixon,224,47,75,18,2,14,156
Montana,Coram,585,147,220,118,27,16,528
Montana,Huntley,504,69,295,14,0,11,389
Moore County metropolitan government; Tennessee,Lynchburg,6351,1171,3056,560,72,467,5326
Nebraska,Stella village,190,24,105,13,1,16,159
Nebraska,Steinauer village,75,10,34,3,1,8,56
Nebraska,Steele City village,74,19,23,14,0,6,62
Nebraska,Stapleton village,298,47,157,10,5,27,246
Nebraska,Stamford village,195,22,87,17,5,19,150
Nebraska,Stanton,1650,305,658,129,23,146,1261
Nebraska,Inavale,66,7,45,3,0,11,66
Nebraska,Imperial,1917,273,1000,129,9,181,1592
Nebraska,Hyannis village,200,12,142,21,0,13,188
Nebraska,Sterling village,470,103,175,54,2,44,378
Nebraska,Aten,49,15,31,3,0,0,49
Nebraska,Staplehurst village,254,53,104,19,8,8,192
Nebraska,Indianola,591,91,274,68,2,45,480
Nebraska,Tekamah,1830,273,898,100,29,157,1457
Nebraska,Inland,89,14,47,0,0,6,67
Nebraska,Tarnov village,67,15,22,8,0,1,46
Nebraska,Tamora,78,9,58,0,0,0,67
Nebraska,Talmage village,218,39,88,26,12,10,175
Nebraska,Table Rock village,282,49,127,32,2,28,238
Nebraska,Syracuse,1933,268,894,187,3,205,1557
Nebraska,Swanton village,93,12,40,13,0,7,72
Nebraska,Sutton,1706,248,770,99,20,127,1264
Nebraska,Sutherland village,1446,243,655,159,19,81,1157
Nebraska,Ashton village,179,29,94,16,0,9,148
Nebraska,Surprise village,50,13,21,2,0,2,38
Nebraska,Inglewood village,372,41,194,44,0,9,288
Nebraska,Superior,1957,307,907,224,22,199,1659
Nebraska,Sumner village,246,41,105,26,1,16,189
Nebraska,Stuart village,605,99,305,33,4,40,481
Nebraska,Stromsburg,1129,185,517,72,21,98,893
Nebraska,Stratton village,404,67,192,31,1,32,323
Nebraska,Strang village,20,1,10,1,1,3,16
Nebraska,Stockville village,10,0,9,1,0,0,10
Nebraska,Stockham village,46,13,22,7,0,4,46
Nebraska,Taylor village,158,20,72,16,15,7,130
Nebraska,Tecumseh,1518,247,597,183,13,159,1199
Nebraska,Inman village,119,12,69,3,4,3,91
Nebraska,Sunol,88,2,63,3,0,4,72
Nebraska,Ashland,2419,465,986,262,25,191,1929
Nebraska,Long Pine,270,32,115,40,1,18,206
Nebraska,Arnold village,520,90,243,65,18,47,463
Nebraska,Battle Creek,1131,188,590,74,3,64,919
Nebraska,Bayard,1064,231,360,116,5,114,826
Nebraska,Bazile Mills village,20,2,13,0,0,0,15
Nebraska,Beatrice,12355,2690,5350,1186,86,943,10255
Nebraska,Beaver City,644,99,273,105,6,60,543
Nebraska,Beaver Crossing village,393,75,212,26,3,11,327
Nebraska,Bee village,215,42,69,56,2,10,179
Nebraska,Beemer village,629,104,292,48,4,80,528
Nebraska,Belden village,87,10,55,6,0,3,74
Nebraska,Huntley village,43,14,10,2,0,6,32
Nebraska,Big Springs village,575,98,251,37,4,40,430
Nebraska,Berwyn village,89,9,58,9,0,2,78
Nebraska,Bertrand village,749,116,341,43,12,91,603
Nebraska,Berea,22,0,22,0,0,0,22
Nebraska,Bennington,1608,368,651,143,20,99,1281
Nebraska,Bennet village,875,123,405,92,8,25,653
Nebraska,Benkelman,936,171,388,115,8,108,790
Nebraska,Benedict village,239,46,98,28,2,13,187
Nebraska,Belvidere village,31,1,22,2,0,3,28
Nebraska,Belmar,146,45,56,24,0,21,146
Nebraska,Bellwood village,345,60,171,18,2,15,266
Nebraska,Bellevue,54067,12507,22542,4768,519,2051,42387
Nebraska,Belgrade village,137,19,65,15,2,15,116
Nebraska,Bladen village,196,37,92,15,0,6,150
Nebraska,Blair,7995,1612,3419,821,159,412,6423
Nebraska,Bloomfield,977,179,453,74,10,132,848
Nebraska,Bassett,594,151,245,51,0,101,548
Nebraska,Arlington village,1205,210,578,92,13,46,939
Nebraska,Archer,44,0,41,0,3,0,44
Nebraska,Louisville,1039,166,410,136,0,72,784
Nebraska,Lorton village,45,8,21,7,0,0,36
Nebraska,Loretto,68,31,13,0,0,0,44
Nebraska,Lorenzo,99,51,48,0,0,0,99
Nebraska,Loomis village,411,76,215,23,10,17,341
Nebraska,Atkinson,1347,169,633,102,2,74,980
Nebraska,Atlanta village,104,10,58,8,1,3,80
Nebraska,Auburn,3387,660,1474,263,101,209,2707
Nebraska,Daykin village,200,25,96,1,0,11,133
Nebraska,Arthur village,129,28,39,13,1,13,94
Nebraska,Decatur village,440,97,167,66,2,80,412
Nebraska,Deshler,621,101,313,26,0,62,502
Nebraska,Deweese village,67,15,14,18,0,13,60
Nebraska,Aurora,4455,789,1974,464,62,225,3514
Nebraska,Avoca village,227,50,114,5,3,5,177
Nebraska,Axtell village,651,79,355,69,8,29,540
Nebraska,Ayr village,68,11,36,2,2,2,53
Nebraska,Bancroft village,547,111,234,38,15,34,432
Nebraska,Barada village,11,0,7,4,0,0,11
Nebraska,Barneston village,101,11,63,14,0,3,91
Nebraska,Bartlett village,135,36,41,23,5,7,112
Nebraska,Bartley village,272,54,113,30,1,8,206
Nebraska,Denton village,240,65,83,31,0,11,190
Nebraska,Humphrey,744,120,367,36,7,50,580
Nebraska,Harrison village,247,59,111,17,0,27,214
Nebraska,Hubbell village,65,3,44,4,0,0,51
Nebraska,Greeley Center village,339,36,151,34,1,65,287
Nebraska,Terrytown,972,286,268,147,31,27,759
Nebraska,Thayer village,58,0,35,1,0,2,38
Nebraska,Thedford village,144,22,80,25,0,2,129
Nebraska,Thurston village,121,18,63,7,0,5,93
Nebraska,Tilden,1172,169,563,65,0,105,902
Nebraska,Tobias village,96,11,51,6,2,12,82
Nebraska,Greenwood village,578,97,287,43,6,33,466
Nebraska,Trenton village,517,92,181,42,13,48,376
Nebraska,Litchfield village,262,52,128,42,3,11,236
Nebraska,Lisco,36,0,31,0,0,5,36
Nebraska,Linwood village,103,37,35,23,0,0,95
Nebraska,Lindy,17,0,13,1,0,0,14
Nebraska,Lindsay village,237,44,129,13,0,12,198
Nebraska,Lincoln,269726,82780,98480,24010,2785,9336,217391
Nebraska,Yutan,1121,253,518,101,0,18,890
Nebraska,Lodgepole village,278,43,141,24,3,25,236
Nebraska,Gresham village,283,54,115,25,5,18,217
Nebraska,Gretna,5026,969,2247,358,31,155,3760
Nebraska,Gross village,3,0,3,0,0,0,3
Nebraska,Curtis,884,289,341,46,7,56,739
Nebraska,Cushing village,53,20,13,6,4,4,47
Nebraska,Dakota City,2271,557,939,138,27,65,1726
Nebraska,Dalton village,298,38,117,28,0,31,214
Nebraska,Danbury village,105,27,49,12,0,7,95
Nebraska,Dannebrog village,319,55,101,66,17,25,264
Nebraska,Davenport village,270,22,156,6,3,20,207
Nebraska,Davey village,128,21,54,16,1,12,104
Nebraska,David City,2862,481,1261,231,15,264,2252
Nebraska,Dawson village,137,26,71,18,2,6,123
Nebraska,Hamlet village,64,11,34,1,2,8,56
Nebraska,Halsey village,70,12,40,9,0,6,67
Nebraska,Hallam village,233,40,90,30,6,8,174
Nebraska,Haigler village,170,8,84,21,0,15,128
Nebraska,Hadar village,302,54,168,13,5,7,247
Nebraska,Gurley village,200,30,96,15,4,17,162
Nebraska,Guide Rock village,220,50,77,29,1,19,176
Nebraska,York,7908,1759,3283,792,155,410,6399
Nebraska,Yankee Hill,318,78,136,13,0,6,233
Nebraska,Wynot village,179,31,100,4,3,14,152
Nebraska,Wymore,1483,274,654,146,26,124,1224
Nebraska,Weeping Water,1180,238,500,101,24,71,934
Nebraska,Liberty village,42,0,28,1,0,6,35
Nebraska,Lexington,10152,2330,3907,552,231,346,7366
Nebraska,Lewiston village,93,28,36,3,0,8,75
Nebraska,Lewellen village,188,35,71,39,4,16,165
Nebraska,Leshara village,101,20,34,14,5,11,84
Nebraska,Lemoyne,54,3,51,0,0,0,54
Nebraska,Leigh village,483,51,256,41,0,62,410
Nebraska,Lebanon village,39,10,18,7,0,3,38
Nebraska,Lawrence village,334,61,181,14,3,24,283
Nebraska,La Vista,16895,3794,6650,2009,117,499,13069
Nebraska,Laurel,1177,164,492,127,13,114,910
Nebraska,La Platte,116,13,18,71,0,0,102
Nebraska,Lamar village,31,0,26,3,0,2,31
Nebraska,Lakeview,309,45,214,11,0,0,270
Nebraska,King Lake,110,39,18,33,0,20,110
Nebraska,Kimball,2577,378,1152,300,8,212,2050
Nebraska,Wellfleet village,69,9,28,22,1,1,61
Nebraska,Culbertson village,631,85,317,86,9,37,534
Nebraska,Western village,311,100,148,15,1,9,273
Nebraska,Weston village,334,70,133,22,3,13,241
Nebraska,Wood River,1393,278,553,146,27,72,1076
Nebraska,Woodland Park,1884,300,899,140,14,30,1383
Nebraska,Woodland Hills,145,10,100,18,0,4,132
Nebraska,Wood Lake village,44,1,35,2,0,1,39
Nebraska,Wolbach village,286,29,140,23,0,27,219
Nebraska,Wisner,1313,272,563,88,27,108,1058
Nebraska,Winslow village,51,8,35,6,0,0,49
Nebraska,Winside village,419,80,178,54,1,15,328
Nebraska,Winnetoon village,60,26,23,2,0,1,52
Nebraska,Winnebago village,895,307,145,81,3,28,564
Nebraska,Wilsonville village,94,6,63,11,0,5,85
Nebraska,Willow Island,11,0,11,0,0,0,11
Nebraska,Wilcox village,473,109,205,46,4,26,390
Nebraska,Wilber,1716,382,719,147,5,124,1377
Nebraska,Whitney village,54,20,21,11,0,2,54
Nebraska,White Clay,0,0,0,0,0,0,0
Nebraska,West Point,3346,596,1538,197,9,298,2638
Nebraska,Westerville,17,3,6,0,0,3,12
Nebraska,Crookston village,35,1,2,12,0,8,23
Nebraska,Crofton,708,83,382,44,4,40,553
Nebraska,Crete,7080,2292,2470,528,40,344,5674
Nebraska,Hazard village,60,5,36,6,0,6,53
Nebraska,Hay Springs village,521,93,251,72,0,72,488
Nebraska,Hayes Center village,361,59,205,19,2,30,315
Nebraska,Hastings,24973,6227,9691,2276,190,1557,19941
Nebraska,Harvard,785,114,333,102,9,68,626
Nebraska,Hartington,1715,311,767,103,10,160,1351
Nebraska,Loup City,1031,176,394,139,0,131,840
Nebraska,Harrisburg,60,12,27,11,5,0,55
Nebraska,Hardy village,153,13,91,13,0,9,126
Nebraska,Harbine village,53,4,30,3,0,2,39
Nebraska,Hampton village,433,63,261,14,0,17,355
Nebraska,Burton village,18,0,16,0,0,0,16
Nebraska,Burwell,1219,207,557,119,26,106,1015
Nebraska,Bushnell village,147,19,105,8,0,8,140
Nebraska,Butte village,333,60,173,21,4,43,301
Nebraska,Byron village,102,19,50,9,0,11,89
Nebraska,Cairo village,888,169,347,84,2,38,640
Nebraska,Heartwell village,62,17,30,6,0,1,54
Nebraska,Callaway village,644,70,305,80,1,41,497
Nebraska,Hebron,1627,305,796,164,8,145,1418
Nebraska,Henderson,947,109,503,51,0,120,783
Nebraska,Hubbard village,208,38,92,20,0,14,164
Nebraska,Howells village,602,133,299,26,4,47,509
Nebraska,Howard City village,168,28,75,27,1,12,143
Nebraska,Hoskins village,197,45,115,8,1,3,172
Nebraska,Hordville village,145,29,57,19,2,8,115
Nebraska,Hooper,792,78,401,86,2,82,649
Nebraska,Homer village,595,124,253,57,0,32,466
Nebraska,Holstein village,265,52,102,56,2,13,225
Nebraska,Holmesville,49,9,23,10,0,7,49
Nebraska,Holdrege,5528,914,2545,655,30,262,4406
Nebraska,Holbrook village,241,24,109,35,3,14,185
Nebraska,Hildreth village,487,70,226,64,2,23,385
Nebraska,Hickman,1888,209,904,99,17,40,1269
Nebraska,Hershey village,598,89,305,44,2,15,455
Nebraska,Herman village,223,62,88,29,5,6,190
Nebraska,Henry village,78,17,32,8,0,6,63
Nebraska,Hendley village,21,6,6,4,0,5,21
Nebraska,Hemingford village,869,138,368,76,6,58,646
Nebraska,Humboldt,857,87,349,141,8,109,694
Nebraska,Cambridge,1093,174,538,56,20,95,883
Nebraska,Carleton village,95,5,77,6,0,2,90
Nebraska,Coleridge village,538,53,295,30,1,45,424
Nebraska,Colon village,167,37,90,5,0,8,140
Nebraska,Columbus,22584,4653,9334,2035,168,1340,17530
Nebraska,Comstock village,108,20,27,28,0,8,83
Nebraska,Concord village,144,21,79,11,1,4,116
Nebraska,Cook village,317,70,151,18,2,24,265
Nebraska,Cordova village,109,16,44,5,7,15,87
Nebraska,Cornlea village,61,12,21,10,0,0,43
Nebraska,Cortland village,527,66,256,50,2,17,391
Nebraska,Cotesfield village,27,3,12,8,0,4,27
Nebraska,Cowles village,12,1,6,3,0,1,11
Nebraska,Cozad,3905,621,1637,513,55,277,3103
Nebraska,Crab Orchard village,57,1,25,13,0,7,46
Nebraska,Craig village,201,44,83,23,8,10,168
Nebraska,Crawford,1113,217,447,178,0,115,957
Nebraska,Creighton,1151,207,516,93,0,148,964
Nebraska,Creston village,163,30,71,15,0,12,128
Nebraska,Cody village,116,20,62,11,3,5,101
Nebraska,Campbell village,303,41,146,16,5,53,261
Nebraska,Clinton village,39,1,25,10,0,3,39
Nebraska,Clay Center,802,140,420,71,2,38,671
Nebraska,Carroll village,190,26,96,16,0,7,145
Nebraska,Cedar Bluffs village,526,80,250,69,8,41,448
Nebraska,Cedar Creek village,394,39,231,48,5,18,341
Nebraska,Cedar Rapids village,401,86,165,43,3,29,326
Nebraska,Center village,101,19,50,3,0,9,81
Nebraska,Central City,2902,561,1267,322,60,242,2452
Nebraska,Ceresco village,945,148,437,91,10,20,706
Nebraska,Chadron,5828,2183,2138,390,15,229,4955
Nebraska,Chalco,11258,2426,5025,743,91,208,8493
Nebraska,Chambers village,277,51,130,30,2,22,235
Nebraska,Champion,64,0,37,14,0,0,51
Nebraska,Chapman village,257,26,114,28,20,18,206
Nebraska,Chappell,894,167,359,108,18,86,738
Nebraska,Chester village,231,31,146,14,0,12,203
Nebraska,Clarks village,387,50,198,18,9,20,295
Nebraska,Clarkson,806,102,413,63,0,97,675
Nebraska,Clatonia village,323,46,117,34,8,18,223
Nebraska,Clearwater village,330,44,167,24,4,18,257
Nebraska,Lushton village,34,5,16,7,0,3,31
Nebraska,Walthill village,781,217,182,72,23,36,530
Nebraska,Lynch village,234,44,87,30,0,25,186
Nebraska,Norman village,67,27,10,1,0,6,44
Nebraska,Norfolk,24393,6185,9629,2001,247,1245,19307
Nebraska,Nora village,18,0,12,3,0,2,17
Nebraska,Niobrara village,344,75,139,55,10,29,308
Nebraska,Nickerson village,386,52,150,51,3,17,273
Nebraska,Newport village,125,11,66,11,4,10,102
Nebraska,Newman Grove,631,98,306,58,4,71,537
Nebraska,North Bend,1292,214,570,100,9,83,976
Nebraska,Newcastle village,252,35,113,38,2,23,211
Nebraska,Nemaha village,170,31,77,27,0,20,155
Nebraska,Nelson,499,49,240,88,8,48,433
Nebraska,Neligh,1484,256,646,118,19,156,1195
Nebraska,Nehawka village,314,24,150,27,0,7,208
Nebraska,Nebraska City,7301,1611,2804,728,73,708,5924
Nebraska,Naponee village,80,27,34,2,0,8,71
Nebraska,Naper village,72,8,42,3,0,5,58
Nebraska,Nenzel village,33,6,26,0,0,1,33
Nebraska,Murray village,417,64,211,42,2,21,340
Nebraska,North Loup village,331,33,156,50,5,21,265
Nebraska,Oak village,47,6,17,12,0,7,42
Nebraska,Orleans village,381,41,201,47,0,31,320
Nebraska,Ord,2257,445,1122,146,12,153,1878
Nebraska,Orchard village,461,73,257,28,0,22,380
Nebraska,Ong village,75,17,21,19,0,14,71
Nebraska,O'Neill,3673,557,1767,327,39,330,3020
Nebraska,Omaha,440034,126356,154959,41308,5706,18883,347212
Nebraska,Ohiowa village,176,28,85,7,0,4,124
Nebraska,North Platte,24420,4640,9701,2482,530,1906,19259
Nebraska,Ogallala,4605,815,1956,528,40,409,3748
Nebraska,Odessa,72,0,49,9,0,0,58
Nebraska,Odell village,313,53,135,33,2,12,235
Nebraska,Octavia village,128,21,56,30,1,2,110
Nebraska,Oconto village,129,18,51,15,11,9,104
Nebraska,Obert village,22,0,14,1,0,2,17
Nebraska,Oakland,1325,209,656,103,10,91,1069
Nebraska,Oakdale village,300,28,142,38,3,16,227
Nebraska,Offutt AFB,4919,849,2254,223,13,5,3344
Nebraska,Osceola,824,138,340,84,9,91,662
Nebraska,Murdock village,254,29,142,31,6,14,222
Nebraska,Morse Bluff village,144,30,65,7,1,12,115
Nebraska,Friend,1232,200,562,76,7,84,929
Nebraska,Fremont,26483,5686,11166,2360,301,1401,20914
Nebraska,Franklin,1050,209,506,48,12,113,888
Nebraska,Foster village,56,14,22,2,0,6,44
Nebraska,Fort Calhoun,691,128,287,82,12,46,555
Nebraska,Fordyce village,135,18,75,6,2,13,114
Nebraska,Fontanelle,69,0,69,0,0,0,69
Nebraska,Fullerton,1416,233,589,127,38,135,1122
Nebraska,Lyman village,452,88,146,35,28,22,319
Nebraska,Farwell village,130,27,48,15,2,15,107
Nebraska,Farnam village,237,27,127,19,4,18,195
Nebraska,Falls City,4246,643,2009,356,33,328,3369
Nebraska,Fairmont village,583,126,238,82,10,59,515
Nebraska,Fairfield,396,64,164,47,2,28,305
Nebraska,Fairbury,3863,682,1539,453,52,435,3161
Nebraska,Exeter village,624,124,296,40,0,59,519
Nebraska,Filley village,101,16,47,20,0,8,91
Nebraska,Mullen village,391,24,230,24,0,60,338
Nebraska,Funk village,209,29,112,17,0,12,170
Nebraska,Garland village,243,43,117,22,8,12,202
Nebraska,Morrill village,885,197,377,102,4,56,736
Nebraska,Grant,1250,242,545,101,8,115,1011
Nebraska,Grand Island,50582,11031,19580,4967,643,2670,38891
Nebraska,Grafton village,127,21,50,25,0,14,110
Nebraska,Gothenburg,3542,627,1500,338,21,257,2743
Nebraska,Gordon,1665,249,660,163,41,136,1249
Nebraska,Goehner village,89,16,42,14,0,7,79
Nebraska,Gandy village,26,11,10,2,0,1,24
Nebraska,Glenwood,767,215,336,0,25,0,576
Nebraska,Giltner village,388,50,192,29,0,16,287
Nebraska,Gilead village,43,8,27,0,0,0,35
Nebraska,Gibbon,1904,211,879,146,57,111,1404
Nebraska,Gering,8429,1666,3517,817,87,531,6618
Nebraska,Genoa,1006,231,462,106,0,47,846
Nebraska,Geneva,2271,473,951,247,29,146,1846
Nebraska,Garrison village,68,19,19,1,0,6,45
Nebraska,Glenvil village,281,58,130,23,1,11,223
Nebraska,Ewing village,410,68,180,19,6,25,298
Nebraska,Oshkosh,792,122,358,91,8,107,686
Nebraska,Otoe village,150,26,65,10,0,16,117
Nebraska,Ames,74,22,52,0,0,0,74
Nebraska,Alvo village,125,3,52,20,2,5,82
Nebraska,Alma,1195,151,610,150,0,116,1027
Nebraska,Alliance,8500,1574,3807,613,139,467,6600
Nebraska,Allen village,356,74,154,32,8,20,288
Nebraska,Alexandria village,151,30,71,19,0,9,129
Nebraska,Alda village,607,119,253,92,0,11,475
Nebraska,Amherst village,230,34,129,14,2,11,190
Nebraska,Albion,1667,297,734,101,18,186,1336
Nebraska,Adams village,596,119,226,52,0,65,462
Nebraska,Abie village,107,18,69,1,0,2,90
Nebraska,Moorefield village,28,1,23,1,2,1,28
Nebraska,Monroe village,353,60,156,22,0,16,254
Nebraska,Monowi village,0,0,0,0,0,0,0
Nebraska,Mitchell,1821,517,660,145,42,120,1484
Nebraska,Minden,3112,472,1484,233,29,274,2492
Nebraska,Ainsworth,1695,279,767,169,16,174,1405
Nebraska,Minatare,791,177,307,94,0,81,659
Nebraska,Anoka village,16,4,12,0,0,0,16
Nebraska,Ansley village,406,78,187,48,10,26,349
Nebraska,Ithaca village,133,17,63,10,0,9,99
Nebraska,Jackson village,194,25,102,22,4,5,158
Nebraska,Jansen village,142,9,79,17,0,3,108
Nebraska,Johnson village,318,39,154,22,0,47,262
Nebraska,Johnstown village,76,2,45,0,5,13,65
Nebraska,Julian village,73,29,25,4,1,8,67
Nebraska,Juniata village,878,197,394,98,7,36,732
Nebraska,Anselmo village,202,23,109,16,1,8,157
Nebraska,Kearney,32217,10408,11859,2529,294,1146,26236
Nebraska,Kennard village,342,58,159,27,3,20,267
Nebraska,Keystone,123,22,70,2,0,7,101
Nebraska,Kilgore village,59,7,27,8,0,1,43
Nebraska,Plattsmouth,6475,1245,2709,661,171,410,5196
Nebraska,Platte Center village,338,64,155,28,1,13,261
Nebraska,Arcadia village,307,64,156,13,1,23,257
Nebraska,Arapahoe,924,152,430,63,11,116,772
Nebraska,Kenesaw village,1014,187,486,86,0,69,828
Nebraska,Osmond,759,143,345,57,8,47,600
Nebraska,Milligan village,343,44,173,19,3,29,268
Nebraska,Milford,2373,646,989,125,38,99,1897
Nebraska,Phillips village,301,51,139,26,0,16,232
Nebraska,Petersburg village,321,51,186,25,1,17,280
Nebraska,Peru,850,523,173,22,3,25,746
Nebraska,Pender village,1117,215,526,55,16,107,919
Nebraska,Paxton village,551,108,289,32,0,26,455
Nebraska,Pawnee City,893,140,394,106,7,95,742
Nebraska,Parks,27,0,13,4,0,10,27
Nebraska,Pickrell village,186,22,104,17,1,12,156
Nebraska,Papillion,19463,4497,9113,1213,159,671,15653
Nebraska,Palmyra village,664,161,234,84,11,25,515
Nebraska,Palmer village,584,111,220,88,5,40,464
Nebraska,Palisade village,407,68,167,48,3,33,319
Nebraska,Page village,212,56,102,13,0,12,183
Nebraska,Oxford village,780,138,383,94,7,51,673
Nebraska,Overton village,677,121,315,41,2,10,489
Nebraska,Overland,199,16,125,19,0,0,160
Nebraska,Panama village,284,45,138,29,5,5,222
Nebraska,Miller village,168,25,56,7,2,21,111
Nebraska,Pierce,1959,329,866,160,22,121,1498
Nebraska,Plainview,990,125,496,120,7,86,834
Nebraska,Merriman village,91,22,41,6,0,10,79
Nebraska,Merna village,388,45,175,43,10,28,301
Nebraska,Memphis village,93,18,50,6,0,3,77
Nebraska,Melbeta village,129,9,80,5,1,11,106
Nebraska,Meadow Grove village,329,60,141,33,1,23,258
Nebraska,Mead village,584,151,240,25,4,29,449
Nebraska,Maywood village,297,28,153,19,5,20,225
Nebraska,Pilger village,276,35,136,46,0,25,242
Nebraska,Maxwell village,283,48,147,27,2,13,237
Nebraska,Mason City village,176,35,73,31,1,10,150
Nebraska,Maskell village,76,7,35,9,0,5,56
Nebraska,Martinsburg village,67,8,34,3,0,8,53
Nebraska,Martin,136,0,73,63,0,0,136
Nebraska,Marquette village,231,55,106,18,4,1,184
Nebraska,Manley village,146,22,92,9,0,3,126
Nebraska,Malmo village,226,47,109,5,0,19,180
Nebraska,Max,44,3,18,4,0,0,25
Nebraska,Eustis village,394,38,245,20,0,23,326
Nebraska,Firth village,550,97,220,38,10,28,393
Nebraska,Endicott village,121,22,56,13,0,9,100
Nebraska,Brady village,343,46,167,31,5,15,264
Nebraska,Brainard village,291,62,148,25,6,20,261
Nebraska,Brewster village,5,0,3,2,0,0,5
Nebraska,Bridgeport,1807,289,694,191,29,105,1308
Nebraska,Bristow village,51,8,31,6,0,4,49
Nebraska,Broadwater village,154,28,73,19,5,5,130
Nebraska,Brock village,147,31,48,19,13,23,134
Nebraska,Bradshaw village,280,34,142,35,1,11,223
Nebraska,Broken Bow,3518,767,1410,245,89,246,2757
Nebraska,Brownville village,117,8,58,24,3,11,104
Nebraska,Brule village,376,64,191,53,1,18,327
Nebraska,Bruning village,219,33,119,14,0,24,190
Nebraska,Bruno village,145,28,61,7,1,4,101
Nebraska,Brunswick village,169,24,101,9,0,12,146
Nebraska,Burchard village,53,3,38,0,0,6,47
Nebraska,Burr village,27,3,14,7,0,2,26
Nebraska,Brownlee,8,0,8,0,0,0,8
Nebraska,Malcolm village,363,53,185,39,5,8,290
Nebraska,Boys Town village,913,595,59,1,107,0,762
Nebraska,Blue Springs,331,96,140,30,2,22,290
Nebraska,Shickley village,340,59,172,12,2,21,266
Nebraska,Sholes village,16,1,10,2,0,0,13
Nebraska,Shubert village,154,27,82,18,0,6,133
Nebraska,Sidney,6830,1182,2852,860,116,474,5484
Nebraska,Silver Creek village,397,50,179,32,3,19,283
Nebraska,Smithfield village,30,9,13,5,0,3,30
Nebraska,Snyder village,348,50,161,18,0,26,255
Nebraska,Bow Valley,102,11,50,22,0,5,88
Nebraska,South Bend village,94,20,51,14,0,5,90
Nebraska,Spalding village,546,127,239,26,8,48,448
Nebraska,Spencer village,482,66,222,42,0,49,379
Nebraska,Sprague village,142,17,55,18,0,22,112
Nebraska,Springfield,1423,210,718,158,4,61,1151
Nebraska,Springview village,210,47,93,14,0,26,180
Nebraska,Bloomington village,131,6,77,7,1,1,92
Nebraska,Blue Hill,908,208,404,78,12,71,773
Nebraska,Ericson village,148,25,69,5,0,19,118
Nebraska,Shelton village,1154,245,501,87,32,69,934
Nebraska,Magnet village,46,13,22,3,2,3,43
Nebraska,Madison,2545,580,995,205,74,144,1998
Nebraska,Verdel village,25,2,8,8,0,6,24
Nebraska,Venice,55,32,14,9,0,0,55
Nebraska,Venango village,141,11,94,9,0,5,119
Nebraska,Valparaiso village,708,131,314,76,0,37,558
Nebraska,Valley,2018,351,864,228,22,130,1595
Nebraska,Valentine,2782,466,1354,213,9,220,2262
Nebraska,Utica village,779,116,423,66,10,32,647
Nebraska,Verdigre village,575,96,222,43,3,120,484
Nebraska,Upland village,158,29,92,7,0,2,130
Nebraska,Unadilla village,276,51,144,21,0,19,235
Nebraska,Ulysses village,249,32,150,24,1,7,214
Nebraska,Uehling village,258,70,127,20,0,13,230
Nebraska,Tryon,81,5,46,11,0,15,77
Nebraska,Trumbull village,229,41,101,10,1,9,162
Nebraska,McCook,7649,1525,3484,654,46,472,6181
Nebraska,Lyons,925,174,421,72,1,118,786
Nebraska,Union village,204,30,106,13,0,11,160
Nebraska,Madrid village,302,54,146,15,0,21,236
Nebraska,Verdon village,164,23,90,13,0,19,145
Nebraska,Waco village,294,41,179,16,1,15,252
Nebraska,Macy,877,341,101,41,14,41,538
Nebraska,McLean village,28,2,22,0,0,4,28
Nebraska,McGrew village,74,18,30,8,0,5,61
Nebraska,McCool Junction village,473,103,227,32,0,7,369
Nebraska,Wayne,5553,2387,2103,192,14,257,4953
Nebraska,Waverly,3614,529,1583,289,7,111,2519
Nebraska,Wausa village,718,88,391,39,0,47,565
Nebraska,Virginia village,44,10,19,9,0,2,40
Nebraska,Wauneta village,699,76,322,72,3,73,546
Nebraska,Waterbury village,59,12,29,6,3,4,54
Nebraska,Washington village,116,41,54,4,1,8,108
Nebraska,Wann,164,30,18,44,0,8,100
Nebraska,Walton,332,71,230,0,0,4,305
Nebraska,Wallace village,299,42,159,20,5,10,236
Nebraska,Wakefield,1539,324,588,139,39,111,1201
Nebraska,Wahoo,4505,724,1832,429,23,408,3416
Nebraska,Waterloo village,1086,178,420,106,21,41,766
Nebraska,Shelby village,766,121,376,61,9,39,606
Nebraska,South Sioux City,13315,2926,5256,896,126,560,9764
Nebraska,Seneca village,50,4,27,3,0,9,43
Nebraska,Dix village,283,33,118,31,13,21,216
Nebraska,Diller village,186,31,91,32,0,10,164
Nebraska,De Witt village,487,90,271,32,3,18,414
Nebraska,Pleasant Dale village,237,30,145,12,0,7,194
Nebraska,Pleasanton village,304,61,126,18,0,29,234
Nebraska,Plymouth village,423,72,194,25,1,29,321
Nebraska,Polk village,332,73,147,35,2,30,287
Nebraska,Ponca,1037,227,451,66,1,94,839
Nebraska,Poole,53,0,40,0,0,0,40
Nebraska,Potter village,315,69,129,33,4,16,251
Nebraska,Prague village,356,92,127,32,15,14,280
Nebraska,Preston village,26,3,18,0,0,0,21
Nebraska,Primrose village,78,5,51,1,0,1,58
Nebraska,Prosser village,109,5,48,21,0,9,83
Nebraska,Raeville,0,0,0,0,0,0,0
Nebraska,Ragan village,60,3,34,5,0,8,50
Nebraska,Ralston,5997,1609,2437,737,146,259,5188
Nebraska,Randolph,786,70,407,33,5,100,615
Nebraska,Ravenna,1466,279,570,174,11,101,1135
Nebraska,Raymond village,139,27,70,24,0,5,126
Nebraska,Red Cloud,1075,182,467,99,22,85,855
Nebraska,Dixon village,84,31,31,4,1,10,77
Nebraska,Republican City village,147,10,71,33,0,15,129
Nebraska,Dodge village,651,113,282,37,12,80,524
Nebraska,Dorchester village,525,103,238,41,0,23,405
Nebraska,Enders,36,0,30,0,0,0,30
Nebraska,Emmet village,38,5,25,4,0,1,35
Nebraska,Emerson village,842,156,376,54,3,78,667
Nebraska,Elyria village,43,3,23,6,0,1,33
Nebraska,Elwood village,756,127,375,37,0,69,608
Nebraska,Elsie village,115,20,53,12,0,10,95
Nebraska,Elmwood village,607,116,287,49,0,38,490
Nebraska,Elm Creek village,909,113,409,76,7,49,654
Nebraska,Elk Creek village,102,26,47,11,0,9,93
Nebraska,Elgin,609,45,338,35,9,72,499
Nebraska,Elba village,271,52,119,42,0,7,220
Nebraska,Edison village,164,31,76,9,0,7,123
Nebraska,Edgar,472,63,246,42,1,44,396
Nebraska,Eddyville village,127,15,60,3,6,6,90
Nebraska,Eagle village,1043,220,408,94,0,35,757
Nebraska,Dwight village,169,31,85,27,0,8,151
Nebraska,Dunning village,103,29,48,3,2,6,88
Nebraska,Duncan village,451,106,192,54,0,15,367
Nebraska,Dunbar village,188,40,89,19,1,19,168
Nebraska,Du Bois village,172,10,91,10,2,18,131
Nebraska,Douglas village,199,40,114,9,0,8,171
Nebraska,Doniphan village,1020,136,420,104,14,63,737
Nebraska,Reynolds village,70,11,36,4,0,9,60
Nebraska,Richfield,175,8,58,16,0,0,82
Nebraska,Richland village,70,13,28,16,1,0,58
Nebraska,Rushville,852,283,270,89,14,87,743
Nebraska,Ruskin village,116,24,57,12,2,5,100
Nebraska,St. Edward,778,135,345,76,10,69,635
Nebraska,Seward,7109,1946,2968,393,61,372,5740
Nebraska,St. Helena village,85,20,48,4,0,3,75
Nebraska,St. Libory,341,37,187,10,5,6,245
Nebraska,St. Paul,2313,404,942,229,4,227,1806
Nebraska,Salem village,90,21,36,16,0,3,76
Nebraska,Santee village,381,99,47,35,7,13,201
Nebraska,Sarben,16,1,15,0,0,0,16
Nebraska,Sargent,598,76,326,54,4,51,511
Nebraska,Saronville village,83,8,35,7,0,4,54
Nebraska,Schuyler,6196,1366,2200,323,165,230,4284
Nebraska,Scotia village,365,77,158,26,2,23,286
Nebraska,Scottsbluff,14955,3757,5092,1777,241,797,11664
Nebraska,Scribner,942,208,392,78,4,85,767
Nebraska,Rulo village,189,27,60,58,0,10,155
Nebraska,Royal village,84,12,58,7,0,3,80
Nebraska,Roseland village,254,46,119,17,2,11,195
Nebraska,Roscoe,14,0,14,0,0,0,14
Nebraska,Rosalie village,221,51,57,17,6,16,147
Nebraska,Rogers village,56,7,27,12,0,0,46
Nebraska,Rockville village,86,26,27,10,2,6,71
Nebraska,Roca village,220,46,105,25,1,1,178
Nebraska,Riverton village,109,12,46,21,1,13,93
Nebraska,Riverdale village,166,34,75,8,4,10,131
Nebraska,Rising City village,292,32,161,39,0,20,252
Nevada,Zephyr Cove,463,68,260,44,0,45,417
Nevada,Yerington,3021,767,891,516,132,284,2590
Nevada,Walker Lake,355,36,155,69,19,38,317
Nevada,Winchester,28365,9373,8367,3698,779,1187,23404
Nevada,Sunrise Manor,191464,56035,60769,17906,5172,7307,147189
Nevada,Sun Valley,19663,4226,7135,2613,313,719,15006
Nevada,Sutcliffe,194,37,55,53,3,5,153
Nevada,Tonopah,2360,510,921,402,98,105,2036
Nevada,Topaz Lake,264,8,135,25,0,9,177
Nevada,Topaz Ranch Estates,1704,304,805,251,19,137,1516
Nevada,Unionville,13,0,0,0,0,13,13
Nevada,Winnemucca,7810,1682,3037,792,83,246,5840
Nevada,Ursine,94,0,47,47,0,0,94
Nevada,Verdi,1525,409,802,75,0,74,1360
Nevada,Virginia City,717,49,352,198,47,71,717
Nevada,Wadsworth,900,282,177,127,24,34,644
Nevada,Washoe Valley,3348,553,1753,451,28,124,2909
Nevada,Wells,1288,211,553,77,52,64,957
Nevada,West Wendover,4422,599,1748,382,33,205,2967
Nevada,Whitney,40165,11537,13877,4290,1115,1411,32230
Nevada,Valmy,8,8,0,0,0,0,8
Nevada,Panaca,1257,257,578,161,0,72,1068
Nevada,Fish Springs,909,84,541,32,2,16,675
Nevada,Oasis,0,0,0,0,0,0,0
Nevada,McGill,1321,190,506,195,20,79,990
Nevada,Mesquite,16533,2401,8168,1945,210,1156,13880
Nevada,Mina,24,0,20,0,0,4,24
Nevada,Minden,3180,457,1717,413,70,183,2840
Nevada,Moapa Town,1149,237,473,39,25,50,824
Nevada,Moapa Valley,7099,1009,3155,612,91,266,5133
Nevada,Mogul,1353,373,566,141,28,96,1204
Nevada,Montello,89,13,49,0,27,0,89
Nevada,Mount Charleston,373,44,197,83,6,10,340
Nevada,Mount Wilson,27,0,27,0,0,0,27
Nevada,Nellis AFB,3554,868,1253,124,62,5,2312
Nevada,Nelson,36,0,36,0,0,0,36
Nevada,Nixon,308,130,39,34,18,15,236
Nevada,North Las Vegas,226860,60192,78403,19159,4724,7379,169857
Nevada,Orovada,144,0,136,0,0,8,144
Nevada,Osino,983,37,521,42,0,0,600
Nevada,Owyhee,1367,406,369,205,7,60,1047
Nevada,Summerlin South,25338,4278,12735,2364,282,1060,20719
Nevada,Stateline,1160,395,379,157,15,9,955
Nevada,Stagecoach,1668,220,658,297,143,38,1356
Nevada,Spring Creek,13564,2139,7121,864,149,197,10470
Nevada,Sparks,93437,22133,36322,10906,1354,3880,74595
Nevada,Spanish Springs,15789,2936,7542,1489,52,666,12685
Nevada,McDermitt,155,0,86,0,0,0,86
Nevada,Lund,217,76,92,0,0,0,168
Nevada,Lovelock,2306,418,854,357,73,86,1788
Nevada,Logan Creek,39,0,39,0,0,0,39
Nevada,Golden Valley,2127,520,921,204,17,127,1789
Nevada,Goldfield,443,77,134,68,4,38,321
Nevada,Goodsprings,101,101,0,0,0,0,101
Nevada,Grass Valley,834,67,367,198,12,14,658
Nevada,Hawthorne,3095,810,1204,360,60,284,2718
Nevada,Henderson,271725,62817,111872,31765,4155,12308,222917
Nevada,Hiko,131,13,81,0,0,0,94
Nevada,Humboldt River Ranch,31,0,31,0,0,0,31
Nevada,Imlay,65,0,23,28,0,14,65
Nevada,Golconda,211,15,63,58,31,4,171
Nevada,Glenbrook,123,0,104,8,0,11,123
Nevada,Smith Valley,1182,154,703,114,27,46,1044
Nevada,Gerlach,194,71,40,21,0,51,183
Nevada,Indian Hills,6193,1017,2952,836,136,294,5235
Nevada,Indian Springs,1050,126,528,59,75,14,802
Nevada,Jackpot,1579,267,611,166,58,73,1175
Nevada,Johnson Lane,6441,730,3776,464,65,319,5354
Nevada,Kingsbury,1970,538,913,303,23,81,1858
Nevada,Kingston,172,7,106,42,0,17,172
Nevada,Lakeridge,318,96,129,61,19,13,318
Nevada,Lamoille,340,0,207,0,0,72,279
Nevada,Las Vegas,605097,161807,207953,71515,13463,26801,481539
Nevada,Laughlin,7622,1283,2957,1387,186,842,6655
Nevada,Lemmon Valley,5073,1209,1889,835,46,260,4239
Nevada,Incline Village,8734,2233,4076,1102,83,244,7738
Nevada,Skyland,230,51,165,14,0,0,230
Nevada,Spring Valley,186632,55994,65875,22677,3683,7629,155858
Nevada,Silver Peak,61,8,40,0,9,4,61
Nevada,Caliente,1029,219,396,89,12,56,772
Nevada,Silver Springs,5351,1280,2281,721,63,199,4544
Nevada,Boulder City,15266,3251,6651,2111,139,1122,13274
Nevada,Blue Diamond,344,55,147,61,0,19,282
Nevada,Bennett Springs,146,26,120,0,0,0,146
Nevada,Beaverdam,28,6,10,0,0,0,16
Nevada,Beatty,1051,209,569,82,0,81,941
Nevada,Battle Mountain,3276,530,1522,292,45,201,2590
Nevada,Baker,30,8,22,0,0,0,30
Nevada,Austin,93,7,34,40,0,6,87
Nevada,Alamo,1095,130,516,0,0,125,771
Nevada,Cal-Nev-Ari,137,7,36,30,0,64,137
Nevada,Silver City,222,71,75,53,0,0,199
Nevada,Schurz,824,325,162,109,3,53,652
Nevada,Sandy Valley,1385,282,611,205,58,116,1272
Nevada,Ruth,391,41,225,11,0,13,290
Nevada,Ruhenstroth,1101,143,621,181,14,63,1022
Nevada,Round Hill Village,849,160,418,172,32,0,782
Nevada,Reno,234161,68016,78702,29651,4397,9281,190047
Nevada,Rachel,87,0,59,28,0,0,87
Nevada,Preston,20,0,0,20,0,0,20
Nevada,Pioche,911,388,363,91,9,12,863
Nevada,Paradise Valley,158,1,61,82,0,0,144
Nevada,Paradise,226957,72780,72769,26334,5408,9486,186777
Nevada,Searchlight,416,102,112,65,0,71,350
Nevada,Carlin,2299,392,839,469,40,140,1880
Nevada,Bunkerville,1374,215,649,145,0,54,1063
Nevada,Fallon Station,799,45,430,7,0,0,482
Nevada,Genoa,1087,219,563,77,0,58,917
Nevada,Gardnerville Ranchos,11023,2286,5116,990,143,480,9015
Nevada,Gardnerville,5636,951,2394,829,51,330,4555
Nevada,Gabbs,126,0,80,37,0,9,126
Nevada,Fort McDermitt,613,217,74,40,6,46,383
Nevada,Pahrump,34902,5702,16387,4679,540,2613,29921
Nevada,Fernley,19185,3594,8152,1940,288,1092,15066
Nevada,Carson,54482,12487,20329,8072,981,3254,45123
Nevada,Fallon,8442,2030,2529,1446,135,510,6650
Nevada,Eureka,487,28,217,119,0,90,454
Nevada,Empire,20,0,20,0,0,0,20
Nevada,Enterprise,125498,33352,48525,12234,1599,3295,99005
Nevada,Elko,19709,5063,7557,1726,323,420,15089
Nevada,Carter Springs,555,123,210,85,12,35,465
Nevada,Cold Springs,8868,1505,4231,702,132,288,6858
Nevada,Crescent Valley,346,48,200,11,0,0,259
Nevada,Crystal Bay,239,36,148,55,0,0,239
Nevada,Ely,4206,983,1528,548,7,345,3411
Nevada,Denio,42,0,32,0,0,10,42
Nevada,Dayton,9163,1823,3744,1209,63,487,7326
Nevada,Dry Valley,45,0,45,0,0,0,45
Nevada,Dyer,264,57,105,55,0,36,253
Nevada,East Valley,1266,236,776,96,0,47,1155
Nevada,Double Spring,176,43,78,7,0,40,168
New Hampshire,Londonderry,10729,2177,5162,1022,101,349,8811
New Hampshire,Littleton,4663,1013,1728,624,54,237,3656
New Hampshire,Manchester,110139,34380,37897,12575,1959,4941,91752
New Hampshire,Loudon,533,68,294,50,14,31,457
New Hampshire,Marlborough,1008,228,444,133,9,46,860
New Hampshire,Milton,791,206,294,38,56,55,649
New Hampshire,Meredith,1749,379,423,198,0,195,1195
New Hampshire,Milford,9107,1886,3774,1019,105,509,7293
New Hampshire,Lisbon,973,236,380,111,18,36,781
New Hampshire,Milton Mills,411,88,153,57,0,27,325
New Hampshire,Melvin Village,161,25,93,0,0,43,161
New Hampshire,Lincoln,761,223,277,111,16,73,700
New Hampshire,New London,1486,1094,217,62,0,113,1486
New Hampshire,Lancaster,1417,310,624,248,0,68,1250
New Hampshire,West Stewartstown,293,98,96,52,0,47,293
New Hampshire,Warner,417,88,244,14,0,32,378
New Hampshire,Walpole,311,82,136,71,0,13,302
New Hampshire,Troy,1379,336,509,144,19,107,1115
New Hampshire,Tilton Northfield,3725,757,1452,432,46,331,3018
New Hampshire,Suncook,5247,1086,1942,662,70,351,4111
New Hampshire,Suissevale,133,30,69,34,0,0,133
New Hampshire,South Hooksett,5825,1820,2456,435,0,263,4974
New Hampshire,New Hampton,327,81,164,33,0,0,278
New Hampshire,Mountain Lakes,416,42,309,18,3,16,388
New Hampshire,Lebanon,13535,3715,5529,1358,89,820,11511
New Hampshire,Nashua,87110,23020,34150,9332,1175,3976,71653
New Hampshire,Union,161,65,87,9,0,0,161
New Hampshire,Hinsdale,1508,308,554,187,38,134,1221
New Hampshire,Henniker,1623,896,472,42,0,15,1425
New Hampshire,Goffstown,3124,639,1338,422,22,177,2598
New Hampshire,Franklin,8460,2259,2957,1100,88,518,6922
New Hampshire,Farmington,4203,925,1587,656,40,181,3389
New Hampshire,Exeter,9223,2422,3483,1383,77,402,7767
New Hampshire,Epping,1597,351,660,167,0,157,1335
New Hampshire,Hanover,8360,5280,1773,272,36,336,7697
New Hampshire,Enfield,1129,236,557,139,0,87,1019
New Hampshire,Dover,30534,8973,11415,3391,497,1250,25526
New Hampshire,Derry,22363,5591,8934,2589,355,1040,18509
New Hampshire,Conway,3325,772,1511,294,8,187,2772
New Hampshire,Contoocook,1801,609,736,88,0,18,1451
New Hampshire,Concord,42537,11688,15748,5444,489,2284,35653
New Hampshire,Colebrook,1286,251,537,156,25,84,1053
New Hampshire,East Merrimack,3774,959,1285,796,14,235,3289
New Hampshire,Claremont,13076,3191,4501,1675,284,859,10510
New Hampshire,Hancock,199,33,95,39,6,3,176
New Hampshire,Hampton,9338,1549,4590,1131,58,497,7825
New Hampshire,Gorham,1518,226,814,117,23,108,1288
New Hampshire,Newfields,324,40,156,31,4,15,246
New Hampshire,Somersworth,11778,2543,5174,1312,100,425,9554
New Hampshire,Seabrook Beach,629,96,387,93,0,31,607
New Hampshire,Sanbornville,867,146,456,108,0,95,805
New Hampshire,Rochester,29954,7775,11358,4278,357,1535,25303
New Hampshire,Hampton Beach,2068,392,1095,284,64,77,1912
New Hampshire,Laconia,16075,3785,6092,1997,175,1258,13307
New Hampshire,Hillsborough,1697,202,853,202,11,81,1349
New Hampshire,Jaffrey,2478,694,739,509,96,145,2183
New Hampshire,Hudson,7388,1773,2939,641,139,584,6076
New Hampshire,Hooksett,3820,902,1942,349,0,146,3339
New Hampshire,Greenville,1178,203,451,155,16,34,859
New Hampshire,Groveton,1132,227,530,71,3,120,951
New Hampshire,Keene,23403,9249,7493,2343,199,1311,20595
New Hampshire,Charlestown,1020,85,453,128,0,52,718
New Hampshire,Durham,10640,8391,1302,226,4,138,10061
New Hampshire,Center Ossipee,358,68,89,51,34,71,313
New Hampshire,Pinardville,4903,1283,1904,908,12,192,4299
New Hampshire,Peterborough,3113,703,1300,390,34,373,2800
New Hampshire,North Woodstock,299,74,157,47,5,12,295
New Hampshire,North Walpole,1023,346,283,167,0,23,819
New Hampshire,North Haverhill,711,157,305,103,21,74,660
New Hampshire,Center Sandwich,172,31,37,13,0,28,109
New Hampshire,Pittsfield,1629,495,468,213,18,89,1283
New Hampshire,Newport,4798,937,1596,1024,14,384,3955
New Hampshire,Woodsville,1364,485,429,66,0,70,1050
New Hampshire,Wolfeboro,2600,426,1302,256,199,159,2342
New Hampshire,Winchester,1544,425,583,227,38,93,1366
New Hampshire,Wilton,939,215,357,131,0,103,806
New Hampshire,Whitefield,1087,178,451,128,30,68,855
New Hampshire,West Swanzey,1402,358,320,172,33,40,923
New Hampshire,Newmarket,5319,2267,1525,612,67,151,4622
New Hampshire,Plainfield,232,45,87,44,4,3,183
New Hampshire,North Conway,2314,771,793,284,44,137,2029
New Hampshire,Portsmouth,21426,6853,8141,2143,367,1157,18661
New Hampshire,Plymouth,3913,2856,618,110,27,77,3688
New Hampshire,Bristol,1928,577,588,215,0,111,1491
New Hampshire,Bradford,411,39,214,17,7,6,283
New Hampshire,Blodgett Landing,150,33,109,8,0,0,150
New Hampshire,Berlin,9580,2817,3305,1380,75,725,8302
New Hampshire,Bennington,335,65,123,52,0,5,245
New Hampshire,Bethlehem,916,151,403,88,0,32,674
New Hampshire,Bartlett,239,14,63,107,0,41,225
New Hampshire,Ashland,1412,434,558,174,15,75,1256
New Hampshire,Antrim,1302,197,650,122,17,76,1062
New Hampshire,Amherst,558,107,288,24,0,23,442
New Hampshire,Alton,154,56,0,84,0,14,154
New Hampshire,Raymond,3052,728,1284,297,8,126,2443
New Hampshire,Belmont,1738,447,944,28,0,61,1480
New Hampshire,Canaan,501,59,252,39,42,25,417
New Jersey,Belle Mead,189,67,88,0,0,0,155
New Jersey,Berlin borough,7618,2063,2995,683,73,471,6285
New Jersey,Belleplain,584,108,313,16,0,36,473
New Jersey,Bellmawr borough,11507,3175,4456,1032,215,792,9670
New Jersey,Belmar borough,5745,1971,2089,687,113,294,5154
New Jersey,Belvidere,2634,608,1084,291,76,96,2155
New Jersey,Bergenfield borough,27339,7465,11485,1845,274,1438,22507
New Jersey,Smithville,7090,1790,3108,658,73,386,6015
New Jersey,Beverly,2569,787,785,332,96,115,2115
New Jersey,Somers Point,10776,3432,3493,1142,238,589,8894
New Jersey,Somerset,24409,5856,10701,1817,233,1381,19988
New Jersey,Somerdale borough,5298,1595,2046,418,97,380,4536
New Jersey,Society Hill,3651,1247,1538,154,59,78,3076
New Jersey,Skillman,115,10,67,7,0,9,93
New Jersey,Belford,1513,395,672,85,26,46,1224
New Jersey,Bernardsville borough,7786,1504,4137,258,41,187,6127
New Jersey,Beckett,4809,1317,1953,422,59,168,3919
New Jersey,Hampton borough,1213,307,573,79,26,70,1055
New Jersey,Beachwood borough,11128,2872,4679,706,158,449,8864
New Jersey,Wallington borough,11584,2871,5434,777,192,548,9822
New Jersey,Waldwick borough,9902,2221,4782,529,51,366,7949
New Jersey,Voorhees,1058,389,286,64,13,56,808
New Jersey,Vista Center,2158,230,1658,97,0,78,2063
New Jersey,Villas,9029,2385,3550,978,201,503,7617
New Jersey,Vienna,796,150,444,64,0,17,675
New Jersey,Wanamassa,4542,1112,1933,418,64,84,3611
New Jersey,Victory Lakes,1751,485,805,50,57,116,1513
New Jersey,Vernon Valley,1427,307,796,101,0,41,1245
New Jersey,Vernon Center,1892,542,542,254,118,115,1571
New Jersey,Ventnor City,10593,3121,3916,1235,208,673,9153
New Jersey,Upper Stewartsville,171,34,80,43,0,11,168
New Jersey,Upper Saddle River borough,8335,1359,4243,284,24,261,6171
New Jersey,Upper Pohatcong,1470,264,712,100,47,98,1221
New Jersey,Victory Gardens borough,1593,480,498,176,12,42,1208
New Jersey,Beattystown,4403,1015,1866,417,81,299,3678
New Jersey,New Village,443,124,187,42,0,21,374
New Jersey,North Beach Haven,2130,382,1337,151,0,169,2039
New Jersey,Beach Haven West,4076,995,2198,319,51,243,3806
New Jersey,Beach Haven borough,991,148,537,125,8,100,918
New Jersey,Bayonne,65378,20842,23218,5115,1157,3296,53628
New Jersey,Bay Head borough,992,152,573,57,7,53,842
New Jersey,Haworth borough,3451,622,1844,161,17,117,2761
New Jersey,Hawthorne borough,18989,4707,7890,1600,352,863,15412
New Jersey,North Arlington borough,15734,4114,6539,1164,431,943,13191
New Jersey,Egg Harbor City,4246,1438,1271,432,98,183,3422
New Jersey,Ellisburg,4301,1017,1702,308,52,443,3522
New Jersey,Elmer borough,1460,364,560,134,27,77,1162
New Jersey,Elmwood Park borough,19959,5379,8426,1170,339,1010,16324
New Jersey,Elwood,1635,616,574,37,61,23,1311
New Jersey,Emerson borough,7616,1694,3701,312,90,526,6323
New Jersey,Englewood,27992,8257,10618,2224,538,1305,22942
New Jersey,Elizabeth,127759,43896,35023,9406,4841,4987,98153
New Jersey,Vineland,60987,18327,20993,5381,1041,3154,48896
New Jersey,Saddle River borough,3229,693,1720,108,26,249,2796
New Jersey,Singac,5108,1503,1698,531,78,269,4079
New Jersey,Rockaway borough,6490,1591,2833,599,45,285,5353
New Jersey,Robertsville,11334,2564,5650,520,52,442,9228
New Jersey,Robbinsville,3326,421,1530,281,15,222,2469
New Jersey,Riverton borough,2766,598,1261,218,59,154,2290
New Jersey,River Edge borough,11566,2658,5576,510,49,623,9416
New Jersey,Riverdale borough,4154,1022,1848,476,14,193,3553
New Jersey,Rio Grande,2499,547,1318,152,50,126,2193
New Jersey,Ringwood borough,12387,2888,6047,609,33,301,9878
New Jersey,Edgewater borough,11935,2873,5137,941,109,526,9586
New Jersey,Eatontown borough,12298,3478,4771,1370,221,471,10311
New Jersey,East Rutherford borough,9076,2782,3780,496,203,466,7727
New Jersey,East Rocky Hill,208,0,137,14,0,17,168
New Jersey,East Orange,64578,27649,13075,5828,2616,3346,52514
New Jersey,East Newark borough,2577,922,789,220,63,52,2046
New Jersey,East Millstone,481,78,252,72,0,0,402
New Jersey,East Freehold,5633,1242,2943,180,42,164,4571
New Jersey,East Franklin,7493,2103,2777,528,61,354,5823
New Jersey,Dunellen borough,7368,1848,2831,550,280,317,5826
New Jersey,Dumont borough,17820,4299,8054,1079,151,970,14553
New Jersey,Dover Beaches South,1185,225,611,136,25,155,1152
New Jersey,Dover Beaches North,1157,140,605,178,0,198,1121
New Jersey,Dover,18324,5598,6686,1384,479,922,15069
New Jersey,Diamond Beach,145,10,110,18,0,7,145
New Jersey,Demarest borough,5004,904,2731,93,7,272,4007
New Jersey,Delaware Park,728,167,322,69,32,48,638
New Jersey,Delaware,78,17,14,14,0,9,54
New Jersey,Deal borough,757,164,367,73,8,74,686
New Jersey,Rockleigh borough,576,119,188,42,16,134,499
New Jersey,Rocky Hill borough,615,128,299,47,0,19,493
New Jersey,Roebling,3550,888,1464,308,64,194,2918
New Jersey,Roosevelt borough,800,150,379,65,2,46,642
New Jersey,Silver Ridge,1299,183,609,152,32,323,1299
New Jersey,Silver Lake CDP (Warren County),328,65,126,22,10,25,248
New Jersey,Silver Lake CDP (Essex County),3908,1224,1196,359,152,251,3182
New Jersey,Shrewsbury borough,3923,779,1895,121,70,253,3118
New Jersey,Short Hills,12831,1671,6842,203,61,494,9271
New Jersey,Ship Bottom borough,914,127,576,82,16,60,861
New Jersey,Shiloh borough,492,139,233,35,8,17,432
New Jersey,Shark River Hills,3721,725,1836,452,0,194,3207
New Jersey,Sewaren,2530,907,974,188,7,131,2207
New Jersey,Secaucus,18170,4745,8134,1095,222,1157,15353
New Jersey,Seaside Park borough,1543,304,788,178,5,141,1416
New Jersey,Seaside Heights borough,2885,1129,572,499,0,132,2332
New Jersey,Sea Isle City,1788,248,1097,132,15,213,1705
New Jersey,Six Mile Run,3002,669,1395,32,23,215,2334
New Jersey,Sea Girt borough,1683,312,928,68,5,176,1489
New Jersey,Sea Bright borough,1387,470,469,204,22,80,1245
New Jersey,Sayreville borough,44051,11379,19441,2690,659,2016,36185
New Jersey,Salem,4997,1925,976,428,126,313,3768
New Jersey,Upper Montclair,11753,2081,5699,689,63,273,8805
New Jersey,Rutherford borough,18434,5265,8072,1079,154,936,15506
New Jersey,Runnemede borough,8414,2371,2925,924,145,474,6839
New Jersey,Rumson borough,6993,1313,3386,345,75,189,5308
New Jersey,Rossmoor,2823,308,1346,493,25,651,2823
New Jersey,Ross Corner,0,0,0,0,0,0,0
New Jersey,Rosenhayn,1226,337,385,191,107,56,1076
New Jersey,Roselle Park borough,13555,3660,5808,806,184,465,10923
New Jersey,Roselle borough,21466,8177,6670,1210,363,1131,17551
New Jersey,Roseland borough,5853,965,2935,570,18,315,4803
New Jersey,Seabrook Farms,993,229,313,15,0,62,619
New Jersey,Union City,68656,24666,20577,5456,2655,2660,56014
New Jersey,Spring Lake borough,2989,592,1463,318,9,186,2568
New Jersey,Twin Rivers,7303,2006,2987,548,51,274,5866
New Jersey,Wildwood,5234,1280,2045,589,149,283,4346
New Jersey,Wildwood Crest borough,3227,476,1691,360,22,261,2810
New Jersey,Williamstown,15539,3676,6098,1387,164,1030,12355
New Jersey,Woodbine borough,2710,1252,594,154,53,108,2161
New Jersey,Woodbridge,19822,4806,8521,1445,181,921,15874
New Jersey,Woodbury,10087,3333,3238,876,237,509,8193
New Jersey,Woodbury Heights borough,3022,630,1406,257,24,188,2505
New Jersey,Woodcliff Lake borough,5818,1027,3145,213,31,262,4678
New Jersey,Woodland Park borough,12267,3323,5132,899,240,573,10167
New Jersey,Woodlynne borough,2970,1217,645,228,113,81,2284
New Jersey,Wood-Ridge borough,7938,2081,3441,501,133,554,6710
New Jersey,Woodstown borough,3562,909,1319,349,53,239,2869
New Jersey,Wrightstown borough,821,375,193,96,18,15,697
New Jersey,Yardville,6868,1410,3393,451,85,419,5758
New Jersey,Whittingham,2570,201,1846,55,7,403,2512
New Jersey,Yorketown,6547,1439,3358,265,39,191,5292
New Jersey,Leisure Knoll,2378,129,1228,257,32,732,2378
New Jersey,Lebanon borough,1836,553,706,168,28,92,1547
New Jersey,Lawrenceville,3825,934,1738,483,28,152,3335
New Jersey,Lawnside borough,2926,985,895,274,92,205,2451
New Jersey,Lavallette borough,2108,294,1217,152,30,215,1908
New Jersey,Laurence Harbor,7232,2271,2734,592,142,295,6034
New Jersey,Laurel Springs borough,1923,563,757,160,30,104,1614
New Jersey,Laurel Lake,3193,754,925,466,49,163,2357
New Jersey,Lambertville,3851,1083,1434,690,42,92,3341
New Jersey,Lakewood,53591,11455,16209,914,362,1058,29998
New Jersey,Lake Telemark,1340,385,559,66,15,31,1056
New Jersey,Lake Mohawk,9635,2120,4534,605,74,614,7947
New Jersey,Lakehurst borough,2669,691,1007,145,56,116,2015
New Jersey,Lake Como borough,1489,491,529,132,18,112,1282
New Jersey,Zarephath,0,0,0,0,0,0,0
New Jersey,Whitesboro,2500,715,599,147,73,237,1771
New Jersey,White Meadow Lake,8943,1722,4712,360,59,269,7122
New Jersey,White House Station,1936,513,701,337,74,147,1772
New Jersey,Ashland,8548,2100,3812,546,84,533,7075
New Jersey,Atlantic City,39547,14505,8887,3561,1663,2161,30777
New Jersey,Atlantic Highlands borough,4346,1018,2024,259,75,242,3618
New Jersey,Audubon borough,8772,2242,3661,701,92,615,7311
New Jersey,Audubon Park borough,1010,283,356,158,30,110,937
New Jersey,Avalon borough,1596,230,1034,104,8,113,1489
New Jersey,Avenel,18793,6485,7146,1179,247,899,15956
New Jersey,Avon-by-the-Sea borough,1809,481,744,183,43,163,1614
New Jersey,Barclay,4376,755,2397,199,9,196,3556
New Jersey,Barnegat,3180,965,1272,283,55,83,2658
New Jersey,Barnegat Light borough,589,94,359,26,3,65,547
New Jersey,Barrington borough,6877,1926,2517,659,49,539,5690
New Jersey,Little Silver borough,5937,969,3016,269,15,171,4440
New Jersey,Little Ferry borough,10856,3163,4615,783,168,535,9264
New Jersey,Linwood,7036,1274,3178,537,73,562,5624
New Jersey,Lindenwold borough,17492,6454,4643,1639,458,1065,14259
New Jersey,Linden,41322,14025,14295,3046,970,2187,34523
New Jersey,White Horse,8447,2282,3887,533,117,637,7456
New Jersey,Wharton borough,6607,2274,2137,571,199,286,5467
New Jersey,Westwood borough,11140,2556,5094,592,76,692,9010
New Jersey,West Wildwood borough,448,91,233,39,5,54,422
New Jersey,Westville borough,4247,1293,1428,400,156,258,3535
New Jersey,Weston,2008,233,1339,91,41,198,1902
New Jersey,Kinnelon borough,10372,2172,5341,392,53,381,8339
New Jersey,Leisuretowne,3454,456,1751,434,0,761,3402
New Jersey,Leisure Village East,3721,288,1774,548,63,1032,3705
New Jersey,Leisure Village West,3072,323,1145,458,50,1096,3072
New Jersey,Leonardo,2495,647,989,307,6,116,2065
New Jersey,Leonia borough,9129,1873,4367,538,188,532,7498
New Jersey,Lincoln Park borough,10478,2423,4680,1046,22,607,8778
New Jersey,Lincroft,6431,1116,3432,215,13,285,5061
New Jersey,Leisure Village,4340,1123,1022,779,17,1167,4108
New Jersey,Union Beach borough,5885,1838,2073,601,58,287,4857
New Jersey,Kingston Estates,6573,1645,2865,291,125,439,5365
New Jersey,Keyport borough,7195,1827,2646,653,143,522,5791
New Jersey,South Bound Brook borough,4612,1483,1624,392,32,215,3746
New Jersey,South Plainfield borough,23871,6010,10641,1627,198,1277,19753
New Jersey,South River borough,16274,5282,5933,1054,164,1053,13486
New Jersey,South Toms River borough,3706,1191,1165,297,18,135,2806
New Jersey,Spotswood borough,8413,1798,3790,581,111,686,6966
New Jersey,Springdale,14145,2669,7282,825,100,718,11594
New Jersey,Dayton,7388,1589,3466,306,31,282,5674
New Jersey,Spring Lake Heights borough,4683,1196,2122,483,116,250,4167
New Jersey,Stanhope borough,3509,750,1515,341,57,176,2839
New Jersey,Stewartsville,276,65,108,16,37,20,246
New Jersey,Stockton borough,624,181,241,63,23,11,519
New Jersey,Stone Harbor borough,875,149,508,67,3,94,821
New Jersey,Stratford borough,7007,2130,2842,490,109,363,5934
New Jersey,Strathmere,191,70,88,0,0,33,191
New Jersey,South Amboy,8787,2325,3564,866,108,620,7483
New Jersey,Strathmore,7010,1531,3628,244,6,395,5804
New Jersey,Summit,21869,3995,10759,1167,141,749,16811
New Jersey,Surf City borough,1130,246,582,102,24,121,1075
New Jersey,Sussex borough,1972,514,669,249,60,107,1599
New Jersey,Swedesboro borough,2612,674,1085,143,29,107,2038
New Jersey,Tavistock borough,8,2,6,0,0,0,8
New Jersey,Tenafly borough,14788,2245,7376,635,64,570,10890
New Jersey,Ten Mile Run,1504,360,785,112,0,69,1326
New Jersey,Teterboro borough,85,10,34,17,2,10,73
New Jersey,Tinton Falls borough,17872,4160,7469,1301,164,2346,15440
New Jersey,Toms River,88687,20798,38284,7559,1022,5358,73021
New Jersey,Totowa borough,10931,3572,4227,442,149,754,9144
New Jersey,Trenton,84632,35231,19411,6115,2854,3517,67128
New Jersey,Tuckerton borough,3364,736,1431,318,11,292,2788
New Jersey,Turnersville,3521,720,1730,155,20,138,2763
New Jersey,Succasunna,8859,1913,4740,311,30,385,7379
New Jersey,Somerville borough,12212,3510,4762,958,120,576,9926
New Jersey,Heathcote,5802,1558,2359,574,38,122,4651
New Jersey,Helmetta borough,2350,595,1013,208,66,75,1957
New Jersey,Kenvil,2854,723,1325,114,43,180,2385
New Jersey,Kenilworth borough,8104,1933,3883,464,67,441,6788
New Jersey,Kendall Park,10323,2176,4922,407,62,563,8130
New Jersey,Kearny,41866,11734,16464,3016,809,1834,33857
New Jersey,Keansburg borough,9967,3341,3378,1096,153,647,8615
New Jersey,Juliustown,301,62,161,21,13,22,279
New Jersey,Johnsonburg,95,10,22,37,0,0,69
New Jersey,Jersey City,259651,91161,89833,16946,6173,10048,214161
New Jersey,Jamesburg borough,5978,1199,2561,531,49,148,4488
New Jersey,Island Heights borough,1640,370,773,133,30,100,1406
New Jersey,Iselin,19146,4029,9900,800,303,920,15952
New Jersey,Interlaken borough,795,139,452,59,5,54,709
New Jersey,Hutchinson,126,8,92,0,0,0,100
New Jersey,Hopewell borough,1845,325,868,188,51,60,1492
New Jersey,Hope,193,34,107,0,0,18,159
New Jersey,Hopatcong borough,14802,3646,6797,1169,157,622,12391
New Jersey,Holiday Heights,2120,192,1211,47,9,661,2120
New Jersey,High Bridge borough,3581,783,1500,411,15,118,2827
New Jersey,Highland Lakes,4862,875,2364,312,180,135,3866
New Jersey,Highland Park borough,14263,3920,5497,1034,287,460,11198
New Jersey,Highlands borough,4947,1906,1836,452,111,144,4449
New Jersey,Hightstown borough,5529,1474,2030,612,87,306,4509
New Jersey,Hillsdale borough,10452,2096,4982,428,226,460,8192
New Jersey,Kingston,1274,273,576,114,0,91,1054
New Jersey,Hi-Nella borough,831,278,258,59,32,45,672
New Jersey,Ho-Ho-Kus borough,4132,733,2137,145,53,131,3199
New Jersey,Holiday City-Berkeley,12132,1290,5965,1621,114,3132,12122
New Jersey,Newton,8036,2448,2612,752,280,689,6781
New Jersey,New Providence borough,12355,2210,6055,432,104,548,9349
New Jersey,Englewood Cliffs borough,5369,840,2908,280,49,227,4304
New Jersey,Holiday City South,4087,724,1979,349,49,854,3955
New Jersey,Hoboken,52452,25397,16125,2662,437,1424,46045
New Jersey,Crestwood Village,7958,803,3378,1369,86,2322,7958
New Jersey,Echelon,11276,3537,4298,1025,93,587,9540
New Jersey,Crandon Lakes,1371,338,564,93,0,121,1116
New Jersey,Guttenberg,11595,3729,3408,1783,342,485,9747
New Jersey,Groveville,2879,711,1470,124,0,62,2367
New Jersey,Griggstown,911,159,470,58,28,16,731
New Jersey,Greenwich,2586,462,1157,98,14,75,1806
New Jersey,Greentree,11283,2377,5662,454,208,421,9122
New Jersey,Green Knoll,6403,1389,2856,376,77,530,5228
New Jersey,Hackensack,44035,14903,15118,4425,973,2178,37597
New Jersey,Great Meadows,316,3,163,1,0,16,183
New Jersey,Gloucester City,11386,3682,3610,867,201,658,9018
New Jersey,Glen Rock borough,11859,2018,5976,392,61,534,8981
New Jersey,Glen Ridge borough,7607,1373,3725,365,0,151,5614
New Jersey,Glen Gardner borough,1560,413,633,181,37,96,1360
New Jersey,Glendora,4442,1114,1774,311,105,419,3723
New Jersey,Glassboro borough,18958,8659,5753,1057,267,492,16228
New Jersey,Golden Triangle,3888,1069,1466,283,173,315,3306
New Jersey,Hackettstown,9579,2790,3938,634,63,499,7924
New Jersey,Haddonfield borough,11474,1793,5712,691,88,511,8795
New Jersey,Haddon Heights borough,7497,1823,3140,631,72,474,6140
New Jersey,West Long Branch borough,7974,2991,3027,450,64,330,6862
New Jersey,West Freehold,14000,2857,6982,823,61,633,11356
New Jersey,Westfield,30552,5640,15336,1211,141,1245,23573
New Jersey,West Cape May borough,966,294,388,104,15,56,857
New Jersey,West Belmar,2424,646,807,509,42,99,2103
New Jersey,Wenonah borough,2199,511,1024,134,15,89,1773
New Jersey,Watchung borough,5900,1743,2707,242,0,376,5068
New Jersey,Washington borough,6466,1590,2513,649,185,143,5080
New Jersey,Waretown,1773,389,857,192,17,105,1560
New Jersey,Wanaque borough,11617,2934,5360,824,96,836,10050
New Jersey,Hammonton,14735,4304,5770,1256,130,999,12459
New Jersey,Hamilton Square,13456,3284,6534,759,135,641,11353
New Jersey,Hamburg borough,3209,685,1483,294,0,179,2641
New Jersey,Haledon borough,8412,2509,2925,619,252,515,6820
New Jersey,Hainesburg,70,9,41,16,0,0,66
New Jersey,Gibbstown,3775,696,1765,327,38,321,3147
New Jersey,West New York,51860,17647,16554,4537,1550,2530,42818
New Jersey,Gibbsboro borough,2236,552,1028,137,36,117,1870
New Jersey,Garfield,31265,8829,11337,2411,677,1652,24906
New Jersey,Fanwood borough,7479,1225,3565,383,1,402,5576
New Jersey,Fairview,3843,952,1750,208,19,157,3086
New Jersey,Fairview borough,14233,4890,5052,1171,367,770,12250
New Jersey,Fairton,1117,298,401,112,37,81,929
New Jersey,Fair Lawn borough,33164,6888,15566,2357,346,2062,27219
New Jersey,Fair Haven borough,6075,821,3134,228,6,248,4437
New Jersey,Far Hills borough,1052,269,506,93,8,12,888
New Jersey,Estell Manor,1728,414,878,125,19,32,1468
New Jersey,Erma,2238,491,1096,90,34,119,1830
New Jersey,Englishtown borough,2186,570,862,182,25,160,1799
New Jersey,Burleigh,404,98,277,7,0,0,382
New Jersey,Buena borough,4566,1075,1680,467,57,457,3736
New Jersey,Budd Lake,8403,2050,3582,619,75,179,6505
New Jersey,Brownville,2727,770,933,387,17,123,2230
New Jersey,Essex Fells borough,2153,375,1118,113,7,63,1676
New Jersey,Farmingdale borough,1434,424,513,120,42,58,1157
New Jersey,Fieldsboro borough,624,190,214,54,6,22,486
New Jersey,Finderne,6333,1799,2439,644,94,343,5319
New Jersey,Frenchtown borough,1444,420,576,175,9,69,1249
New Jersey,Cresskill borough,8729,1576,4461,347,0,527,6911
New Jersey,Franklin Park,15238,4111,6140,1207,118,566,12142
New Jersey,Franklin Lakes borough,10799,2254,5850,364,8,515,8991
New Jersey,Franklin Center,4275,599,2661,292,23,347,3922
New Jersey,Franklin borough,4944,1117,1953,578,117,278,4043
New Jersey,Fort Lee borough,36251,8126,17489,2485,528,2701,31329
New Jersey,Fort Dix,8305,3447,2354,993,383,35,7212
New Jersey,Forked River,5194,1438,2211,396,5,372,4422
New Jersey,Fords,15085,3932,6822,928,116,672,12470
New Jersey,Folsom borough,1891,411,795,160,52,129,1547
New Jersey,Florham Park borough,11802,3746,5124,598,151,450,10069
New Jersey,Florence,4409,1304,1536,423,90,420,3773
New Jersey,Flemington borough,4676,1117,1654,553,193,237,3754
New Jersey,Finesville,210,9,132,0,0,0,141
New Jersey,Garwood borough,4306,1253,1787,309,47,183,3579
New Jersey,Browns Mills,10831,3362,3427,1251,257,448,8745
New Jersey,Burlington,9868,3136,3340,913,181,689,8259
New Jersey,Buttzville,165,48,117,0,0,0,165
New Jersey,New Milford borough,16640,4174,7678,819,252,842,13765
New Jersey,Asbury,304,54,116,85,0,26,281
New Jersey,Asbury Park,15945,6999,2951,1463,462,789,12664
New Jersey,Camden,76904,33475,12364,4895,2309,2982,56025
New Jersey,Califon borough,1283,208,653,65,5,23,954
New Jersey,North Caldwell borough,6415,913,3492,174,16,278,4873
New Jersey,Annandale,1413,326,634,149,0,41,1150
New Jersey,North Cape May,2751,613,1172,301,56,218,2360
New Jersey,North Haledon borough,8507,1439,4462,638,92,501,7132
New Jersey,North Middletown,3212,793,1271,214,57,142,2477
New Jersey,North Plainfield borough,22156,6048,8719,1521,501,617,17406
New Jersey,Northvale borough,4763,1142,2266,222,45,234,3909
New Jersey,North Wildwood,3957,715,1841,358,26,462,3402
New Jersey,Norwood borough,5823,1053,3171,392,27,275,4918
New Jersey,Northfield,8597,2004,3595,710,115,478,6902
New Jersey,Andover borough,662,145,340,52,0,44,581
New Jersey,Anderson,294,58,170,17,0,34,279
New Jersey,Hasbrouck Heights borough,12100,3296,5137,850,64,722,10069
New Jersey,Absecon,8394,1933,3562,886,91,564,7036
New Jersey,Allamuchy,116,17,61,0,0,0,78
New Jersey,Allendale borough,6717,1107,3108,518,35,336,5104
New Jersey,Allenhurst borough,486,142,182,62,7,24,417
New Jersey,Allentown borough,1888,511,782,155,22,100,1570
New Jersey,Allenwood,973,235,487,38,0,63,823
New Jersey,Alloway,1686,305,845,52,7,113,1322
New Jersey,Alpha borough,2272,451,995,200,51,142,1839
New Jersey,Alpine borough,1559,359,843,54,6,101,1363
New Jersey,Hancocks Bridge,210,51,57,30,0,0,138
New Jersey,Harlingen,188,25,105,25,0,0,155
New Jersey,Harmony,382,75,184,22,18,22,321
New Jersey,Harrington Park borough,4764,814,2513,219,0,152,3698
New Jersey,Harrison,14629,4594,5704,900,336,495,12029
New Jersey,Harvey Cedars borough,416,43,275,22,3,49,392
New Jersey,Oakhurst,3727,751,1901,184,8,155,2999
New Jersey,Butler borough,7659,2048,3080,789,120,352,6389
New Jersey,Oakland borough,13003,2727,6213,789,124,533,10386
New Jersey,Oak Valley,3325,905,1366,223,60,259,2813
New Jersey,Peapack and Gladstone borough,2588,556,1160,186,20,157,2079
New Jersey,Pedricktown,516,125,177,54,13,22,391
New Jersey,Pemberton borough,1485,350,623,173,32,55,1233
New Jersey,Pemberton Heights,2595,774,983,163,92,200,2212
New Jersey,Pennington borough,2599,501,1267,161,22,195,2146
New Jersey,Penns Grove borough,5032,1894,1070,354,133,187,3638
New Jersey,Paulsboro borough,6025,2164,1645,419,119,233,4580
New Jersey,Pennsville,11623,2719,4867,1274,206,703,9769
New Jersey,Phillipsburg,14608,4195,5179,1148,425,986,11933
New Jersey,Pine Beach borough,2175,488,1031,116,0,157,1792
New Jersey,Pine Hill borough,10419,3415,3223,839,344,500,8321
New Jersey,Pine Lake Park,9064,1820,4246,561,91,376,7094
New Jersey,Caldwell borough,7902,2433,3127,811,67,362,6800
New Jersey,Byram Center,39,16,13,5,0,0,34
New Jersey,Perth Amboy,52179,17981,15668,3433,1184,1899,40165
New Jersey,Paterson,146987,57146,38377,8153,4354,5485,113515
New Jersey,Passaic,70618,26090,18907,2738,1378,2244,51357
New Jersey,Park Ridge borough,8820,1836,3979,553,71,576,7015
New Jersey,Ocean Acres,16000,3715,7117,1206,110,727,12875
New Jersey,Ocean City,11470,2535,5453,990,141,973,10092
New Jersey,Ocean Gate borough,2105,624,686,330,8,133,1781
New Jersey,Ocean Grove,3015,978,938,489,43,385,2833
New Jersey,Oceanport borough,5800,1178,2563,599,0,327,4667
New Jersey,Ogdensburg borough,2432,528,1071,180,43,123,1945
New Jersey,Old Bridge,23550,5764,11297,956,175,1227,19419
New Jersey,Old Tappan borough,5922,1201,3109,163,0,330,4803
New Jersey,Olivet,1444,172,845,40,9,95,1161
New Jersey,Oradell borough,8146,1391,4116,369,109,347,6332
New Jersey,Oxford,1069,317,420,98,11,97,943
New Jersey,Palisades Park borough,20364,6764,9008,1088,296,687,17843
New Jersey,Palmyra borough,7356,2252,2898,637,169,350,6306
New Jersey,Panther Valley,3518,836,1555,435,18,200,3044
New Jersey,Paramus borough,26760,6193,12859,1471,77,2071,22671
New Jersey,Oaklyn borough,4004,1100,1702,318,12,275,3407
New Jersey,Brooklawn borough,1944,654,597,231,66,98,1646
New Jersey,Freehold borough,11978,3501,4231,804,245,497,9278
New Jersey,Brookdale,9813,2398,4406,436,152,524,7916
New Jersey,Ridgefield borough,11256,2891,5188,796,142,576,9593
New Jersey,Ridgefield Park village,12969,3426,5267,887,181,585,10346
New Jersey,Ridgewood village,25370,4414,12349,1343,49,836,18991
New Jersey,Cape May,3553,1200,1461,200,0,383,3244
New Jersey,Cape May Court House,5472,1331,2431,377,54,398,4591
New Jersey,Carlstadt borough,6225,2022,2601,374,79,295,5371
New Jersey,Richwood,3130,787,1497,176,27,43,2530
New Jersey,Carneys Point,7162,1730,2594,780,157,627,5888
New Jersey,Cedar Glen Lakes,1459,119,590,249,52,449,1459
New Jersey,Cedar Glen West,1001,165,382,174,0,280,1001
New Jersey,Cedarville,681,205,262,21,18,80,586
New Jersey,Brookfield,638,44,326,50,0,218,638
New Jersey,Cherry Hill Mall,13829,3675,5924,949,191,771,11510
New Jersey,Chesilhurst borough,1662,539,505,257,28,142,1471
New Jersey,Carteret borough,23965,7823,9007,1297,346,1071,19544
New Jersey,Chester borough,1612,309,718,121,20,73,1241
New Jersey,Red Bank borough,12238,4753,3139,1178,251,761,10082
New Jersey,Ramtown,6050,1590,2870,205,20,217,4902
New Jersey,Lopatcong Overlook,545,76,213,98,9,61,457
New Jersey,Long Valley,1835,327,889,87,0,118,1421
New Jersey,Longport borough,999,135,532,101,27,146,941
New Jersey,Long Branch,30721,9280,10186,2711,580,1315,24072
New Jersey,Lodi borough,24590,8039,8068,2199,602,1204,20112
New Jersey,Loch Arbour village,189,62,77,14,0,3,156
New Jersey,Raritan borough,7328,1636,3254,555,124,385,5954
New Jersey,Prince,28936,10526,11530,1453,199,808,24516
New Jersey,Princeton Meadows,13839,3595,6208,702,131,372,11008
New Jersey,Prospect Park borough,5924,1801,1799,331,142,334,4407
New Jersey,Quinton,596,116,267,50,0,35,468
New Jersey,Rahway,28644,8632,10370,2191,847,1462,23502
New Jersey,Ramblewood,5823,1345,2613,480,93,312,4843
New Jersey,Ramsey borough,14889,2621,7655,983,60,723,12042
New Jersey,Princeton Junction,2423,381,1391,106,0,64,1942
New Jersey,McGuire AFB,5113,754,2204,115,47,0,3120
New Jersey,Pine Ridge at Crestwood,2247,341,1096,399,50,361,2247
New Jersey,Pitman borough,8932,1949,3784,770,137,635,7275
New Jersey,Cliffside Park borough,24493,6372,10756,2156,297,1614,21195
New Jersey,Cliffwood Beach,3151,728,1326,273,59,162,2548
New Jersey,Clifton,85552,25555,33312,5684,1211,4274,70036
New Jersey,Clinton,2681,637,1084,253,27,125,2126
New Jersey,Closter borough,8582,1638,4579,342,17,233,6809
New Jersey,Clyde,253,71,105,0,0,0,176
New Jersey,Clementon borough,4968,1591,1571,463,196,232,4053
New Jersey,Collings Lakes,1242,352,511,102,0,72,1037
New Jersey,Colonia,17517,4319,8166,881,144,946,14456
New Jersey,Columbia,331,57,114,6,38,24,239
New Jersey,Concordia,3227,175,1838,312,0,889,3214
New Jersey,Corbin City,482,121,210,48,9,21,409
New Jersey,Country Lake Estates,3658,1149,1517,203,57,212,3138
New Jersey,Cranbury,2283,504,1083,120,12,110,1829
New Jersey,Collingswood borough,13925,4271,4915,1425,198,891,11700
New Jersey,Pine Valley borough,3,0,3,0,0,0,3
New Jersey,Clearbrook Park,2713,101,1418,302,56,789,2666
New Jersey,Presidential Lakes Estates,2235,472,1055,38,81,134,1780
New Jersey,Plainfield,50678,19963,12805,3782,1600,2142,40292
New Jersey,Plainsboro Center,2785,556,1443,128,30,118,2275
New Jersey,Pleasant Plains,694,172,407,0,0,19,598
New Jersey,Pleasantville,20518,7278,4726,1951,1047,1182,16184
New Jersey,Point Pleasant borough,18426,4688,8294,1382,197,789,15350
New Jersey,Point Pleasant Beach borough,4604,1146,2118,397,48,159,3868
New Jersey,Clayton borough,8292,1970,3219,681,307,359,6536
New Jersey,Pomona,7495,1691,3174,360,89,517,5831
New Jersey,Port Colden,126,71,55,0,0,0,126
New Jersey,Port Monmouth,3568,876,1444,328,85,156,2889
New Jersey,Port Murray,96,50,31,15,0,0,96
New Jersey,Port Norris,1282,406,342,147,34,59,988
New Jersey,Port Reading,3634,882,1497,197,31,232,2839
New Jersey,Port Republic,996,230,493,58,9,62,852
New Jersey,Pompton Lakes borough,11179,2746,4793,840,104,841,9324
New Jersey,Madison borough,16091,4608,6578,874,150,796,13006
New Jersey,Chatham borough,9011,1591,4131,423,29,315,6489
New Jersey,Madison Park,6690,2009,2751,490,146,243,5639
New Jersey,Newfield borough,1616,396,698,154,47,59,1354
New Jersey,New Egypt,2016,476,746,238,62,134,1656
New Jersey,New Brunswick,56338,30208,10207,2329,1342,961,45047
New Jersey,Newark,279793,117160,60794,20322,10157,11519,219952
New Jersey,Netcong borough,3258,1217,1137,347,19,108,2828
New Jersey,Neptune City borough,4834,1414,1630,672,90,206,4012
New Jersey,Navesink,1738,468,679,187,0,63,1397
New Jersey,National Park borough,3005,871,1049,333,72,107,2432
New Jersey,Mystic Island,7864,1675,3703,641,95,688,6802
New Jersey,Mullica Hill,4377,1200,2079,230,32,166,3707
New Jersey,Mount Hermon,108,16,62,7,3,3,91
New Jersey,Mount Ephraim borough,4646,1626,1540,244,103,333,3846
New Jersey,Mount Arlington borough,5187,1042,2521,463,99,480,4605
New Jersey,Mountainside borough,6832,1267,3381,284,45,520,5497
New Jersey,Mountain Lakes borough,4262,900,2162,190,0,73,3325
New Jersey,Blackwells Mills,503,124,313,15,0,0,452
New Jersey,Mountain Lake,579,146,298,34,20,44,542
New Jersey,Blackwood,4662,1214,1935,279,111,243,3782
New Jersey,Blawenburg,343,28,173,20,0,13,234
New Jersey,Broadway,194,34,75,11,0,36,156
New Jersey,Brigantine,9347,2529,4225,913,71,535,8273
New Jersey,Brielle borough,4769,846,2463,317,82,171,3879
New Jersey,Bridgeville,173,56,86,0,0,0,142
New Jersey,Bridgeton,25201,10314,5232,1649,813,810,18818
New Jersey,Branchville borough,889,219,369,81,11,37,717
New Jersey,Brainards,189,52,98,16,0,3,169
New Jersey,Bradley Gardens,13994,3105,6213,828,77,583,10806
New Jersey,Bradley Beach borough,4297,1397,1458,543,124,178,3700
New Jersey,Bound Brook borough,10515,3337,3647,1104,124,433,8645
New Jersey,Bordentown,3903,1123,1092,730,51,230,3226
New Jersey,Boonton,8422,2361,3454,604,84,375,6878
New Jersey,Bogota borough,8329,2417,3327,734,110,323,6911
New Jersey,Bloomsbury borough,720,124,376,57,12,20,589
New Jersey,Bloomingdale borough,7933,2094,3218,696,185,561,6754
New Jersey,Blairstown,540,256,67,100,0,38,461
New Jersey,Morristown,18563,7531,5904,1530,294,614,15873
New Jersey,Brass Castle,1575,283,885,17,31,128,1344
New Jersey,Morganville,4999,954,2527,200,21,153,3855
New Jersey,Medford Lakes borough,4124,741,2118,254,35,192,3340
New Jersey,Maywood borough,9694,2703,4229,597,32,583,8144
New Jersey,Mays Landing,1932,435,732,294,23,96,1580
New Jersey,Matawan borough,8887,2216,3843,625,55,516,7255
New Jersey,Martinsville,11950,2386,6401,509,65,647,10008
New Jersey,Marlton,10271,3071,4350,759,114,535,8829
New Jersey,Mendham borough,5016,854,2468,259,18,256,3855
New Jersey,Marksboro,96,26,37,14,0,5,82
New Jersey,Manville borough,10454,2892,4012,835,281,701,8721
New Jersey,Mantoloking borough,340,39,242,8,10,25,324
New Jersey,Manasquan borough,5830,1457,2813,442,38,360,5110
New Jersey,Manahawkin,2474,759,875,235,40,137,2046
New Jersey,Morris Plains borough,5598,1283,2645,269,60,335,4592
New Jersey,Magnolia borough,4314,1430,1504,385,78,211,3608
New Jersey,Margate City,6304,1328,3009,652,76,738,5803
New Jersey,Mercerville,13371,3400,5695,759,209,1101,11164
New Jersey,Cape May Point borough,240,51,143,7,3,36,240
New Jersey,Milltown borough,6989,1511,3378,393,16,436,5734
New Jersey,Monmouth Beach borough,3258,556,1673,203,70,199,2701
New Jersey,Millville,28515,7902,8751,3031,755,1705,22144
New Jersey,Merchantville borough,3793,979,1382,357,100,236,3054
New Jersey,Monmouth Junction,3267,772,1593,187,0,87,2639
New Jersey,Millstone borough,487,123,194,40,6,14,377
New Jersey,Milford borough,1123,290,469,127,7,62,955
New Jersey,Moonachie borough,2753,660,1177,209,50,193,2289
New Jersey,Middlesex borough,13831,3587,5912,997,133,719,11348
New Jersey,Middlebush,2478,562,1140,146,0,221,2069
New Jersey,Metuchen borough,13765,2939,6204,880,99,669,10791
New Jersey,Moorestown-Lenola,14217,3241,6221,1086,65,788,11401
New Jersey,Midland Park borough,7269,1388,3582,331,49,373,5723
New Jersey,Montvale borough,8199,1786,3805,348,246,357,6542
New Mexico,Lower Frisco,0,0,0,0,0,0,0
New Mexico,Lovington,11499,2504,4229,712,180,433,8058
New Mexico,Loving village,1451,410,555,134,37,53,1189
New Mexico,Los Ranchos de Albuquerque village,6067,1259,2836,783,21,302,5201
New Mexico,Los Ojos,114,58,0,56,0,0,114
New Mexico,Luis Lopez,246,126,17,14,0,34,191
New Mexico,Williamsburg village,512,89,158,104,0,42,393
New Mexico,Los Luceros,523,111,102,72,0,117,402
New Mexico,Lumberton,114,68,4,27,0,15,114
New Mexico,Los Chaves,5067,1073,2230,617,64,183,4167
New Mexico,Los Cerrillos,421,142,175,44,0,15,376
New Mexico,Los Alamos,11815,2117,6288,916,91,373,9785
New Mexico,Lordsburg,2740,793,770,347,72,226,2208
New Mexico,Logan village,1012,259,441,134,0,73,907
New Mexico,Los Lunas village,15281,3619,5870,1715,241,495,11940
New Mexico,Luna,130,0,45,8,20,57,130
New Mexico,Malaga,66,0,30,27,0,9,66
New Mexico,McCartys Village,88,29,28,12,0,10,79
New Mexico,Middle Frisco,165,75,63,0,0,0,138
New Mexico,Mesquite,563,77,175,95,0,29,376
New Mexico,Mesita,627,238,182,32,29,19,500
New Mexico,Mesilla,2403,764,893,191,51,172,2071
New Mexico,Mescalero,1520,585,294,146,35,82,1142
New Mexico,Melrose village,634,120,244,65,4,71,504
New Mexico,Meadow Lake,4813,1368,1325,369,170,127,3359
New Mexico,Lyden,386,62,219,0,0,0,281
New Mexico,Mayhill,234,39,88,71,0,0,198
New Mexico,Manzano Springs,149,28,67,27,0,0,122
New Mexico,Manzano,13,13,0,0,0,0,13
New Mexico,Loco Hills,34,0,0,34,0,0,34
New Mexico,Magdalena village,603,145,260,60,0,55,520
New Mexico,Madrone,577,188,139,65,0,37,429
New Mexico,Madrid,178,52,22,97,7,0,178
New Mexico,McIntosh,809,22,589,80,0,32,723
New Mexico,Maxwell village,137,11,50,35,6,15,117
New Mexico,Llano del Medio,49,0,0,0,0,49,49
New Mexico,Las Palomas,444,74,285,0,0,0,359
New Mexico,Lemitar,331,101,69,57,0,28,255
New Mexico,La Jara,197,14,103,62,0,4,183
New Mexico,La Huerta,1116,161,592,39,0,37,829
New Mexico,La Hacienda,671,133,304,0,0,0,437
New Mexico,Laguna,1510,523,393,138,16,126,1196
New Mexico,La Cueva,113,0,63,50,0,0,113
New Mexico,La Cienega,2884,510,1363,284,32,61,2250
New Mexico,Kirtland,6068,2042,1879,478,90,186,4675
New Mexico,Kingston,9,0,0,9,0,0,9
New Mexico,Yah-ta-hey,383,122,99,6,0,8,235
New Mexico,Young Place,108,0,55,53,0,0,108
New Mexico,Youngsville,87,26,28,3,28,2,87
New Mexico,Zia Pueblo,879,413,183,21,10,29,656
New Mexico,Zuni Pueblo,9494,3989,2255,579,301,511,7635
New Mexico,Winston,20,0,20,0,0,0,20
New Mexico,Windmill,63,0,14,9,0,24,47
New Mexico,La Joya,0,0,0,0,0,0,0
New Mexico,Livingston Wheeler,645,60,362,0,0,69,491
New Mexico,Lake Arthur,436,152,166,26,10,14,368
New Mexico,Lake Roberts Heights,25,0,25,0,0,0,25
New Mexico,Lee Acres,6480,1407,2586,323,171,196,4683
New Mexico,La Villita,1153,290,291,209,0,78,868
New Mexico,La Union,1561,412,395,147,61,50,1065
New Mexico,Las Vegas,13713,5546,2819,1706,227,1154,11452
New Mexico,Las Nutrias,335,109,104,88,0,0,301
New Mexico,Las Maravillas,1994,420,815,184,47,26,1492
New Mexico,Las Cruces,101164,30893,33138,10010,1528,4700,80269
New Mexico,La Puebla,1000,191,487,14,23,61,776
New Mexico,La Plata,751,128,286,42,0,38,494
New Mexico,Lamy,174,23,41,36,18,0,118
New Mexico,La Mesilla,2134,458,940,270,22,92,1782
New Mexico,La Mesa,887,278,286,60,18,38,680
New Mexico,La Luz,1837,360,845,222,65,55,1547
New Mexico,Lake Valley,55,30,14,4,0,3,51
New Mexico,Lake Sumner,166,38,67,19,0,8,132
New Mexico,Lake Roberts,0,0,0,0,0,0,0
New Mexico,La Madera,123,0,82,41,0,0,123
New Mexico,Jarales,2000,483,965,217,15,24,1704
New Mexico,Abiquiu,61,12,32,0,0,0,44
New Mexico,Pueblitos,708,230,276,22,3,122,653
New Mexico,Pueblo,16,0,0,0,0,16,16
New Mexico,Pueblo of Sandia Village,362,109,92,43,0,16,260
New Mexico,Pueblo Pintado,407,157,73,33,12,4,279
New Mexico,Des Moines village,123,21,57,10,4,8,100
New Mexico,Dexter,1390,243,573,51,24,40,931
New Mexico,Dixon,1009,233,336,156,0,77,802
New Mexico,Do?a Ana,1313,124,553,76,99,0,852
New Mexico,Dora village,65,18,29,0,7,0,54
New Mexico,Pueblito,112,55,45,0,0,0,100
New Mexico,Dulce,2499,830,655,187,13,60,1745
New Mexico,Abeytas,28,0,19,0,0,9,28
New Mexico,Puerto de Luna,174,0,83,0,0,38,121
New Mexico,Pulpotio Bareas,151,102,36,0,0,13,151
New Mexico,Quemado,72,39,21,0,12,0,72
New Mexico,Questa village,1748,476,641,169,17,104,1407
New Mexico,Radium Springs,1400,215,853,105,0,16,1189
New Mexico,Ramah,278,28,96,36,0,5,165
New Mexico,Rancho Grande,157,0,157,0,0,0,157
New Mexico,Ranchos de Taos,2435,423,824,313,57,356,1973
New Mexico,Duran,15,0,6,0,0,4,10
New Mexico,Raton,6493,1613,2098,975,69,602,5357
New Mexico,Portales,12416,3978,3865,965,147,689,9644
New Mexico,Ponderosa,498,83,117,77,0,33,310
New Mexico,Paradise Hills,4733,965,1886,612,57,215,3735
New Mexico,Paraje,817,230,217,143,25,116,731
New Mexico,Pastura,8,6,0,2,0,0,8
New Mexico,Peak Place,347,99,96,26,6,6,233
New Mexico,Pecan Park,33,0,10,23,0,0,33
New Mexico,Pecos village,1409,577,356,138,15,95,1181
New Mexico,Pe?a Blanca,584,134,244,43,17,21,459
New Mexico,Pe?asco,527,171,173,66,5,36,451
New Mexico,Peralta,3625,561,1815,461,4,152,2993
New Mexico,Ponderosa Pine,1225,221,666,157,12,55,1111
New Mexico,Picuris Pueblo,49,5,25,9,0,8,47
New Mexico,Pinehill,81,32,16,9,5,13,75
New Mexico,Pinon,26,0,26,0,0,0,26
New Mexico,Pinos Altos,226,50,67,36,0,0,153
New Mexico,Placitas CDP (Do?a Ana County),678,97,234,20,24,0,375
New Mexico,Placitas CDP (Sandoval County),4917,653,3204,484,17,266,4624
New Mexico,Playas,157,71,31,20,0,0,122
New Mexico,Pleasanton,119,23,68,0,0,4,95
New Mexico,Pojoaque,2202,556,737,291,43,74,1701
New Mexico,Polvadera,783,349,216,49,0,39,653
New Mexico,Pie Town,123,0,68,37,18,0,123
New Mexico,Pajarito Mesa,329,32,116,66,13,0,227
New Mexico,Red River,328,109,110,55,3,10,287
New Mexico,Reserve village,613,171,209,35,19,74,508
New Mexico,Sandia Knolls,1486,202,783,223,0,37,1245
New Mexico,Sandia Park,105,75,15,8,7,0,105
New Mexico,San Felipe Pueblo,3167,1640,497,43,18,88,2286
New Mexico,San Fidel,133,96,0,2,0,0,98
New Mexico,San Ildefonso Pueblo,699,326,180,55,4,38,603
New Mexico,San Jon village,153,7,61,29,0,14,111
New Mexico,San Jose CDP (Rio Arriba County),677,154,298,56,8,44,560
New Mexico,San Jose CDP (San Miguel County),161,57,96,0,0,8,161
New Mexico,San Lorenzo,51,0,41,10,0,0,51
New Mexico,Sandia Heights,3377,384,2146,336,40,176,3082
New Mexico,San Luis,29,13,0,16,0,0,29
New Mexico,San Miguel,1213,289,467,44,0,94,894
New Mexico,Sanostee,387,133,89,26,0,24,272
New Mexico,San Pablo,1042,266,465,66,0,37,834
New Mexico,San Pedro,187,0,137,19,0,31,187
New Mexico,San Rafael,1055,211,493,110,0,77,891
New Mexico,Santa Ana Pueblo,645,312,122,33,9,40,516
New Mexico,Santa Clara village,1560,412,474,167,20,229,1302
New Mexico,Santa Clara Pueblo,1086,383,333,106,2,43,867
New Mexico,Santa Cruz,351,76,107,37,6,26,252
New Mexico,San Mateo,316,113,187,16,0,0,316
New Mexico,Regina,4,0,0,0,0,4,4
New Mexico,San Cristobal,288,81,83,110,0,14,288
New Mexico,San Antonito CDP (Bernalillo County),952,168,330,214,14,67,793
New Mexico,Ribera,763,396,170,27,6,27,626
New Mexico,Rincon,54,6,15,0,0,0,21
New Mexico,Rio Communities,5189,992,2047,485,75,410,4009
New Mexico,Corona village,132,7,81,13,0,25,126
New Mexico,Rio Lucio,392,141,123,38,6,23,331
New Mexico,Rio Rancho,91807,21031,36148,9894,850,3638,71561
New Mexico,Rivers,0,0,0,0,0,0,0
New Mexico,Rock Springs,314,115,56,3,3,2,179
New Mexico,Rodeo,95,12,62,4,0,0,78
New Mexico,San Antonito CDP (Socorro County),123,9,114,0,0,0,123
New Mexico,Rodey,198,54,44,22,26,0,146
New Mexico,Roswell,48553,12191,16662,4787,620,3200,37460
New Mexico,Rowe,361,62,207,50,13,15,347
New Mexico,Roy village,222,48,95,56,1,16,216
New Mexico,Ruidoso village,7884,1323,3255,1340,89,556,6563
New Mexico,Ruidoso Downs,2674,696,783,430,47,171,2127
New Mexico,Sacramento,92,14,78,0,0,0,92
New Mexico,Salem,975,149,425,51,27,0,652
New Mexico,San Acacia,87,0,0,48,0,0,48
New Mexico,San Antonio,32,32,0,0,0,0,32
New Mexico,Rosedale,267,0,67,138,0,62,267
New Mexico,Paguate,328,115,110,49,0,46,320
New Mexico,Orogrande,109,0,82,0,0,6,88
New Mexico,Organ,189,41,109,20,19,0,189
New Mexico,Cedro,302,24,143,104,0,9,280
New Mexico,Cedar Hill,693,93,494,48,10,0,645
New Mexico,Cedar Grove,669,108,464,21,22,6,621
New Mexico,Cedar Crest,919,307,378,62,21,94,862
New Mexico,Causey village,56,8,36,1,2,1,48
New Mexico,Casa Colorada,112,29,60,14,0,0,103
New Mexico,Carrizozo,934,271,251,216,22,105,865
New Mexico,Carnuel,1687,484,701,144,22,162,1513
New Mexico,Carlsbad,27592,6150,9858,3228,414,1646,21296
New Mexico,Chama village,868,212,306,73,11,71,673
New Mexico,Capulin,100,6,61,2,4,0,73
New Mexico,Canova,0,0,0,0,0,0,0
New Mexico,Ca?ones,65,0,21,28,0,11,60
New Mexico,Ca?on,219,24,11,100,0,22,157
New Mexico,Cannon AFB,2575,641,1198,26,41,10,1916
New Mexico,Canjilon,340,19,143,110,0,57,329
New Mexico,Ca?ada de los Alamos,229,56,136,17,0,20,229
New Mexico,Caballo,46,0,23,23,0,0,46
New Mexico,Buckhorn,182,85,25,0,0,34,144
New Mexico,Brimhall Nizhoni,371,154,75,55,9,21,314
New Mexico,Capitan village,1306,340,438,256,0,130,1164
New Mexico,Brazos,51,0,51,0,0,0,51
New Mexico,Chamberino,923,235,397,50,32,42,756
New Mexico,Chamita,987,297,352,57,29,89,824
New Mexico,Cordova,417,192,69,83,0,42,386
New Mexico,Conchas Dam,82,0,41,0,0,0,41
New Mexico,Columbus village,1265,163,405,181,28,141,918
New Mexico,Cochiti Lake,590,107,278,104,4,32,525
New Mexico,Cochiti,453,194,84,36,5,33,352
New Mexico,Cobre,18,18,0,0,0,0,18
New Mexico,Clovis,39466,9740,14162,4202,688,1689,30481
New Mexico,Cloudcroft village,530,95,294,46,3,45,483
New Mexico,Cliff,334,17,175,37,0,41,270
New Mexico,Chamisal,285,88,95,50,8,20,261
New Mexico,Clayton,2816,899,865,419,110,210,2503
New Mexico,Cimarron village,1035,221,479,130,6,58,894
New Mexico,Church Rock,1051,378,228,77,21,40,744
New Mexico,Chupadero,270,100,142,24,0,0,266
New Mexico,Chimayo,2369,926,711,221,0,123,1981
New Mexico,Chilili,46,0,23,23,0,0,46
New Mexico,Chili,648,233,125,0,0,122,480
New Mexico,Chical,134,49,48,15,8,0,120
New Mexico,Chaparral,13629,3162,5295,849,321,473,10100
New Mexico,Chamizal,44,0,44,0,0,0,44
New Mexico,City of the Sun,38,0,38,0,0,0,38
New Mexico,Costilla,61,32,20,0,0,0,52
New Mexico,Cotton City,284,32,159,0,0,32,223
New Mexico,Coyote,150,5,99,26,0,9,139
New Mexico,Nakaibito,473,257,77,15,14,34,397
New Mexico,Nambe,1906,514,659,248,24,107,1552
New Mexico,Napi Headquarters,688,213,187,51,4,19,474
New Mexico,Nara Visa,52,0,21,3,3,25,52
New Mexico,Naschitti,229,116,45,10,16,21,208
New Mexico,Navajo,1918,793,315,41,25,10,1184
New Mexico,Navajo Dam,91,17,18,28,0,9,72
New Mexico,Nenahnezad,812,299,201,35,9,43,587
New Mexico,Newcomb,265,119,80,6,0,8,213
New Mexico,Nageezi,284,101,39,21,2,17,180
New Mexico,Newkirk,0,0,0,0,0,0,0
New Mexico,North Acomita Village,250,90,64,30,7,21,212
New Mexico,North Hobbs,6034,901,3071,384,35,267,4658
New Mexico,North Hurley,290,19,84,25,29,26,183
New Mexico,North Light Plant,426,130,33,70,0,32,265
New Mexico,North San Ysidro,121,0,99,0,0,0,99
New Mexico,North Valley,11221,3031,3889,1530,85,732,9267
New Mexico,Oasis,113,12,44,57,0,0,113
New Mexico,Ohkay Owingeh,1531,601,402,142,8,88,1241
New Mexico,Ojo Amarillo,659,244,126,45,10,23,448
New Mexico,Nogal,112,31,43,25,0,13,112
New Mexico,Nadine,381,37,181,61,0,5,284
New Mexico,Mountain View,88,0,52,0,0,36,88
New Mexico,Mountainair,1137,216,334,169,29,84,832
New Mexico,Crownpoint,2565,1072,697,128,21,80,1998
New Mexico,Cruzville,167,0,48,0,0,0,48
New Mexico,Crystal,364,117,110,17,3,26,273
New Mexico,Cuartelez,404,85,137,83,0,0,305
New Mexico,Cuba village,725,161,239,69,21,39,529
New Mexico,Cubero,256,109,75,22,0,15,221
New Mexico,Cundiyo,11,8,3,0,0,0,11
New Mexico,Cuyamungue,548,91,259,49,1,22,422
New Mexico,Cuyamungue Grant,127,49,26,23,0,11,109
New Mexico,Datil,109,0,109,0,0,0,109
New Mexico,Deming,14667,3882,4711,1382,396,1045,11416
New Mexico,Midway,1065,192,401,66,24,56,739
New Mexico,Milan village,3257,1111,1129,311,8,78,2637
New Mexico,Mimbres,737,58,344,124,0,78,604
New Mexico,Monterey Park,1697,484,522,73,38,25,1142
New Mexico,Monument,159,0,110,0,0,21,131
New Mexico,Moquino,0,0,0,0,0,0,0
New Mexico,Mora,751,379,260,27,0,18,684
New Mexico,Moriarty,2227,515,729,300,37,153,1734
New Mexico,Morningside,970,239,297,14,0,0,550
New Mexico,Mosquero village,52,6,21,7,0,2,36
New Mexico,Santa Fe,83008,23210,28828,11781,1092,4113,69024
New Mexico,Santa Rosa,3040,1055,724,510,61,249,2599
New Mexico,Rio en Medio,196,95,76,0,0,15,186
New Mexico,Santo Domingo Pueblo,2665,1571,352,31,16,109,2079
New Mexico,South Acomita Village,116,64,28,0,0,10,102
New Mexico,South Valley,41660,11995,14575,4363,624,2028,33585
New Mexico,Spencerville,1587,332,604,242,14,59,1251
New Mexico,Springer,1051,272,354,75,13,126,840
New Mexico,Sunland Park,15142,4086,5020,837,661,600,11204
New Mexico,Sunshine,307,17,91,20,54,67,249
New Mexico,Tajique,58,0,58,0,0,0,58
New Mexico,Talpa,1014,396,470,41,0,9,916
New Mexico,Taos,5711,1883,1508,941,181,437,4950
New Mexico,Taos Pueblo,1098,386,363,123,28,56,956
New Mexico,Taos Ski Valley village,115,63,32,0,0,0,95
New Mexico,Tatum,751,124,298,82,0,32,536
New Mexico,Tecolote,96,21,0,9,0,66,96
New Mexico,Sombrillo,398,82,189,70,3,30,374
New Mexico,Tecolotito,123,18,31,0,0,9,58
New Mexico,Tesuque Pueblo,243,82,69,13,6,20,190
New Mexico,Texico,1355,306,562,78,31,35,1012
New Mexico,Thoreau,1570,607,307,136,18,121,1189
New Mexico,Tierra Amarilla,598,306,205,31,9,13,564
New Mexico,Tijeras village,530,127,268,40,5,29,469
New Mexico,Timberon,357,53,91,97,0,38,279
New Mexico,Tohatchi,1004,372,239,80,11,52,754
New Mexico,Tome,1855,401,770,247,12,203,1633
New Mexico,Torreon CDP (Sandoval County),368,140,112,2,3,27,284
New Mexico,Torreon CDP (Torrance County),184,21,163,0,0,0,184
New Mexico,Trout Valley,0,0,0,0,0,0,0
New Mexico,Truchas,388,28,259,62,0,10,359
New Mexico,Truth or Consequences,6266,1433,2173,1111,163,626,5506
New Mexico,Tesuque,961,164,449,176,10,92,891
New Mexico,Soham,191,29,61,101,0,0,191
New Mexico,Socorro,8843,3509,1625,936,128,753,6951
New Mexico,Skyline-Ganipa,1232,487,232,90,31,45,885
New Mexico,Hagerman,1112,277,408,121,6,20,832
New Mexico,Hanover,190,38,0,37,0,0,75
New Mexico,Happy Valley,850,188,246,145,28,79,686
New Mexico,Hatch village,1757,414,706,93,14,56,1283
New Mexico,Hernandez,937,252,410,23,34,37,756
New Mexico,Highland Meadows,688,140,237,105,6,62,550
New Mexico,High Rolls,558,137,281,26,21,62,527
New Mexico,Hillsboro,110,29,81,0,0,0,110
New Mexico,Hobbs,36191,8591,13333,2953,620,1298,26795
New Mexico,Holloman AFB,4112,767,1794,69,6,0,2636
New Mexico,Homestead,52,0,34,18,0,0,52
New Mexico,Hope village,98,9,63,7,0,7,86
New Mexico,Hot Springs Landing,150,0,150,0,0,0,150
New Mexico,House village,38,0,35,2,0,1,38
New Mexico,Hurley,1275,204,552,189,26,98,1069
New Mexico,Indian Hills,1374,266,378,273,53,116,1086
New Mexico,Isleta Village Proper,509,204,98,78,11,40,431
New Mexico,Jacona,449,84,203,45,2,18,352
New Mexico,Jaconita,476,112,189,67,11,14,393
New Mexico,Jal,2161,393,1005,150,35,123,1706
New Mexico,Jemez Pueblo,1969,877,445,58,15,113,1508
New Mexico,Jemez Springs village,272,70,127,33,0,5,235
New Mexico,Keeler Farm,1823,302,827,142,31,93,1395
New Mexico,Seboyeta,108,34,38,0,0,0,72
New Mexico,Sedillo,851,62,670,33,0,0,765
New Mexico,Sena,157,97,22,38,0,0,157
New Mexico,Sheep Springs,215,84,61,7,3,10,165
New Mexico,Shiprock,8496,3228,2017,513,85,282,6125
New Mexico,Silver City,10184,3002,3168,1244,169,634,8217
New Mexico,Tse Bonito,207,85,65,18,0,0,168
New Mexico,Hachita,57,0,37,20,0,0,57
New Mexico,Tucumcari,5157,1623,1549,489,88,469,4218
New Mexico,Twin Forks,101,0,92,9,0,0,101
New Mexico,Berino,1775,330,611,63,49,85,1138
New Mexico,Bent,123,29,0,53,0,41,123
New Mexico,Belen,7209,1857,2123,983,27,484,5474
New Mexico,Beclabito,267,106,84,3,8,17,218
New Mexico,Bayard,2490,657,717,308,19,276,1977
New Mexico,Aztec,6501,1599,2125,934,59,376,5093
New Mexico,Atoka,727,156,388,83,20,45,692
New Mexico,Artesia,11641,2369,4773,1004,68,608,8822
New Mexico,Arroyo Seco,888,133,407,313,0,0,853
New Mexico,Arroyo Hondo,334,58,175,0,0,34,267
New Mexico,Arrey,312,95,118,47,0,0,260
New Mexico,Arenas Valley,1524,423,683,87,0,44,1237
New Mexico,Aragon,9,0,0,9,0,0,9
New Mexico,Bernalillo,8522,2228,3088,1073,224,460,7073
New Mexico,Apache Creek,21,0,17,0,0,4,21
New Mexico,Anton Chico,39,7,32,0,0,0,39
New Mexico,Anthony,9429,2449,3126,354,265,459,6653
New Mexico,Animas,167,9,132,8,6,0,155
New Mexico,Angel Fire village,960,148,603,121,0,7,879
New Mexico,Algodones,932,250,429,41,0,83,803
New Mexico,Alcalde,210,76,73,28,4,10,191
New Mexico,Albuquerque,556092,161735,189931,62450,8141,24227,446484
New Mexico,Alamogordo,31198,7447,12058,3151,632,1807,25095
New Mexico,Alamo,607,339,115,15,7,56,532
New Mexico,Alamillo,106,17,46,43,0,0,106
New Mexico,Agua Fria,2857,717,999,201,22,157,2096
New Mexico,Adelino,841,86,460,167,0,128,841
New Mexico,Acomita Lake,375,139,113,17,0,28,297
New Mexico,Anzac Village,129,46,31,6,4,12,99
New Mexico,Bibo,173,106,0,0,0,20,126
New Mexico,Black Rock,1613,547,313,48,48,28,984
New Mexico,Blanco,200,0,115,30,0,0,145
New Mexico,Twin Lakes,908,454,196,41,12,40,743
New Mexico,Tyrone,545,34,224,126,4,21,409
New Mexico,University Park,3276,2552,326,94,20,10,3002
New Mexico,Upper Fruitland,1660,624,519,79,5,59,1286
New Mexico,Ute Park,100,31,39,0,0,30,100
New Mexico,Vadito,300,90,99,28,5,27,249
New Mexico,Vado,2681,557,1096,137,30,121,1941
New Mexico,Valencia,2295,717,953,153,46,182,2051
New Mexico,Vaughn,437,97,200,35,6,8,346
New Mexico,Veguita,108,15,14,34,0,0,63
New Mexico,Velarde,409,202,68,26,0,21,317
New Mexico,Ventura,183,9,93,38,0,43,183
New Mexico,Villanueva,133,0,122,0,0,0,122
New Mexico,Virden village,172,12,86,7,0,12,117
New Mexico,Wagon Mound village,649,213,139,120,0,142,614
New Mexico,Waterflow,1784,497,615,93,5,72,1282
New Mexico,Watrous,0,0,0,0,0,0,0
New Mexico,Weed,46,0,31,15,0,0,46
New Mexico,West Hammond,2867,902,1115,256,10,159,2442
New Mexico,White Rock,5927,989,3187,329,87,109,4701
New Mexico,White Sands,1567,334,689,43,29,1,1096
New Mexico,Whites City,164,78,60,26,0,0,164
New Mexico,White Signal,235,36,181,0,0,0,217
New Mexico,Willard village,230,28,116,25,5,10,184
New Mexico,Bosque Farms village,3864,722,1750,358,37,242,3109
New Mexico,Boles Acres,2053,343,885,328,132,129,1817
New Mexico,Bluewater Village,350,40,39,74,0,102,255
New Mexico,Bluewater Acres,347,121,115,63,0,0,299
New Mexico,Bloomfield,7735,1773,2807,768,25,351,5724
New Mexico,Tularosa village,2914,852,746,518,28,396,2540
New Mexico,Santa Teresa,4710,1272,1702,532,51,37,3594
New Mexico,Corrales village,8455,1478,4605,639,83,435,7240
New Mexico,Grenville village,28,2,20,0,0,0,22
New Mexico,Grady village,84,12,42,14,0,4,72
New Mexico,Golden,38,0,31,0,0,0,31
New Mexico,Glorieta,549,216,226,55,0,12,509
New Mexico,Glenwood,0,0,0,0,0,0,0
New Mexico,Ensenada,161,41,63,41,0,16,161
New Mexico,Escondida,23,0,0,23,0,0,23
New Mexico,Escudilla Bonita,31,0,0,31,0,0,31
New Mexico,Glen Acres,276,36,139,13,5,13,206
New Mexico,Espa?ola,10168,3239,2958,968,148,652,7965
New Mexico,Estancia,1804,750,516,227,14,64,1571
New Mexico,Grants,9243,2477,2911,1182,278,446,7294
New Mexico,Gila,318,0,184,10,0,34,228
New Mexico,Gallup,22467,6871,5907,1592,427,835,15632
New Mexico,Gallina,268,79,60,26,0,82,247
New Mexico,Galisteo,194,31,39,57,6,21,154
New Mexico,Eunice,3060,567,1388,248,45,86,2334
New Mexico,Fairacres,1030,469,234,69,83,119,974
New Mexico,Farmington,44865,11406,16401,4132,553,1864,34356
New Mexico,Faywood,113,34,18,17,19,25,113
New Mexico,Fence Lake,0,0,0,0,0,0,0
New Mexico,Flora Vista,2040,195,1184,269,0,34,1682
New Mexico,Floyd village,121,31,54,6,0,1,92
New Mexico,Garfield,50,18,24,0,0,8,50
New Mexico,Folsom village,41,12,17,9,0,3,41
New Mexico,Fort Sumner village,1251,475,207,223,41,174,1120
New Mexico,Eldorado at Santa Fe,6486,800,3630,1022,43,321,5816
New Mexico,Edgewood,3773,699,1933,352,24,56,3064
New Mexico,Edith Endave,328,64,135,37,3,11,250
New Mexico,El Cerro,2965,615,1379,233,30,176,2433
New Mexico,El Cerro Mission,4547,1038,1835,257,174,191,3495
New Mexico,El Duende,972,176,349,43,0,3,571
New Mexico,Elephant Butte,1393,110,652,335,0,126,1223
New Mexico,Elida,190,51,64,24,4,16,159
New Mexico,East Pecos,569,193,0,69,98,22,382
New Mexico,El Rancho,1219,284,481,137,24,39,965
New Mexico,El Valle de Arroyo Seco,1291,404,490,151,10,17,1072
New Mexico,Encinal,111,28,24,59,0,0,111
New Mexico,Encino village,36,7,15,13,0,1,36
New Mexico,Seama,366,143,100,22,19,16,300
New Mexico,Sausal,1322,284,354,235,9,34,916
New Mexico,San Ysidro village,177,39,58,28,3,20,148
New Mexico,San Ysidro,2432,559,1274,83,9,18,1943
New Mexico,El Rito,1051,509,300,59,21,14,903
New Mexico,Eagle Nest village,264,59,108,31,0,2,200
New York,Lake Placid village,2539,786,883,256,84,175,2184
New York,Lake Katrine,2322,700,861,153,64,292,2070
New York,Lake Mohegan,5663,1625,2138,596,44,342,4745
New York,Lake Luzerne,1252,347,434,177,63,50,1071
New York,Lakeland,2747,563,1370,244,40,143,2360
New York,Lake Erie Beach,4228,1054,1864,368,50,238,3574
New York,Lake Grove village,11262,2917,5011,603,185,544,9260
New York,Lake George village,851,282,354,117,7,41,801
New York,Brentwood,61374,21653,18701,3860,1228,2110,47552
New York,Kennedy,504,99,252,72,11,33,467
New York,Lake Carmel,8294,1832,3874,525,194,424,6849
New York,La Fargeville,560,90,192,64,12,89,447
New York,Lacona village,682,203,214,69,20,29,535
New York,Lackawanna,18019,5888,5102,1787,492,1337,14606
New York,Windsor village,1030,149,527,77,19,42,814
New York,Kysorville,156,22,72,6,6,0,106
New York,Kiryas Joel village,21749,2276,7225,29,34,111,9675
New York,Kingston,23625,7421,7137,2286,826,1535,19205
New York,Kings Point village,5071,1323,2424,73,21,121,3962
New York,Kings Park,17823,3931,8413,968,204,1098,14614
New York,Kinderhook village,1389,245,742,101,23,116,1227
New York,Keuka Park,875,794,52,10,0,10,866
New York,Kerhonkson,2247,569,610,278,37,221,1715
New York,Lake Ronkonkoma,19943,5063,8482,1306,256,1051,16158
New York,Winthrop,371,32,94,83,15,97,321
New York,Keeseville village,1776,462,606,140,47,126,1381
New York,Kenmore village,15271,4558,5820,1436,233,941,12988
New York,Kensington village,1113,183,605,44,8,71,911
New York,Lake Success village,3027,566,1458,134,26,384,2568
New York,Lakeview,6569,2395,1978,228,345,363,5309
New York,Lakeville,1055,123,308,127,138,13,709
New York,Brighton,36929,10973,14811,2923,369,2549,31625
New York,Brightwaters village,3102,712,1528,113,24,161,2538
New York,Brinckerhoff,2602,782,1246,186,33,138,2385
New York,Broadalbin village,1550,414,539,171,0,85,1209
New York,Brockport village,8428,5044,1751,447,110,348,7700
New York,Brocton village,1518,396,501,250,21,109,1277
New York,Bridgewater,612,158,200,53,10,16,437
New York,Bronxville village,6409,1281,2941,306,50,268,4846
New York,Brookville village,3546,1630,1272,40,25,83,3050
New York,Brownville village,958,159,439,72,19,55,744
New York,Brushton village,578,115,240,56,17,18,446
New York,Buchanan village,2218,429,1127,103,48,115,1822
New York,Buffalo,259517,107641,59339,22622,7002,13732,210336
New York,Wheatley Heights,5220,1660,2081,242,95,178,4256
New York,Brookhaven,3138,716,1217,321,74,252,2580
New York,Bridgeport,1668,418,494,392,15,70,1389
New York,Bridgehampton,1274,257,720,52,22,65,1116
New York,Briarcliff Manor village,7739,1765,3819,313,56,451,6404
New York,Breesport,738,63,338,55,16,52,524
New York,Brasher Falls,452,69,207,31,11,38,356
New York,Boonville village,2067,635,549,295,50,204,1733
New York,Bolton Landing,416,41,257,18,0,6,322
New York,Bolivar village,1123,251,447,98,34,67,897
New York,Bohemia,9977,2531,3779,1022,166,633,8131
New York,Blue Point,4725,1048,2111,295,40,212,3706
New York,Bloomville,186,58,106,5,4,3,176
New York,Brewster village,2212,792,824,118,38,49,1821
New York,Bloomfield village,1550,375,603,144,34,65,1221
New York,Blodgett Mills,321,69,166,0,26,0,261
New York,Bliss,613,153,211,63,13,44,484
New York,Blauvelt,5394,1396,2561,126,24,279,4386
New York,Blasdell village,2579,875,704,287,45,214,2125
New York,Brewster Hill,1378,101,783,178,0,43,1105
New York,Whitehall village,2769,755,872,288,87,172,2174
New York,White Plains,57790,16850,22405,4158,1245,2907,47565
New York,Whitesboro village,3731,1121,956,596,134,247,3054
New York,Whitney Point village,1004,229,386,108,20,61,804
New York,Liberty village,4241,1229,1295,319,168,340,3351
New York,Lewiston village,2598,595,966,298,35,254,2148
New York,Levittown,51593,12942,23412,2832,825,2839,42850
New York,Le Roy village,4333,1170,1500,377,191,304,3542
New York,Leicester village,444,98,193,51,5,21,368
New York,Leeds,480,134,246,0,7,0,387
New York,Lawrence village,6529,1153,3457,141,55,298,5104
New York,Laurens village,233,80,69,32,8,13,202
New York,Laurel Hollow village,1835,304,929,62,11,103,1409
New York,Laurel,1250,351,553,99,17,168,1188
New York,Lattingtown village,1542,260,782,123,17,89,1271
New York,Larchmont village,6005,764,2989,286,104,139,4282
New York,Lansing village,3629,1132,1359,409,13,102,3015
New York,Lancaster village,10300,2877,3781,911,230,601,8400
New York,Lakewood village,2951,661,1171,303,86,226,2447
New York,Lido Beach,2600,460,1439,116,23,187,2225
New York,Brewerton,4414,870,1685,458,81,248,3342
New York,Lima village,2433,736,934,167,31,95,1963
New York,Limestone,330,64,130,31,3,21,249
New York,Williamson,2324,537,926,340,107,138,2048
New York,Williamsville village,5269,1371,1992,824,70,373,4630
New York,Williston Park village,7322,1858,3338,419,39,329,5983
New York,Willsboro,891,200,359,109,13,82,763
New York,Wilmington,1055,263,485,54,25,56,883
New York,Wilson village,1163,224,505,151,3,82,965
New York,Windham,312,59,169,50,0,30,308
New York,Liverpool village,2230,824,806,234,35,150,2049
New York,Little Valley village,1276,374,355,109,20,79,937
New York,Little Falls,4878,1161,1627,709,118,417,4032
New York,Lisle village,257,80,82,39,1,6,208
New York,Linwood,64,6,24,11,0,0,41
New York,Lindenhurst village,27310,7481,11962,1931,450,1353,23177
New York,Lincoln Park,2082,439,764,165,31,331,1730
New York,Lincolndale,1537,333,630,124,57,46,1190
New York,Lime Lake,661,117,255,67,0,114,553
New York,Bloomingburg village,471,146,142,33,18,39,378
New York,Chatham village,1381,449,508,136,30,97,1220
New York,Woodbury village,10873,2579,4928,597,108,428,8640
New York,Canandaigua,10499,2903,3531,1307,316,717,8774
New York,Canaseraga village,600,137,224,55,1,43,460
New York,Canastota village,4707,1111,1715,523,94,243,3686
New York,Candor village,677,110,283,65,20,33,511
New York,Canisteo village,2298,490,908,232,51,126,1807
New York,Canton village,6665,4245,1295,404,21,187,6152
New York,Cape Vincent village,645,106,288,45,20,56,515
New York,Carle Place,5152,1429,2204,321,71,318,4343
New York,Carmel Hamlet,6542,1546,2848,453,25,441,5313
New York,Caroga Lake,496,72,247,84,9,52,464
New York,Carthage village,3682,711,1198,354,102,234,2599
New York,Cassadaga village,709,187,300,61,7,38,593
New York,Castile village,922,218,403,72,61,29,783
New York,Castleton-on-Hudson village,1322,239,599,100,33,93,1064
New York,Castorland village,376,63,145,22,6,21,257
New York,Cato village,655,171,213,71,6,30,491
New York,Catskill village,3952,1378,1217,269,109,78,3051
New York,Cattaraugus village,1035,277,428,100,26,58,889
New York,Cayuga village,545,110,284,50,15,24,483
New York,Cayuga Heights village,3789,1552,1478,122,32,167,3351
New York,Cazenovia village,2815,1304,789,289,81,160,2623
New York,Cedarhurst village,6655,1755,2771,242,77,200,5045
New York,Celoron village,1183,274,411,181,46,78,990
New York,Centereach,32649,8948,13794,2047,270,1696,26755
New York,Center Moriches,8418,1903,4018,414,13,337,6685
New York,Centerport,5447,1087,2579,380,50,312,4408
New York,Central Bridge,282,56,161,10,15,11,253
New York,Canajoharie village,2195,592,732,212,52,172,1760
New York,Campbell,630,129,314,90,11,8,552
New York,Camillus village,1242,348,442,118,41,96,1045
New York,Camden village,2491,576,821,297,54,213,1961
New York,Jamestown West,2267,541,1102,177,30,194,2044
New York,Jefferson Heights,1116,330,336,132,28,136,962
New York,Jefferson Valley-Yorktown,14923,3023,7164,870,116,912,12085
New York,Jeffersonville village,387,115,135,23,30,27,330
New York,Jericho,13746,2771,7038,608,232,518,11167
New York,Johnson City village,14903,4803,4585,1624,329,1008,12349
New York,Johnstown,8500,2076,3086,965,476,481,7084
New York,Jordan village,1495,376,586,135,54,65,1216
New York,Kaser village,4998,533,1842,20,12,11,2418
New York,Katonah,2196,561,940,121,57,42,1721
New York,Clarkson,4325,819,1946,251,43,288,3347
New York,Clark Mills,2139,381,908,254,16,145,1704
New York,Clarence Center,2151,363,1142,128,8,42,1683
New York,Central Islip,34960,12033,10276,2551,702,1650,27212
New York,Clarence,3164,733,1495,146,57,231,2662
New York,Chittenango village,4992,1083,2047,548,92,187,3957
New York,Chestnut Ridge village,8090,1915,3534,426,93,416,6384
New York,Wolcott village,1723,505,462,244,55,106,1372
New York,Burdett village,364,105,135,44,11,30,325
New York,Burke village,169,16,74,16,5,17,128
New York,Busti,477,102,209,19,0,8,338
New York,Byersville,131,16,48,10,0,9,83
New York,Cairo,1325,398,388,320,51,72,1229
New York,Calcium,4102,613,2148,137,112,31,3041
New York,Caledonia village,2137,578,876,164,31,173,1822
New York,Callicoon,172,63,51,29,0,6,149
New York,Calverton,6380,1382,2725,568,164,891,5730
New York,Cambridge village,1715,310,671,206,17,163,1367
New York,Churchville village,1981,449,853,125,63,138,1628
New York,Central Square village,1945,438,831,167,31,122,1589
New York,Centre Island village,454,94,253,14,0,15,376
New York,Chadwicks,1757,389,713,191,17,38,1348
New York,Belfast,907,163,337,101,8,67,676
New York,Bellerose village,1132,254,547,47,5,42,895
New York,Bellerose Terrace,2004,465,945,80,6,134,1630
New York,Belle Terre village,783,97,449,11,2,35,594
New York,Belleville,474,52,128,55,0,21,256
New York,Bellmore,15871,3091,8033,712,138,912,12886
New York,Bellport village,2059,365,1082,137,30,166,1780
New York,Belmont village,1010,197,402,107,12,75,793
New York,Bemus Point village,192,34,83,17,4,24,162
New York,Bergen village,1312,352,538,80,8,36,1014
New York,Bethpage,16315,3760,7990,832,61,1205,13848
New York,Big Flats,5303,1029,2397,507,50,326,4309
New York,Billington Heights,1653,376,748,123,0,101,1348
New York,Bedford Hills,3271,940,1333,89,37,79,2478
New York,Binghamton,46495,18673,11433,4893,1098,3140,39237
New York,Black River village,1381,227,629,92,39,72,1059
New York,Yonkers,199435,64597,69047,13359,5326,10445,162774
New York,Yaphank,5958,1837,2537,466,60,203,5103
New York,Wyoming village,381,101,160,39,2,12,314
New York,Wynantskill,3036,634,1499,178,44,165,2520
New York,Wyandanch,11558,4736,2775,526,388,481,8906
New York,Wurtsboro village,1131,348,350,139,28,91,956
New York,Worcester,973,179,510,62,16,94,861
New York,Woodsville,62,24,26,6,4,0,60
New York,Woodstock,1766,499,826,221,38,102,1686
New York,Woodsburgh village,740,112,411,20,15,26,584
New York,Woodridge village,732,228,238,76,5,40,587
New York,Woodmere,17217,3516,7818,470,91,954,12849
New York,Binghamton University,6084,6057,22,5,0,0,6084
New York,Woodbury,8473,1260,4399,531,63,1011,7264
New York,Bedford,2044,342,1028,66,0,107,1543
New York,Beacon,14375,5261,4620,1153,394,808,12236
New York,Champlain village,1139,249,353,165,13,80,860
New York,Chappaqua,1287,346,599,85,0,47,1077
New York,Chateaugay village,626,118,267,58,19,82,544
New York,Chaumont village,796,167,342,56,16,43,624
New York,Chautauqua,594,278,259,29,0,0,566
New York,Chazy,448,97,208,33,25,15,378
New York,Cheektowaga,74905,22548,28086,7709,754,4951,64048
New York,Chenango Bridge,2795,583,1445,174,0,160,2362
New York,Cherry Creek village,447,67,206,34,9,24,340
New York,Cherry Valley village,562,135,270,40,11,31,487
New York,Chester village,3928,1304,1443,406,203,119,3475
New York,Chestertown,764,119,329,33,8,57,546
New York,Zena,1385,291,712,82,0,53,1138
New York,Beaver Dam Lake,1780,427,819,90,39,71,1446
New York,Youngstown village,1967,418,875,177,44,122,1636
New York,Yorktown Heights,1964,480,753,224,12,46,1515
New York,Yorkshire,1093,200,507,186,0,136,1029
New York,York Hamlet,459,63,206,93,0,22,384
New York,Barneveld village,221,54,109,7,2,11,183
New York,Barnum Island,2226,527,1109,135,9,89,1869
New York,Batavia,15188,3962,5649,1406,365,1110,12492
New York,Bath village,5720,1340,1951,646,193,578,4708
New York,Baxter Estates village,816,164,395,55,9,55,678
New York,Bay Park,1856,385,1020,81,10,55,1551
New York,Bayport,8305,1728,3684,732,115,608,6867
New York,Bay Shore,29670,9382,9807,2451,742,1315,23697
New York,Bayville village,6724,1648,3192,389,76,339,5644
New York,Baywood,7249,2061,2484,650,125,504,5824
New York,Yorkville village,2642,1030,792,252,3,138,2215
New York,Witherbee,333,82,76,12,0,81,251
New York,South Glens Falls village,3586,1138,1071,548,70,213,3040
New York,West Valley,468,90,198,64,23,5,380
New York,Millerton village,866,315,329,60,3,44,751
New York,Miller Place,11312,2295,5098,720,121,388,8622
New York,Millbrook village,1542,374,618,131,46,157,1326
New York,Milford village,396,84,176,61,5,19,345
New York,Middleville village,533,116,195,76,2,26,415
New York,Middletown,27828,9524,8702,1865,918,1164,22173
New York,Mill Neck village,994,243,550,37,6,50,886
New York,Middleport village,1788,420,657,170,53,130,1430
New York,Middleburgh village,1448,481,514,193,38,75,1301
New York,Rodman,215,34,115,3,0,0,152
New York,Rome,32916,9947,10325,3795,789,2453,27309
New York,Romulus,524,117,249,24,4,19,413
New York,Ronkonkoma,18634,4955,8182,1260,320,730,15447
New York,Roosevelt,16645,5818,5101,836,482,650,12887
New York,Middle Island,9949,2272,4083,976,130,765,8226
New York,Roscoe,564,121,225,69,0,55,470
New York,Millport village,355,107,109,45,12,18,291
New York,Milton CDP (Ulster County),1521,539,611,171,9,75,1405
New York,Mooers,293,145,35,23,18,53,274
New York,Montrose,2659,481,1208,284,2,216,2191
New York,Montour Falls village,1821,347,568,326,41,207,1489
New York,Monticello village,6685,2403,1744,534,250,428,5359
New York,Montgomery village,4311,695,2052,325,39,215,3326
New York,Montebello village,4616,947,2186,285,10,312,3740
New York,Milton CDP (Saratoga County),3536,941,1725,158,29,116,2969
New York,Montauk,3495,894,1752,183,0,442,3271
New York,Monroe village,8532,2214,3600,404,40,275,6533
New York,Mohawk village,2571,821,883,281,13,108,2106
New York,Minoa village,3514,715,1406,300,36,251,2708
New York,Mineville,1273,453,533,172,7,17,1182
New York,Minetto,933,202,400,79,29,62,772
New York,Mineola village,18980,5165,7869,1602,341,931,15908
New York,Monsey,21001,3913,7149,198,52,209,11521
New York,Moravia village,1521,436,526,207,23,115,1307
New York,Rosendale Hamlet,1453,398,524,129,0,54,1105
New York,Roslyn Estates village,1159,136,644,39,3,47,869
New York,St. Regis Falls,383,88,182,28,7,23,328
New York,Salamanca,5686,1548,1558,648,126,365,4245
New York,Salem village,698,178,275,69,6,54,582
New York,Salisbury,12467,2996,6121,484,92,799,10492
New York,Salisbury Mills,308,142,78,50,0,19,289
New York,Saltaire village,46,3,27,2,0,3,35
New York,St. Johnsville village,1789,467,528,230,75,138,1438
New York,Salt Point,195,30,109,0,0,22,161
New York,Sand Ridge,663,157,220,65,92,106,640
New York,Sands Point village,2715,519,1429,135,21,117,2221
New York,Sandy Creek village,875,174,401,57,1,22,655
New York,Saranac Lake village,5727,1666,2014,566,180,330,4756
New York,Saratoga Springs,27244,9197,10407,2138,492,1280,23514
New York,Saugerties village,3940,1329,1282,421,88,276,3396
New York,Sanborn,1361,315,482,191,0,134,1122
New York,Roslyn village,2779,773,1046,248,12,322,2401
New York,St. James,13536,3181,6156,728,110,1011,11186
New York,Sag Harbor village,2075,414,1020,156,39,153,1782
New York,Roslyn Harbor village,952,173,520,32,4,52,781
New York,Roslyn Heights,6969,1695,3065,354,165,425,5704
New York,Rotterdam,20949,5377,8056,1921,353,1630,17337
New York,Round Lake village,693,142,320,96,7,32,597
New York,Rouses Point village,2126,571,847,190,41,177,1826
New York,Rushford,327,82,113,50,0,15,260
New York,St. Bonaventure,2052,1571,317,60,0,32,1980
New York,Rushville village,679,196,243,46,20,43,548
New York,Rye,15944,2462,7783,662,227,726,11860
New York,Rye Brook village,9510,1871,4814,444,18,528,7675
New York,Sackets Harbor village,1495,327,708,129,35,40,1239
New York,Saddle Rock village,904,217,428,33,3,39,720
New York,Saddle Rock Estates,343,83,175,18,0,25,301
New York,Sagaponack village,208,28,120,13,0,14,175
New York,Russell Gardens village,878,172,482,26,10,31,721
New York,Saugerties South,2119,585,832,188,40,162,1807
New York,Moriches,2703,655,1114,157,164,201,2291
New York,Morrisonville,1444,357,581,101,22,76,1137
New York,Rhinebeck village,2629,573,1221,213,72,162,2241
New York,Rhinecliff,290,33,101,7,56,36,233
New York,Richburg village,615,118,228,43,6,39,434
New York,Richfield Springs village,1229,304,490,162,38,60,1054
New York,Richmondville village,918,231,335,63,30,45,704
New York,Richville village,363,85,130,23,0,18,256
New York,Retsof,214,48,101,18,0,10,177
New York,Ridge,12835,2591,5689,1213,108,1296,10897
New York,Ripley,966,212,410,86,13,72,793
New York,Riverhead,14258,4669,4912,1144,174,889,11788
New York,Riverside village,589,129,188,76,16,39,448
New York,Riverside,4912,3184,888,396,69,210,4747
New York,Rochester,210745,92748,40831,17955,7144,8992,167670
New York,Rock Hill,1497,317,735,67,15,142,1276
New York,Rifton,609,132,200,57,0,0,389
New York,Rockville Centre village,24155,6083,10496,1446,252,1209,19486
New York,Rensselaer Falls village,403,85,141,28,2,23,279
New York,Remsenburg-Speonk,1867,368,999,119,8,97,1591
New York,Pultneyville,458,65,244,0,9,41,359
New York,Putnam Lake,3877,1101,1688,314,30,192,3325
New York,Quiogue,640,218,246,54,0,49,567
New York,Quogue village,854,137,459,90,15,53,754
New York,Randolph,1179,226,384,130,49,78,867
New York,Ransomville,1668,435,766,127,27,75,1430
New York,Rensselaer,9502,3045,2869,922,206,702,7744
New York,Rapids,1653,318,755,193,23,31,1320
New York,Red Creek village,646,164,202,28,17,34,445
New York,Redford,528,146,138,19,52,0,355
New York,Red Hook village,1715,428,671,175,53,103,1430
New York,Red Oaks Mill,3671,800,1790,260,45,125,3020
New York,Redwood,584,129,231,40,0,38,438
New York,Remsen village,506,172,156,53,15,13,409
New York,Ravena village,3289,941,1236,337,67,123,2704
New York,Morris village,396,98,161,57,12,35,363
New York,Rocky Point,13593,3340,5664,967,181,542,10694
New York,New Hartford village,1813,421,729,155,47,188,1540
New York,Nanuet,18678,4546,8156,1277,275,1237,15491
New York,Myers Corner,6867,1420,3585,360,68,258,5691
New York,Muttontown village,3626,829,1997,86,11,183,3106
New York,Munsons Corners,2387,774,643,252,4,373,2046
New York,Munsey Park village,2715,554,1352,73,19,56,2054
New York,Munnsville village,498,164,162,25,16,19,386
New York,Napanoch,1096,282,461,97,6,33,879
New York,Mount Vernon,68221,24674,19065,5883,1980,3574,55176
New York,Mount Morris village,2505,691,794,296,77,136,1994
New York,Mount Kisco village,11060,3526,4506,668,139,338,9177
New York,Mount Ivy,7090,2244,2523,482,128,210,5587
New York,Mountain Lodge Park,1639,480,665,160,8,38,1351
New York,Morrisville village,1938,1446,272,63,3,59,1843
New York,Morristown village,431,142,189,30,2,25,388
New York,Mount Sinai,12451,2326,6297,464,71,550,9708
New York,New Hempstead village,5265,1542,1947,140,80,210,3919
New York,Napeague,211,42,112,0,0,37,191
New York,Narrowsburg,382,88,204,34,14,15,355
New York,Newfield Hamlet,699,141,273,158,15,84,671
New York,Newfane,3769,612,1590,405,19,375,3001
New York,New City,33722,7432,17414,1432,306,1367,27951
New York,New Cassel,13903,5304,4047,497,353,542,10743
New York,Newburgh,28495,9996,6630,1473,947,1076,20122
New York,New Berlin village,1170,223,457,118,35,133,966
New York,Naples village,990,312,366,115,28,44,865
New York,Newark Valley village,1188,284,450,95,53,41,923
New York,Nesconset,13876,3104,6498,906,147,674,11329
New York,Nelsonville village,805,171,363,35,6,30,605
New York,Nelliston village,535,119,237,61,20,41,478
New York,Nedrow,2176,757,754,185,40,128,1864
New York,Natural Bridge,776,110,323,0,0,13,446
New York,Nassau village,1077,229,529,70,19,47,894
New York,Newark village,8965,2779,3106,781,267,552,7485
New York,Savannah,405,82,147,57,34,20,340
New York,Savona village,809,196,243,115,20,59,633
New York,Sayville,16621,3593,7398,1013,172,1289,13465
New York,Elmira Heights village,3945,1051,1384,293,38,286,3052
New York,Elmira,28817,10572,7194,2675,842,1619,22902
New York,Elma Center,2639,440,1372,227,16,240,2295
New York,Sharon Springs village,614,165,229,85,14,39,532
New York,Shelter Island,1313,185,705,75,0,71,1036
New York,Shelter Island Heights,1493,354,706,80,21,109,1270
New York,Elmont,37388,12382,13967,2359,772,1674,31154
New York,Shenorock,1874,391,964,21,47,61,1484
New York,Sherman village,681,120,307,52,13,53,545
New York,Sherrill,3073,673,1383,295,31,197,2579
New York,Shinnecock Hills,2152,710,838,247,0,114,1909
New York,Shirley,25691,7045,10820,1822,482,731,20900
New York,Shokan,1111,288,642,71,8,70,1079
New York,Shoreham village,432,73,285,7,3,18,386
New York,Sherburne village,1359,294,458,217,35,116,1120
New York,Shortsville village,1385,349,564,160,47,80,1200
New York,Elmsford village,4765,1543,1889,268,123,178,4001
New York,Endicott village,13143,4137,3898,1615,452,773,10875
New York,Hyde Park,2192,553,826,205,66,139,1789
New York,Ilion village,8066,2111,2806,682,256,545,6400
New York,Interlaken village,703,233,236,57,13,60,599
New York,Inwood,10052,2893,3416,510,315,531,7665
New York,Irondequoit,51337,13116,20509,5171,783,3368,42947
New York,Irvington village,6540,1078,3499,264,128,272,5241
New York,Elwood,10941,2342,5402,576,70,339,8729
New York,Islandia village,3370,977,1310,292,60,169,2808
New York,Islip,18433,5376,7851,993,247,953,15420
New York,West Winfield village,820,137,415,47,15,54,668
New York,Ithaca,30565,21808,4450,1224,406,399,28287
New York,Jamesport,1355,516,630,39,0,51,1236
New York,Jamestown,30546,8259,9724,3584,809,1835,24211
New York,Endwell,11445,2581,4943,1146,190,648,9508
New York,Island Park village,4694,1410,1696,548,63,339,4056
New York,Hurley,3452,666,1723,241,86,214,2930
New York,Shrub Oak,1997,555,984,86,28,125,1778
New York,Silver Creek village,2598,531,995,243,90,152,2011
New York,South Fallsburg,3571,950,686,252,71,224,2183
New York,South Farmingdale,15130,3535,7131,592,186,877,12321
New York,South Floral Park village,2058,554,840,143,21,67,1625
New York,Ellisburg village,256,57,97,24,4,9,191
New York,South Hempstead,3152,800,1330,235,73,124,2562
New York,South Hill,6501,4835,1030,91,27,189,6172
New York,South Dayton village,756,174,243,72,11,54,554
New York,South Huntington,9724,2302,4469,698,76,629,8174
New York,South Lockport,7788,2047,2800,973,115,484,6419
New York,South Nyack village,3549,1391,1219,257,22,182,3071
New York,Southold,6295,1167,3471,560,92,350,5640
New York,Southport,7001,1585,2973,816,202,463,6039
New York,South Valley Stream,6588,1722,2929,460,36,337,5484
New York,Spackenkill,4122,829,2157,176,66,168,3396
New York,South Lima,252,55,114,0,0,41,210
New York,Sidney village,4146,834,1454,502,195,217,3202
New York,South Corning village,1060,237,447,97,28,99,908
New York,Southampton village,3193,771,1206,467,53,336,2833
New York,Silver Springs village,951,306,249,125,5,83,768
New York,Sinclairville village,644,121,279,40,5,30,475
New York,Skaneateles village,2553,374,1186,280,22,217,2079
New York,Sleepy Hollow village,10074,2581,4111,650,243,450,8035
New York,Sloan village,3624,1077,1199,432,102,264,3074
New York,Sloatsburg village,3106,911,1232,211,37,138,2529
New York,South Blooming Grove village,3214,823,1318,208,85,145,2579
New York,Smallwood,269,70,101,85,0,0,256
New York,Smithville Flats,480,123,161,24,28,21,357
New York,Smyrna village,236,55,94,10,10,16,185
New York,Sodus village,2374,683,801,135,62,102,1783
New York,Sodus Point village,981,182,428,88,29,72,799
New York,Solvay village,6490,1902,2244,629,173,488,5436
New York,Sound Beach,8071,1738,3522,658,71,252,6241
New York,Smithtown,25974,5812,12045,1504,276,1561,21198
New York,Huntington Station,34088,9607,12555,2323,591,1308,26384
New York,Huntington Bay village,1509,275,856,49,24,74,1278
New York,Huntington,17917,4238,8343,1252,342,945,15120
New York,Seneca Knolls,2393,641,1024,207,0,131,2003
New York,Setauket-East Setauket,14346,2738,7169,742,241,704,11594
New York,Hartwick,577,150,233,54,4,43,484
New York,Hastings-on-Hudson village,7951,1715,3803,512,83,351,6464
New York,Hauppauge,20616,4538,9793,1222,240,1128,16921
New York,Haverstraw village,12094,3949,3748,861,569,510,9637
New York,Seneca Falls,6493,1683,2461,722,58,460,5384
New York,Haviland,3470,672,1815,317,15,152,2971
New York,Head of the Harbor village,1330,324,701,31,12,68,1136
New York,Hemlock,401,32,195,26,0,80,333
New York,Hempstead village,55105,21573,14339,3485,1528,2309,43234
New York,Henderson,170,38,60,13,3,30,144
New York,Heritage Hills,4024,422,2375,366,54,589,3806
New York,Herkimer village,7731,2058,2891,816,218,631,6614
New York,Hawthorne,4583,1040,2203,289,75,142,3749
New York,Hermon village,404,123,94,51,13,33,314
New York,Selden,20123,5813,8256,1332,263,875,16539
New York,Seaford,15656,3775,7248,726,196,832,12777
New York,Scarsdale village,17621,2634,9561,380,123,369,13067
New York,Schaghticoke village,564,126,237,50,0,39,452
New York,Schenectady,65735,24191,18059,5837,1663,4029,53779
New York,Schenevus,537,143,242,58,0,34,477
New York,Schoharie village,859,252,293,138,2,86,771
New York,Schroon Lake,474,91,219,39,0,81,430
New York,Searingtown,4765,908,2548,168,0,287,3911
New York,Schuylerville village,1621,371,512,205,49,89,1226
New York,Scotchtown,9061,2649,3582,531,135,376,7273
New York,Scotia village,7744,1874,2890,820,57,363,6004
New York,Scottsburg,116,20,66,8,0,13,107
New York,Scotts Corners,563,95,251,125,34,16,521
New York,Scottsville village,2616,674,1046,173,41,73,2007
New York,Sea Cliff village,5025,1129,2516,332,34,215,4226
New York,Scio,508,97,245,52,8,54,456
New York,Herricks,4370,1092,2044,204,5,295,3640
New York,Herrings village,78,19,38,4,0,4,65
New York,Heuvelton village,798,191,335,53,23,58,660
New York,Homer village,3224,822,1091,371,62,181,2527
New York,Honeoye,655,137,280,19,12,132,580
New York,Honeoye Falls village,2720,644,1028,242,66,245,2225
New York,Hoosick Falls village,3453,1082,1103,316,178,234,2913
New York,Hopewell Junction,362,98,173,24,0,25,320
New York,Hornell,8471,2284,2962,880,142,496,6764
New York,Holtsville,20081,5152,9053,1153,208,786,16352
New York,Horseheads village,6594,1542,2589,546,147,586,5410
New York,Hortonville,235,94,94,7,11,5,211
New York,Houghton,1747,1079,398,17,9,94,1597
New York,Hudson,6572,2368,1522,810,239,346,5285
New York,Hudson Falls village,7239,2098,2331,829,153,377,5788
New York,Hunt,44,6,22,0,6,4,38
New York,Hunter village,320,120,53,31,10,87,301
New York,Horseheads North,2755,553,1520,140,43,76,2332
New York,Holley village,2032,529,585,291,59,145,1609
New York,Holland Patent village,373,106,152,47,7,15,327
New York,Holland,1236,309,507,97,20,62,995
New York,Hewlett,6032,1292,3002,403,75,191,4963
New York,Hewlett Bay Park village,354,63,217,14,1,17,312
New York,Hewlett Harbor village,1229,255,666,23,0,71,1015
New York,Hewlett Neck village,352,52,212,1,2,10,277
New York,Hicksville,42333,11445,20277,1830,452,2298,36302
New York,High Falls,905,299,392,54,57,17,819
New York,Highland,5189,1250,2061,326,122,372,4131
New York,Highland Falls village,3856,1133,1722,301,90,146,3392
New York,Hillburn village,872,201,330,87,34,39,691
New York,Hillcrest,7317,2056,3078,431,118,419,6102
New York,Hillside,855,153,498,27,0,52,730
New York,Hillside Lake,1070,261,475,24,11,99,870
New York,Hilton village,5936,1430,2480,546,30,387,4873
New York,Hobart village,481,98,223,29,14,23,387
New York,Holbrook,27533,6742,11705,2277,279,1267,22270
New York,Pulaski village,2214,487,673,278,112,125,1675
New York,Sparkill,1523,386,590,100,0,55,1131
New York,Prospect village,214,48,72,23,5,23,171
New York,Prattsville,263,73,108,8,0,30,219
New York,Groton village,2536,740,932,205,51,169,2097
New York,Greigsville,296,101,176,10,0,0,287
New York,Greenwood Lake village,3118,632,1197,493,13,137,2472
New York,Greenwich village,1885,413,809,141,54,96,1513
New York,Greenville CDP (Westchester County),7543,1509,3648,394,51,186,5788
New York,Greenville CDP (Greene County),505,108,200,80,17,51,456
New York,Groveland Station,283,53,114,39,3,9,218
New York,Greenvale,1003,347,399,77,75,27,925
New York,Greenport village,2234,691,819,190,17,145,1862
New York,Greenlawn,14481,3561,5598,969,214,986,11328
New York,Green Island village,2629,766,892,284,100,65,2107
New York,Greene village,1592,352,619,141,29,153,1294
New York,Greece,14568,3432,5747,1534,231,1161,12105
New York,Great River,1561,302,786,63,7,78,1236
New York,Greenport West,2002,403,922,117,35,301,1778
New York,Great Neck Plaza village,6879,1417,2869,780,62,888,6016
New York,Guilford,339,55,182,39,7,17,300
New York,Hagaman village,1414,328,601,197,26,97,1249
New York,Harbor Hills,545,90,325,10,0,52,477
New York,Hannibal village,604,143,230,76,20,24,493
New York,Hannawa Falls,925,152,483,68,6,92,801
New York,Hancock village,946,232,336,118,35,88,809
New York,Hampton Manor,2104,545,903,115,43,166,1772
New York,Hampton Bays,12866,2891,5929,1058,210,746,10834
New York,Hadley,846,149,424,108,29,28,738
New York,Hammondsport village,592,93,284,89,11,56,533
New York,Hamlin,5587,1205,2290,668,75,119,4357
New York,Hamilton village,4064,2855,614,90,44,137,3740
New York,Hamburg village,9521,2014,4114,954,76,603,7761
New York,Hall,152,19,111,5,0,0,135
New York,Halesite,2810,390,1582,193,20,167,2352
New York,Hailesboro,686,214,344,11,11,35,615
New York,Hammond village,342,68,132,15,2,27,244
New York,Harbor Isle,1529,257,836,76,0,63,1232
New York,Great Neck Gardens,1166,254,642,24,0,16,936
New York,Great Neck village,10095,2026,4497,422,82,446,7473
New York,Glasco,2464,701,864,182,30,203,1980
New York,Gilgo,208,76,102,0,0,22,200
New York,Gilbertsville village,361,78,136,43,10,43,310
New York,Ghent,438,125,167,0,0,0,292
New York,Old Field village,858,143,482,31,11,50,717
New York,Old Brookville village,2307,507,1168,64,0,119,1858
New York,Glen Aubrey,308,87,101,28,35,13,264
New York,Old Bethpage,5252,1070,2653,182,18,270,4193
New York,Ogdensburg,10996,3520,3362,1157,425,602,9066
New York,Odessa village,661,144,218,81,21,63,527
New York,Oceanside,30371,7600,14802,1315,274,1692,25683
New York,Ocean Beach village,32,7,12,9,0,4,32
New York,Oakfield village,1767,412,784,130,15,138,1479
New York,Oakdale,7336,1708,3430,559,87,421,6205
New York,Olcott,1096,379,405,144,19,71,1018
New York,Great Neck Estates village,2809,553,1411,116,32,81,2193
New York,Glen Cove,27245,7888,10791,1880,532,1334,22425
New York,Glen Park village,577,131,230,29,13,24,427
New York,Great Bend,854,174,384,27,89,21,695
New York,Granville village,2321,458,786,322,136,179,1881
New York,Grandyle Village,4812,985,2148,489,15,188,3825
New York,Grand View-on-Hudson village,295,72,147,18,3,15,255
New York,Gowanda village,2656,780,751,357,82,189,2159
New York,Gouverneur village,3882,1130,1307,441,54,278,3210
New York,Glen Head,4620,1035,2239,231,66,220,3791
New York,Goshen village,5394,1404,2019,480,92,450,4445
New York,Gordon Heights,3866,1209,992,420,139,106,2866
New York,Golden's Bridge,1694,282,772,134,9,69,1266
New York,Gloversville,15293,4287,5274,1519,394,884,12358
New York,Glenwood Landing,3767,738,1780,254,51,220,3043
New York,Glens Falls North,8494,1837,3538,782,153,708,7018
New York,Glens Falls,14496,5182,4312,1794,326,705,12319
New York,Gorham,601,135,350,34,0,9,528
New York,Oak Beach-Captree,134,0,91,43,0,0,134
New York,Harriman village,2704,769,1054,194,72,84,2173
New York,Harrison village,27998,9505,10860,1560,255,1100,23280
New York,Philadelphia village,1113,221,451,68,45,44,829
New York,Phelps village,1983,520,697,196,54,160,1627
New York,Peru,1300,293,550,188,44,79,1154
New York,Perrysburg,325,62,125,40,7,22,256
New York,Perry village,3462,765,1496,308,36,149,2754
New York,Penn Yan village,4815,1390,1372,675,139,388,3964
New York,Philmont village,1373,337,507,140,40,33,1057
New York,Pelham Manor village,5567,1195,2588,185,6,312,4286
New York,Peekskill,23928,6750,8808,2193,657,1099,19507
New York,Peconic,526,101,297,53,0,50,501
New York,Pearl River,16383,4089,7034,982,171,894,13170
New York,Peach Lake,1428,262,689,122,0,54,1127
New York,Pawling village,2243,730,695,303,8,144,1880
New York,Pavilion,549,129,204,68,5,47,453
New York,Pelham village,6993,1698,3046,413,143,214,5514
New York,Paul Smiths,667,663,4,0,0,0,667
New York,Phoenicia,215,108,25,46,12,14,205
New York,Piermont village,2557,740,1199,218,13,117,2287
New York,Plattekill,1240,461,452,91,0,64,1068
New York,Plandome Manor village,813,129,431,32,1,53,646
New York,Plandome Heights village,988,198,479,29,9,52,767
New York,Plandome village,1278,240,662,25,7,32,966
New York,Plainview,26199,4619,13686,1001,215,1581,21102
New York,Plainedge,9343,2264,4261,512,156,538,7731
New York,Phoenix village,2496,698,721,239,93,138,1889
New York,Pittsford village,1516,300,695,142,31,72,1240
New York,Pine Plains,1575,258,696,88,62,123,1227
New York,Pine Hill,172,32,62,45,5,5,149
New York,Pine Bush,1514,422,595,202,29,121,1369
New York,Pike,233,65,86,30,0,3,184
New York,Piffard,260,29,107,67,0,0,203
New York,Pierrepont Manor,143,0,101,0,5,0,106
New York,Pine Valley,774,152,407,101,26,26,712
New York,Harris Hill,5499,1211,2541,413,53,340,4558
New York,Patchogue village,12173,3762,3836,1360,270,517,9745
New York,Parish village,489,114,187,46,9,17,373
New York,Oriskany village,1280,295,477,163,18,133,1086
New York,Orient,706,142,389,76,4,74,685
New York,Orchard Park village,3229,683,1489,313,71,124,2680
New York,Orange Lake,6718,1722,3088,496,86,445,5837
New York,Orangeburg,4442,1627,1548,233,28,382,3818
New York,Ontario,2190,479,772,233,113,233,1830
New York,Oriskany Falls village,857,142,319,85,48,44,638
New York,Oneonta,13862,8406,2877,713,161,545,12702
New York,Oneida,11252,3111,4223,1103,272,432,9141
New York,Olean,14099,4125,4599,1895,274,744,11637
New York,Old Westbury village,4418,2028,1616,95,5,129,3873
New York,Old Forge,441,134,152,31,5,114,436
New York,Hartsdale,5146,1317,2265,605,115,152,4454
New York,Harrisville village,590,101,218,86,17,56,478
New York,Oneida Castle village,689,146,253,89,15,36,539
New York,Parishville,832,182,302,89,13,45,631
New York,Ossining village,25311,7629,9283,1960,675,1008,20555
New York,Otego village,1152,251,551,97,11,20,930
New York,Parc,206,206,0,0,0,0,206
New York,Panama village,503,88,219,37,18,28,390
New York,Pamelia Center,404,85,237,35,0,0,357
New York,Palmyra village,3446,973,1103,435,65,265,2841
New York,Palenville,760,236,375,57,0,0,668
New York,Palatine Bridge village,814,138,290,108,39,127,702
New York,Oswego,17988,5991,5621,1772,528,1014,14926
New York,Painted Post village,1689,333,717,148,26,140,1364
New York,Oyster Bay,6562,1495,2800,584,47,544,5470
New York,Oxford village,1370,310,562,126,56,92,1146
New York,Oxbow,96,12,49,8,0,8,77
New York,Owego village,3807,1275,1338,341,74,286,3314
New York,Ovid village,602,156,160,86,6,65,473
New York,Otisville village,1110,236,512,93,25,21,887
New York,Oyster Bay Cove village,2190,409,1259,41,19,78,1806
New York,Nyack village,6769,2008,2296,659,295,293,5551
New York,Nunda village,1422,282,612,143,21,104,1162
New York,Noyack,3970,1071,1695,271,38,213,3288
New York,Fleischmanns village,386,112,76,46,24,37,295
New York,Flanders,4906,1573,1586,370,68,111,3708
New York,Fishkill village,2001,490,762,238,49,95,1634
New York,Fishers Landing,70,0,52,0,0,18,70
New York,Fishers Island,339,79,181,2,2,33,297
New York,Firthcliffe,4681,1071,1770,693,30,246,3810
New York,Floral Park village,16093,3794,7628,834,177,768,13201
New York,Fire Island,298,73,132,11,1,9,226
New York,Felts Mills,257,39,102,12,22,14,189
New York,Fayetteville village,4203,1027,1882,395,13,232,3549
New York,Farnham village,405,108,195,26,0,26,355
New York,Farmingville,15690,3938,7153,756,201,674,12722
New York,Farmingdale village,8399,2106,3646,775,132,510,7169
New York,Falconer village,2573,664,897,242,61,187,2051
New York,Fillmore,596,92,247,33,40,46,458
New York,Fairview CDP (Westchester County),2874,1299,695,193,11,152,2350
New York,Florida village,2865,598,1168,229,82,159,2236
New York,Fonda village,737,220,256,64,33,37,610
New York,Franklin Square,31544,8400,14257,1564,271,1813,26305
New York,Franklin village,375,75,174,29,0,9,287
New York,Frankfort village,2560,733,836,346,26,95,2036
New York,Fowlerville,258,101,60,0,8,28,197
New York,Fort Salonga,9821,2067,5047,421,26,413,7974
New York,Fort Plain village,1949,535,602,190,101,168,1596
New York,Flower Hill village,4772,742,2277,204,75,225,3523
New York,Fort Montgomery,1421,399,714,125,0,11,1249
New York,Fort Edward village,3318,1060,1182,345,109,83,2779
New York,Fort Drum,13985,4103,5364,353,131,36,9987
New York,Fort Covington Hamlet,1481,420,525,92,46,88,1171
New York,Fort Ann village,545,123,233,37,12,24,429
New York,Forestville village,581,166,201,68,11,35,481
New York,Forest Home,555,219,256,14,3,0,492
New York,Fort Johnson village,582,153,219,75,26,27,500
New York,Franklinville village,1850,382,659,172,23,142,1378
New York,Fairview CDP (Dutchess County),5700,2274,1902,313,38,249,4776
New York,Fairmount,10106,2761,4068,921,166,635,8551
New York,Port Ewen,3413,918,1285,322,114,287,2926
New York,Port Gibson,495,103,259,62,0,0,424
New York,Port Henry village,920,221,357,90,20,40,728
New York,Port Jefferson village,7802,1851,3837,598,59,313,6658
New York,Port Jefferson Station,8582,2472,3500,471,132,382,6957
New York,Port Jervis,8681,2396,2730,769,218,777,6890
New York,Port Dickinson village,1648,466,609,199,58,40,1372
New York,Port Leyden village,756,202,236,58,37,34,567
New York,Port Washington,16233,2876,7931,948,122,833,12710
New York,Port Washington North village,3190,620,1578,141,8,247,2594
New York,Potsdam village,9656,6653,1544,453,108,373,9131
New York,Pottersville,489,160,153,12,0,0,325
New York,Poughkeepsie,30635,11429,8083,2562,800,1745,24619
New York,Prattsburgh,753,167,307,64,19,26,583
New York,Portville village,1146,221,403,149,15,71,859
New York,Fairport village,5362,989,2712,657,91,298,4747
New York,Port Chester village,29406,9947,10529,1506,1039,994,24015
New York,Poquott village,856,225,404,57,9,35,730
New York,Fair Haven village,700,183,283,88,22,51,627
New York,Fabius village,310,74,131,29,1,13,248
New York,Evans Mills village,481,94,218,30,13,33,388
New York,Esperance village,357,79,133,30,1,21,264
New York,Erin,357,86,150,47,27,27,337
New York,Plattsburgh,19845,9404,5016,1552,377,1170,17519
New York,Port Byron village,1310,381,477,114,17,43,1032
New York,Plattsburgh West,1458,395,586,134,22,93,1230
New York,Pleasantville village,7125,1636,3188,494,87,323,5728
New York,Plessis,115,56,19,40,0,0,115
New York,Poestenkill,1010,214,417,103,9,92,835
New York,Point Lookout,1267,223,653,41,34,133,1084
New York,Poland village,381,63,175,39,4,13,294
New York,Pomona village,3286,972,1420,79,11,89,2571
New York,Pleasant Valley,1452,320,639,150,0,106,1215
New York,Fredonia village,10881,4912,3475,803,98,388,9676
New York,Freedom Plains,472,144,144,74,22,56,440
New York,Freeport village,43251,14664,13445,3335,1109,2041,34594
New York,North Lindenhurst,11679,2780,4630,618,270,667,8965
New York,North Hornell village,867,129,408,58,19,152,766
New York,North Hills village,5190,558,3232,407,0,425,4622
New York,North Haven village,846,159,462,57,3,35,716
New York,North Great River,4091,1258,1726,211,19,237,3451
New York,North Gates,9756,2987,3379,966,285,669,8286
New York,North Lynbrook,496,141,203,7,0,67,418
New York,Northeast Ithaca,3103,864,1448,112,16,83,2523
New York,North Collins village,1352,246,538,135,36,36,991
New York,North Boston,2749,659,1285,205,13,203,2365
New York,North Bellport,11623,3622,3572,907,249,429,8779
New York,North Bellmore,20153,4483,9560,1027,141,1154,16365
New York,North Bay Shore,20127,6303,6759,1166,542,572,15342
New York,North Ballston Spa,1569,474,602,171,0,86,1333
New York,North Creek,446,88,182,57,5,100,432
New York,North Babylon,17228,4360,7465,1083,199,939,14046
New York,North Massapequa,18749,4109,8856,922,189,1173,15249
New York,North New Hyde Park,15177,3553,7584,434,147,903,12621
New York,Norwood village,1644,447,552,172,32,92,1295
New York,Norwich,7032,1927,2066,877,236,405,5511
New York,Northwest Ithaca,1193,283,463,116,26,176,1064
New York,Northwest Harbor,4004,652,2126,407,33,214,3432
New York,North Wantagh,11713,2395,5312,772,143,1019,9641
New York,Northville,1685,183,941,40,74,144,1382
New York,North Merrick,12077,2892,5769,663,104,485,9913
New York,Northville village,934,225,459,31,29,72,816
New York,North Tonawanda,31077,8586,12123,3093,472,2062,26336
New York,North Syracuse village,6641,1808,2325,770,92,603,5598
New York,North Sea,4441,919,2321,328,47,249,3864
New York,North Rose,544,139,241,30,0,55,465
New York,Northport village,7412,1330,3719,561,100,322,6032
New York,North Patchogue,6680,1876,2920,400,42,272,5510
New York,North Valley Stream,17845,5481,6810,1215,460,952,14918
New York,Northampton,578,206,284,16,21,21,548
New York,North Amityville,19895,7311,5011,1518,524,1078,15442
New York,Norfolk,1387,504,452,32,46,101,1135
New York,Gardnertown,5033,1339,1826,473,158,277,4073
New York,Gardiner,643,172,334,33,0,9,548
New York,Garden City South,4265,1028,1966,301,8,290,3593
New York,Garden City Park,8221,1915,4043,269,85,560,6872
New York,Garden City village,22575,5223,11005,599,126,1097,18050
New York,Gang Mills,4401,1110,1830,375,38,265,3618
New York,Gasport,1103,246,340,208,45,49,888
New York,Galway village,320,48,150,37,1,12,248
New York,Gainesville village,204,49,105,14,8,9,185
New York,Fultonville village,667,198,216,73,13,34,534
New York,Fulton,11713,3015,3950,1311,299,699,9274
New York,Friendship,1255,349,341,118,65,41,914
New York,Frewsburg,2207,480,926,389,31,165,1991
New York,Freeville village,524,132,251,40,7,14,444
New York,Galeville,4821,1212,1807,379,80,461,3939
New York,Gates,5034,1544,2008,359,32,374,4317
New York,Geneseo village,8096,5860,1277,202,102,175,7616
New York,Geneva,13157,5984,3349,994,235,598,11160
New York,Niverville,1629,299,828,190,53,60,1430
New York,Nissequogue village,1692,321,893,57,13,58,1342
New York,Niskayuna,4911,831,2371,337,39,160,3738
New York,Nichols village,594,151,252,48,2,19,472
New York,Niagara Falls,49435,16371,14577,4976,1184,3155,40263
New York,New York Mills village,3243,795,874,492,57,293,2511
New York,New York,8426743,3043299,2711950,552095,229556,385618,6922518
New York,New Windsor,8691,2478,3513,742,210,327,7270
New York,New Suffolk,310,88,139,57,0,20,304
New York,New Square village,7540,1040,2467,11,9,29,3556
New York,New Rochelle,79027,22947,30721,5227,1501,4395,64791
New York,Newport village,544,112,185,85,17,38,437
New York,New Paltz village,7055,4983,930,307,78,331,6629
New York,New Hyde Park village,9788,2295,4609,421,154,574,8053
New York,Germantown,860,139,427,73,12,49,700
New York,Preston-Potter Hollow,420,108,187,38,3,29,365
New York,Speculator village,362,124,138,77,0,12,351
New York,Islip Terrace,5327,1298,2339,310,155,229,4331
New York,Spencerport village,3598,909,1480,411,56,216,3072
New York,Turin village,163,29,83,15,3,6,136
New York,Tuscarora,0,0,0,0,0,0,0
New York,Tuxedo Park village,590,77,319,20,21,27,464
New York,Unadilla village,831,180,362,49,11,64,666
New York,Uniondale,25092,8647,7774,1713,662,1193,19989
New York,Union Springs village,1268,344,497,93,38,86,1058
New York,Unionville village,596,110,192,65,23,53,443
New York,University at Buffalo,6174,6080,58,8,0,0,6146
New York,University Gardens,4122,1009,2027,192,55,143,3426
New York,Upper Brookville village,1528,401,814,44,12,97,1368
New York,Upper Nyack village,2050,507,961,141,16,95,1720
New York,Utica,61628,21433,16106,5793,1255,3933,48520
New York,Vails Gate,3509,1142,1276,367,62,301,3148
New York,Valatie village,1735,480,549,151,58,185,1423
New York,Valhalla,3352,930,1463,117,13,293,2816
New York,Tupper Lake village,3566,829,1316,290,103,214,2752
New York,Tully village,1082,377,297,132,6,86,898
New York,Tuckahoe village,6586,2024,2286,813,128,316,5567
New York,Tuckahoe,1169,228,641,124,0,5,998
New York,Theresa village,903,227,314,75,24,65,705
New York,Thiells,5173,1504,2348,232,58,264,4406
New York,Thomaston village,2624,477,1281,138,51,92,2039
New York,Thornwood,4054,1084,1772,225,82,201,3364
New York,Thousand Island Park,71,0,50,0,0,21,71
New York,Three Mile Bay,198,74,41,13,0,26,154
New York,Ticonderoga,3123,854,1247,161,61,175,2498
New York,Valley Cottage,10191,2304,4459,714,224,696,8397
New York,Spencer village,993,137,417,100,7,68,729
New York,Tivoli village,1184,617,287,111,18,43,1076
New York,Tonawanda,15000,4563,5905,1363,228,1005,13064
New York,Tonawanda,58149,14978,23241,5546,715,4364,48844
New York,Town Line,2270,499,1087,154,7,129,1876
New York,Tribes Hill,808,145,312,114,0,101,672
New York,Troy,49933,22980,11661,3796,1063,2134,41634
New York,Trumansburg village,1637,364,681,199,74,74,1392
New York,Titusville,561,58,324,37,8,61,488
New York,Valley Falls village,531,127,238,27,10,12,414
New York,Valley Stream village,37838,10270,15733,2167,575,1862,30607
New York,Van Etten village,602,151,217,81,14,20,483
New York,Mayville village,1413,414,518,182,69,60,1243
New York,Mayfield village,760,226,343,50,4,28,651
New York,Maybrook village,3093,1057,1052,327,57,160,2653
New York,Mattydale,6434,2069,1826,731,108,404,5138
New York,Mattituck,4435,955,2313,270,21,84,3643
New York,Matinecock village,813,172,418,34,0,46,670
New York,Mastic Beach village,14883,4677,5047,1095,274,628,11721
New York,Mechanicstown,7130,2052,2519,637,220,576,6004
New York,Mastic,16084,4000,6583,1100,220,499,12402
New York,Massapequa Park village,17175,3795,8103,754,136,1172,13960
New York,Massapequa,22128,5252,10502,1051,323,1155,18283
New York,Marlboro,3518,703,1448,424,28,143,2746
New York,Marion,1403,265,628,79,9,128,1109
New York,Mariaville Lake,609,237,308,33,0,5,583
New York,Margaretville village,566,150,200,90,3,109,552
New York,Marcellus village,1655,494,607,161,28,130,1420
New York,Massena village,11086,2858,3855,1085,298,777,8873
New York,Thendara,183,36,105,0,0,12,153
New York,Mechanicville,5205,1693,1561,604,170,326,4354
New York,Medina village,5936,1425,2080,681,129,440,4755
New York,Vernon village,1198,354,422,149,51,79,1055
New York,Verona,735,121,358,52,0,74,605
New York,Verplanck,1662,414,613,148,22,88,1285
New York,Victor village,2768,622,1135,136,50,134,2077
New York,Victory village,471,118,180,47,13,15,373
New York,Village Green,3527,777,1471,527,0,255,3030
New York,Village of the Branch village,1986,362,979,70,5,80,1496
New York,Medford,24793,7767,8876,1925,552,1545,20665
New York,Viola,6282,1491,2387,194,58,401,4531
New York,Voorheesville village,2820,588,1336,199,33,132,2288
New York,Merritt Park,1720,251,913,84,0,32,1280
New York,Merrick,20572,4715,10430,856,188,883,17072
New York,Meridian village,293,63,141,11,0,22,237
New York,Menands village,4004,1303,1521,304,12,54,3194
New York,Melville,18682,3346,9370,1091,247,1591,15645
New York,Melrose Park,2199,422,1102,150,78,133,1885
New York,Virgil,344,47,177,21,4,0,249
New York,Terryville,12296,2892,5566,697,135,619,9909
New York,Tarrytown village,11452,3527,4814,613,110,433,9497
New York,Tappan,6873,1475,3349,317,38,457,5636
New York,Crompond,2466,409,1291,163,10,190,2063
New York,Croghan village,696,129,294,57,16,63,559
New York,Cranberry Lake,187,38,109,4,0,19,170
New York,Cragsmoor,608,29,340,132,0,11,512
New York,Coxsackie village,2753,894,948,236,18,211,2307
New York,Cove Neck village,298,29,160,7,0,17,213
New York,Country Knolls,2102,259,1197,79,7,88,1630
New York,Croton-on-Hudson village,8202,1472,3788,554,160,376,6350
New York,Cortland West,1289,153,769,80,0,35,1037
New York,Cornwall-on-Hudson village,2984,692,1373,261,31,87,2444
New York,Corning,11059,2925,3835,1329,327,611,9027
New York,Corinth village,2545,560,925,265,69,163,1982
New York,Corfu village,807,243,320,69,44,47,723
New York,Coram,40685,10619,16365,3576,678,2032,33270
New York,Copiague,22772,6997,8652,1873,406,1326,19254
New York,Copenhagen village,716,181,319,68,17,43,628
New York,Cortland,19134,9122,4521,1596,361,924,16524
New York,Copake Lake,518,74,254,34,19,28,409
New York,Crown Heights,2830,758,1254,163,21,202,2398
New York,Crystal Beach,727,133,369,80,30,11,623
New York,Depauville,961,128,406,31,8,0,573
New York,Delhi village,3078,2090,468,226,20,112,2916
New York,Delevan village,1076,292,379,79,39,61,850
New York,Delanson village,390,92,182,16,1,15,306
New York,DeKalb Junction,576,133,211,26,49,4,423
New York,Deferiet village,276,85,74,28,6,16,209
New York,Deer Park,27346,7245,11040,1719,611,1674,22289
New York,Crugers,1720,458,611,246,61,216,1592
New York,Davenport Center,417,59,135,112,46,25,377
New York,Dannemora village,3894,2163,924,349,216,89,3741
New York,Dalton,306,46,172,11,0,28,257
New York,Cuylerville,344,95,154,0,11,15,275
New York,Cutchogue,3192,708,1635,212,60,159,2774
New York,Cumminsville,146,6,75,29,10,26,146
New York,Cumberland Head,1564,230,921,107,0,65,1323
New York,Cuba village,1654,415,618,176,46,113,1368
New York,Dansville village,4537,1323,1734,423,102,323,3905
New York,Marathon village,939,262,322,77,57,46,764
New York,Copake Hamlet,352,75,166,28,6,0,275
New York,Cooperstown village,2185,512,1105,159,35,157,1968
New York,Clayville village,328,101,128,15,8,16,268
New York,Clayton village,1917,469,702,211,52,117,1551
New York,Claverack-Red Mills,735,80,384,103,14,39,620
New York,Mexico village,1702,336,640,207,32,48,1263
New York,Stony Brook University,9101,8548,317,16,0,196,9077
New York,Stony Point,12882,3300,6057,529,152,678,10716
New York,Stottville,1355,434,503,127,48,77,1189
New York,Cleveland village,776,203,247,65,17,64,596
New York,Strykersville,719,163,291,49,0,38,541
New York,Sunset Bay,781,231,271,75,7,53,637
New York,SUNY Oswego,3559,3549,0,10,0,0,3559
New York,Sylvan Beach village,856,100,414,132,15,107,768
New York,Syosset,19157,3600,9911,773,180,721,15185
New York,Syracuse,144564,63709,30811,11715,3960,6815,117010
New York,Taconic Shores,639,92,262,109,7,103,573
New York,Tannersville village,714,200,221,47,11,41,520
New York,Suffern village,10914,2876,4361,913,199,695,9044
New York,Copake Falls,184,30,33,22,8,49,142
New York,Clifton Springs village,2180,435,831,270,0,214,1750
New York,Clintondale,1391,298,545,158,0,226,1227
New York,Coopers Plains,407,132,151,29,0,57,369
New York,Constantia,837,208,413,86,40,57,804
New York,Constableville village,239,67,105,14,3,10,199
New York,Congers,8698,2161,3906,620,108,469,7264
New York,Conesus Lake,2584,677,1349,221,8,97,2352
New York,Conesus Hamlet,512,121,191,28,15,5,360
New York,Commack,35914,7670,17969,1676,283,2024,29622
New York,Clinton village,1850,463,726,215,46,108,1558
New York,Colton,428,55,197,45,0,42,339
New York,Cold Spring Harbor,5076,1012,2582,247,51,175,4067
New York,Cold Spring village,1790,438,823,97,39,103,1500
New York,Cold Brook village,336,99,104,23,16,17,259
New York,Cohoes,16281,5347,5234,1735,254,1178,13748
New York,Cohocton village,1016,236,398,71,42,45,792
New York,Cobleskill village,4602,2243,1116,257,51,341,4008
New York,Clyde village,2012,461,665,166,64,88,1444
New York,Colonie village,7898,2145,3064,863,141,492,6705
New York,Depew village,15227,3983,6195,1215,242,981,12616
New York,Manorville,14501,3331,6393,815,45,847,11431
New York,Mannsville village,375,67,169,35,2,18,291
New York,Walton Park,2281,630,1032,165,0,49,1876
New York,Wampsville village,577,181,246,37,15,41,520
New York,Wanakah,2836,547,1566,167,42,208,2530
New York,Wantagh,18939,4511,9356,733,133,785,15518
New York,Wappingers Falls village,5424,1519,1870,462,151,453,4455
New York,Warrensburg,3170,588,1372,324,79,192,2555
New York,Warsaw village,3519,806,1168,580,71,322,2947
New York,Warwick village,6797,1324,2873,776,229,545,5747
New York,Washington Heights,2149,582,749,244,71,68,1714
New York,Washington Mills,1360,541,531,50,48,74,1244
New York,Washingtonville village,5814,1575,2495,370,116,290,4846
New York,Watchtower,2603,1183,1265,62,8,6,2524
New York,Waterford village,2233,822,793,229,66,70,1980
New York,Waterloo village,5048,1298,1511,689,118,435,4051
New York,Water Mill,2273,453,1215,202,63,138,2071
New York,Walton village,3026,575,1109,423,133,138,2378
New York,Wallkill,2227,571,886,221,22,106,1806
New York,Walker Valley,829,33,320,20,12,89,474
New York,Walden village,6886,2304,2361,445,129,332,5571
New York,Avoca village,1033,263,420,131,11,29,854
New York,Avon village,3343,870,1405,218,47,169,2709
New York,Babylon village,12186,3252,5299,639,173,726,10089
New York,Bainbridge village,1237,239,430,143,66,78,956
New York,Baiting Hollow,1542,299,910,40,14,86,1349
New York,Baldwin,24481,7056,9709,1363,452,1080,19660
New York,Baldwin Harbor,7724,2171,3441,445,87,244,6388
New York,Watertown,27250,7018,9531,2650,900,1429,21528
New York,Baldwinsville village,7692,1599,3098,963,90,606,6356
New York,Balmville,2741,598,1174,255,52,206,2285
New York,Bardonia,3551,883,1843,197,31,203,3157
New York,Barker village,738,146,279,52,12,20,509
New York,Waddington village,953,176,437,77,36,68,794
New York,Wading River,7762,1401,4120,404,37,200,6162
New York,Wadsworth,350,93,118,31,0,25,267
New York,Wainscott,753,265,318,47,13,30,673
New York,Ballston Spa village,5256,1634,1887,392,24,457,4394
New York,Waterville village,1574,437,536,150,60,187,1370
New York,Watervliet,10241,3979,2744,819,421,453,8416
New York,Watkins Glen village,1912,587,594,275,24,92,1572
New York,West Hampton Dunes village,53,0,45,0,0,4,49
New York,West Haverstraw village,10347,3328,3682,533,314,272,8129
New York,West Hempstead,19012,4948,8292,1029,229,868,15366
New York,West Hills,5098,947,2805,220,43,230,4245
New York,West Hurley,2034,326,986,266,67,153,1798
New York,West Islip,27224,6312,12560,1580,213,1649,22314
New York,Westmere,6758,1875,2766,516,144,452,5753
New York,Westhampton Beach village,1918,363,937,157,24,154,1635
New York,Westmoreland,584,137,238,108,0,0,483
New York,Weston Mills,1527,404,654,142,5,132,1337
New York,West Point,6830,3923,1400,124,4,22,5473
New York,Westport,427,71,214,15,9,39,348
New York,West Sand Lake,2845,588,1498,111,5,139,2341
New York,West Sayville,4712,1183,2191,219,53,287,3933
New York,West Seneca,45089,10931,19410,3585,483,3556,37965
New York,Westvale,5210,1282,2362,336,36,271,4287
New York,West Nyack,3939,733,1780,212,87,250,3062
New York,Averill Park,1413,173,599,141,65,85,1063
New York,Westhampton,2935,524,1298,316,41,261,2440
New York,Westfield village,3466,811,1287,282,78,303,2761
New York,Waverly village,4328,1152,1416,405,224,385,3582
New York,Wayland village,1750,384,664,214,41,125,1428
New York,Webster village,5524,1437,1812,540,81,423,4293
New York,Websters Crossing,22,0,22,0,0,0,22
New York,Weedsport village,1847,527,630,239,64,113,1573
New York,Wells,970,315,323,72,4,83,797
New York,Wellsburg village,573,152,229,56,7,14,458
New York,West Glens Falls,7670,1976,2370,887,211,559,6003
New York,Wellsville village,4589,1179,1580,631,143,289,3822
New York,West Babylon,42664,10891,18294,3093,679,2877,35834
New York,West Bay Shore,4684,744,2309,326,34,320,3733
New York,Westbury village,15273,4119,6239,938,266,901,12463
New York,West Carthage village,2019,403,976,154,33,119,1685
New York,West Chazy,986,276,339,13,45,19,692
New York,West Elmira,5160,792,2746,302,39,322,4201
New York,West End,1482,325,749,86,37,143,1340
New York,Wesley Hills village,5820,1027,2637,214,9,47,3934
New York,Au Sable Forks,472,89,220,39,9,56,413
New York,Aurora village,740,484,187,29,4,7,711
New York,Auburn,27264,8633,8085,3115,928,2103,22864
New York,Lynbrook village,19556,4928,8623,1232,209,1303,16295
New York,Lowville village,3506,917,1444,338,36,189,2924
New York,Lorraine,108,23,60,6,0,9,98
New York,Lorenz Park,2265,568,788,233,32,161,1782
New York,Long Lake,302,74,168,14,0,20,276
New York,Long Beach,33470,11103,11751,3723,618,2066,29261
New York,Lodi village,404,68,218,44,11,8,349
New York,Lyncourt,4098,1217,1354,443,22,372,3408
New York,Locust Valley,3270,801,1394,305,52,153,2705
New York,Loch Sheldrake,1187,561,408,34,22,24,1049
New York,Lloyd Harbor village,3684,773,1883,61,9,81,2807
New York,Livonia Center,236,55,116,0,29,14,214
New York,Livonia village,1196,272,401,159,33,63,928
New York,Livingston Manor,1104,253,417,71,176,74,991
New York,Accord,762,193,191,46,80,36,546
New York,Adams village,1717,363,565,169,54,120,1271
New York,Lockport,20857,6002,7054,2412,372,1214,17054
New York,Adams Center,1865,415,920,87,81,69,1572
New York,Lyndonville village,789,147,344,102,20,27,640
New York,Lyons village,3241,957,992,458,132,172,2711
New York,Manlius village,4670,902,2011,441,48,252,3654
New York,Manhasset Hills,3755,577,2075,95,7,269,3023
New York,Manhasset,8248,2103,3486,453,32,497,6571
New York,Manchester village,1712,300,694,179,70,147,1390
New York,Mamaroneck village,19219,4862,8020,1339,283,968,15472
New York,Malverne Park Oaks,557,103,367,0,0,14,484
New York,Malverne village,8552,1998,3880,522,71,654,7125
New York,Lyon Mountain,279,12,188,20,12,16,248
New York,Malone village,5830,1383,1850,809,248,370,4660
New York,Mahopac,8083,1990,3922,565,120,284,6881
New York,Madrid,659,141,251,42,31,72,537
New York,Madison village,327,80,124,22,15,11,252
New York,Machias,500,138,171,60,7,22,398
New York,McGraw village,936,189,472,86,11,37,795
New York,Macedon village,1591,292,778,114,25,74,1283
New York,Lyons Falls village,741,109,384,43,2,40,578
New York,Malden-on-Hudson,202,58,46,22,0,53,179
New York,Manorhaven village,6684,2000,2478,580,133,330,5521
New York,Addison village,1788,426,725,129,64,71,1415
New York,Airmont village,8808,1776,3927,422,101,599,6825
New York,Angelica village,831,125,399,76,23,42,665
New York,Angola village,1858,424,731,184,32,108,1479
New York,Angola on the Lake,1720,477,756,171,9,144,1557
New York,Antwerp village,511,123,219,45,16,11,414
New York,Apalachin,1508,267,673,132,22,163,1257
New York,Aquebogue,1958,703,792,163,0,90,1748
New York,Arcade village,2214,547,670,249,54,135,1655
New York,Andover village,829,159,406,46,18,46,675
New York,Ardsley village,4542,1114,2281,216,9,198,3818
New York,Arkport village,760,149,289,75,44,63,620
New York,Arlington,3888,2043,709,257,124,332,3465
New York,Armonk,4541,927,2214,121,58,121,3441
New York,Asharoken village,532,107,329,15,6,24,481
New York,Athens village,1420,392,483,149,54,191,1269
New York,Atlantic Beach village,1511,277,835,98,23,102,1335
New York,Attica village,2643,646,986,203,61,104,2000
New York,Argyle village,379,91,167,22,1,18,299
New York,Afton village,1086,265,379,146,37,87,914
New York,Andes,230,20,106,26,3,23,178
New York,Amityville village,9515,2440,4012,840,130,619,8041
New York,Akron village,2860,729,1134,386,0,173,2422
New York,Albany,98468,51078,20168,6613,1491,4839,84189
New York,Albertson,5146,968,2785,245,19,318,4335
New York,Albion village,5631,1409,2138,473,133,414,4567
New York,Alden village,2590,634,967,295,35,195,2126
New York,Alexander village,516,140,202,41,6,12,401
New York,Alexandria Bay village,965,208,336,165,46,60,815
New York,Amsterdam,18157,5807,5299,1611,539,1241,14497
New York,Alfred village,4314,3962,241,20,2,23,4248
New York,Almond village,480,77,213,36,10,32,368
New York,Altamont village,1610,326,768,143,13,88,1338
New York,Altmar village,412,89,100,65,21,12,287
New York,Altona,789,368,235,67,16,46,732
New York,Amagansett,1211,247,659,54,7,82,1049
New York,Amenia,1060,218,447,113,47,47,872
New York,Ames village,165,24,106,8,1,6,145
New York,Allegany village,1839,681,702,126,23,63,1595
New York,Deposit village,1832,413,773,168,18,137,1509
New York,Tillson,1597,592,557,75,51,104,1379
New York,East Ithaca,2322,995,832,151,13,33,2024
New York,Eden,3271,717,1509,317,44,147,2734
New York,Eatons Neck,1469,325,773,78,4,47,1227
New York,East Williston village,2585,561,1239,112,17,119,2048
New York,East Syracuse village,3043,942,872,356,93,156,2419
New York,East Shoreham,6455,1267,3191,299,34,153,4944
New York,East Rockaway village,9871,2565,4389,494,87,708,8243
New York,East Rochester village,6678,2174,1986,720,156,340,5376
New York,Edmeston,794,188,355,43,19,19,624
New York,East Randolph,588,133,226,54,1,25,439
New York,Eastport,1869,429,1120,108,10,52,1719
New York,East Patchogue,22452,5790,8682,2081,581,1487,18621
New York,East Norwich,2751,628,1306,182,14,103,2233
New York,East Northport,19682,4835,9059,1150,270,943,16257
New York,East Nassau village,624,128,251,75,14,24,492
New York,East Moriches,5428,1438,2455,403,54,271,4621
New York,East Meadow,37836,9335,16589,2234,549,3292,31999
New York,East Quogue,4589,851,2351,285,31,175,3693
New York,East Marion,915,163,495,81,0,141,880
New York,Edwards,380,172,120,15,3,30,340
New York,Elba village,713,152,351,39,9,24,575
New York,Springs,6065,1504,2980,355,52,266,5157
New York,Spring Valley village,32221,9609,9825,1683,894,954,22965
New York,Springville village,4328,789,1726,598,65,358,3536
New York,Springwater Hamlet,484,110,160,81,20,15,386
New York,Staatsburg,183,22,103,18,0,31,174
New York,Stamford village,1455,412,421,185,18,178,1214
New York,Stannards,841,101,369,124,9,102,705
New York,Eggertsville,15675,4352,6240,1202,301,671,12766
New York,Star Lake,719,116,297,65,37,65,580
New York,Stillwater village,1812,405,716,170,28,94,1413
New York,Stone Ridge,1256,435,527,27,18,52,1059
New York,Stony Brook,13889,2854,7064,567,131,687,11303
New York,Ellicottville village,273,68,137,17,0,33,255
New York,Ellenville village,4131,979,1485,364,112,152,3092
New York,Elizabethtown,763,188,239,108,17,117,669
New York,Elbridge village,1080,306,450,121,9,39,925
New York,Stewart Manor village,2113,399,1060,79,5,128,1671
New York,East Kingston,391,57,118,34,48,26,283
New York,East Massapequa,19843,4967,8553,1412,317,1183,16432
New York,East Islip,13802,3397,6014,773,216,910,11310
New York,Dering Harbor village,6,3,0,2,0,1,6
New York,DeRuyter village,545,119,169,76,18,48,430
New York,Dexter village,1359,338,482,115,39,61,1035
New York,Dix Hills,27374,6642,13987,836,165,1006,22636
New York,Dobbs Ferry village,11055,3206,4750,687,137,585,9365
New York,Dolgeville village,2349,461,940,208,51,178,1838
New York,Dover Plains,919,308,269,148,51,28,804
New York,Downsville,648,186,195,47,13,65,506
New York,Dresden village,452,119,172,38,14,9,352
New York,Duane Lake,361,52,217,30,0,0,299
New York,Duanesburg,359,87,209,0,0,0,296
New York,Dundee village,1448,341,532,192,50,84,1199
New York,Dunkirk,12308,3910,3798,1376,539,542,10165
New York,Dryden village,2014,519,787,206,18,108,1638
New York,Earlville village,1102,274,400,44,19,69,806
New York,East Hills village,7066,1095,3771,161,60,214,5301
New York,Durhamville,806,98,240,15,63,73,489
New York,East Hampton village,1148,230,561,157,0,109,1057
New York,East Greenbush,4752,1128,2253,264,36,159,3840
New York,East Glenville,6621,1467,2979,413,95,562,5516
New York,East Garden City,6470,3977,1550,252,71,401,6251
New York,East Farmingdale,6414,2003,2520,334,90,329,5276
New York,East Hampton North,3979,1208,1608,239,62,142,3259
New York,East Avon,619,147,164,124,17,12,464
New York,East Aurora village,6251,1369,2616,706,54,331,5076
New York,East Atlantic Beach,2126,728,854,178,8,128,1896
New York,Eastchester,19885,4697,9087,1083,177,1232,16276
North Carolina,Hertford,2197,606,658,227,104,176,1771
North Carolina,Henderson,15311,5342,3260,1588,457,1090,11737
North Carolina,Hendersonville,13457,2626,4663,1712,419,1469,10889
North Carolina,Henrietta,456,187,138,25,42,28,420
North Carolina,Hobgood,384,112,140,17,28,43,340
North Carolina,Hillsborough,6316,1761,2033,586,146,244,4770
North Carolina,Hildebran,2173,500,899,185,95,115,1794
North Carolina,High Shoals,580,128,259,37,9,53,486
North Carolina,High Point,108031,30119,37538,9259,3087,5211,85214
North Carolina,Highlands,1059,146,628,89,1,98,962
North Carolina,Hemby Bridge,1307,282,649,113,9,58,1111
North Carolina,Hickory,40172,10916,14951,3319,878,2495,32559
North Carolina,Hiddenite,605,82,290,53,73,19,517
North Carolina,Hightsville,828,252,233,272,60,11,828
North Carolina,Hays,1896,373,819,87,34,97,1410
North Carolina,Dillsboro,295,91,123,31,5,19,269
North Carolina,Haw River,2585,594,986,289,52,115,2036
North Carolina,Elroy,3635,1035,1088,467,236,260,3086
North Carolina,Emerald Isle,3708,579,2096,338,82,222,3317
North Carolina,Enfield,2426,995,507,194,97,199,1992
North Carolina,Engelhard,805,305,212,14,41,57,629
North Carolina,Enochville,2788,496,1309,267,34,187,2293
North Carolina,Erwin,4601,1081,1696,440,107,434,3758
North Carolina,Etowah,6797,1160,3363,665,143,555,5886
North Carolina,Eureka,144,30,52,10,11,22,125
North Carolina,Everetts,157,47,40,34,6,9,136
North Carolina,Evergreen,400,50,202,51,45,9,357
North Carolina,Fair Bluff,859,230,260,78,41,138,747
North Carolina,Fairfield,306,77,130,51,0,48,306
North Carolina,Fairfield Harbour,2749,243,1856,146,50,251,2546
North Carolina,Fairmont,2684,786,803,283,88,209,2169
North Carolina,Fairplains,2181,429,933,244,6,150,1762
North Carolina,Fairview,2815,664,1253,173,54,0,2144
North Carolina,Fairview,3530,663,1878,195,112,64,2912
North Carolina,Lake Santeetlah,36,0,31,1,0,2,34
North Carolina,Lake Royale,3162,744,1462,385,19,156,2766
North Carolina,Lake Park village,3636,742,1500,384,112,231,2969
North Carolina,Lake Norman of Catawba,7274,1083,4106,441,176,349,6155
North Carolina,Lake Lure,1409,244,812,162,42,45,1305
North Carolina,Lake Junaluska,2682,518,1344,303,7,284,2456
North Carolina,Elrod,502,104,131,38,11,33,317
North Carolina,La Grange,2842,742,829,512,159,213,2455
North Carolina,Kure Beach,2286,439,1332,150,39,121,2081
North Carolina,Fallston,667,155,308,27,19,36,545
North Carolina,Falkland,59,25,12,2,4,4,47
North Carolina,Falcon,226,54,80,16,4,23,177
North Carolina,Faith,875,196,374,53,13,73,709
North Carolina,Faison,1107,337,386,67,35,61,886
North Carolina,Knightdale,13243,2960,5476,1082,392,404,10314
North Carolina,Elon,9698,4970,2918,313,94,548,8843
North Carolina,Elm City,1630,544,580,161,4,86,1375
North Carolina,Ellerbe,1137,314,345,127,48,82,916
North Carolina,Dunn,9654,2649,2991,1122,288,932,7982
North Carolina,Dundarrach,60,43,17,0,0,0,60
North Carolina,Duck,534,102,269,72,12,49,504
North Carolina,Dublin,411,85,134,25,24,14,282
North Carolina,Drexel,1869,398,623,196,45,267,1529
North Carolina,Dover,284,57,115,29,8,33,242
North Carolina,Durham,246084,82874,79868,21373,5188,8922,198225
North Carolina,Dortches,1000,136,520,53,36,47,792
North Carolina,Dobbins Heights,858,295,199,80,36,72,682
North Carolina,Hobucken,64,12,23,0,0,20,55
North Carolina,Harrisburg,13883,2550,6229,904,203,338,10224
North Carolina,Hassell,38,5,13,3,0,13,34
North Carolina,Hatteras,466,31,342,0,0,31,404
North Carolina,Havelock,20729,5067,8518,1371,418,300,15674
North Carolina,Dobson,1569,495,588,149,53,81,1366
North Carolina,Hayesville,404,76,171,35,27,43,352
North Carolina,Earl,303,57,130,18,8,9,222
North Carolina,East Bend,473,94,222,34,28,33,411
North Carolina,Ellenboro,1250,406,275,124,61,64,930
North Carolina,Elk Park,411,76,177,61,7,45,366
North Carolina,Elkin,4217,759,1528,432,112,369,3200
North Carolina,Elizabethtown,3610,1003,944,366,107,525,2945
North Carolina,Elizabeth City,18111,6503,4860,1540,639,1147,14689
North Carolina,Efland,837,120,471,96,6,25,718
North Carolina,East Arcadia,440,174,110,39,14,32,369
North Carolina,Edneyville,2069,485,750,261,17,75,1588
North Carolina,Eden,15483,3782,4711,2003,897,1041,12434
North Carolina,East Spencer,1453,599,217,141,51,103,1111
North Carolina,East Rockingham,3921,1005,1297,434,95,284,3115
North Carolina,Eastover,3681,803,1669,275,44,221,3012
North Carolina,East Laurinburg,367,105,120,33,13,29,300
North Carolina,East Flat Rock,3500,743,1681,478,64,199,3165
North Carolina,Edenton,4942,1093,1525,471,192,452,3733
North Carolina,Hoffman,572,194,195,27,12,58,486
North Carolina,Canton,4156,1009,1473,364,55,418,3319
North Carolina,Denton,1766,360,681,200,48,89,1378
North Carolina,Mount Gilead,1282,384,447,99,43,88,1061
North Carolina,Mount Airy,10391,1869,4028,1196,290,1045,8428
North Carolina,Mountain View,3276,763,1665,311,84,110,2933
North Carolina,Mountain Home,3603,690,1652,367,98,251,3058
North Carolina,Morven,510,208,58,51,33,70,420
North Carolina,Morrisville,21726,3616,10747,1280,154,403,16200
North Carolina,Morganton,16748,4381,5443,2188,573,1363,13948
North Carolina,Morehead City,9162,2002,3234,1346,191,766,7539
North Carolina,Moravian Falls,1564,313,593,258,17,82,1263
North Carolina,Mooresville,34930,8271,14278,2321,602,1419,26891
North Carolina,Mooresboro,486,92,145,30,33,72,372
North Carolina,Montreat,677,334,271,14,7,18,644
North Carolina,Monroe,33951,8657,11925,2463,932,1762,25739
North Carolina,Moncure,506,59,149,126,0,93,427
North Carolina,Momeyer,250,60,85,33,7,29,214
North Carolina,Mocksville,5090,1227,1676,611,121,390,4025
North Carolina,Misenheimer village,711,545,110,27,0,10,692
North Carolina,Mint Hill,24545,4824,12016,2111,219,1006,20176
North Carolina,Minnesott Beach,385,28,291,29,0,26,374
North Carolina,Mineral Springs,2797,786,1219,223,39,97,2364
North Carolina,Milton,176,23,58,35,3,28,147
North Carolina,Mount Holly,13924,2958,5713,1480,458,816,11425
North Carolina,Mount Olive,4756,1933,1057,425,129,538,4082
North Carolina,Mount Pleasant,1825,424,774,161,2,123,1484
North Carolina,Moyock,3456,464,1658,205,66,124,2517
North Carolina,North Wilkesboro,4250,1274,1209,416,129,368,3396
North Carolina,Northwest,959,255,340,114,21,36,766
North Carolina,North Topsail Beach,1047,231,488,90,71,71,951
North Carolina,Northlakes,1681,193,1081,102,15,7,1398
North Carolina,Northchase,3386,818,1182,524,87,155,2766
North Carolina,Norman,151,12,43,22,8,12,97
North Carolina,Norlina,1131,330,326,100,39,139,934
North Carolina,Newton Grove,526,91,245,39,27,82,484
North Carolina,Newton,12980,3210,4575,1317,308,1052,10462
North Carolina,Newport,4598,1074,1811,654,204,332,4075
North Carolina,Mills River,6964,1396,3635,447,92,264,5834
North Carolina,New London,596,75,309,72,14,24,494
North Carolina,New Bern,30218,7154,10695,2831,1047,2238,23965
North Carolina,Neuse Forest,2244,348,1127,136,23,122,1756
North Carolina,Navassa,1887,624,458,210,80,100,1472
North Carolina,Nashville,5459,1538,1775,904,113,301,4631
North Carolina,Nags Head,2825,659,1281,289,88,200,2517
North Carolina,Myrtle Grove,8972,1700,4686,623,125,454,7588
North Carolina,Murraysville,14844,3742,6344,1346,170,465,12067
North Carolina,Murphy,2095,433,610,350,119,209,1721
North Carolina,Murfreesboro,2920,1371,854,137,55,128,2545
North Carolina,Mulberry,2122,384,923,299,53,139,1798
North Carolina,Newland,844,250,278,78,11,59,676
North Carolina,Denver,1994,515,761,202,38,180,1696
North Carolina,Millingport,368,42,187,30,25,24,308
North Carolina,Midway,4716,743,2171,338,220,346,3818
North Carolina,Hudson,3732,710,1932,336,0,171,3149
North Carolina,Hot Springs,573,86,227,96,21,46,476
North Carolina,Horse Shoe,2509,291,1629,159,28,59,2166
North Carolina,Hope Mills,16123,3798,5552,1602,361,742,12055
North Carolina,Hoopers Creek,1399,169,817,94,27,58,1165
North Carolina,Hookerton,318,53,118,28,17,63,279
North Carolina,Holly Springs,28640,4280,13672,1618,403,692,20665
North Carolina,Holly Ridge,1785,367,740,194,78,65,1444
North Carolina,Hollister,854,279,214,77,9,36,615
North Carolina,Holden Beach,955,85,647,69,8,41,850
North Carolina,Lake Waccamaw,1465,402,548,107,34,175,1266
North Carolina,Dallas,4540,993,1829,463,102,312,3699
North Carolina,Dana,2486,379,1373,183,50,101,2086
North Carolina,Danbury,175,79,58,24,0,6,167
North Carolina,Davidson,11765,3327,4536,986,293,299,9441
North Carolina,Davis,352,41,135,22,15,67,280
North Carolina,Deercroft,289,0,194,33,36,0,263
North Carolina,Delco,249,35,181,12,0,21,249
North Carolina,Dellview,5,5,0,0,0,0,5
North Carolina,Norwood,2881,765,1031,289,75,219,2379
North Carolina,Delway,53,30,0,11,0,12,53
North Carolina,Huntersville,50433,9027,24186,3137,503,1388,38241
North Carolina,Icard,2971,788,1010,515,65,173,2551
North Carolina,Indian Beach,179,37,99,9,5,18,168
North Carolina,Indian Trail,35602,6475,15537,2229,542,947,25730
North Carolina,Midland,3243,678,1824,248,65,168,2983
North Carolina,Middlesex,1058,234,315,95,48,53,745
North Carolina,Middleburg,154,55,30,17,8,6,116
North Carolina,Micro,603,105,235,63,11,45,459
North Carolina,Mesic,215,52,97,27,10,10,196
North Carolina,Mebane,13309,2882,5359,1331,369,519,10460
North Carolina,Maysville,915,247,276,139,31,89,782
North Carolina,Mayodan,2762,705,859,268,114,281,2227
North Carolina,Maxton,2598,971,571,146,86,228,2002
North Carolina,Maury,1563,795,198,277,91,16,1377
North Carolina,Millers Creek,1842,358,780,177,21,169,1505
North Carolina,Jonesville,2496,491,873,288,70,161,1883
North Carolina,Jamesville,547,169,123,66,22,61,441
North Carolina,Jamestown,3638,770,1803,305,60,173,3111
North Carolina,James City,5513,885,2464,789,114,354,4606
North Carolina,Jacksonville,68315,19518,26707,3973,1784,1638,53620
North Carolina,Jackson Heights,838,146,443,87,10,66,752
North Carolina,Jackson,511,126,217,42,25,65,475
North Carolina,JAARS,335,44,188,31,0,6,269
North Carolina,Ivanhoe,182,35,80,25,15,0,155
North Carolina,Iron Station,620,117,282,120,0,34,553
North Carolina,Ingold,525,127,135,0,0,32,294
North Carolina,Jefferson,1374,284,497,179,28,173,1161
North Carolina,Landis,3097,519,1113,324,108,498,2562
North Carolina,Lansing,194,41,81,14,0,10,146
North Carolina,Lasker,124,14,75,12,1,8,110
North Carolina,Brookford,402,95,103,86,16,39,339
North Carolina,Brunswick,988,527,151,107,72,60,917
North Carolina,Bryson City,1748,316,589,264,68,137,1374
North Carolina,Buies Creek,2668,2072,269,93,0,60,2494
North Carolina,Bunn,365,48,157,42,16,35,298
North Carolina,Bunnlevel,770,190,205,70,41,81,587
North Carolina,Burgaw,4011,1249,1040,548,251,275,3363
North Carolina,Burlington,52241,13707,18033,5469,1670,3134,42013
North Carolina,Burnsville,1653,308,720,195,90,176,1489
North Carolina,Butner,7672,2140,2585,812,211,404,6152
North Carolina,Butters,201,98,28,21,0,54,201
North Carolina,McFarlan,162,42,61,8,0,21,132
North Carolina,McLeansville,897,217,415,105,18,44,799
North Carolina,Brogden,2364,802,753,189,38,186,1968
North Carolina,Macon,143,54,57,3,13,14,141
North Carolina,Maggie Valley,1533,158,847,121,20,86,1232
North Carolina,Magnolia,1211,351,332,62,60,54,859
North Carolina,Maiden,3346,726,1153,316,66,105,2366
North Carolina,Mamers,1029,294,272,150,0,40,756
North Carolina,Manns Harbor,1282,321,567,7,28,52,975
North Carolina,Manteo,1522,285,544,231,82,134,1276
North Carolina,Marble,202,8,109,37,0,18,172
North Carolina,Marietta,127,28,53,12,4,8,105
North Carolina,Marion,7914,1986,2133,1079,421,670,6289
North Carolina,Mar-Mac,3924,822,1378,400,195,129,2924
North Carolina,Marshall,764,151,276,113,18,61,619
North Carolina,Marshallberg,312,44,149,42,0,44,279
North Carolina,Mars Hill,2410,1189,579,193,22,117,2100
North Carolina,Madison,2278,533,877,288,76,225,1999
North Carolina,Marshville,2538,735,732,260,79,128,1934
North Carolina,Broadway,1242,273,526,91,37,142,1069
North Carolina,Bridgeton,304,50,151,43,15,6,265
North Carolina,Benson,3478,765,1209,374,112,225,2685
North Carolina,Bent Creek,1431,79,798,103,159,59,1198
North Carolina,Bermuda Run,2532,357,1507,226,6,259,2355
North Carolina,Bessemer City,5455,1530,1589,703,201,411,4434
North Carolina,Bethania,359,80,208,31,2,18,339
North Carolina,Bethel,1849,566,553,114,76,178,1487
North Carolina,Bethlehem,4620,996,2309,326,112,206,3949
North Carolina,Beulaville,1570,396,468,207,94,137,1302
North Carolina,Biltmore Forest,1474,213,899,64,4,73,1253
North Carolina,Biscoe,1874,457,572,156,9,146,1340
North Carolina,Black Creek,642,153,201,86,21,14,475
North Carolina,Black Mountain,8079,1815,3204,1032,340,775,7166
North Carolina,Bladenboro,1875,409,631,170,37,131,1378
North Carolina,Broad Creek,2525,385,1183,341,78,77,2064
North Carolina,Blowing Rock,1206,155,667,117,3,147,1089
North Carolina,Boardman,199,64,64,15,14,13,170
North Carolina,Bogue,662,78,397,43,7,34,559
North Carolina,Boiling Spring Lakes,5610,1338,2374,648,133,187,4680
North Carolina,Boiling Springs,4636,1844,1499,203,0,174,3720
North Carolina,Bolivia,310,60,83,40,6,8,197
North Carolina,Bolton,796,196,283,44,6,71,600
North Carolina,Bonnetsville,425,135,107,17,12,11,282
North Carolina,Boone,17966,14521,1702,751,62,413,17449
North Carolina,Boonville,1370,227,543,137,26,93,1026
North Carolina,Bostic,360,78,170,26,5,23,302
North Carolina,Bowmore,26,0,19,0,0,7,26
North Carolina,Brevard,7656,2122,2801,685,127,791,6526
North Carolina,Brices Creek,3921,466,2034,98,179,55,2832
North Carolina,Blue Clay Farms,12,0,12,0,0,0,12
North Carolina,Marvin village,5938,686,3121,59,13,104,3983
North Carolina,Matthews,29352,5716,14261,1901,465,1426,23769
North Carolina,Cullowhee,5534,4503,433,120,108,69,5233
North Carolina,Cherryville,5868,1097,2515,464,127,528,4731
North Carolina,Cherokee,2157,365,835,230,50,154,1634
North Carolina,Charlotte,792137,250116,267046,63094,18766,27841,626863
North Carolina,Chapel Hill,58766,27371,18769,3423,390,1190,51143
North Carolina,Chadbourn,2169,745,447,252,101,183,1728
North Carolina,Cerro Gordo,154,32,50,20,0,19,121
North Carolina,Centerville,91,22,39,11,1,5,78
North Carolina,Cedar Rock village,326,28,210,27,0,23,288
North Carolina,Cedar Point,1429,198,756,96,3,90,1143
North Carolina,Catawba,688,115,249,51,17,71,503
North Carolina,Caswell Beach,387,45,263,33,10,30,381
North Carolina,Castle Hayne,953,164,335,177,26,49,751
North Carolina,Castalia,363,113,112,56,3,11,295
North Carolina,Chimney Rock Village village,68,11,36,10,5,1,63
North Carolina,Cashiers,109,8,71,21,0,9,109
North Carolina,Cary,151186,29473,72488,9494,1889,4595,117939
North Carolina,Carthage,2531,500,911,310,43,178,1942
North Carolina,Carrboro,20639,7517,6823,1457,301,388,16486
North Carolina,Carolina Shores,3549,331,2014,583,90,352,3370
North Carolina,Carolina Beach,5970,1203,2532,768,213,355,5071
North Carolina,Caroleen,502,61,267,59,0,0,387
North Carolina,Buxton,1250,75,577,146,34,55,887
North Carolina,Cajah's Mountain,2752,478,1337,247,82,189,2333
North Carolina,Calabash,1775,313,832,212,39,135,1531
North Carolina,Calypso,545,143,168,60,11,36,418
North Carolina,Camden,577,272,140,55,0,0,467
North Carolina,Cameron,287,51,103,30,9,36,229
North Carolina,Candor,759,232,241,66,34,34,607
North Carolina,Casar,269,49,105,31,11,18,214
North Carolina,China Grove,4164,842,1510,288,173,198,3011
North Carolina,Chocowinity,936,242,274,127,77,68,788
North Carolina,Claremont,1394,257,622,97,32,56,1064
North Carolina,Crossnore,237,72,91,12,0,15,190
North Carolina,Cricket,1712,269,687,211,30,224,1421
North Carolina,Creswell,294,75,97,34,7,8,221
North Carolina,Creedmoor,4289,1119,1782,303,132,191,3527
North Carolina,Cramerton,4245,1024,1699,490,89,216,3518
North Carolina,Cove Creek,1072,190,461,146,11,62,870
North Carolina,Cove City,457,126,182,22,23,35,388
North Carolina,Cornelius,26866,5692,11297,3104,280,915,21288
North Carolina,Cordova,1875,420,819,244,37,89,1609
North Carolina,Cooleemee,839,197,363,69,27,37,693
North Carolina,Conway,728,130,237,57,29,50,503
North Carolina,Conover,8221,1630,3278,1020,121,515,6564
North Carolina,Connelly Springs,1854,402,690,199,58,70,1419
North Carolina,Conetoe,352,95,113,30,30,21,289
North Carolina,Concord,83903,18691,33780,7445,1540,3163,64619
North Carolina,Como,82,26,31,13,0,2,72
North Carolina,Columbus,1161,223,409,134,19,105,890
North Carolina,Columbia,795,245,251,49,13,91,649
North Carolina,Colerain,191,21,87,14,11,30,163
North Carolina,Coinjock,235,81,56,31,0,30,198
North Carolina,Cofield village,301,69,115,38,15,31,268
North Carolina,Coats,2628,745,915,249,43,84,2036
North Carolina,Clyde,1311,221,555,122,74,70,1042
North Carolina,Clinton,8750,2272,2594,1021,335,728,6950
North Carolina,Cliffside,327,49,169,15,0,46,279
North Carolina,Cleveland,930,216,349,125,34,48,772
North Carolina,Clemmons village,19340,3557,8886,1685,255,968,15351
North Carolina,Clayton,17869,3667,6702,2040,494,632,13535
North Carolina,Clarkton,671,175,273,60,11,49,568
North Carolina,Bennett,190,29,102,18,0,41,190
North Carolina,Cape Carteret,2223,392,1115,155,22,136,1820
North Carolina,Belwood,994,165,385,100,31,44,725
North Carolina,Belville,2437,511,922,180,57,117,1787
North Carolina,Bakersville,487,77,191,42,9,54,373
North Carolina,Bald Head Island village,205,0,185,10,0,9,204
North Carolina,Balfour,1556,474,697,95,11,70,1347
North Carolina,Banner Elk,1183,634,406,23,11,26,1100
North Carolina,Barker Heights,1530,487,447,187,14,55,1190
North Carolina,Barker Ten Mile,853,159,477,46,0,77,759
North Carolina,Bath,270,51,147,19,1,39,257
North Carolina,Bayboro,1389,589,224,254,44,99,1210
North Carolina,Bayshore,3283,723,1686,354,32,54,2849
North Carolina,Bayview,241,56,97,26,19,43,241
North Carolina,Bear Grass,137,21,39,10,0,8,78
North Carolina,Beaufort,4153,1634,1145,541,84,240,3644
North Carolina,Beech Mountain,571,32,408,33,2,55,530
North Carolina,Bailey,530,82,233,45,11,32,403
North Carolina,Belhaven,2000,540,614,212,64,237,1667
North Carolina,Belmont,10387,2748,4102,1111,234,555,8750
North Carolina,Kelford,215,65,35,33,7,26,166
North Carolina,Kelly,496,96,224,19,31,18,388
North Carolina,Kenansville,926,198,322,81,29,135,765
North Carolina,Kenly,1674,454,393,206,85,159,1297
North Carolina,Kernersville,23617,5052,9668,2756,608,1304,19388
North Carolina,Kill Devil Hills,6881,1678,2408,973,233,380,5672
North Carolina,King,6697,1038,2825,1006,120,470,5459
North Carolina,Kings Grant,8913,2164,3517,971,350,336,7338
North Carolina,Kings Mountain,10792,2699,3709,1084,398,760,8650
North Carolina,Kingstown,742,263,201,72,39,64,639
North Carolina,Kinston,21540,6816,6301,1750,961,1742,17570
North Carolina,Kittrell,284,45,78,31,3,34,191
North Carolina,Bell Arthur,334,30,167,0,0,0,197
North Carolina,Kitty Hawk,3362,559,1568,459,104,210,2900
North Carolina,McDonald,99,28,37,14,7,4,90
North Carolina,McAdenville,660,110,302,74,31,41,558
North Carolina,Lattimore,469,191,168,24,8,23,414
North Carolina,Laurel Hill,931,262,300,125,28,104,819
North Carolina,Laurel Park,2765,280,1574,225,49,176,2304
North Carolina,Laurinburg,15694,4555,4443,1615,545,1192,12350
North Carolina,Lawndale,709,146,294,86,42,42,610
North Carolina,Leggett,38,9,12,0,10,1,32
North Carolina,Leland,16122,2471,8074,1601,311,616,13073
North Carolina,Lenoir,17978,3569,6047,2631,681,1726,14654
North Carolina,Lewiston Woodville,846,223,256,71,14,19,583
North Carolina,Lewisville,13212,2210,6922,1014,144,425,10715
North Carolina,Lexington,19129,5079,5864,2172,599,1147,14861
North Carolina,Liberty,2674,628,1033,289,74,166,2190
North Carolina,Light Oak,763,116,280,164,0,59,619
North Carolina,Macclesfield,513,136,185,48,14,67,450
North Carolina,Lilesville,464,130,193,38,11,30,402
North Carolina,Lincolnton,10696,2376,3870,1129,350,809,8534
North Carolina,Linden,169,42,69,6,4,8,129
North Carolina,Littleton,533,181,151,30,34,67,463
North Carolina,Locust,2956,505,1315,224,105,191,2340
North Carolina,Long View,5050,1111,1649,598,338,232,3928
North Carolina,Louisburg,3499,1433,948,218,59,453,3111
North Carolina,Love Valley,112,19,31,23,6,11,90
North Carolina,Lowell,3594,815,1282,504,89,354,3044
North Carolina,Lowesville,3266,597,1596,304,16,105,2618
North Carolina,Lowgap,350,85,199,25,0,21,330
North Carolina,Lucama,930,270,260,105,42,47,724
North Carolina,Lumber Bridge,82,9,43,9,1,13,75
North Carolina,Lumberton,21721,6776,6079,1912,729,1486,16982
North Carolina,Lillington,3388,1321,639,552,118,332,2962
North Carolina,Harrellsville,177,30,70,17,1,5,123
North Carolina,Harrells,153,27,82,14,7,9,139
North Carolina,Harmony,602,164,186,60,25,61,496
North Carolina,Gastonia,73211,19199,24275,7107,2309,4184,57074
North Carolina,Gaston,1038,330,281,129,33,124,897
North Carolina,Garysburg,1033,346,198,120,49,133,846
North Carolina,Garner,27160,6478,10769,2416,1090,1236,21989
North Carolina,Garland,674,199,193,81,34,58,565
North Carolina,Gamewell,3986,695,1690,550,76,239,3250
North Carolina,Fuquay-Varina,21399,4039,9451,1297,452,758,15997
North Carolina,Fruitland,2637,490,1176,362,23,177,2228
North Carolina,Frisco,111,52,43,9,0,7,111
North Carolina,Fremont,1147,347,307,108,42,139,943
North Carolina,Franklinville,1064,278,331,139,16,66,830
North Carolina,Franklinton,2319,612,791,189,41,204,1837
North Carolina,Franklin,3910,1055,1363,598,67,225,3308
North Carolina,Gatesville,403,54,180,21,12,38,305
North Carolina,Foxfire village,1344,135,716,119,16,76,1062
North Carolina,Fountain,450,113,122,53,17,33,338
North Carolina,Foscoe,1465,290,713,140,9,106,1258
North Carolina,Forest Oaks,3342,700,1951,143,32,128,2954
North Carolina,Forest Hills village,405,149,165,18,0,11,343
North Carolina,Forest City,7359,1948,2128,725,316,509,5626
North Carolina,Fontana Dam,0,0,0,0,0,0,0
North Carolina,Fletcher,7394,1230,3259,805,259,485,6038
North Carolina,Flat Rock,1466,432,648,142,49,116,1387
North Carolina,Flat Rock village,3211,331,2111,280,33,240,2995
North Carolina,Five Points,979,83,606,26,7,33,755
North Carolina,Fearrington Village,2797,243,1734,219,0,501,2697
North Carolina,Fayetteville,202521,54136,71372,19370,6418,8637,159933
North Carolina,Farmville,4755,1305,1610,274,202,345,3736
North Carolina,Four Oaks,1900,419,620,255,89,112,1495
North Carolina,Germanton,838,200,290,222,0,38,750
North Carolina,Gerton,255,84,129,0,10,0,223
North Carolina,Gibson,516,169,97,58,21,58,403
North Carolina,Harkers Island,1637,252,928,153,16,96,1445
North Carolina,Hampstead,4528,569,2036,437,126,255,3423
North Carolina,Hamlet,6525,1814,1929,578,226,358,4905
North Carolina,Hamilton,384,110,121,40,14,47,332
North Carolina,Hallsboro,421,136,65,48,60,42,351
North Carolina,Halifax,271,66,96,13,22,26,223
North Carolina,Half Moon,7915,1789,3472,465,62,329,6117
North Carolina,Gulf,401,74,283,0,0,21,378
North Carolina,Grover,1037,294,399,66,27,42,828
North Carolina,Grimesland,421,81,158,33,36,28,336
North Carolina,Grifton,2576,719,835,231,81,176,2042
North Carolina,Greenville,88598,41930,21323,6696,1685,3059,74693
North Carolina,Greensboro,279427,94616,89571,24671,6137,12766,227761
North Carolina,Green Level,1977,524,618,171,61,87,1461
North Carolina,Greenevers,847,241,227,59,34,52,613
North Carolina,Grantsboro,822,153,361,79,22,58,673
North Carolina,Granite Quarry,2963,425,1274,284,45,177,2205
North Carolina,Granite Falls,4683,1124,1610,646,117,299,3796
North Carolina,Grandfather village,61,5,50,2,0,2,59
North Carolina,Graham,14468,3275,4720,1459,490,936,10880
North Carolina,Gorman,1310,453,386,112,0,94,1045
North Carolina,Goldston,285,52,123,27,2,39,243
North Carolina,Goldsboro,35952,10646,10408,3519,1712,2061,28346
North Carolina,Godwin,140,23,59,20,0,9,111
North Carolina,Gloucester,681,151,284,87,8,46,576
North Carolina,Glenville,48,0,22,0,17,9,48
North Carolina,Glen Raven,2607,463,1244,151,23,122,2003
North Carolina,Glen Alpine,1513,322,775,94,3,65,1259
North Carolina,Gibsonville,6634,1152,2948,790,131,283,5304
North Carolina,Belvoir,463,78,163,16,0,83,340
North Carolina,Oakboro,1924,299,989,88,40,107,1523
North Carolina,Keener,836,138,287,64,88,17,594
North Carolina,Oriental,926,173,510,78,6,85,852
North Carolina,Ogden,6802,995,3518,467,189,273,5442
North Carolina,Ocracoke,486,115,218,59,23,0,415
North Carolina,Ocean Isle Beach,678,42,500,39,16,35,632
North Carolina,Oak Ridge,6513,908,3545,303,113,240,5109
North Carolina,Oak Island,7199,1085,3658,908,235,510,6396
North Carolina,Oak City,371,113,125,18,20,45,321
North Carolina,Tobaccoville village,2537,439,1135,284,33,124,2015
North Carolina,Toast,1293,213,567,170,8,152,1110
North Carolina,Thomasville,27084,6284,8803,3477,777,1932,21273
North Carolina,Teachey,345,50,137,25,12,13,237
North Carolina,Taylortown,1100,360,371,51,10,72,864
North Carolina,Taylorsville,2183,568,610,241,111,218,1748
North Carolina,Tar Heel,173,61,68,7,1,14,151
North Carolina,Tarboro,11292,3355,3468,1060,455,1046,9384
North Carolina,Tabor City,3946,1439,832,486,237,371,3365
North Carolina,Old Fort,1033,332,255,96,70,137,890
North Carolina,Old Hundred,371,31,149,82,0,13,275
North Carolina,Orrum,52,9,24,3,0,5,41
North Carolina,Ossipee,692,149,330,94,18,17,608
North Carolina,Pinetown,71,34,19,0,7,11,71
North Carolina,Pinetops,1161,408,271,113,43,85,920
North Carolina,Pine Level,1991,483,728,219,68,87,1585
North Carolina,Pine Knoll Shores,1515,115,963,132,14,83,1307
North Carolina,Pinehurst village,15313,1318,9706,931,249,1409,13613
North Carolina,Pinebluff,1255,268,462,252,12,45,1039
North Carolina,Pilot Mountain,1725,303,661,222,33,109,1328
North Carolina,Sylva,2597,652,857,236,121,210,2076
North Carolina,Pikeville,751,144,291,121,17,56,629
North Carolina,Peletier,866,279,282,116,35,25,737
North Carolina,Peachland,396,125,137,30,8,38,338
North Carolina,Patterson Springs,662,165,205,58,42,30,500
North Carolina,Parmele,334,138,85,36,7,47,313
North Carolina,Parkton,560,119,254,45,9,23,450
North Carolina,Pantego,222,48,88,18,13,16,183
North Carolina,Oxford,8650,2400,2492,1110,416,707,7125
North Carolina,Pembroke,3002,1440,386,281,85,200,2392
North Carolina,Swepsonville,1275,176,693,81,8,65,1023
North Carolina,Swansboro,2956,605,1226,357,36,169,2393
North Carolina,Swan Quarter,344,87,151,0,10,45,293
North Carolina,Staley,363,49,134,35,5,21,244
North Carolina,Spruce Pine,2444,540,916,230,56,147,1889
North Carolina,Spring Lake,13336,2969,4843,885,262,199,9158
North Carolina,Spring Hope,1289,348,363,153,74,153,1091
North Carolina,Spivey's Corner,492,87,271,30,0,27,415
North Carolina,Spindale,4279,1196,1498,347,80,424,3545
North Carolina,Aberdeen,6914,1424,2663,892,155,331,5465
North Carolina,Stallings,14495,2893,6998,1170,211,360,11632
North Carolina,Advance,951,105,380,198,0,66,749
North Carolina,Alamance village,871,124,502,59,6,61,752
North Carolina,Sims,333,52,144,23,14,4,237
North Carolina,Alliance,696,146,275,48,17,102,588
North Carolina,Altamahaw,465,112,249,32,0,0,393
North Carolina,Andrews,2050,471,525,261,86,131,1474
North Carolina,Angier,4855,937,2039,355,111,263,3705
North Carolina,Ansonville,720,312,138,97,16,62,625
North Carolina,Ahoskie,4976,1478,1279,396,191,479,3823
North Carolina,Pineville,8066,2487,1692,1068,445,686,6378
North Carolina,Stanfield,1612,330,717,80,69,52,1248
North Carolina,Stantonsburg,814,177,314,99,25,49,664
North Carolina,Swannanoa,4685,1281,2048,419,107,188,4043
North Carolina,Surf City,2481,501,1290,215,26,91,2123
North Carolina,Sunset Beach,3695,370,2748,245,61,155,3579
North Carolina,Sunbury,284,60,134,21,0,12,227
North Carolina,Summerfield,10622,1744,5628,614,147,352,8485
North Carolina,Sugar Mountain village,465,47,276,30,5,13,371
North Carolina,Stovall,388,94,111,62,12,40,319
North Carolina,Stanley,3615,585,1622,293,75,305,2880
North Carolina,Stony Point,1770,738,465,102,0,46,1351
North Carolina,Stoneville,1295,235,591,135,24,68,1053
North Carolina,Stokesdale,5221,996,2374,245,161,255,4031
North Carolina,Stokes,361,138,60,67,0,96,361
North Carolina,Stem,859,245,389,46,5,14,699
North Carolina,Stedman,1313,182,612,123,35,41,993
North Carolina,Statesville,25443,7573,7443,2610,745,1456,19827
North Carolina,Star,870,251,332,120,15,38,756
North Carolina,Stonewall,215,65,45,18,10,31,169
North Carolina,Piney Green,13738,2493,5661,1043,303,551,10051
North Carolina,Kannapolis,44520,10109,16633,4235,1543,2263,34783
North Carolina,Pink Hill,466,117,190,44,6,27,384
North Carolina,Sawmills,5130,976,2068,783,150,278,4255
North Carolina,Saratoga,493,108,161,60,15,33,377
North Carolina,Sanford,28988,8188,9160,2546,757,1599,22250
North Carolina,Sandyfield,473,133,127,66,14,15,355
North Carolina,Sandy Creek,304,38,159,17,5,10,229
North Carolina,Salvo,240,10,105,22,0,0,137
North Carolina,Saluda,656,166,257,63,9,64,559
North Carolina,Saxapahaw,1430,222,685,214,0,85,1206
North Carolina,Salisbury,33653,10427,10033,3680,1208,2399,27747
North Carolina,Salem,2182,452,891,285,44,136,1808
North Carolina,St. Stephens,8954,1477,3906,751,179,584,6897
North Carolina,St. Pauls,2223,612,764,191,95,155,1817
North Carolina,St. James,4050,114,3712,71,0,153,4050
North Carolina,St. Helena village,393,36,197,43,19,17,312
North Carolina,Rutherfordton,4193,825,1836,611,78,374,3724
North Carolina,Rutherford College,1420,336,615,128,95,68,1242
North Carolina,Salemburg,374,54,187,37,0,46,324
North Carolina,Ruth,439,77,197,62,4,38,378
North Carolina,Scotch Meadows,572,101,336,24,19,0,480
North Carolina,Seaboard,736,227,240,66,24,65,622
North Carolina,Simpson village,383,82,147,31,17,35,312
North Carolina,Silver Lake,5874,1679,2103,429,291,338,4840
North Carolina,Silver City,914,244,347,69,13,105,778
North Carolina,Siler City,8193,2542,2387,578,230,474,6211
North Carolina,Shelby,20245,5751,6582,1594,740,1542,16209
North Carolina,Sharpsburg,2228,583,569,198,118,182,1650
North Carolina,Shannon,345,82,141,0,0,0,223
North Carolina,Scotland Neck,1613,668,289,214,81,171,1423
North Carolina,Shallotte,3816,612,1806,386,86,398,3288
North Carolina,Seven Springs,76,23,12,16,5,11,67
North Carolina,Seven Lakes,4806,525,2549,263,65,390,3792
North Carolina,Seven Devils,240,23,154,26,1,18,222
North Carolina,Selma,6220,1949,1507,429,303,285,4473
North Carolina,Sedalia,563,161,217,73,9,49,509
North Carolina,Seagrove,308,46,115,50,1,23,235
North Carolina,Sea Breeze,1971,260,1044,263,111,112,1790
North Carolina,Severn,233,39,91,27,20,36,213
North Carolina,Apex,42220,8053,19205,2755,428,869,31310
North Carolina,Rural Hall,3046,549,1380,259,169,195,2552
North Carolina,Tyro,3525,621,1694,318,27,147,2807
North Carolina,Prospect,921,224,293,147,40,75,779
North Carolina,Proctorville,176,49,70,24,0,15,158
North Carolina,Princeville,2188,732,434,211,150,173,1700
North Carolina,Princeton,1310,265,425,145,25,99,959
North Carolina,Powellsville,279,78,90,24,4,19,215
North Carolina,Potters Hill,523,160,119,68,50,28,425
North Carolina,Porters Neck,6500,665,3904,364,0,347,5280
North Carolina,Pumpkin Center,1869,624,847,77,55,117,1720
North Carolina,Pollocksville,463,47,173,27,5,63,315
North Carolina,Polkton,3372,1579,617,481,138,114,2929
North Carolina,Plymouth,3736,1155,1172,273,81,241,2922
North Carolina,Pleasant Hill,621,147,321,33,59,13,573
North Carolina,Pleasant Garden,4632,840,2021,366,53,520,3800
North Carolina,Plain View,2450,324,1078,259,142,69,1872
North Carolina,Pittsboro,3992,1157,1369,466,56,292,3340
North Carolina,Pinnacle,690,144,318,29,2,41,534
North Carolina,Polkville,496,91,231,66,10,35,433
North Carolina,Ruffin,286,45,101,49,0,21,216
North Carolina,Raeford,4830,1247,1113,574,202,372,3508
North Carolina,Raleigh,432520,148744,141846,36103,9513,13738,349944
North Carolina,Unionville,6295,1042,3275,376,230,173,5096
North Carolina,Valdese,4471,732,1928,484,167,490,3801
North Carolina,Rich Square,927,227,354,97,48,93,819
North Carolina,Richlands,2394,349,967,180,36,64,1596
North Carolina,Richfield,653,119,250,99,14,32,514
North Carolina,Rhodhiss,846,236,283,101,37,85,742
North Carolina,Rex,65,17,48,0,0,0,65
North Carolina,Raemon,135,12,43,10,0,19,84
North Carolina,Rennert,369,115,118,29,15,12,289
North Carolina,Red Springs,3451,1032,833,333,65,230,2493
North Carolina,Red Oak,3428,715,1877,107,17,170,2886
North Carolina,Red Cross,706,97,371,78,14,39,599
North Carolina,Raynham,59,13,20,7,2,3,45
North Carolina,Ranlo,3496,854,1283,405,57,191,2790
North Carolina,Randleman,4136,998,1327,584,141,294,3344
North Carolina,Ramseur,1926,479,579,196,64,221,1539
North Carolina,Reidsville,14191,3426,5034,1804,558,971,11793
North Carolina,Zebulon,4690,1262,1251,385,235,268,3401
North Carolina,Albemarle,15969,3610,5381,2018,612,1271,12892
North Carolina,Yanceyville,2080,778,474,231,62,234,1779
North Carolina,Wilson's Mills,2662,606,968,189,45,84,1892
North Carolina,Windsor,3652,1576,898,420,113,205,3212
North Carolina,Winfall,624,170,234,37,16,63,520
North Carolina,Wingate,3742,1969,834,180,42,117,3142
North Carolina,Winston-Salem,236642,74822,75552,20180,5570,11561,187685
North Carolina,Winterville,9464,1860,4079,869,139,345,7292
North Carolina,Wilson,49478,14076,15653,4604,1727,3287,39347
North Carolina,Winton,842,282,196,90,39,63,670
North Carolina,Woodland,867,276,198,64,69,82,689
North Carolina,Aquadale,298,46,153,47,18,0,264
North Carolina,Arapahoe,498,77,277,41,19,40,454
North Carolina,Archdale,11396,2144,4908,1404,309,622,9387
North Carolina,Archer Lodge,4521,912,2013,237,192,48,3402
North Carolina,Asheboro,25897,5874,8474,2754,971,1719,19792
North Carolina,Woodfin,6204,1915,2189,661,123,407,5295
North Carolina,Skippers Corner,2883,836,1249,169,41,58,2353
North Carolina,Wilmington,111998,40017,36327,11018,2686,5027,95075
North Carolina,Wilkesboro,3548,788,1110,327,194,327,2746
North Carolina,Wendell,6169,1060,2249,684,162,355,4510
North Carolina,Wentworth,2762,779,1158,224,75,99,2335
North Carolina,Wesley Chapel village,8010,1449,4028,317,97,183,6074
North Carolina,West Canton,1346,215,605,95,39,107,1061
North Carolina,West Jefferson,1232,284,512,149,17,97,1059
North Carolina,West Marion,1413,148,500,266,65,93,1072
North Carolina,Williamston,5569,1760,1568,542,75,560,4505
North Carolina,Westport,3708,352,2069,312,30,153,2916
North Carolina,Whitakers,898,317,181,102,51,91,742
North Carolina,White Lake,1248,267,530,133,31,95,1056
North Carolina,Youngsville,1394,359,514,113,69,16,1071
North Carolina,White Plains,1075,178,463,142,62,116,961
North Carolina,Whiteville,5512,1333,1669,650,301,507,4460
North Carolina,Whitsett,756,107,450,59,13,21,650
North Carolina,Whispering Pines village,3067,229,1671,127,39,202,2268
North Carolina,Smithfield,11562,2639,3922,1426,482,1101,9570
North Carolina,Sneads Ferry,3714,535,1851,304,48,79,2817
North Carolina,Snow Hill,1847,403,548,268,108,147,1474
North Carolina,Autryville,426,154,121,10,9,22,316
North Carolina,Avery Creek,2493,572,916,400,34,109,2031
North Carolina,Avon,926,178,439,100,54,56,827
North Carolina,Ayden,5035,1726,1345,466,127,335,3999
North Carolina,Badin,1895,654,598,250,84,150,1736
North Carolina,Spencer Mountain,21,3,11,0,0,0,14
North Carolina,Aurora,505,80,221,61,1,62,425
North Carolina,Topsail Beach,356,46,224,28,1,22,321
North Carolina,Trent Woods,4212,633,2371,299,62,280,3645
North Carolina,Trinity,6652,1089,3185,589,176,266,5305
North Carolina,Troutman,2476,578,957,221,10,119,1885
North Carolina,Troy,3446,1048,967,353,137,277,2782
North Carolina,Tryon,1624,442,482,266,28,223,1441
North Carolina,Turkey,280,65,115,38,0,21,239
North Carolina,Trenton,363,86,107,32,25,19,269
North Carolina,Aulander,785,124,221,71,50,74,540
North Carolina,Atlantic Beach,1596,446,601,282,68,73,1470
North Carolina,Atlantic,417,84,189,42,31,29,375
North Carolina,Southern Pines,13018,2819,4800,1264,567,1554,11004
North Carolina,Southern Shores,2789,421,1728,180,30,133,2492
North Carolina,South Henderson,735,281,182,42,37,101,643
North Carolina,South Mills,196,77,82,0,0,37,196
North Carolina,Southmont,1422,332,713,35,18,164,1262
North Carolina,Southport,3154,492,1278,499,18,399,2686
North Carolina,South Rosemary,2736,771,793,197,145,284,2190
North Carolina,South Weldon,696,286,88,55,40,53,522
North Carolina,Sparta,1802,365,715,220,74,154,1528
North Carolina,Speed,95,24,22,9,11,27,93
North Carolina,Spencer,3276,661,1331,232,230,193,2647
North Carolina,Asheville,86789,27642,28331,9920,1878,4727,72498
North Carolina,Ashley Heights,394,100,87,72,6,25,290
North Carolina,Askewville,231,21,118,12,19,41,211
North Carolina,Atkinson,378,99,164,27,2,30,322
North Carolina,Weldon,1623,448,504,143,63,154,1312
North Carolina,Welcome,4743,1013,2214,311,47,335,3920
North Carolina,White Oak,309,92,77,60,0,58,287
North Carolina,Webster,409,68,177,51,14,8,318
North Carolina,Roper,445,140,71,38,17,33,299
North Carolina,Roseboro,1655,378,567,100,79,126,1250
North Carolina,Weddington,10091,1941,5637,285,131,378,8372
North Carolina,Rosman,721,218,235,77,26,21,577
North Carolina,Rougemont,838,193,483,26,0,41,743
North Carolina,Rowland,1227,438,312,93,66,92,1001
North Carolina,Ronda,461,77,191,50,20,40,378
North Carolina,Roxboro,8316,2946,2004,787,256,729,6722
North Carolina,Royal Pines,5084,868,2401,609,54,206,4138
North Carolina,Valle Crucis,226,22,118,47,0,10,197
North Carolina,Valley Hill,2269,384,1176,265,40,89,1954
North Carolina,Vanceboro,1199,271,390,143,43,49,896
North Carolina,Vandemere,271,118,69,16,22,24,249
North Carolina,Vander,1097,152,437,239,16,109,953
North Carolina,Roxobel,290,101,92,26,15,32,266
North Carolina,Rolesville,5006,735,2559,173,125,98,3690
North Carolina,Rodanthe,270,89,2,21,65,75,252
North Carolina,Rocky Point,1967,405,934,136,3,72,1550
North Carolina,Yadkinville,2946,519,1079,290,58,332,2278
North Carolina,Wrightsville Beach,2540,983,869,270,66,109,2297
North Carolina,Wrightsboro,5525,1291,2275,568,47,287,4468
North Carolina,Woodlawn,726,137,399,68,18,16,638
North Carolina,Riegelwood,390,91,119,57,25,46,338
North Carolina,River Bend,3161,399,1823,327,51,218,2818
North Carolina,River Road,4124,642,2059,338,133,383,3555
North Carolina,Roanoke Rapids,15557,3655,5330,1437,420,1249,12091
North Carolina,Robbins,1201,300,385,109,24,43,861
North Carolina,Robbinsville,575,206,164,92,28,42,532
North Carolina,Robersonville,1501,475,411,190,21,155,1252
North Carolina,Rockfish,3810,794,1624,276,34,0,2728
North Carolina,Rockingham,9376,2669,3094,628,383,677,7451
North Carolina,Rockwell,1932,438,765,266,18,124,1611
North Carolina,Rocky Mount,56642,17751,16394,5500,2070,3636,45351
North Carolina,Vann Crossroads,406,133,171,0,0,0,304
North Carolina,Varnamtown,576,129,265,56,12,29,491
North Carolina,Rose Hill,1844,466,678,124,52,167,1487
North Carolina,Waco,322,67,129,37,15,33,281
North Carolina,Vass,637,139,231,57,14,56,497
North Carolina,Washington,9777,2403,3078,1008,262,915,7666
North Carolina,Washington Park,563,95,275,65,6,26,467
North Carolina,Watha,216,40,103,23,0,14,180
North Carolina,Waves,65,0,65,0,0,0,65
North Carolina,Waxhaw,11586,2028,5570,400,106,234,8338
North Carolina,Waynesville,9748,1995,3921,1184,310,1145,8555
North Carolina,Weaverville,3834,694,1816,415,65,326,3316
North Carolina,Warrenton,932,243,323,124,36,79,805
North Carolina,Wanchese,1475,195,610,226,59,67,1157
North Carolina,Warsaw,3168,995,550,239,183,390,2357
North Carolina,Walnut Creek village,870,114,524,35,15,50,738
North Carolina,Walnut Cove,1751,410,632,202,17,166,1427
North Carolina,Wallburg,3067,576,1637,214,61,133,2621
North Carolina,Wallace,3962,1355,1171,566,245,380,3717
North Carolina,Walkertown,4839,1057,1852,642,170,354,4075
North Carolina,Wakulla,200,0,120,0,0,0,120
North Carolina,Wake Forest,34786,5823,15896,2258,547,1002,25526
North Carolina,Wagram,897,285,279,84,30,76,754
North Carolina,Wadesboro,5664,1716,1580,455,217,481,4449
North Carolina,Wade,562,106,194,43,13,35,391
North Carolina,Walstonburg,317,73,132,27,9,26,267
North Dakota,New Town,2306,823,545,247,37,63,1715
North Dakota,Niagara,61,20,22,5,0,5,52
North Dakota,Nome,62,9,36,1,0,0,46
North Dakota,Noonan,188,54,56,17,0,7,134
North Dakota,New Salem,831,108,420,66,0,110,704
North Dakota,Lakota,588,84,274,102,0,43,503
North Dakota,Northwood,740,150,304,74,14,84,626
North Dakota,Oakes,1975,290,944,132,16,184,1566
North Dakota,New Rockford,1428,316,490,182,13,135,1136
North Dakota,Oberon,173,53,47,8,2,7,117
North Dakota,Oriska,80,20,29,7,0,3,59
North Dakota,Orrin,0,0,0,0,0,0,0
North Dakota,Osnabrock,114,27,46,12,0,21,106
North Dakota,North River,59,9,37,2,0,0,48
North Dakota,New Leipzig,248,23,160,24,0,20,227
North Dakota,Munich,249,36,132,7,0,11,186
North Dakota,Newburg,134,6,74,8,0,5,93
North Dakota,Jud,62,5,34,4,2,5,50
North Dakota,Karlsruhe,84,17,43,3,2,4,69
North Dakota,Kathryn,72,3,31,21,1,11,67
North Dakota,LaMoure,931,154,451,54,8,61,728
North Dakota,Landa,54,6,20,13,0,8,47
North Dakota,Kenmare,975,173,455,69,4,95,796
North Dakota,Kensal,201,53,83,20,1,12,169
North Dakota,Kief,9,0,7,2,0,0,9
North Dakota,Killdeer,851,178,303,130,2,54,667
North Dakota,New England,579,139,257,64,15,51,526
North Dakota,Kindred,709,92,332,66,14,12,516
North Dakota,Kramer,40,1,25,4,4,0,34
North Dakota,Kulm,333,32,146,18,1,65,262
North Dakota,Mooreton,231,60,108,15,1,7,191
North Dakota,Mott,760,104,330,70,2,101,607
North Dakota,Mylo,10,1,8,0,0,1,10
North Dakota,Napoleon,767,124,377,46,5,114,666
North Dakota,Nash,6,6,0,0,0,0,6
North Dakota,Neche,361,71,153,19,0,31,274
North Dakota,Nekoma,34,5,26,0,0,0,31
North Dakota,Knox,34,16,8,8,0,2,34
North Dakota,Langdon,1833,298,909,127,0,188,1522
North Dakota,Mountain,85,15,36,3,0,25,79
North Dakota,Lansford,358,87,137,22,1,1,248
North Dakota,McVille,321,38,149,26,1,66,280
North Dakota,McLeod,14,0,8,0,0,6,14
North Dakota,McHenry,111,12,49,2,0,11,74
North Dakota,McClusky,302,50,118,41,0,57,266
North Dakota,Luverne,56,5,38,6,2,5,56
North Dakota,Ludden,36,3,21,5,0,0,29
North Dakota,Loraine,3,1,2,0,0,0,3
North Dakota,Loma,10,5,3,1,0,1,10
North Dakota,Wishek,947,140,450,80,0,153,823
North Dakota,Wing,127,30,54,16,1,12,113
North Dakota,Wimbledon,274,23,157,12,3,7,202
North Dakota,Wilton,921,200,429,65,1,43,738
North Dakota,Willow City,178,44,84,10,0,11,149
North Dakota,Williston,22051,5443,9332,1563,309,760,17407
North Dakota,Wildrose,87,11,38,18,0,3,70
North Dakota,White Shield,384,108,101,32,4,16,261
North Dakota,White Earth,149,20,40,13,6,0,79
North Dakota,Wheatland,57,0,38,7,0,12,57
North Dakota,Westhope,450,101,234,29,0,42,406
North Dakota,West Fargo,29892,6564,13058,2607,160,749,23138
North Dakota,Watford City,3728,756,1695,231,30,178,2890
North Dakota,Washburn,1421,266,723,108,7,54,1158
North Dakota,Warwick,44,14,17,3,2,2,38
North Dakota,Walhalla,1084,243,456,81,0,93,873
North Dakota,Wales,37,11,16,4,0,0,31
North Dakota,Walcott,223,23,122,14,1,5,165
North Dakota,Wahpeton,7835,2975,2873,583,49,266,6746
North Dakota,Maddock,372,57,156,47,10,23,293
North Dakota,Makoti,165,38,62,16,1,4,121
North Dakota,Mandan,19962,4319,8758,1899,143,1008,16127
North Dakota,Mandaree,806,230,100,82,16,35,463
North Dakota,Erie,149,26,68,16,0,0,110
North Dakota,Esmond,81,8,47,10,0,12,77
North Dakota,Fairdale,32,7,17,1,0,3,28
North Dakota,Fairmount,363,74,154,42,5,12,287
North Dakota,Montpelier,98,23,40,15,0,5,83
North Dakota,Monango,54,7,18,2,0,3,30
North Dakota,Mohall,703,173,306,64,9,52,604
North Dakota,Minto,573,56,305,55,3,24,443
North Dakota,Minot AFB,5890,1425,2786,83,34,68,4396
North Dakota,Minot,46194,13248,17163,4037,555,2288,37291
North Dakota,Minnewaukan,226,63,91,20,4,8,186
North Dakota,Milton,60,6,43,3,0,5,57
North Dakota,Milnor,591,104,317,37,0,35,493
North Dakota,Voltaire,45,16,20,3,0,0,39
North Dakota,Michigan City,203,13,121,26,0,19,179
North Dakota,Menoken,82,12,48,7,0,4,71
North Dakota,Medora,184,60,92,15,0,4,171
North Dakota,Medina,297,58,106,32,7,30,233
North Dakota,Mayville,1787,640,611,129,18,176,1574
North Dakota,Maxbass,94,36,25,7,2,5,75
North Dakota,Max,327,74,164,20,2,13,273
North Dakota,Martin,96,15,49,5,0,11,80
North Dakota,Marmarth,154,45,46,15,6,14,126
North Dakota,Marion,139,28,71,17,8,5,129
North Dakota,Mapleton,798,148,390,11,3,7,559
North Dakota,Manvel,405,73,187,30,0,5,295
North Dakota,Mantador,82,29,35,4,0,4,72
North Dakota,Manning,22,4,10,5,0,3,22
North Dakota,Mercer,57,6,27,4,0,9,46
North Dakota,Lankin,129,14,70,14,0,5,103
North Dakota,Verona,77,19,32,5,0,13,69
North Dakota,Velva,1132,211,349,95,20,148,823
North Dakota,Sheldon,80,9,53,6,0,1,69
North Dakota,Sharon,83,16,45,10,0,7,78
North Dakota,Sentinel Butte,90,10,44,7,0,2,63
North Dakota,Selz,7,0,0,0,0,7,7
North Dakota,Selfridge,216,49,53,23,2,10,137
North Dakota,Scranton,317,44,177,8,1,17,247
North Dakota,Sawyer,336,82,165,31,0,19,297
North Dakota,Sarles,17,6,9,0,0,0,15
North Dakota,Sanborn,149,38,75,11,0,11,135
North Dakota,St. Thomas,310,34,169,34,1,28,266
North Dakota,St. John,291,82,67,25,12,24,210
North Dakota,Logan,204,48,112,8,0,10,178
North Dakota,Litchville,152,26,83,11,2,11,133
North Dakota,Lisbon,2081,453,813,185,27,215,1693
North Dakota,Linton,1042,167,548,86,0,110,911
North Dakota,Lincoln,3093,498,1573,152,0,76,2299
North Dakota,Lignite,91,31,40,3,3,12,89
North Dakota,Lidgerwood,706,152,286,54,6,95,593
North Dakota,Leonard,317,52,162,11,0,13,238
North Dakota,Leith,22,0,12,0,0,1,13
North Dakota,Lehr,76,4,60,5,0,7,76
North Dakota,Leeds,505,104,210,19,3,36,372
North Dakota,Leal,19,2,9,4,0,2,17
North Dakota,Lawton,20,7,12,0,0,1,20
North Dakota,Overly,23,0,12,2,0,0,14
North Dakota,Larson,6,2,0,4,0,0,6
North Dakota,Larimore,1513,247,683,103,22,72,1127
North Dakota,Shell Valley,1396,404,351,58,14,38,865
North Dakota,Sherwood,226,40,114,22,0,7,183
North Dakota,Sheyenne,192,35,80,30,0,18,163
North Dakota,Sibley,33,15,9,2,0,2,28
North Dakota,Valley City,6626,1514,2972,600,7,625,5718
North Dakota,Upham,225,44,97,30,2,8,181
North Dakota,Underwood,791,144,409,37,10,54,654
North Dakota,Tuttle,89,6,55,13,0,6,80
North Dakota,Turtle Lake,476,94,197,58,12,51,412
North Dakota,Towner,493,120,194,70,0,50,434
North Dakota,Tower City,288,44,161,23,0,9,237
North Dakota,Tolna,170,47,84,11,1,13,156
North Dakota,Tolley,29,4,10,9,3,1,27
North Dakota,Tioga,1072,244,541,50,9,74,918
North Dakota,Thompson,1067,180,545,69,1,18,813
North Dakota,Taylor,221,36,88,24,0,17,165
North Dakota,Tappen,265,55,137,12,3,9,216
North Dakota,Venturia,35,14,7,0,0,3,24
North Dakota,Sykeston,116,17,58,5,0,18,98
North Dakota,Surrey,1054,174,555,94,2,30,855
North Dakota,Streeter,83,19,39,9,0,15,82
North Dakota,Strasburg,439,105,188,35,0,61,389
North Dakota,Steele,781,102,400,57,1,41,601
North Dakota,Starkweather,123,13,55,13,0,2,83
North Dakota,Stanton,380,70,192,33,0,29,324
North Dakota,Stanley,2118,642,885,130,5,122,1784
North Dakota,Springbrook,10,2,3,0,0,3,8
North Dakota,Spiritwood Lake,106,10,76,4,0,4,94
North Dakota,Spiritwood,7,0,7,0,0,0,7
North Dakota,South Heart,295,37,135,31,0,6,209
North Dakota,Souris,68,8,26,4,0,6,44
North Dakota,Solen,75,26,12,10,0,5,53
North Dakota,Sutton,9,0,6,0,0,3,9
North Dakota,Oxbow,411,66,191,17,3,6,283
North Dakota,Conway,9,1,2,0,0,3,6
North Dakota,Palermo,130,21,54,16,7,7,105
North Dakota,Balta,150,28,42,17,0,6,93
North Dakota,Balfour,9,5,2,1,1,0,9
North Dakota,Ayr,20,11,3,5,0,1,20
North Dakota,Auburn,24,0,13,6,0,0,19
North Dakota,Ashley,771,102,421,20,0,128,671
North Dakota,Arthur,385,68,136,43,2,56,305
North Dakota,Arnegard,88,38,21,16,0,8,83
North Dakota,Argusville,449,61,222,17,0,2,302
North Dakota,Ardoch,98,6,47,3,0,1,57
North Dakota,Antler,10,0,0,5,0,5,10
North Dakota,Aneta,263,87,92,31,0,37,247
North Dakota,Anamoose,286,31,150,31,0,15,227
North Dakota,Bantry,18,4,9,1,2,0,16
North Dakota,Amidon,32,0,30,2,0,0,32
North Dakota,Ambrose,19,6,4,9,0,0,19
North Dakota,Alsen,63,11,26,4,0,3,44
North Dakota,Almont,132,18,54,16,3,5,96
North Dakota,Alice,33,0,22,3,0,3,28
North Dakota,Alexander,225,32,106,21,2,7,168
North Dakota,Alamo,72,19,38,5,1,1,64
North Dakota,Adams,142,44,50,16,2,20,132
North Dakota,Abercrombie,251,42,120,23,0,9,194
North Dakota,Forman,560,136,196,60,11,56,459
North Dakota,Fort Ransom,107,7,69,9,0,11,96
North Dakota,Fort Totten,1284,468,117,65,31,39,720
North Dakota,Fortuna,47,4,17,8,0,1,30
North Dakota,Amenia,83,9,56,2,0,0,67
North Dakota,Fort Yates,212,76,41,24,4,5,150
North Dakota,Barney,55,10,22,11,0,4,47
North Dakota,Bathgate,52,15,26,5,0,3,49
North Dakota,Butte,51,5,30,5,0,2,42
North Dakota,Burlington,1234,393,428,98,9,15,943
North Dakota,Buffalo,173,20,99,15,0,10,144
North Dakota,Bucyrus,19,7,8,0,0,4,19
North Dakota,Buchanan,43,5,31,0,0,0,36
North Dakota,Brooktree Park,18,0,18,0,0,0,18
North Dakota,Brocket,89,14,49,0,0,5,68
North Dakota,Brinsmade,81,13,9,23,0,1,46
North Dakota,Briarwood,67,21,27,5,1,0,54
North Dakota,Braddock,8,2,6,0,0,0,8
North Dakota,Bowman,1677,347,712,113,23,165,1360
North Dakota,Bowdon,123,13,68,18,0,14,113
North Dakota,Barton,10,0,10,0,0,0,10
North Dakota,Bowbells,402,79,166,55,12,23,335
North Dakota,Blanchard,11,0,0,5,0,6,11
North Dakota,Bismarck,66980,17739,27091,6013,312,3728,54883
North Dakota,Bisbee,159,27,63,14,0,19,123
North Dakota,Binford,157,30,66,21,0,14,131
North Dakota,Beulah,3286,512,1584,290,0,210,2596
North Dakota,Berthold,372,55,184,24,4,15,282
North Dakota,Berlin,31,7,13,0,0,3,23
North Dakota,Bergen,12,1,10,1,0,0,12
North Dakota,Benedict,71,12,36,1,0,0,49
North Dakota,Belfield,969,197,432,85,0,26,740
North Dakota,Belcourt,1904,759,288,168,44,111,1370
North Dakota,Beach,955,158,416,92,0,111,777
North Dakota,Bottineau,2273,569,977,138,14,263,1961
North Dakota,Four Bears Village,702,267,91,76,8,0,442
North Dakota,Foxholm,58,14,17,11,0,0,42
North Dakota,Fredonia,46,10,28,1,0,3,42
North Dakota,Hampden,36,3,20,2,0,7,32
North Dakota,Hankinson,997,197,415,101,7,92,812
North Dakota,Hannaford,106,7,69,11,0,17,104
North Dakota,Hannah,10,3,2,3,0,1,9
North Dakota,Hansboro,15,4,5,5,0,0,14
North Dakota,Harmon,212,30,131,0,0,0,161
North Dakota,Harvey,1920,302,860,126,35,236,1559
North Dakota,Harwood,869,131,498,36,0,11,676
North Dakota,Hatton,653,102,281,68,0,94,545
North Dakota,Havana,69,0,56,9,0,1,66
North Dakota,Haynes,12,0,10,1,0,1,12
North Dakota,Hazelton,223,40,89,16,2,22,169
North Dakota,Hamilton,61,9,39,5,0,8,61
North Dakota,Hazen,2578,447,1425,142,7,120,2141
North Dakota,Heil,17,0,14,0,0,3,17
North Dakota,Heimdal,5,0,0,2,0,3,5
North Dakota,Hettinger,1233,168,643,98,4,104,1017
North Dakota,Hillsboro,1673,299,730,134,13,169,1345
North Dakota,Hoople,301,49,149,19,0,8,225
North Dakota,Hope,372,61,202,17,5,35,320
North Dakota,Horace,2523,418,1386,46,18,34,1902
North Dakota,Hunter,353,79,145,21,8,9,262
North Dakota,Hurdsfield,58,8,38,0,0,2,48
North Dakota,Inkster,30,5,17,4,0,1,27
North Dakota,Jamestown,15418,4121,6028,1668,132,1011,12960
North Dakota,Jessie,35,0,23,0,0,5,28
North Dakota,Hebron,831,105,458,32,1,27,623
North Dakota,Hamberg,16,2,9,5,0,0,16
North Dakota,Halliday,305,49,107,46,0,7,209
North Dakota,Hague,57,10,24,12,0,5,51
North Dakota,Frontier,219,39,140,3,0,2,184
North Dakota,Fullerton,64,9,22,9,0,17,57
North Dakota,Gackle,371,70,165,30,7,30,302
North Dakota,Galesburg,131,24,40,32,5,6,107
North Dakota,Gardena,11,2,7,0,0,2,11
North Dakota,Gardner,88,15,35,7,0,2,59
North Dakota,Garrison,1377,212,687,115,0,166,1180
North Dakota,Gascoyne,11,1,7,2,0,1,11
North Dakota,Gilby,215,48,94,14,1,15,172
North Dakota,Gladstone,366,91,172,11,0,12,286
North Dakota,Glenburn,529,98,210,29,9,12,358
North Dakota,Glenfield,99,10,44,11,0,8,73
North Dakota,Glen Ullin,716,122,321,80,0,102,625
North Dakota,Golden Valley,277,31,127,43,6,14,221
North Dakota,Golva,103,33,45,14,0,5,97
North Dakota,Goodrich,149,31,83,3,0,14,131
North Dakota,Grace City,58,13,24,5,4,1,47
North Dakota,Grafton,4282,977,1728,391,9,314,3419
North Dakota,Grand Forks,54944,20548,18955,4428,367,1852,46150
North Dakota,Grand Forks AFB,2663,727,1098,85,0,0,1910
North Dakota,Grandin,211,29,139,1,0,0,169
North Dakota,Grano,3,0,3,0,0,0,3
North Dakota,Granville,279,55,131,24,1,21,232
North Dakota,Great Bend,69,16,34,6,0,4,60
North Dakota,Green Acres,784,238,83,97,0,14,432
North Dakota,Grenora,236,41,83,26,0,11,161
North Dakota,Gwinner,862,192,409,85,7,29,722
North Dakota,Buxton,346,50,169,15,9,17,260
North Dakota,Page,283,71,87,16,2,14,190
North Dakota,Caledonia,20,0,20,0,0,0,20
North Dakota,Calvin,8,0,6,0,0,0,6
North Dakota,Rolette,679,146,220,75,3,35,479
North Dakota,Rolla,1316,331,407,120,9,89,956
North Dakota,Ross,88,44,23,4,0,1,72
North Dakota,Rugby,3112,638,1379,357,33,203,2610
North Dakota,Ruso,8,2,2,0,0,0,4
North Dakota,Ruthville,220,58,35,51,0,9,153
North Dakota,Rutland,181,29,83,30,0,14,156
North Dakota,Ryder,122,36,43,6,0,7,92
North Dakota,Zeeland,100,24,34,8,0,9,75
North Dakota,Zap,209,34,123,4,2,12,175
North Dakota,Ypsilanti,80,0,21,28,0,23,72
North Dakota,York,43,1,33,3,0,4,41
North Dakota,Rogers,46,6,17,5,0,2,30
North Dakota,Wyndmere,479,49,225,46,9,34,363
North Dakota,Wolford,26,3,12,5,1,0,21
North Dakota,Fargo,113464,41373,38514,9092,944,4245,94168
North Dakota,Fessenden,464,54,209,63,4,38,368
North Dakota,Fingal,94,14,51,15,1,3,84
North Dakota,Finley,421,69,210,63,0,25,367
North Dakota,Flasher,308,63,134,12,4,20,233
North Dakota,Flaxton,59,6,28,3,1,2,40
North Dakota,Forbes,33,1,22,3,0,0,26
North Dakota,Fordville,247,64,104,24,0,15,207
North Dakota,Enderlin,950,229,378,87,18,108,820
North Dakota,Emerado,360,118,134,32,5,14,303
North Dakota,Embden,67,13,29,0,0,11,53
North Dakota,Woodworth,28,7,7,3,0,11,28
North Dakota,Elliott,15,0,6,8,0,1,15
North Dakota,Rocklake,138,30,45,24,2,11,112
North Dakota,Riverdale,212,18,142,36,1,3,200
North Dakota,Park River,1480,281,670,118,0,152,1221
North Dakota,Parshall,1071,311,271,110,9,66,767
North Dakota,Pekin,78,9,36,9,0,2,56
North Dakota,Pembina,570,106,288,21,2,45,462
North Dakota,Perth,7,2,4,0,0,0,6
North Dakota,Petersburg,196,45,86,19,0,8,158
North Dakota,Pettibone,63,16,32,2,0,9,59
North Dakota,Pick City,125,23,56,23,0,17,119
North Dakota,Pillsbury,18,0,9,2,0,7,18
North Dakota,Pingree,58,19,27,3,0,1,50
North Dakota,Pisek,112,18,51,13,1,5,88
North Dakota,Plaza,239,37,80,26,0,20,163
North Dakota,Robinson,33,6,17,2,0,4,29
North Dakota,Porcupine,222,73,37,4,2,2,118
North Dakota,Portland,583,168,242,17,7,23,457
North Dakota,Powers Lake,426,63,209,20,3,19,314
North Dakota,Prairie Rose,87,1,53,0,0,3,57
North Dakota,Raleigh,3,0,3,0,0,0,3
North Dakota,Ray,527,100,285,33,1,23,442
North Dakota,Reeder,159,40,71,17,0,15,143
North Dakota,Regan,57,11,14,12,0,0,37
North Dakota,Regent,205,21,102,17,1,18,159
North Dakota,Reile's Acres,511,77,274,8,0,0,359
North Dakota,Reynolds,302,55,139,32,6,20,252
North Dakota,Rhame,176,36,92,10,0,2,140
North Dakota,Richardton,662,103,334,52,0,55,544
North Dakota,Portal,114,20,52,7,0,7,86
North Dakota,Calio,6,0,3,0,0,3,6
North Dakota,Ellendale,1466,446,611,63,6,130,1256
North Dakota,Egeland,25,2,12,6,0,5,25
North Dakota,Courtenay,47,11,26,2,0,1,40
North Dakota,Elgin,600,105,284,50,3,84,526
North Dakota,Epping,97,22,49,6,0,0,77
North Dakota,Columbus,219,40,89,4,5,14,152
North Dakota,Colfax,121,14,69,0,0,4,87
North Dakota,Coleharbor,63,19,28,7,4,3,61
North Dakota,Cogswell,78,13,38,18,0,7,76
North Dakota,Clifford,19,5,10,3,0,1,19
North Dakota,Cleveland,113,33,44,7,0,2,86
North Dakota,Churchs Ferry,5,0,5,0,0,0,5
North Dakota,Christine,140,34,77,9,0,5,125
North Dakota,Center,605,91,317,52,5,46,511
North Dakota,Cayuga,43,3,29,6,0,2,40
North Dakota,Cavalier,1230,235,511,104,20,128,998
North Dakota,Cathay,53,8,20,9,2,3,42
North Dakota,Casselton,2466,340,1202,98,0,139,1779
North Dakota,Carson,238,42,94,30,1,38,205
North Dakota,Carrington,2011,444,976,114,14,212,1760
North Dakota,Forest River,126,21,68,12,0,5,106
North Dakota,Carpio,140,22,60,8,1,4,95
North Dakota,Canton City,14,1,12,0,0,1,14
North Dakota,Cannon Ball,908,343,150,84,16,29,622
North Dakota,Cando,1089,150,533,73,3,111,870
North Dakota,Crary,158,42,51,35,0,2,130
North Dakota,Crosby,1064,151,586,91,0,151,979
North Dakota,Cooperstown,1091,178,549,62,4,132,925
North Dakota,Dahlen,79,53,0,13,0,0,66
North Dakota,Edmore,171,20,70,14,4,39,147
North Dakota,Edinburg,170,31,102,9,0,19,161
North Dakota,Edgeley,590,58,302,59,10,45,474
North Dakota,East Fairview,56,8,29,4,0,0,41
North Dakota,East Dunseith,587,239,93,27,6,18,383
North Dakota,Dwight,81,13,45,5,0,1,64
North Dakota,Dunseith,822,268,160,79,5,45,557
North Dakota,Dunn Center,235,27,135,19,0,11,192
North Dakota,Crystal,142,33,68,20,0,8,129
North Dakota,Drayton,714,74,390,61,9,56,590
North Dakota,Drake,361,44,166,32,2,37,281
North Dakota,Douglas,53,9,29,4,0,1,43
North Dakota,Driscoll,74,26,25,6,0,2,59
North Dakota,Dodge,133,28,54,5,0,10,97
North Dakota,Davenport,244,29,127,35,2,2,195
North Dakota,Dawson,74,22,30,16,0,6,74
North Dakota,Dazey,118,28,50,6,0,8,92
North Dakota,Deering,122,42,59,6,0,3,110
North Dakota,De Lamere,30,0,20,3,0,0,23
North Dakota,Donnybrook,85,24,39,2,0,9,74
North Dakota,Englevale,130,48,45,0,0,0,93
North Dakota,Denhoff,14,0,9,2,0,2,13
North Dakota,Des Lacs,228,52,121,12,1,2,188
North Dakota,Devils Lake,7275,2083,2445,878,24,501,5931
North Dakota,Dickey,32,7,18,2,0,0,27
North Dakota,Dickinson,21097,5305,8937,1322,230,1168,16962
Ohio,Englewood,13456,2844,5621,1499,301,853,11118
Ohio,Elyria,54050,15891,18052,5805,872,2886,43506
Ohio,Etna,1113,336,458,87,0,0,881
Ohio,Euclid,48105,16606,12403,5571,1186,3339,39105
Ohio,Evendale village,2762,481,1586,134,11,95,2307
Ohio,Empire village,263,69,114,17,10,17,227
Ohio,Enon village,2606,463,1231,282,21,234,2231
Ohio,Edon village,823,147,312,102,13,61,635
Ohio,Elmore village,1361,189,630,105,9,94,1027
Ohio,Dover,12869,2368,5027,1734,120,1139,10388
Ohio,Donnelsville village,467,87,200,43,2,11,343
Ohio,Dola,131,30,79,4,5,7,125
Ohio,Dillonvale village,756,122,381,54,11,32,600
Ohio,Dillonvale,3603,902,1374,394,57,204,2931
Ohio,Dexter City village,128,50,33,10,0,7,100
Ohio,Devola,2708,546,1280,198,12,196,2232
Ohio,Deshler village,1780,372,683,150,22,117,1344
Ohio,Derby,324,85,169,36,0,5,295
Ohio,Dent,11043,2222,5230,872,84,544,8952
Ohio,Dennison village,2690,637,857,305,65,159,2023
Ohio,Delta village,3350,744,1348,375,39,147,2653
Ohio,Delshire,2975,702,1208,270,22,102,2304
Ohio,Delphos,7261,1552,3142,685,76,493,5948
Ohio,Dellroy village,315,52,125,27,9,15,228
Ohio,Delhi Hills,5172,1308,2518,235,22,176,4259
Ohio,Delaware,36794,9149,13957,3609,434,1558,28707
Ohio,De Graff village,1501,255,628,97,16,86,1082
Ohio,Defiance,16571,4053,6151,1779,263,1027,13273
Ohio,Deersville village,57,7,34,3,0,5,49
Ohio,Deer Park,5701,1638,1919,669,88,453,4767
Ohio,Dayton,141368,54738,31577,18074,3643,7131,115163
Ohio,Day Heights,2366,413,1252,95,47,84,1891
Ohio,Darrtown,316,71,180,16,0,17,284
Ohio,Darbyville village,221,34,90,13,6,28,171
Ohio,Darbydale,946,284,357,67,13,0,721
Ohio,Danville village,1094,249,386,132,25,98,890
Ohio,Doylestown village,3064,465,1578,206,29,219,2497
Ohio,Elmwood Place village,1951,673,546,262,6,145,1632
Ohio,Dresden village,1707,425,629,192,25,113,1384
Ohio,Dry Ridge,2534,523,1367,106,16,191,2203
Ohio,Elizabethtown,234,50,42,83,0,26,201
Ohio,Elida village,1962,332,935,227,2,66,1562
Ohio,Elgin village,32,4,17,5,0,3,29
Ohio,Eldorado village,633,141,252,57,0,58,508
Ohio,Fairborn,33251,9735,11600,3807,437,1582,27161
Ohio,Edison village,389,76,133,52,19,28,308
Ohio,Edgewood,4418,1190,1716,493,11,203,3613
Ohio,Edgerton village,2166,503,817,216,30,201,1767
Ohio,Eaton Estates,1032,266,391,168,14,23,862
Ohio,Eaton,8294,1785,2919,990,87,738,6519
Ohio,East Springfield,554,177,213,0,0,0,390
Ohio,East Sparta village,956,232,418,78,4,59,791
Ohio,East Rochester,283,108,39,62,0,31,240
Ohio,East Palestine village,4634,981,1772,501,116,302,3672
Ohio,East Liverpool,10999,2497,4062,1156,277,694,8686
Ohio,East Liberty,248,9,193,31,0,0,233
Ohio,Eastlake,18380,4812,7379,2020,163,984,15358
Ohio,East Fultonham,371,32,199,0,19,27,277
Ohio,East Cleveland,17519,6933,3161,2427,461,1295,14277
Ohio,East Canton village,1424,314,673,150,5,51,1193
Ohio,Dupont village,270,45,113,34,1,19,212
Ohio,Dunlap,2040,484,1049,148,0,81,1762
Ohio,Dunkirk village,969,193,397,96,6,41,733
Ohio,Dundee,516,122,240,30,22,9,423
Ohio,Duncan Falls,1008,296,344,134,0,90,864
Ohio,Dublin,43224,7244,21930,2389,174,1082,32819
Ohio,Dry Run,7887,1369,4121,163,23,162,5838
Ohio,Drexel,1805,546,329,359,64,107,1405
Ohio,Fairfax village,1633,335,641,219,13,90,1298
Ohio,Farmersville village,923,166,438,95,17,51,767
Ohio,Wayne Lakes village,703,107,319,88,14,64,592
Ohio,Adamsville village,117,18,35,15,1,7,76
Ohio,Ada village,6050,3004,1463,536,3,225,5231
Ohio,Aberdeen village,1487,325,507,267,19,132,1250
Ohio,Hilltop,486,114,205,64,0,44,427
Ohio,Hillsboro,6556,1593,2096,969,181,513,5352
Ohio,Hills and Dales village,282,52,155,15,0,6,228
Ohio,Hilliard,31803,5962,14575,1788,308,1370,24003
Ohio,Highpoint,1262,199,664,99,0,38,1000
Ohio,Highland Holiday,461,57,207,40,0,62,366
Ohio,Highland Hills village,950,571,109,167,14,52,913
Ohio,Highland Heights,8337,2001,4227,396,50,332,7006
Ohio,Highland village,289,44,115,18,5,9,191
Ohio,Higginsport village,278,44,114,35,6,36,235
Ohio,Hide-A-Way Hills,670,16,537,82,0,35,670
Ohio,Hicksville village,3252,744,1060,469,85,239,2597
Ohio,Hessville,332,78,116,23,0,31,248
Ohio,Hemlock village,186,59,72,10,7,8,156
Ohio,Helena village,242,44,101,30,5,9,189
Ohio,Hebron village,2395,538,758,427,73,170,1966
Ohio,Heath,10411,2181,4197,1277,241,668,8564
Ohio,Hayesville village,483,65,278,24,4,14,385
Ohio,Addyston village,936,287,280,117,20,62,766
Ohio,Haydenville,134,40,53,9,0,32,134
Ohio,Adelphi village,364,63,121,69,2,25,280
Ohio,Akron,198329,68796,55180,23340,4141,10233,161690
Ohio,Aquilla village,301,66,115,21,7,22,231
Ohio,Apple Valley,5466,622,3137,358,5,329,4451
Ohio,Apple Creek village,1092,233,467,95,22,69,886
Ohio,Antwerp village,1540,281,620,171,17,166,1255
Ohio,Antioch village,147,43,66,7,1,4,121
Ohio,Ansonia village,1160,235,507,124,4,49,919
Ohio,Anna village,1557,240,702,114,15,41,1112
Ohio,Andover village,1143,188,372,226,14,148,948
Ohio,Andersonville,798,141,407,81,14,16,659
Ohio,Amsterdam village,527,100,229,45,2,41,417
Ohio,Amherst,12114,2443,5422,1284,122,792,10063
Ohio,Amesville village,109,22,43,11,1,10,87
Ohio,Damascus,385,94,175,32,0,27,328
Ohio,Amelia village,5319,1012,2172,596,0,137,3917
Ohio,Amberley village,3590,425,2067,100,26,121,2739
Ohio,Amanda village,702,115,290,90,10,30,535
Ohio,Alvordton,209,48,96,44,9,12,209
Ohio,Alliance,22137,6616,6502,2735,476,1654,17983
Ohio,Alger village,686,141,251,75,16,74,557
Ohio,Alexandria village,590,149,168,88,13,61,479
Ohio,Albany village,1116,188,459,202,7,67,923
Ohio,Adena village,737,226,289,61,2,59,637
Ohio,Arcadia village,678,126,284,88,9,9,516
Ohio,Haviland village,192,58,89,11,0,4,162
Ohio,Harveysburg village,601,139,276,36,0,15,466
Ohio,Green Meadows,2578,533,975,382,6,185,2081
Ohio,Greenhills village,3590,952,1512,284,7,182,2937
Ohio,Greenfield village,4761,1076,1361,611,115,488,3651
Ohio,Green Camp village,368,67,128,48,20,32,295
Ohio,Green,25868,5512,12551,1917,190,1310,21480
Ohio,Graysville village,79,16,41,8,0,0,65
Ohio,Gratis village,1013,232,459,81,25,61,858
Ohio,Gratiot village,381,75,118,43,3,26,265
Ohio,Granville South,1479,135,826,61,12,33,1067
Ohio,Granville village,5706,2629,1902,187,10,73,4801
Ohio,Grandview Heights,7014,1946,2971,538,82,192,5729
Ohio,Grandview,1452,332,617,29,60,15,1053
Ohio,Grand River village,387,112,172,22,0,12,318
Ohio,Grand Rapids village,1057,202,446,107,27,78,860
Ohio,Grafton village,6090,2815,1504,960,253,169,5701
Ohio,Goshen,616,128,238,115,20,76,577
Ohio,Gordon village,207,42,94,15,2,13,166
Ohio,Good Hope,342,16,204,12,0,11,243
Ohio,Golf Manor village,3608,1230,946,477,41,178,2872
Ohio,Gnadenhutten village,1462,258,644,115,15,67,1099
Ohio,Northwood,5316,872,2518,556,143,232,4321
Ohio,Green Springs village,1530,327,415,178,20,180,1120
Ohio,Haskins village,1302,204,603,76,9,42,934
Ohio,Greentown,4414,773,2421,211,30,113,3548
Ohio,Greenwich village,1296,265,529,153,28,62,1037
Ohio,Hartville village,2963,714,1150,333,19,195,2411
Ohio,Hartford village,320,67,118,44,0,21,250
Ohio,Harrod village,440,90,186,45,0,14,335
Ohio,Harrisville village,261,25,134,26,0,24,209
Ohio,Harrison,10366,1957,4779,814,95,277,7922
Ohio,Harrisburg village,394,102,140,44,0,29,315
Ohio,Harpster village,231,43,111,26,0,11,191
Ohio,Harbor View village,128,45,32,10,0,3,90
Ohio,Harbor Hills,1553,166,841,190,15,89,1301
Ohio,Hanoverton village,370,81,154,41,7,31,314
Ohio,Hanover village,1158,262,489,95,11,24,881
Ohio,Hannibal,346,68,193,23,0,26,310
Ohio,Hanging Rock village,196,32,76,39,2,28,177
Ohio,Hamler village,745,173,286,46,15,37,557
Ohio,Hamilton,62359,15605,19938,8071,1424,3590,48628
Ohio,Hamersville village,611,113,288,63,0,23,487
Ohio,Hamden village,945,233,332,125,11,62,763
Ohio,Grover Hill village,374,69,150,29,10,35,293
Ohio,Groveport,5604,1174,2388,574,83,320,4539
Ohio,Grove City,37751,7710,16575,3689,505,1623,30102
Ohio,Groesbeck,7026,1720,2554,713,118,315,5420
Ohio,Greenville,13081,3091,4408,1713,224,1317,10753
Ohio,Arcanum village,2161,366,983,198,65,132,1744
Ohio,Archbold village,4304,819,1865,303,52,215,3254
Ohio,Arlington village,1471,288,615,133,26,112,1174
Ohio,Venedocia village,153,42,44,7,5,13,111
Ohio,Vaughnsville,227,19,134,0,0,0,153
Ohio,Midvale village,799,191,299,124,15,13,642
Ohio,Vanlue village,304,38,149,31,3,10,231
Ohio,Vandalia,15168,3210,6708,1425,256,783,12382
Ohio,Van Buren village,391,58,206,21,0,7,292
Ohio,Valleyview village,729,159,255,87,17,46,564
Ohio,Valley View village,1956,456,978,112,19,112,1677
Ohio,Valley Hi village,320,32,124,32,22,4,214
Ohio,Valley City,553,145,318,29,0,7,499
Ohio,Utica village,2224,531,822,234,35,145,1767
Ohio,Urbancrest village,995,361,226,92,10,63,752
Ohio,Urbana,11618,2649,3804,1603,313,948,9317
Ohio,Upper Sandusky,6790,1410,2883,569,128,582,5572
Ohio,Upper Arlington,34465,6433,16585,2407,231,1340,26996
Ohio,University Heights,13331,4610,4907,747,56,488,10808
Ohio,Uniopolis village,193,26,82,14,40,7,169
Ohio,Unionville Center village,268,57,106,24,3,14,204
Ohio,Uniontown,3428,440,1640,312,23,205,2620
Ohio,Union City village,1717,382,489,268,68,136,1343
Ohio,Union,6430,929,3010,576,80,241,4836
Ohio,Vermilion,10462,2172,4929,1034,75,929,9139
Ohio,Uhrichsville,5410,1152,1833,712,111,522,4330
Ohio,Verona village,449,113,163,51,6,10,343
Ohio,Vickery,92,47,20,0,0,15,82
Ohio,Wayne village,1077,272,403,89,27,42,833
Ohio,Waverly village,4323,904,1547,586,63,519,3619
Ohio,Wauseon,7179,1347,2939,880,110,348,5624
Ohio,Waterville,5505,845,2586,518,46,191,4186
Ohio,Waterford,400,59,174,26,0,6,265
Ohio,Washingtonville village,847,222,301,85,44,26,678
Ohio,Washington Court House,14057,2684,5176,2098,336,908,11202
Ohio,Warsaw village,679,124,223,99,10,40,496
Ohio,Warrensville Heights,13336,4820,3217,1712,268,771,10788
Ohio,Warren,40705,12941,10746,5126,896,2824,32533
Ohio,Wapakoneta,9776,2001,4191,862,79,711,7844
Ohio,Walton Hills village,2288,454,1168,244,22,243,2131
Ohio,Walnut Creek,1058,98,483,88,0,94,763
Ohio,Waldo village,377,44,181,50,0,29,304
Ohio,Walbridge village,3070,682,1257,357,92,276,2664
Ohio,Wakeman village,978,183,458,110,12,63,826
Ohio,Waite Hill village,460,58,291,32,4,25,410
Ohio,Wadsworth,21777,3878,9159,2372,277,1269,16955
Ohio,Vinton village,246,21,129,13,9,11,183
Ohio,Vincent,282,0,134,44,0,0,178
Ohio,Vienna Center,651,108,292,88,21,18,527
Ohio,Versailles village,2724,505,1174,227,41,195,2142
Ohio,Twinsburg Heights,932,362,100,107,18,37,624
Ohio,Twinsburg,18820,3820,8633,1252,89,1359,15153
Ohio,Tuscarawas village,1311,223,617,97,17,81,1035
Ohio,Baltimore village,2970,566,1025,280,81,159,2111
Ohio,Baltic village,748,143,307,76,2,80,608
Ohio,Ballville,2901,422,1511,290,0,199,2422
Ohio,Bairdstown village,183,34,52,37,5,10,138
Ohio,Bainbridge village,810,152,307,101,44,79,683
Ohio,Bainbridge,2659,499,1442,237,7,116,2301
Ohio,Bailey Lakes village,543,89,235,59,18,24,425
Ohio,Avon Lake,23052,4049,11182,1831,79,1179,18320
Ohio,Avon,22046,3871,9938,1703,198,1061,16771
Ohio,Austintown,28759,7196,11423,2971,180,2146,23916
Ohio,Austinburg,410,113,145,43,0,92,393
Ohio,Aurora,15663,2841,7691,1281,152,1024,12989
Ohio,Atwater,938,290,396,112,0,9,807
Ohio,Attica village,1033,183,488,123,2,31,827
Ohio,Athens,24220,18430,3235,804,136,417,23022
Ohio,Athalia village,273,58,127,25,4,18,232
Ohio,Ashville village,4144,660,2008,238,52,110,3068
Ohio,Ashtabula,18663,5008,5671,2522,312,1271,14784
Ohio,Ashley village,1186,252,451,198,13,70,984
Ohio,Ashland,20392,5747,7340,2335,247,1270,16939
Ohio,Arlington Heights village,947,260,319,103,17,32,731
Ohio,Bannock,253,72,167,0,4,0,243
Ohio,Barberton,26340,7424,8701,2858,435,2106,21524
Ohio,Barnesville village,3832,544,1641,498,41,392,3116
Ohio,Barnhill village,390,86,140,36,8,26,296
Ohio,Turpin Hills,4741,767,2518,293,13,89,3680
Ohio,Tuppers Plains,593,116,211,89,0,20,436
Ohio,Troy,25411,5694,10253,3057,317,1256,20577
Ohio,Trotwood,24258,7913,6867,2999,468,1744,19991
Ohio,Trinway,194,82,97,15,0,0,194
Ohio,Trimble village,437,66,168,68,13,36,351
Ohio,Trenton,12176,2247,4968,1182,257,350,9004
Ohio,Tremont City village,440,115,164,51,6,21,357
Ohio,Toronto,4980,1256,2040,621,60,308,4285
Ohio,Tontogany village,488,116,238,35,5,12,406
Ohio,Waynesburg village,899,214,324,113,16,69,736
Ohio,Toledo,282275,94533,77918,33671,5399,15087,226608
Ohio,Tippecanoe,63,0,16,0,0,19,35
Ohio,Tipp City,9812,1918,4032,1316,110,498,7874
Ohio,Timberlake village,704,156,332,72,4,48,612
Ohio,Tiltonsville village,1327,276,577,163,6,101,1123
Ohio,Beach City village,920,158,404,121,14,63,760
Ohio,Bay Village,15469,2611,7864,1071,63,661,12270
Ohio,Bay View village,566,125,262,76,9,50,522
Ohio,Batesville village,87,25,36,8,0,4,73
Ohio,Batavia village,1720,581,570,163,37,75,1426
Ohio,Bascom,470,48,244,21,0,32,345
Ohio,Tiro village,203,30,79,21,4,10,144
Ohio,Fayette village,1384,280,551,177,0,49,1057
Ohio,Beckett Ridge,8825,1886,4195,739,25,260,7105
Ohio,North Royalton,30321,7310,13787,2895,203,1554,25749
Ohio,Hubbard,7745,1559,3134,937,100,589,6319
Ohio,Huber Heights,38897,8357,15539,3803,807,1987,30493
Ohio,Huber Ridge,4710,1309,1668,481,41,146,3645
Ohio,Hudson,22389,3673,11892,1231,88,780,17664
Ohio,Hunter,2131,437,1141,311,0,88,1977
Ohio,Hunting Valley village,837,97,499,32,0,28,656
Ohio,Huntsville village,550,99,248,50,3,18,418
Ohio,Huron,7077,1826,2993,558,35,423,5835
Ohio,Iberia,533,100,245,17,13,46,421
Ohio,Independence,7144,1415,3571,322,36,522,5866
Ohio,Irondale village,349,50,152,27,6,23,258
Ohio,Ironton,11172,2507,3816,1357,268,1057,9005
Ohio,Ithaca village,146,34,67,7,4,2,114
Ohio,Jackson,6324,1385,2454,886,171,433,5329
Ohio,Jacksonburg village,45,8,16,7,0,3,34
Ohio,Jackson Center village,1675,241,812,114,5,74,1246
Ohio,Jacksonville village,610,182,215,81,3,20,501
Ohio,Jamestown village,2044,291,864,167,39,136,1497
Ohio,Jefferson village,3199,862,917,539,9,380,2707
Ohio,Jeffersonville village,1233,237,395,209,79,47,967
Ohio,Jenera village,221,27,112,14,0,1,154
Ohio,Jeromesville village,578,128,200,67,20,12,427
Ohio,Jerry City village,472,96,199,66,1,15,377
Ohio,Jerusalem village,153,27,72,14,2,9,124
Ohio,Jewett village,616,101,268,60,13,27,469
Ohio,Hoytville village,301,96,91,28,2,15,232
Ohio,Howland Center,6812,1318,3073,752,63,439,5645
Ohio,Howard,238,6,138,38,0,12,194
Ohio,Hopedale village,1059,176,457,141,18,92,884
Ohio,Napoleon,8851,2230,3162,1091,80,719,7282
Ohio,Nashville village,233,40,92,19,6,15,172
Ohio,Navarre village,1914,405,626,362,4,232,1629
Ohio,Neapolis,388,42,282,0,0,14,338
Ohio,Neffs,963,258,443,91,6,61,859
Ohio,Negley,198,0,159,12,0,9,180
Ohio,Nellie village,109,8,57,6,0,8,79
Ohio,Nelsonville,5184,2213,1202,602,183,270,4470
Ohio,Nettle Lake,408,89,190,11,0,48,338
Ohio,Nevada village,848,127,336,81,8,39,591
Ohio,Neville village,60,21,17,9,5,1,53
Ohio,New Albany,9136,1136,4525,453,7,210,6331
Ohio,Johnstown village,5373,1128,2369,363,50,191,4101
Ohio,New Alexandria village,205,42,88,22,11,17,180
Ohio,Hiram village,1279,936,175,64,8,15,1198
Ohio,Hockingport,165,52,61,0,0,18,131
Ohio,Holgate village,1193,189,539,109,14,95,946
Ohio,Holiday City village,37,4,18,1,0,5,28
Ohio,Holiday Lakes,741,122,404,35,0,48,609
Ohio,Holiday Valley,1386,218,677,173,18,111,1197
Ohio,Holland village,1744,336,657,194,3,225,1415
Ohio,Hollansburg village,311,58,112,34,2,18,224
Ohio,Holloway village,293,46,116,50,25,4,241
Ohio,Holmesville village,481,97,189,71,0,30,387
Ohio,Homeworth,304,74,136,17,10,35,272
Ohio,Hooven,680,230,222,42,9,58,561
Ohio,Newark,47829,11887,16415,6070,822,2993,38187
Ohio,Junction City village,834,185,271,90,16,33,595
Ohio,Kalida village,1389,246,787,39,9,117,1198
Ohio,Kanauga,176,45,50,43,0,0,138
Ohio,Broughton village,106,13,31,23,2,8,77
Ohio,Brownsville,135,0,115,20,0,0,135
Ohio,Brunswick,34512,8493,14478,3266,305,1715,28257
Ohio,Bryan,8493,1872,3061,1142,183,597,6855
Ohio,Buchtel village,567,148,268,49,7,28,500
Ohio,Buckeye Lake village,2724,644,938,425,18,121,2146
Ohio,Buckland village,304,57,119,22,2,19,219
Ohio,Bucyrus,12045,2615,4547,1515,167,1080,9924
Ohio,Buffalo,287,55,191,10,0,31,287
Ohio,Buford,275,47,158,10,0,39,254
Ohio,Burbank village,227,52,96,27,5,5,185
Ohio,Burgoon village,161,33,52,25,8,7,125
Ohio,Brookville,6077,982,2659,643,74,660,5018
Ohio,Burkettsville village,237,23,140,7,0,14,184
Ohio,Burton village,1226,305,441,120,15,147,1028
Ohio,Butler village,999,215,381,148,14,49,807
Ohio,Butlerville village,99,8,34,24,0,7,73
Ohio,Byesville village,2248,561,871,242,63,182,1919
Ohio,Cadiz village,3258,697,1331,416,34,181,2659
Ohio,Cairo village,410,58,187,62,0,33,340
Ohio,Calcutta,3516,646,1627,245,38,401,2957
Ohio,Caldwell village,1747,300,695,217,49,212,1473
Ohio,Caledonia village,617,121,314,78,6,29,548
Ohio,Cambridge,10511,2157,3357,1589,386,808,8297
Ohio,Camden village,2229,477,807,324,38,151,1797
Ohio,Wright-Patterson AFB,2621,1068,891,76,0,20,2055
Ohio,Burlington,2243,468,674,370,29,322,1863
Ohio,Mutual village,137,5,75,5,0,8,93
Ohio,Brookside village,654,136,291,108,3,49,587
Ohio,Brooklyn Heights village,1526,301,746,135,3,71,1256
Ohio,Kansas,51,25,26,0,0,0,51
Ohio,Kelleys Island village,138,24,81,17,0,16,138
Ohio,Kent,29563,16097,6375,2155,386,842,25855
Ohio,Kenton,7849,1805,2516,1152,136,607,6216
Ohio,Kenwood,6906,1341,2838,681,68,590,5518
Ohio,Kettering,55944,13687,21587,6871,752,3158,46055
Ohio,Kettlersville village,184,24,84,8,0,8,124
Ohio,Kidron,1032,165,507,10,0,29,711
Ohio,Kilbourne,159,42,72,0,0,22,136
Ohio,Killbuck village,903,216,304,125,9,68,722
Ohio,Kimbolton,68,0,18,11,0,39,68
Ohio,Kings Mills,1313,246,706,88,13,8,1061
Ohio,Brook Park,18956,4805,7300,2060,236,1406,15807
Ohio,Kingston village,1085,252,454,149,24,32,911
Ohio,Kipton village,245,41,116,22,2,11,192
Ohio,Kirby village,76,24,27,5,0,12,68
Ohio,Kirkersville village,590,114,241,91,9,37,492
Ohio,Kirtland,6836,1449,3318,472,91,382,5712
Ohio,Kirtland Hills village,686,110,407,24,3,25,569
Ohio,Kunkle,129,25,53,51,0,0,129
Ohio,La Croft,1138,294,358,185,10,66,913
Ohio,Lafayette village,386,83,144,49,12,39,327
Ohio,Lafayette,382,31,143,90,26,6,296
Ohio,Broadview Heights,19268,4296,8622,1578,92,1044,15632
Ohio,Brookfield Center,1274,341,520,147,1,70,1079
Ohio,Brooklyn,11002,3383,3868,1257,110,825,9443
Ohio,Kinsman Center,440,55,271,10,0,36,372
Ohio,Wren village,200,54,112,7,2,9,184
Ohio,Murray City village,369,80,164,37,0,42,323
Ohio,Mulberry,3572,666,1543,465,23,379,3076
Ohio,Martinsburg village,260,73,88,39,1,10,211
Ohio,Marshallville village,702,135,323,78,1,37,574
Ohio,Marseilles village,124,23,47,23,0,5,98
Ohio,Marne,698,169,355,42,0,27,593
Ohio,Marlboro,278,69,110,35,0,0,214
Ohio,Marion,36701,10098,11761,4958,1024,2185,30026
Ohio,Marietta,13996,4310,4606,1654,230,1162,11962
Ohio,Mariemont village,3397,643,1478,203,54,168,2546
Ohio,Marengo village,281,60,81,44,14,14,213
Ohio,Marblehead village,933,122,554,82,9,86,853
Ohio,Marble Cliff village,640,171,310,36,2,29,548
Ohio,Maplewood Park,372,105,140,22,37,47,351
Ohio,Maple Ridge,893,187,448,81,0,43,759
Ohio,Maple Heights,22792,8404,5860,2484,527,1441,18716
Ohio,Mantua village,1248,398,440,145,39,57,1079
Ohio,Mansfield,46998,13966,13995,6272,1484,3109,38826
Ohio,Manchester village,2129,557,663,265,101,156,1742
Ohio,Malvern village,1169,286,438,147,8,89,968
Ohio,Malta village,802,103,355,59,32,19,568
Ohio,Malinta village,318,107,100,31,11,15,264
Ohio,Maineville village,1003,200,420,88,12,72,792
Ohio,Magnolia village,989,176,463,67,7,45,758
Ohio,Magnetic Springs village,260,62,92,25,6,13,198
Ohio,Madison village,3183,654,1426,273,0,184,2537
Ohio,Madeira,8858,1594,4295,614,59,439,7001
Ohio,Martins Ferry,6829,1609,2643,755,201,462,5670
Ohio,Martinsville village,406,99,127,37,11,20,294
Ohio,Marysville,22732,5241,8618,2851,408,973,18091
Ohio,Mason,31654,5715,14832,2185,278,1342,24352
Ohio,Midway village,196,16,86,18,8,23,151
Ohio,Mifflin village,144,37,45,27,7,8,124
Ohio,Middletown,48563,12061,16293,6551,1149,2791,38845
Ohio,Middleport village,2111,416,692,341,86,220,1755
Ohio,Middle Point village,534,81,265,49,9,27,431
Ohio,Middlefield village,2690,616,1048,328,17,265,2274
Ohio,Middleburg Heights,15790,3575,6818,1683,104,1148,13328
Ohio,Miamiville,152,39,51,6,17,0,113
Ohio,Miamitown,1315,437,342,126,53,38,996
Ohio,Miamisburg,20119,3498,8955,2226,237,1533,16449
Ohio,Miami Heights,5154,945,2470,254,37,242,3948
Ohio,Meyers Lake village,622,195,246,123,1,35,600
Ohio,Macksburg village,150,42,51,17,1,19,130
Ohio,Metamora village,673,151,305,48,3,24,531
Ohio,Mentor,46952,9552,22769,4107,237,2798,39463
Ohio,Mendon village,557,139,196,76,0,37,448
Ohio,Melrose village,127,28,60,12,0,9,109
Ohio,Melmore,88,0,17,20,11,0,48
Ohio,Medina,26529,5796,10607,2460,291,1348,20502
Ohio,Mechanicsburg village,1875,392,586,291,49,77,1395
Ohio,Mayfield Heights,18918,5250,6467,2040,143,1716,15616
Ohio,Mayfield village,3421,779,1609,193,48,288,2917
Ohio,Maumee,14083,3151,6002,1525,150,693,11521
Ohio,Matamoras village,867,221,363,82,7,64,737
Ohio,Masury,2096,584,808,254,9,117,1772
Ohio,Massillon,32215,8425,11600,4339,299,1752,26415
Ohio,Mentor-on-the-Lake,7432,1879,2942,1053,110,413,6397
Ohio,McKinley Heights,748,112,335,80,34,19,580
Ohio,Mack,11213,2092,6099,521,20,389,9121
Ohio,McGuffey village,451,149,139,57,5,20,370
Ohio,Monroeville village,1382,196,552,150,52,76,1026
Ohio,Montezuma village,208,25,97,38,0,12,172
Ohio,Montgomery,10363,1410,5583,414,37,658,8102
Ohio,Montpelier village,4026,955,1546,496,43,209,3249
Ohio,Montrose-Ghent,4520,454,2508,460,11,191,3624
Ohio,Moraine,6332,1076,2600,718,204,351,4949
Ohio,Moreland Hills village,3305,549,1816,253,11,109,2738
Ohio,Morgandale,809,285,195,102,0,122,704
Ohio,Morral village,436,73,193,61,2,26,355
Ohio,Morristown village,288,75,117,43,0,22,257
Ohio,Morrow village,1581,364,637,133,19,60,1213
Ohio,Moscow village,124,35,72,12,0,2,121
Ohio,Monroe,13666,2431,5793,1011,170,846,10251
Ohio,Mount Blanchard village,486,88,178,59,19,12,356
Ohio,Mount Cory village,223,31,91,18,6,11,157
Ohio,Mount Eaton village,215,71,79,11,0,9,170
Ohio,Mount Gilead village,3624,849,1315,362,80,385,2991
Ohio,Mount Healthy,6071,1716,1574,877,33,578,4778
Ohio,Mount Healthy Heights,3276,771,932,341,70,156,2270
Ohio,Mount Orab village,4018,885,1473,349,32,261,3000
Ohio,Mount Pleasant village,534,100,241,65,8,31,445
Ohio,Mount Repose,4393,887,1903,334,37,216,3377
Ohio,Mount Sterling village,1816,414,628,276,23,74,1415
Ohio,Mount Vernon,16882,4595,5902,1870,373,1159,13899
Ohio,Mount Victory village,561,80,277,47,18,22,444
Ohio,Mowrystown village,293,69,96,42,14,20,241
Ohio,Mount Carmel,4706,1177,1801,560,43,232,3813
Ohio,Munroe Falls,5025,959,2667,303,13,289,4231
Ohio,Monfort Heights,12454,2917,6119,560,78,705,10379
Ohio,Mitiwanga,195,53,56,39,25,10,183
Ohio,Macedonia,11469,2140,5978,634,90,773,9615
Ohio,McDonald village,3196,639,1331,377,24,195,2566
Ohio,McDermott,739,277,185,0,17,70,549
Ohio,McCutchenville,349,126,91,69,0,9,295
Ohio,McConnelsville village,1871,409,613,300,20,237,1579
Ohio,McComb village,1645,320,701,170,25,65,1281
Ohio,McClure village,656,115,304,51,5,39,514
Ohio,Milan village,1317,362,498,137,5,102,1104
Ohio,Milford,6767,1655,2350,696,212,646,5559
Ohio,Milford Center village,821,195,308,92,14,31,640
Ohio,Millbury village,1325,257,595,174,7,60,1093
Ohio,Milledgeville village,178,48,45,20,0,12,125
Ohio,Mogadore village,3792,1024,1501,279,16,220,3040
Ohio,Miller City village,103,30,48,4,0,14,96
Ohio,Millersport village,1338,306,533,147,12,44,1042
Ohio,Millfield,295,28,127,66,47,9,277
Ohio,Millville village,782,123,352,94,21,32,622
Ohio,Milton Center village,208,40,64,34,10,15,163
Ohio,Miltonsburg village,60,14,17,21,0,2,54
Ohio,Mineral City village,679,159,325,96,6,29,615
Ohio,Mineral Ridge,3698,923,1392,477,8,180,2980
Ohio,Minerva village,3829,704,1612,404,81,332,3133
Ohio,Minerva Park village,1500,274,694,115,4,46,1133
Ohio,Minford,676,187,267,70,0,96,620
Ohio,Mingo Junction village,3212,827,1334,363,31,211,2766
Ohio,Minster village,2905,501,1418,78,6,247,2250
Ohio,Millersburg village,3116,810,1032,577,38,157,2614
Ohio,Worthington,13867,2286,6543,1256,96,786,10967
Ohio,Wooster,26551,7751,9782,2774,294,1336,21937
Ohio,Woodville village,2166,388,852,257,13,155,1665
Ohio,Centerburg village,1844,408,606,218,66,145,1443
Ohio,Centerville village,69,9,49,1,0,6,65
Ohio,Centerville,23952,4726,10814,2142,282,1902,19866
Ohio,Chagrin Falls village,4083,647,1686,482,64,403,3282
Ohio,Champion Heights,6494,1056,3123,616,44,465,5304
Ohio,Chardon,5170,1275,2032,598,111,214,4230
Ohio,Chatfield village,260,36,156,19,2,4,217
Ohio,Chauncey village,1220,312,431,149,30,68,990
Ohio,Cherry Fork village,221,36,110,14,1,7,168
Ohio,Cherry Grove,4624,1031,2215,82,37,158,3523
Ohio,Chesapeake village,891,235,325,83,10,50,703
Ohio,Cheshire village,226,35,111,18,7,10,181
Ohio,Chesterhill village,382,74,169,20,2,28,293
Ohio,Wyoming,8407,1648,4105,370,94,360,6577
Ohio,Xenia,26002,6209,9046,3037,356,1734,20382
Ohio,Yankee Lake village,90,13,57,4,0,2,76
Ohio,Yellow Springs village,3683,1013,1396,529,47,168,3153
Ohio,Yorkshire village,71,19,28,6,0,7,60
Ohio,Yorkville village,1084,277,450,113,21,83,944
Ohio,Youngstown,65573,23313,14559,8640,1738,4739,52989
Ohio,Zaleski village,373,83,200,9,3,31,326
Ohio,Zanesfield village,227,43,93,29,1,9,175
Ohio,Zanesville,25470,6602,7349,3720,632,1736,20039
Ohio,Zoar village,199,62,106,10,0,14,192
Ohio,New Athens village,223,33,95,19,0,39,186
Ohio,Celina,10373,2170,4187,1170,219,741,8487
Ohio,Celeryville,380,36,102,72,0,21,231
Ohio,Cedarville village,4004,2941,633,121,0,110,3805
Ohio,Cecil village,166,56,68,21,1,3,149
Ohio,Bedford Heights,10665,3182,3026,1758,432,731,9129
Ohio,Bedford,12868,3558,4205,1483,322,851,10419
Ohio,North Zanesville,3133,468,1638,310,0,160,2576
Ohio,Beaverdam village,468,89,201,59,8,12,369
Ohio,Beavercreek,45999,10421,22897,3026,324,1922,38590
Ohio,Beaver village,531,103,154,57,19,45,378
Ohio,Beallsville village,394,100,155,44,5,28,332
Ohio,Beachwood,11801,1959,5671,924,48,1310,9912
Ohio,Campbell,8075,2486,2495,969,149,599,6698
Ohio,Camp Dennison,252,49,98,71,0,29,247
Ohio,Canal Fulton,5483,1220,2358,577,34,491,4680
Ohio,Canal Lewisville,246,29,117,23,11,32,212
Ohio,New Baltimore,656,119,282,41,0,29,471
Ohio,Canal Winchester,7621,1325,3799,614,9,426,6173
Ohio,Canfield,7424,1349,4129,493,33,410,6414
Ohio,Canton,72463,22859,18698,9684,1396,4121,56758
Ohio,Carbon Hill,265,110,65,10,0,55,240
Ohio,Cardington village,2352,500,749,323,48,113,1733
Ohio,Carey village,3513,672,1421,361,101,228,2783
Ohio,Carlisle village,5024,964,2421,386,44,328,4143
Ohio,Carroll village,411,94,190,41,13,18,356
Ohio,Carrollton village,3020,751,1251,339,59,182,2582
Ohio,Casstown village,275,59,105,41,2,11,218
Ohio,Castalia village,808,181,340,75,10,49,655
Ohio,Castine village,152,37,71,11,2,6,127
Ohio,Catawba village,371,81,114,52,4,13,264
Ohio,Candlewood Lake,1155,146,678,92,10,17,943
Ohio,New Bavaria village,107,16,54,7,0,2,79
Ohio,New Bloomington village,455,82,144,79,23,19,347
Ohio,New Boston village,2125,483,543,437,27,243,1733
Ohio,Newtown village,2668,582,1115,279,39,109,2124
Ohio,New Vienna village,1424,232,491,183,10,69,985
Ohio,New Washington village,991,145,456,61,13,55,730
Ohio,New Waterford village,1270,239,560,111,13,86,1009
Ohio,New Weston village,115,40,27,6,0,14,87
Ohio,Ney village,313,62,130,29,1,18,240
Ohio,Niles,18886,4677,6137,2763,340,1394,15311
Ohio,North Baltimore village,3460,913,1207,355,44,216,2735
Ohio,North Bend village,790,125,450,121,4,27,727
Ohio,Northbrook,10545,2910,3394,1064,247,388,8003
Ohio,North Canton,17431,4432,7037,1945,111,1361,14886
Ohio,North College Hill,9361,2883,2346,1294,423,627,7573
Ohio,Newtonsville village,398,91,111,59,15,21,297
Ohio,North Fairfield village,605,91,270,76,9,27,473
Ohio,Northgate,7677,1958,3149,765,107,414,6393
Ohio,North Hampton village,398,67,163,34,7,22,293
Ohio,North Kingsville village,2871,565,1361,315,22,135,2398
Ohio,North Lawrence,195,24,89,27,0,30,170
Ohio,North Lewisburg village,1522,302,548,224,12,75,1161
Ohio,North Madison,8961,1799,3667,849,73,324,6712
Ohio,North Olmsted,32248,7781,14211,2956,341,1869,27158
Ohio,North Perry village,776,154,412,76,8,44,694
Ohio,North Randall village,998,352,220,176,60,101,909
Ohio,Northridge,7161,1106,3540,873,70,411,6000
Ohio,North Ridgeville,31240,5575,14805,2659,452,1439,24930
Ohio,North Robinson village,241,28,139,31,4,13,215
Ohio,Northfield village,3649,1137,1282,529,23,227,3198
Ohio,Beechwood Trails,2889,417,1888,126,14,80,2525
Ohio,Newton Falls village,4707,1199,1794,490,118,376,3977
Ohio,New Riegel village,258,50,98,45,0,21,214
Ohio,New Bremen village,3127,554,1611,200,0,106,2471
Ohio,Newburgh Heights village,2012,653,523,294,36,106,1612
Ohio,New Burlington,4881,1300,2060,248,95,181,3884
Ohio,New California,1761,166,900,55,0,53,1174
Ohio,New Carlisle,5727,1116,2116,747,78,405,4462
Ohio,Newcomerstown village,3748,596,1655,503,56,197,3007
Ohio,New Concord village,2670,1516,526,147,27,176,2392
Ohio,New Franklin,14258,2902,7200,1180,89,716,12087
Ohio,New Hampshire,202,13,104,21,0,4,142
Ohio,New Haven CDP (Hamilton County),523,144,239,49,0,25,457
Ohio,New Haven CDP (Huron County),394,67,214,46,0,28,355
Ohio,New Holland village,732,121,296,106,6,36,565
Ohio,New Straitsville village,757,133,327,83,39,40,622
Ohio,New Knoxville village,927,127,457,57,6,43,690
Ohio,New Lexington village,4795,1168,1789,405,85,283,3730
Ohio,New London village,2606,529,1016,284,24,96,1949
Ohio,New Madison village,929,200,369,85,6,50,710
Ohio,New Marshfield,386,94,83,104,0,13,294
Ohio,New Miami village,2169,564,679,271,115,107,1736
Ohio,New Middletown village,1666,403,739,172,16,129,1459
Ohio,New Paris village,1593,302,486,225,34,117,1164
Ohio,New Philadelphia,17397,4011,6847,1891,325,1077,14151
Ohio,New Pittsburg,285,62,115,29,0,66,272
Ohio,Newport CDP (Shelby County),152,44,66,12,0,7,129
Ohio,Newport CDP (Washington County),782,194,332,29,41,65,661
Ohio,New Richmond village,2624,516,933,357,32,134,1972
Ohio,New Lebanon village,4310,1144,1360,631,29,253,3417
Ohio,Bellaire village,4215,1049,1293,618,193,305,3458
Ohio,Bellbrook,7063,1250,3364,629,92,376,5711
Ohio,Belle Center village,807,149,360,54,9,75,647
Ohio,Wheelersburg,6181,1241,2841,663,39,424,5208
Ohio,Wharton village,363,70,165,26,3,19,283
Ohio,Wetherington,1305,244,856,38,10,63,1211
Ohio,West Unity village,1775,363,718,196,38,70,1385
Ohio,West Union village,3180,639,1092,518,75,311,2635
Ohio,West Salem village,1653,408,628,185,30,78,1329
Ohio,West Rushville village,217,34,89,19,7,6,155
Ohio,West Portsmouth,2978,540,1208,431,52,174,2405
Ohio,Weston village,1688,404,627,219,31,63,1344
Ohio,Westminster,340,66,132,54,0,12,264
Ohio,West Milton village,4679,1061,1943,623,18,332,3977
Ohio,West Millgrove village,140,35,38,20,3,17,113
Ohio,Whitehall,18521,5355,5227,2302,398,628,13910
Ohio,West Mansfield village,754,96,377,58,13,42,586
Ohio,West Liberty village,1699,327,732,150,8,185,1402
Ohio,West Leipsic village,167,34,72,11,0,14,131
Ohio,Westlake,32469,6668,14974,2962,244,2233,27081
Ohio,West Lafayette village,2312,549,837,292,19,206,1903
Ohio,West Jefferson village,4235,814,1758,547,47,270,3436
Ohio,West Hill,1898,500,545,231,47,259,1582
Ohio,Westfield Center village,1159,216,657,61,3,90,1027
Ohio,West Farmington village,550,110,211,35,11,15,382
Ohio,Westerville,37540,8379,16953,2913,333,1938,30516
Ohio,West Elkton village,243,41,112,14,4,18,189
Ohio,West Carrollton,13051,3393,4469,1924,165,766,10717
Ohio,West Alexandria village,1726,456,599,209,37,75,1376
Ohio,West Manchester village,591,145,215,64,12,42,478
Ohio,Wellsville village,3461,847,888,389,105,203,2432
Ohio,Whitehouse village,4219,824,1918,322,12,162,3238
Ohio,Whites Landing,342,68,221,0,0,9,298
Ohio,Woodstock village,326,75,108,40,7,8,238
Ohio,Woodsfield village,2412,414,864,364,93,272,2007
Ohio,Woodmere village,925,224,309,115,4,55,707
Ohio,Woodlawn village,3284,1162,897,362,97,199,2717
Ohio,Wolfhurst,1211,291,402,140,9,189,1031
Ohio,Withamsville,7116,1942,2954,797,133,282,6108
Ohio,Wintersville village,4113,923,1736,492,20,296,3467
Ohio,Winesburg,256,26,156,8,0,7,197
Ohio,Windham village,1852,633,482,236,52,44,1447
Ohio,Winchester village,1120,251,343,110,25,72,801
Ohio,Wilson village,130,20,68,6,1,6,101
Ohio,Wilmot village,295,37,160,20,2,13,232
Ohio,White Oak,18664,4202,7983,1713,314,975,15187
Ohio,Wilmington,12428,3352,4264,1389,324,881,10210
Ohio,Willowick,14051,3466,5570,1349,88,1022,11495
Ohio,Willoughby Hills,9428,2487,4100,959,173,454,8173
Ohio,Willoughby,22433,5984,8603,2644,209,1665,19105
Ohio,Williston,645,223,275,15,0,43,556
Ohio,Williamsport village,1225,272,416,106,21,54,869
Ohio,Williamsdale,691,151,296,76,0,9,532
Ohio,Williamsburg village,2536,687,898,242,40,84,1951
Ohio,Willard,6135,1507,2196,555,145,327,4730
Ohio,Wilkesville village,182,44,57,34,0,12,147
Ohio,Wilberforce,2278,1888,183,48,0,18,2137
Ohio,Wightmans Grove,0,0,0,0,0,0,0
Ohio,Wickliffe,12629,2906,5117,1431,125,971,10550
Ohio,Willshire village,399,83,175,52,7,21,338
Ohio,North Star village,272,58,132,8,0,17,215
Ohio,Wellston,5569,1180,2039,764,101,550,4634
Ohio,Waynesville village,2924,632,1112,299,45,239,2327
Ohio,Blanchester village,4244,1005,1537,462,83,273,3360
Ohio,Blakeslee village,66,17,33,1,0,8,59
Ohio,Bladensburg,103,32,46,0,0,7,85
Ohio,Blacklick Estates,8960,2430,2800,1099,190,389,6908
Ohio,Bexley,13442,3720,5558,828,70,339,10515
Ohio,Beverly village,1139,218,428,138,15,132,931
Ohio,Beulah Beach,71,0,52,0,0,19,71
Ohio,Bettsville village,642,95,264,81,6,46,492
Ohio,Bethesda village,1382,288,507,185,25,84,1089
Ohio,Bethel village,2756,726,983,326,43,175,2253
Ohio,Berlin Heights village,531,124,258,43,2,45,472
Ohio,Berlin,1445,451,640,51,0,30,1172
Ohio,Bloomdale village,676,138,295,73,11,27,544
Ohio,Berkey village,338,80,157,30,6,7,280
Ohio,Berea,19001,6467,6342,2351,148,957,16265
Ohio,Bentonville,198,24,132,13,0,14,183
Ohio,Benton Ridge village,361,64,165,50,12,20,311
Ohio,Bentleyville village,938,155,540,35,0,19,749
Ohio,Belpre,6448,1215,2683,1034,65,539,5536
Ohio,Beloit village,1039,241,413,147,20,92,913
Ohio,Belmore village,119,26,59,3,0,3,91
Ohio,Belmont village,521,134,270,34,3,35,476
Ohio,Bellville village,1841,297,823,200,27,137,1484
Ohio,Bellevue,8109,1837,3100,864,262,583,6646
Ohio,Belle Valley village,220,57,81,32,7,21,198
Ohio,Bellefontaine,13279,3094,4357,1653,564,680,10348
Ohio,Bergholz village,765,137,305,68,15,44,569
Ohio,Wellington village,4981,1210,1803,445,124,375,3957
Ohio,Bloomingburg village,1079,226,415,114,9,44,808
Ohio,Bloomville village,909,215,336,96,13,83,743
Ohio,Waynesfield village,739,166,331,69,9,46,621
Ohio,Brimfield,3614,1038,1422,232,39,147,2878
Ohio,Brilliant,1690,339,666,211,55,117,1388
Ohio,Bridgetown,13628,3263,5704,1128,47,1136,11278
Ohio,Bridgeport village,1799,553,699,202,27,93,1574
Ohio,Brice village,110,29,33,15,5,8,90
Ohio,Brewster village,2308,600,873,261,38,185,1957
Ohio,Bremen village,1669,361,649,142,49,83,1284
Ohio,Brecon,425,93,186,35,15,14,343
Ohio,Brecksville,13516,2949,6606,1124,96,509,11284
Ohio,Bratenahl village,1153,200,618,176,10,73,1077
Ohio,Brady Lake village,458,136,184,43,7,19,389
Ohio,Bloomingdale village,189,21,86,15,3,19,144
Ohio,Bradner village,957,173,403,112,32,55,775
Ohio,Bowling Green,31506,17186,7711,1939,332,933,28101
Ohio,Bowersville village,279,45,105,33,1,12,196
Ohio,Bowerston village,387,82,155,36,1,48,322
Ohio,Bourneville,253,0,143,0,0,0,143
Ohio,Botkins village,1320,209,587,97,26,53,972
Ohio,Boston Heights village,1252,288,675,68,0,34,1065
Ohio,Bolivar village,1030,198,400,133,11,124,866
Ohio,Bolindale,2003,389,935,167,46,191,1728
Ohio,Boardman,34794,8846,14112,3890,444,2280,29572
Ohio,Bluffton village,4210,984,1887,285,22,315,3493
Ohio,Blue Jay,1182,205,710,31,0,26,972
Ohio,Blue Ash,12102,2304,5901,1083,66,606,9960
Ohio,Bradford village,1716,283,811,141,8,105,1348
Ohio,Norton,12054,2075,5991,898,121,660,9745
Ohio,Van Wert,10769,2109,4174,1401,205,729,8618
Ohio,Norwich village,96,27,34,10,4,13,88
Ohio,Sulphur Springs,102,22,72,8,0,0,102
Ohio,Sugar Grove village,509,149,160,72,10,28,419
Ohio,Sugarcreek village,2235,327,1117,181,10,178,1813
Ohio,Sugar Bush Knolls village,172,40,91,9,1,18,159
Ohio,Stryker village,1195,205,480,155,15,36,891
Ohio,Struthers,10515,2767,3737,1283,233,814,8834
Ohio,Summerfield village,213,43,85,44,1,19,192
Ohio,Strongsville,44649,8305,22728,3380,219,2468,37100
Ohio,Stratton village,318,42,116,54,8,17,237
Ohio,Strasburg village,3132,537,1589,326,15,183,2650
Ohio,Stow,34765,7476,15716,3207,289,1745,28433
Ohio,Stoutsville village,467,94,239,37,6,19,395
Ohio,Stony Ridge,321,98,136,21,14,17,286
Ohio,Stony Prairie,1328,325,629,78,0,119,1151
Ohio,Streetsboro,16222,3822,6944,1550,261,781,13358
Ohio,Summerside,5167,958,2025,652,67,164,3866
Ohio,Summitville village,110,8,71,5,0,1,85
Ohio,Sunbury village,4771,694,2287,373,0,156,3510
Ohio,Tiffin,17793,5734,6107,1707,264,990,14802
Ohio,Thurston village,539,75,236,75,0,31,417
Ohio,Thornville village,1244,285,513,84,7,66,955
Ohio,Thornport,1058,81,622,158,53,56,970
Ohio,The Village of Indian Hill,5793,669,3568,157,27,122,4543
Ohio,The Plains,3230,574,1061,445,18,210,2308
Ohio,Terrace Park village,2330,355,1180,99,2,41,1677
Ohio,Tedrow,227,91,88,12,4,14,209
Ohio,Taylor Creek,3451,764,1664,289,62,57,2836
Ohio,Tarlton village,276,69,113,28,7,20,237
Ohio,Tallmadge,17459,4019,7858,1404,93,1065,14439
Ohio,Syracuse village,719,123,380,42,21,41,607
Ohio,Sylvania,18943,4462,8502,1641,108,1047,15760
Ohio,Sycamore village,980,188,429,91,3,49,760
Ohio,Swanton village,4040,791,1807,270,68,332,3268
Ohio,Stone Creek village,157,34,50,26,1,10,121
Ohio,Stockport village,529,102,241,51,5,23,422
Ohio,Stockdale,12,0,0,12,0,0,12
Ohio,Stewart,298,68,100,45,28,9,250
Ohio,South Charleston village,1818,360,676,226,26,113,1401
Ohio,South Canal,1190,225,742,29,7,71,1074
Ohio,South Bloomfield village,2225,463,780,319,32,108,1702
Ohio,South Amherst village,1807,482,874,182,1,65,1604
Ohio,Somerville village,269,65,110,26,3,17,221
Ohio,Somerset village,1564,323,495,155,36,132,1141
Ohio,Solon,23114,3860,11647,1323,141,1084,18055
Ohio,Smithville village,1157,258,552,71,2,64,947
Ohio,Smithfield village,852,164,359,115,0,46,684
Ohio,Skyline Acres,1829,594,411,241,62,82,1390
Ohio,Lockland village,3426,1052,827,632,62,146,2719
Ohio,Lodi village,2780,672,1056,417,36,171,2352
Ohio,Logan,7292,1633,2509,1019,172,562,5895
Ohio,Logan Elm Village,1086,180,487,154,1,116,938
Ohio,London,9961,2499,3297,1293,258,501,7848
Ohio,South Euclid,21971,7462,7469,2121,295,1086,18433
Ohio,Lockington village,135,23,64,18,0,10,115
Ohio,South Lebanon village,4992,1050,2274,421,52,94,3891
Ohio,South Russell village,3838,463,2052,218,10,189,2932
Ohio,Steubenville,18381,5867,5956,2154,242,1287,15506
Ohio,Sterling,593,164,213,80,5,36,498
Ohio,Stafford village,119,17,62,4,0,11,94
Ohio,Spring Valley village,508,102,245,42,3,45,437
Ohio,Springfield,60007,16865,17691,7604,1395,4200,47755
Ohio,Springdale,11194,2810,3824,866,73,712,8285
Ohio,Springboro,17585,2788,8877,1164,75,404,13308
Ohio,Spencerville village,2090,393,811,244,15,120,1583
Ohio,Spencer village,686,136,337,61,5,32,571
Ohio,Sparta village,166,32,61,21,0,5,119
Ohio,South Zanesville village,2233,539,642,391,29,123,1724
Ohio,South Webster village,666,115,333,64,2,33,547
Ohio,South Vienna village,387,115,169,47,2,20,353
Ohio,South Solon village,317,74,147,25,9,14,269
Ohio,South Salem village,256,40,108,32,1,13,194
Ohio,South Point village,3671,771,1640,341,23,241,3016
Ohio,Lockbourne village,219,52,79,32,2,11,176
Ohio,Little Hocking,267,152,75,11,0,29,267
Ohio,Lithopolis village,1446,214,694,105,23,46,1082
Ohio,Rittman,6520,1089,3034,579,66,387,5155
Ohio,Riverlea village,636,72,278,72,4,31,457
Ohio,Riverside,25075,6006,9225,2887,381,1443,19942
Ohio,Roaming Shores village,1678,197,843,198,0,62,1300
Ohio,Robertsville,391,51,166,70,0,10,297
Ohio,Rochester village,179,31,98,9,0,14,152
Ohio,Rockbridge,218,55,28,61,0,28,172
Ohio,Rock Creek village,393,71,189,56,7,21,344
Ohio,Rockford village,1199,217,497,100,18,82,914
Ohio,Rocky Fork Point,656,96,326,60,42,40,564
Ohio,Rocky Ridge village,485,97,171,42,16,18,344
Ohio,Norwalk,16892,3882,6081,2126,242,893,13224
Ohio,Lafferty,370,139,136,72,0,0,347
Ohio,LaGrange village,2265,494,967,214,39,145,1859
Ohio,Lake Buckhorn,900,111,566,40,0,10,727
Ohio,Risingsun village,583,115,261,67,5,15,463
Ohio,Lake Darby,4481,548,2187,395,57,74,3261
Ohio,Ripley village,1980,367,793,250,61,131,1602
Ohio,Ridgeway village,295,46,136,38,0,7,227
Ohio,Raymond,83,7,34,8,0,6,55
Ohio,Reading,10349,3082,3560,1002,189,662,8495
Ohio,Reminderville village,3743,681,1624,425,8,80,2818
Ohio,Remington,114,0,66,32,0,16,114
Ohio,Rendville village,32,7,13,1,1,2,24
Ohio,Reno,1156,257,352,123,0,201,933
Ohio,Republic village,611,132,241,72,2,50,497
Ohio,Reynoldsburg,36899,10140,13303,4147,503,1418,29511
Ohio,Richfield village,3665,641,1902,289,16,224,3072
Ohio,Richmond village,364,50,200,62,7,14,333
Ohio,Richmond Dale,312,70,137,39,13,0,259
Ohio,Richmond Heights,10485,3537,3988,921,158,709,9313
Ohio,Richville,3329,576,1648,332,7,189,2752
Ohio,Richwood village,2268,493,804,224,22,133,1676
Ohio,Ridgeville Corners,354,26,198,24,0,26,274
Ohio,Rio Grande village,977,550,131,54,24,17,776
Ohio,Lorain,63778,18369,20186,6534,1634,3604,50327
Ohio,Lake Lakengren,3379,485,1688,235,19,132,2559
Ohio,Lake Lorelei,1095,157,583,115,0,29,884
Ohio,Leesville village,156,16,88,13,4,12,133
Ohio,Leetonia village,1925,418,690,296,57,125,1586
Ohio,Leipsic village,2089,381,844,221,12,174,1632
Ohio,Lewisburg village,1605,300,606,230,18,83,1237
Ohio,Lewistown,95,9,51,25,0,0,85
Ohio,Lewisville village,222,50,91,18,5,22,186
Ohio,Lexington village,5712,1066,2275,548,205,239,4333
Ohio,Liberty Center village,1125,194,457,125,13,90,879
Ohio,Lima,38232,13146,8852,4906,717,1875,29496
Ohio,Limaville village,139,22,72,13,0,15,122
Ohio,Lincoln Heights village,3365,1417,595,427,156,219,2814
Ohio,Lincoln Village,9417,2574,3020,1146,267,557,7564
Ohio,Lindsey village,557,92,300,28,0,30,450
Ohio,Linndale village,159,30,44,18,4,9,105
Ohio,Lisbon village,2738,711,932,380,42,201,2266
Ohio,Leesburg village,1377,314,512,200,67,44,1137
Ohio,Lakeline village,271,49,120,24,5,13,211
Ohio,Lebanon,20450,4312,8079,2032,255,822,15500
Ohio,Laurelville village,506,115,141,85,22,49,412
Ohio,Lake Milton,666,125,283,122,27,14,571
Ohio,Lake Mohawk,1571,158,845,188,20,43,1254
Ohio,Lakemore village,3051,831,1223,352,0,205,2611
Ohio,Lake Seneca,587,46,336,32,7,16,437
Ohio,Lakeside,615,22,357,56,0,180,615
Ohio,Lake Tomahawk,697,180,364,46,0,26,616
Ohio,Lakeview village,1148,205,404,276,18,50,953
Ohio,Lake Waynoka,1043,144,584,80,96,48,952
Ohio,Lakewood,51155,18686,15613,5765,704,2234,43002
Ohio,Lancaster,39312,9091,14041,5168,868,2538,31706
Ohio,Landen,6985,1271,2892,860,35,254,5312
Ohio,Lansing,772,155,253,148,0,17,573
Ohio,La Rue village,669,103,220,93,15,49,480
Ohio,Latty village,186,38,82,34,6,4,164
Ohio,Laura village,425,74,165,48,2,26,315
Ohio,Leavittsburg,1616,410,557,194,7,168,1336
Ohio,Rayland village,403,94,134,55,2,41,326
Ohio,Lordstown village,3346,606,1746,342,32,214,2940
Ohio,Loudonville village,2749,571,1127,334,37,211,2280
Ohio,Germantown,5521,977,2480,598,29,235,4319
Ohio,Georgetown village,4792,873,1568,590,152,396,3579
Ohio,Genoa village,2405,510,969,176,19,188,1862
Ohio,Geneva-on-the-Lake village,1390,262,444,270,47,61,1084
Ohio,Geneva,6101,1213,2321,653,74,561,4822
Ohio,Gates Mills village,2179,373,1137,209,15,165,1899
Ohio,Gettysburg village,598,135,237,58,13,22,465
Ohio,Garrettsville village,2937,672,1174,254,64,88,2252
Ohio,Gann village,133,33,43,17,2,8,103
Ohio,Gambier village,2482,1903,329,113,14,36,2395
Ohio,Gallipolis village,3674,855,1021,761,48,224,2909
Ohio,Galion,10227,2032,4248,1053,208,681,8222
Ohio,Galena village,745,147,338,69,5,14,573
Ohio,Gahanna,34095,7558,14632,3589,504,1421,27704
Ohio,Garfield Heights,28365,9230,8484,2987,357,2024,23082
Ohio,Gibsonburg village,2732,639,885,221,42,164,1951
Ohio,Gilboa village,213,51,81,16,0,7,155
Ohio,Girard,9716,2402,3697,1027,170,552,7848
Ohio,Shreve village,1521,343,604,172,14,69,1202
Ohio,Sidney,20981,4893,7860,2338,299,1256,16646
Ohio,Silver Lake village,2518,518,1387,176,14,116,2211
Ohio,Silverton village,4769,1507,1316,682,72,352,3929
Ohio,Sinking Spring village,107,25,38,12,0,11,86
Ohio,Sixteen Mile Stand,3443,883,1616,334,36,66,2935
Ohio,Glouster village,1656,391,510,212,45,93,1251
Ohio,Gloria Glens Park village,485,144,211,39,3,23,420
Ohio,Glenwillow village,1010,131,396,100,11,119,757
Ohio,Glenmoor,1943,240,916,279,38,116,1589
Ohio,Glenmont village,222,26,102,25,5,21,179
Ohio,Glenford village,184,45,68,10,5,11,139
Ohio,Glendale village,2128,341,1115,148,30,122,1756
Ohio,Glencoe,285,42,89,62,0,23,216
Ohio,Glandorf village,892,128,457,46,0,68,699
Ohio,Fultonham village,164,25,64,9,1,10,109
Ohio,Fulton village,338,52,104,57,0,12,225
Ohio,Fruit Hill,3574,555,1482,371,118,147,2673
Ohio,Friendship,289,30,172,11,0,36,249
Ohio,Flushing village,818,163,333,116,13,67,692
Ohio,Florida village,267,60,109,34,0,13,216
Ohio,Fletcher village,430,79,190,39,11,29,348
Ohio,Flat Rock,57,20,22,3,0,1,46
Ohio,Five Points,1778,253,1056,37,35,122,1503
Ohio,Finneytown,12366,3497,4614,1054,288,634,10087
Ohio,Findlay,41278,10685,15708,4391,638,2546,33968
Ohio,Felicity village,871,182,300,117,12,103,714
Ohio,Fayetteville village,370,63,153,56,5,22,299
Ohio,Fairfield,42678,10365,17668,4395,803,2144,35375
Ohio,Fairfield Beach,809,194,349,163,0,29,735
Ohio,Fairlawn,7429,2016,2973,743,95,708,6535
Ohio,Fairport Harbor village,3100,862,1043,398,44,160,2507
Ohio,Fairview village,94,27,32,9,1,12,81
Ohio,Fairview Park,16552,4399,6745,1706,92,772,13714
Ohio,Forest village,1609,301,594,243,32,66,1236
Ohio,Shiloh village,694,128,273,53,5,52,511
Ohio,Forest Park,18667,4992,6517,2103,357,749,14718
Ohio,Fort Jennings village,448,98,221,19,0,36,374
Ohio,Fresno,149,40,65,0,0,8,113
Ohio,Fremont,16484,4519,4952,2040,313,902,12726
Ohio,Freeport village,382,70,181,28,10,34,323
Ohio,Fredericktown village,3018,515,1293,297,28,173,2306
Ohio,Fredericksburg village,413,74,200,32,3,25,334
Ohio,Frazeysburg village,1620,394,569,168,18,50,1199
Ohio,Franklin Furnace,1741,622,509,143,32,148,1454
Ohio,Franklin,11840,2378,4471,1597,337,654,9437
Ohio,Frankfort village,847,161,344,107,22,86,720
Ohio,Four Bridges,3462,586,1693,117,31,267,2694
Ohio,Fostoria,13187,3045,4137,1731,213,1081,10207
Ohio,Fort Shawnee,6143,950,3025,600,145,394,5114
Ohio,Fort Seneca,269,41,170,16,4,5,236
Ohio,Fort Recovery village,1570,312,611,110,21,97,1151
Ohio,Fort Loramie village,1317,277,615,38,13,64,1007
Ohio,Forestville,10535,1817,4916,849,150,716,8448
Ohio,Sherwood,3635,597,1860,335,47,101,2940
Ohio,Sherwood village,737,116,311,97,0,45,569
Ohio,Sherrodsville village,257,70,82,28,7,16,203
Ohio,Roseville village,2185,500,749,242,32,69,1592
Ohio,Rosewood,423,47,177,0,0,12,236
Ohio,Ross,3850,872,1779,158,46,181,3036
Ohio,Rossburg village,231,55,97,33,1,13,199
Ohio,Rossford,6458,1715,2782,637,0,273,5407
Ohio,Rossmoyne,2242,850,544,286,42,65,1787
Ohio,Roswell village,210,23,87,37,5,14,166
Ohio,Rudolph,341,103,64,97,0,38,302
Ohio,Rushsylvania village,638,109,287,58,11,28,493
Ohio,Rushville village,381,97,147,30,3,19,296
Ohio,Russells Point village,1118,147,381,177,36,82,823
Ohio,Russellville village,650,153,275,65,25,36,554
Ohio,Russia village,664,124,298,20,1,24,467
Ohio,Rutland village,452,120,178,21,5,38,362
Ohio,Sabina village,2352,408,986,373,26,102,1895
Ohio,Rosemount,1995,616,767,230,0,122,1735
Ohio,St. Bernard village,4358,1273,1577,342,80,282,3554
Ohio,Rose Farm,356,157,108,23,0,29,317
Ohio,Rogers village,224,67,92,23,7,11,200
Ohio,Louisville,9132,1667,3867,956,107,621,7218
Ohio,Loveland,12451,3007,5268,971,96,700,10042
Ohio,Loveland Park,1272,251,732,69,15,13,1080
Ohio,Lowell village,492,95,208,42,6,42,393
Ohio,Lowellville village,1150,311,407,145,10,90,963
Ohio,Lower Salem village,59,14,21,5,4,1,45
Ohio,Lucas village,577,128,225,65,7,16,441
Ohio,Lucasville,2333,469,1114,125,73,17,1798
Ohio,Luckey village,1005,170,442,105,8,50,775
Ohio,Ludlow Falls village,255,69,74,27,19,9,198
Ohio,Lynchburg village,1350,262,551,150,11,47,1021
Ohio,Lyndhurst,13792,2672,6863,1075,63,933,11606
Ohio,Lyons village,492,138,206,47,5,37,433
Ohio,McArthur village,1925,371,708,254,9,117,1459
Ohio,Rocky River,20187,4739,8570,1537,232,1648,16726
Ohio,Rome village,71,11,32,5,0,15,63
Ohio,Lore City village,300,73,121,43,11,7,255
Ohio,St. Clairsville,5133,717,2486,567,61,490,4321
Ohio,St. Johns,179,53,63,23,0,7,146
Ohio,Sebring village,4320,998,1446,518,69,615,3646
Ohio,Senecaville village,432,114,156,51,2,19,342
Ohio,Seven Hills,11716,2514,5939,713,62,841,10069
Ohio,Seven Mile village,802,183,331,101,11,51,677
Ohio,Seville village,2357,532,1142,204,22,145,2045
Ohio,Shadyside village,3752,971,1445,423,69,301,3209
Ohio,Shaker Heights,27934,6539,11767,2234,333,1130,22003
Ohio,Sharonville,13872,3492,4972,1424,120,982,10990
Ohio,Shawnee,834,194,501,59,0,18,772
Ohio,Shawnee village,670,167,224,68,12,40,511
Ohio,Shawnee Hills village,826,127,389,66,18,19,619
Ohio,Shawnee Hills,2151,378,1128,146,4,99,1755
Ohio,Sheffield village,4004,755,2021,364,29,233,3402
Ohio,Sheffield Lake,9063,2264,3747,860,104,537,7512
Ohio,Shelby,8910,1722,3028,1289,360,842,7241
Ohio,Seaman village,928,164,324,107,29,46,670
Ohio,St. Henry village,2529,553,1220,59,6,88,1926
Ohio,Scott village,313,61,146,32,0,9,248
Ohio,Scio village,868,197,344,99,2,62,704
Ohio,St. Louisville village,396,85,154,45,4,37,325
Ohio,St. Martin,357,71,186,58,2,12,329
Ohio,St. Marys,8117,1593,3224,728,128,661,6334
Ohio,St. Paris village,2186,481,940,174,6,103,1704
Ohio,Salem,12115,2594,4571,1714,172,947,9998
Ohio,Salem Heights,3200,537,1597,223,47,185,2589
Ohio,Salesville village,123,27,55,12,8,3,105
Ohio,Salineville village,1239,293,436,166,6,65,966
Ohio,Sandusky,25488,7852,7468,3302,456,1683,20761
Ohio,Sandyville,277,23,109,40,36,13,221
Ohio,Sarahsville village,149,22,71,19,0,13,125
Ohio,Sardinia village,1503,282,512,137,8,49,988
Ohio,Sardis,479,61,262,47,0,14,384
Ohio,Savannah village,410,90,168,26,14,23,321
Ohio,Sawyerwood,1249,330,471,189,12,74,1076
Ohio,Sciotodale,1246,230,590,177,0,54,1051
Ohio,Rawson village,544,72,249,30,3,18,372
Ohio,Midland village,422,71,117,47,20,8,263
Ohio,Rarden village,157,37,91,8,0,2,138
Ohio,Perry Heights,8553,1785,3436,1179,104,558,7062
Ohio,Perrysburg,21243,4375,9546,1400,202,1165,16688
Ohio,Perrysville village,768,205,300,89,6,24,624
Ohio,Pettisville,529,111,291,31,2,23,458
Ohio,Pheasant Run,1620,231,662,186,55,25,1159
Ohio,Phillipsburg village,493,96,203,73,0,47,419
Ohio,Philo village,866,210,313,104,11,42,680
Ohio,Pickerington,19157,3752,8759,1267,197,614,14589
Ohio,Pigeon Creek,1041,175,506,38,14,34,767
Ohio,Piketon village,2050,423,755,289,43,91,1601
Ohio,Pioneer village,1653,405,635,157,31,96,1324
Ohio,Piqua,20681,4902,7293,2583,373,1313,16464
Ohio,Pitsburg village,410,62,211,36,6,9,324
Ohio,Plain City village,4330,829,1699,551,20,216,3315
Ohio,Plainfield village,164,22,89,8,4,6,129
Ohio,Pleasant City village,423,114,136,58,8,12,328
Ohio,Plainville,22,11,0,0,11,0,22
Ohio,Chesterland,2035,386,900,257,24,157,1724
Ohio,Chesterville village,228,51,61,36,0,21,169
Ohio,Cheviot,8327,2575,2428,1083,324,399,6809
Ohio,Chickasaw village,363,95,170,19,2,18,304
Ohio,Chillicothe,21765,5433,7080,3323,565,1559,17960
Ohio,Chilo village,89,31,31,5,0,11,78
Ohio,Chippewa Lake village,711,189,281,112,9,44,635
Ohio,Chippewa Park,838,132,369,148,24,76,749
Ohio,Perry village,1636,272,767,126,31,81,1277
Ohio,Pepper Pike,6115,1048,3451,150,56,299,5004
Ohio,Peninsula village,590,106,304,40,8,36,494
Ohio,Pemberville village,1625,308,703,145,26,64,1246
Ohio,Oregon,20207,4803,8458,2126,314,1217,16918
Ohio,Orient,303,56,126,33,9,17,241
Ohio,Orrville,8329,1581,3638,809,33,590,6651
Ohio,Orwell village,1615,343,571,203,3,147,1267
Ohio,Osgood village,314,56,152,4,2,19,233
Ohio,Ostrander village,1025,198,423,102,3,29,755
Ohio,Ottawa village,4424,935,2029,321,35,297,3617
Ohio,Ottawa Hills village,4487,750,2287,268,13,210,3528
Ohio,Ottoville village,900,120,418,86,7,45,676
Ohio,Otway village,98,15,30,11,0,7,63
Ohio,Owensville village,854,130,240,176,34,98,678
Ohio,Oxford,21762,16395,3162,630,211,377,20775
Ohio,Choctaw Lake,1510,242,871,125,0,54,1292
Ohio,Painesville,19694,6164,6087,1979,367,758,15355
Ohio,Pancoastburg,124,15,76,0,25,0,116
Ohio,Pandora village,1202,251,522,107,6,84,970
Ohio,Park Layne,4612,1089,1656,334,130,157,3366
Ohio,Parkman,129,56,53,20,0,0,129
Ohio,Parma,80380,21716,31808,7794,812,5302,67432
Ohio,Parma Heights,20409,5225,7717,2274,80,1388,16684
Ohio,Parral village,222,51,76,46,9,15,197
Ohio,Pataskala,15120,3334,6139,1417,239,769,11898
Ohio,Patterson village,144,21,48,15,9,10,103
Ohio,Paulding village,3699,766,1547,282,8,295,2898
Ohio,Payne village,1109,308,427,123,10,69,937
Ohio,Peebles village,1857,409,650,231,40,146,1476
Ohio,Palestine village,205,39,87,17,0,11,154
Ohio,Orangeville village,216,44,75,25,0,12,156
Ohio,Christiansburg village,564,116,251,53,6,31,457
Ohio,Cincinnati,297397,123599,66652,30726,6784,13428,241189
Ohio,Continental village,998,223,433,86,3,64,809
Ohio,Convoy village,1285,267,451,134,28,65,945
Ohio,Coolville village,649,174,191,67,3,77,512
Ohio,Corning village,452,135,107,50,12,66,370
Ohio,Cortland,7001,1403,3648,456,61,570,6138
Ohio,Corwin village,539,76,268,44,5,33,426
Ohio,Coshocton,11153,2362,4570,1438,140,845,9355
Ohio,Covedale,6623,1309,3009,551,94,415,5378
Ohio,Covington village,2606,517,960,353,11,135,1976
Ohio,Craig Beach village,1174,256,454,133,25,69,937
Ohio,Crestline village,4472,1067,1619,480,89,339,3594
Ohio,Creston village,2235,422,965,228,40,108,1763
Ohio,Cridersville village,1785,233,764,233,19,168,1417
Ohio,Crooksville village,2399,539,1000,313,52,129,2033
Ohio,Crown City village,382,77,162,58,7,28,332
Ohio,Crystal Lakes,1377,238,530,107,69,47,991
Ohio,Crystal Rock,126,20,39,25,18,12,114
Ohio,Cumberland village,479,102,202,25,10,21,360
Ohio,Curtice,1842,527,791,136,12,87,1553
Ohio,Custar village,135,40,56,13,8,6,123
Ohio,Cuyahoga Falls,49287,12102,19619,5595,518,2815,40649
Ohio,Cuyahoga Heights village,616,180,148,91,9,47,475
Ohio,Cygnet village,746,121,267,69,9,57,523
Ohio,Cynthiana,0,0,0,0,0,0,0
Ohio,Dalton village,1717,316,784,145,4,206,1455
Ohio,Connorville,160,25,93,16,0,10,144
Ohio,Conneaut,12806,3480,4644,1652,210,832,10818
Ohio,Congress village,162,33,61,20,2,3,119
Ohio,Conesville village,345,66,177,31,2,17,293
Ohio,Cinnamon Lake,923,162,376,116,40,114,808
Ohio,Clarington village,424,94,171,47,4,41,357
Ohio,Clarksburg village,537,124,174,51,6,37,392
Ohio,Clarksville village,592,165,161,65,25,39,455
Ohio,Clarktown,555,53,257,65,21,84,480
Ohio,Ravenna,11642,3227,3508,1836,232,696,9499
Ohio,Clay Center village,307,55,115,30,8,17,225
Ohio,Clayton,13196,2755,6090,1057,98,595,10595
Ohio,Cleveland,390584,157259,79734,45570,11022,21911,315496
Ohio,Cleveland Heights,45388,15625,14777,4156,639,1894,37091
Ohio,Cleves village,3365,698,1307,264,35,81,2385
Ohio,Clifton village,152,46,49,9,9,9,122
Ohio,Churchill,2002,665,821,97,81,260,1924
Ohio,Clinton village,1160,259,513,134,14,59,979
Ohio,Clyde,6305,1451,2609,621,48,349,5078
Ohio,Coal Grove village,2066,495,811,304,17,179,1806
Ohio,Coalton village,642,134,193,131,3,19,480
Ohio,Coldstream,1271,206,729,47,0,34,1016
Ohio,Coldwater village,4327,876,1931,197,9,471,3484
Ohio,College Corner village,401,101,181,50,12,17,361
Ohio,Collins,482,55,284,17,7,52,415
Ohio,Columbiana,6393,1176,2988,691,27,594,5476
Ohio,Columbus,824663,292470,242366,82431,16195,30181,663643
Ohio,Columbus Grove village,1971,353,919,182,16,100,1570
Ohio,Commercial Point village,1643,241,713,118,10,44,1126
Ohio,Concorde Hills,663,178,345,32,0,33,588
Ohio,Cloverdale village,158,28,65,18,1,6,118
Ohio,Orange village,3288,418,1703,333,0,139,2593
Ohio,Circleville,13706,3214,5140,1674,270,936,11234
Ohio,Olmsted Falls,8923,1818,4115,834,78,435,7280
Ohio,Ontario,6142,1221,2956,533,39,535,5284
Ohio,Pleasant Hills,541,227,139,58,0,56,480
Ohio,Pleasant Plain village,147,47,53,21,2,13,136
Ohio,Pleasant Run,4898,1431,1875,433,14,258,4011
Ohio,Pleasant Run Farm,4789,1074,1820,407,26,311,3638
Ohio,Pleasantville village,1175,242,400,107,17,46,812
Ohio,Plumwood,257,50,81,49,0,37,217
Ohio,Plymouth village,1719,338,712,157,32,130,1369
Ohio,Poland village,2846,520,1443,177,20,157,2317
Ohio,Polk village,301,62,134,34,9,18,257
Ohio,Pomeroy village,1953,445,699,259,23,117,1543
Ohio,Portage village,388,75,166,50,2,17,310
Ohio,Portage Lakes,7038,2302,2514,1022,152,369,6359
Ohio,Port Clinton,6025,1291,2345,883,112,338,4969
Ohio,Norwood,19316,7639,5237,2082,430,1118,16506
Ohio,Port Jefferson village,425,55,198,65,2,13,333
Ohio,Port Washington village,610,92,295,50,9,29,475
Ohio,Port William village,249,74,64,36,0,8,182
Ohio,Potsdam village,326,64,133,28,1,21,247
Ohio,Pottery Addition,355,144,97,19,22,0,282
Ohio,Powell,12298,1569,6270,649,69,196,8753
Ohio,Powhatan Point village,1474,333,603,201,22,114,1273
Ohio,Proctorville village,554,117,154,101,14,54,440
Ohio,Prospect village,1118,193,462,128,33,45,861
Ohio,Pulaski,70,27,17,15,0,0,59
Ohio,Put-in-Bay village,117,31,60,16,0,6,113
Ohio,Quaker City village,501,65,199,82,17,34,397
Ohio,Quincy village,667,114,297,58,9,28,506
Ohio,Racine village,616,127,236,109,14,39,525
Ohio,Radnor,248,67,138,24,0,0,229
Ohio,Portsmouth,20376,6010,5795,2991,453,1706,16955
Ohio,Oak Harbor village,2740,496,1142,286,41,175,2140
Ohio,Pleasant Hill village,1167,227,547,88,9,45,916
Ohio,Oak Hill village,1684,330,520,231,8,145,1234
Ohio,Pleasant Grove,1794,448,681,172,0,80,1381
Ohio,Old Washington village,357,78,139,33,18,33,301
Ohio,Old Fort,200,31,105,18,0,0,154
Ohio,Olde West Chester,97,15,66,0,0,9,90
Ohio,Ohio City village,753,131,346,70,7,56,610
Ohio,Oakwood village (Cuyahoga County),3689,949,1328,445,70,300,3092
Ohio,Oceola,123,0,77,0,0,0,77
Ohio,Obetz village,4558,1074,1640,463,102,158,3437
Ohio,Oberlin,8356,4131,2142,567,92,427,7359
Ohio,Oakwood village (Paulding County),568,101,233,55,9,40,438
Ohio,Oakwood,9118,1597,4239,652,47,401,6936
Ohio,Octa village,41,7,11,7,1,8,34
Oklahoma,Brush Creek,73,22,37,14,0,0,73
Oklahoma,Brushy,945,175,398,87,10,76,746
Oklahoma,Buffalo,1408,264,550,158,23,119,1114
Oklahoma,Bull Hollow,54,0,36,7,0,0,43
Oklahoma,Burbank,115,20,46,24,2,6,98
Oklahoma,Burlington,149,21,63,8,0,17,109
Oklahoma,Burneyville,562,64,290,52,3,49,458
Oklahoma,Burns Flat,2271,363,835,297,74,60,1629
Oklahoma,Bushyhead,1359,261,619,115,30,53,1078
Oklahoma,McAlester,18324,4008,6349,2590,431,1333,14711
Oklahoma,McCord,1593,247,826,149,20,102,1344
Oklahoma,McCurtain,469,74,198,54,5,21,352
Oklahoma,McLoud,4587,1254,1555,504,220,337,3870
Oklahoma,Macomb,30,6,2,11,4,2,25
Oklahoma,Madill,3839,735,1657,348,74,276,3090
Oklahoma,Manchester,66,1,32,9,0,1,43
Oklahoma,Mangum,2937,550,1174,312,36,204,2276
Oklahoma,Manitou,228,66,48,40,0,19,173
Oklahoma,Mannford,3105,448,1249,387,36,319,2439
Oklahoma,Butler,322,72,123,36,3,23,257
Oklahoma,Brooksville,54,11,20,11,0,4,46
Oklahoma,Broken Arrow,103437,19158,46985,9587,1086,3710,80526
Oklahoma,Broken Bow,4127,1043,1435,391,90,242,3201
Oklahoma,Blue,194,37,96,9,0,32,174
Oklahoma,Bluejacket,316,76,108,40,3,22,249
Oklahoma,Boise City,1140,204,465,73,22,146,910
Oklahoma,Bokchito,638,117,231,77,18,61,504
Oklahoma,Bokoshe,484,107,184,54,10,41,396
Oklahoma,Boley,1098,515,158,261,45,75,1054
Oklahoma,Boswell,707,193,216,95,18,42,564
Oklahoma,Bowlegs,391,61,161,63,3,24,312
Oklahoma,Box,125,13,94,8,0,10,125
Oklahoma,Bromide,118,18,67,10,1,11,107
Oklahoma,Boynton,193,42,60,21,4,18,145
Oklahoma,Braggs,270,31,117,23,10,27,208
Oklahoma,Braman,178,31,70,23,3,16,143
Oklahoma,Bray,1291,237,589,137,13,73,1049
Oklahoma,Breckenridge,290,36,144,21,5,14,220
Oklahoma,Brent,808,139,410,89,17,29,684
Oklahoma,Mannsville,828,161,306,112,17,38,634
Oklahoma,Bridgeport,115,22,44,22,1,6,95
Oklahoma,Briggs,287,54,91,28,0,4,177
Oklahoma,Bristow,4263,817,1280,667,133,334,3231
Oklahoma,Bradley,107,26,52,17,3,2,100
Oklahoma,Bridge Creek,271,35,144,17,2,5,203
Oklahoma,Tecumseh,6583,1175,2483,868,122,489,5137
Oklahoma,Marietta,144,28,57,19,0,0,104
Oklahoma,Mountain Park,477,92,217,50,6,10,375
Oklahoma,Mountain View,777,90,374,103,6,48,621
Oklahoma,Mulberry,139,31,40,23,3,3,100
Oklahoma,Muldrow,3331,713,1015,487,79,335,2629
Oklahoma,Mulhall,273,30,115,32,11,27,215
Oklahoma,Zion,35,5,22,0,0,2,29
Oklahoma,Zena,204,20,97,38,0,0,155
Oklahoma,Zeb,673,28,372,64,18,36,518
Oklahoma,Yukon,24746,4133,10629,2713,529,1477,19481
Oklahoma,Yeager,71,20,25,12,0,4,61
Oklahoma,Yale,1145,243,469,158,18,66,954
Oklahoma,Wynona,474,50,194,70,5,40,359
Oklahoma,Wynnewood,2235,473,832,294,78,140,1817
Oklahoma,Wyandotte,342,81,132,35,9,21,278
Oklahoma,Kinta,257,46,82,35,3,19,185
Oklahoma,Kingston,1537,278,543,278,13,147,1259
Oklahoma,Kingfisher,4755,597,2263,451,8,406,3725
Oklahoma,Kildare,71,7,41,3,0,4,55
Oklahoma,Kiefer,2055,323,952,180,7,65,1527
Oklahoma,Keys,578,63,227,89,33,24,436
Oklahoma,Keyes,238,47,126,16,0,19,208
Oklahoma,Ketchum,439,81,160,52,6,44,343
Oklahoma,Keota,651,115,208,78,12,54,467
Oklahoma,Kenwood,1011,216,380,115,17,69,797
Oklahoma,Kenton,59,0,50,0,0,0,50
Oklahoma,Mounds,1192,247,469,139,27,73,955
Oklahoma,Marble City,225,80,58,21,10,11,180
Oklahoma,Morrison,773,122,334,89,8,24,577
Oklahoma,Mooreland,1724,232,676,213,32,99,1252
Oklahoma,Marietta,2683,557,955,204,24,206,1946
Oklahoma,Marland,282,41,114,30,4,12,201
Oklahoma,Marlow,4632,822,1720,701,96,421,3760
Oklahoma,Marshall,309,94,108,33,5,16,256
Oklahoma,Martha,141,26,65,24,0,8,123
Oklahoma,Maud,917,138,372,123,2,38,673
Oklahoma,May,49,16,22,4,0,1,43
Oklahoma,Maysville,1288,262,479,138,31,71,981
Oklahoma,Mazie,207,120,40,13,20,14,207
Oklahoma,Mead,78,12,43,5,2,8,70
Oklahoma,Medford,1015,243,406,144,0,60,853
Oklahoma,Medicine Park,233,40,112,52,4,8,216
Oklahoma,Meeker,1158,176,404,180,25,96,881
Oklahoma,Meno,239,45,131,9,2,6,193
Oklahoma,Meridian,52,18,11,4,7,9,49
Oklahoma,Meridian,1085,190,517,113,16,86,922
Oklahoma,Miami,13666,3227,4690,1794,267,883,10861
Oklahoma,Midwest City,56507,13629,19861,6970,1175,3202,44837
Oklahoma,Milburn,320,62,116,43,1,26,248
Oklahoma,Mill Creek,312,62,124,39,1,24,250
Oklahoma,Millerton,287,50,128,25,8,14,225
Oklahoma,Minco,1364,234,603,150,21,101,1109
Oklahoma,Moffett,128,45,25,23,5,9,107
Oklahoma,Monroe,199,28,54,31,3,49,165
Oklahoma,Moore,58615,12354,23848,6066,879,2522,45669
Oklahoma,Morris,1511,372,505,153,32,113,1175
Oklahoma,Maramec,95,9,51,4,0,9,73
Oklahoma,Stoney Point,284,15,97,19,10,19,160
Oklahoma,Strang,65,8,23,21,0,5,57
Oklahoma,Tribbey,370,53,188,39,3,29,312
Oklahoma,Tryon,527,75,187,83,8,28,381
Oklahoma,Tullahassee,284,155,84,18,4,8,269
Oklahoma,Tulsa,398082,105656,135301,47172,8267,18864,315260
Oklahoma,Tupelo,345,79,108,37,10,23,257
Oklahoma,Turley,2291,474,905,373,129,96,1977
Oklahoma,Turpin,577,145,225,57,0,23,450
Oklahoma,Tushka,286,52,133,28,7,8,228
Oklahoma,Tuskahoma,132,16,62,13,2,15,108
Oklahoma,Tuttle,6411,1120,3055,440,79,255,4949
Oklahoma,Kenefic,201,42,71,21,2,10,146
Oklahoma,Twin Oaks,227,48,128,0,12,22,210
Oklahoma,Tyrone,965,226,357,77,13,28,701
Oklahoma,Union City,1511,295,706,228,23,105,1357
Oklahoma,Valley Brook,718,169,194,108,55,34,560
Oklahoma,Valley Park,58,10,25,1,0,1,37
Oklahoma,Arpelar,281,58,116,41,3,22,240
Oklahoma,Arnett,498,74,237,68,4,39,422
Oklahoma,Armstrong,185,11,87,8,3,13,122
Oklahoma,Arkoma,1915,361,702,306,37,165,1571
Oklahoma,Ardmore,24955,5766,8387,3248,285,1906,19592
Oklahoma,Arcadia,175,61,55,24,0,14,154
Oklahoma,Arapaho,550,128,213,102,10,35,488
Oklahoma,Apache,1282,230,466,125,35,110,966
Oklahoma,Antlers,2471,446,822,429,40,229,1966
Oklahoma,Tonkawa,3149,771,1145,403,30,203,2552
Oklahoma,Anadarko,6777,1913,1622,983,186,387,5091
Oklahoma,Titanic,252,38,141,15,4,5,203
Oklahoma,Tipton,867,148,449,50,19,56,722
Oklahoma,Temple,1091,152,452,144,27,73,848
Oklahoma,Tenkiller,523,143,184,103,26,21,477
Oklahoma,Teresita,147,40,54,14,9,4,121
Oklahoma,Terlton,107,20,54,2,1,5,82
Oklahoma,Terral,390,67,166,38,3,21,295
Oklahoma,Texanna,2273,416,1117,255,10,192,1990
Oklahoma,Texhoma,851,113,431,39,4,31,618
Oklahoma,Texola,54,30,19,5,0,0,54
Oklahoma,Thackerville,471,91,178,29,22,30,350
Oklahoma,The Village,9223,2590,2973,1360,195,687,7805
Oklahoma,Thomas,1220,200,599,128,17,75,1019
Oklahoma,Stonewall,384,75,120,59,3,68,325
Oklahoma,Stilwell,4007,915,1266,418,135,255,2989
Oklahoma,Stillwater,47523,22720,13423,2845,372,1395,40755
Oklahoma,Stigler,2725,396,1022,416,86,220,2140
Oklahoma,Stidham,45,0,26,1,0,1,28
Oklahoma,Sterling,620,87,320,57,0,35,499
Oklahoma,Steely Hollow,157,36,40,24,4,39,143
Oklahoma,Springer,639,125,239,91,6,68,529
Oklahoma,Sportsmen Acres,371,59,144,34,21,11,269
Oklahoma,Spiro,2640,453,1046,345,50,243,2137
Oklahoma,Sperry,1140,218,462,179,16,44,919
Oklahoma,Spencer,4004,1090,1585,529,34,156,3394
Oklahoma,Spavinaw,350,83,126,54,12,39,314
Oklahoma,Tiawah,223,73,138,0,0,0,211
Oklahoma,Tishomingo,3075,695,995,444,126,219,2479
Oklahoma,Amorita,6,2,0,1,0,3,6
Oklahoma,Ames,239,41,108,16,6,24,195
Oklahoma,Amber,370,74,138,35,11,16,274
Oklahoma,Beggs,1189,230,386,154,25,113,908
Oklahoma,Belfonte,269,58,89,43,4,5,199
Oklahoma,Goltry,183,45,88,15,0,9,157
Oklahoma,Goldsby,1982,291,1002,161,13,70,1537
Oklahoma,Glenpool,11982,2183,4833,1339,152,377,8884
Oklahoma,Glencoe,574,86,257,48,9,18,418
Oklahoma,Gideon,15,0,11,0,0,0,11
Oklahoma,Gerty,85,13,49,2,2,7,73
Oklahoma,Taloga,388,55,171,47,18,17,308
Oklahoma,Talihina,1087,256,324,159,32,102,873
Oklahoma,Talala,324,85,120,26,0,11,242
Oklahoma,Tahlequah,16354,5936,4300,1732,361,901,13230
Oklahoma,Tagg Flats,107,37,34,0,0,0,71
Oklahoma,Taft,176,51,45,21,9,19,145
Oklahoma,Sycamore,358,28,168,72,0,12,280
Oklahoma,Swink,83,13,43,8,4,4,72
Oklahoma,Sweetwater,186,34,69,19,0,9,131
Oklahoma,Summit,135,32,61,10,7,7,117
Oklahoma,Sulphur,5032,1097,1836,810,85,291,4119
Oklahoma,Sugden,38,4,29,0,0,1,34
Oklahoma,Stuart,184,54,75,14,0,13,156
Oklahoma,Stroud,2710,475,1046,383,36,262,2202
Oklahoma,Strong City,62,17,15,17,2,2,53
Oklahoma,Stringtown,340,60,166,29,15,23,293
Oklahoma,Stratford,1503,340,467,178,27,100,1112
Oklahoma,Bee,137,16,66,55,0,0,137
Oklahoma,Beaver,1592,195,783,119,6,105,1208
Oklahoma,Bearden,142,25,80,3,2,3,113
Oklahoma,Bartlesville,36360,6717,15188,4117,697,2347,29066
Oklahoma,Alva,5023,1425,1775,496,78,364,4138
Oklahoma,Altus,19549,4079,7530,2161,429,1040,15239
Oklahoma,Allen,831,147,315,103,15,98,678
Oklahoma,Aline,245,48,119,17,10,11,205
Oklahoma,Alex,536,78,230,58,10,36,412
Oklahoma,Alderson,309,41,138,35,1,19,234
Oklahoma,Albion,59,10,18,8,2,5,43
Oklahoma,Albany,102,13,49,9,0,10,81
Oklahoma,Akins,610,122,241,68,0,39,470
Oklahoma,Agra,300,56,124,25,4,22,231
Oklahoma,Afton,1063,175,411,113,34,56,789
Oklahoma,Addington,101,23,35,10,2,15,85
Oklahoma,Tatums,111,51,17,13,7,13,101
Oklahoma,Adair,868,125,380,86,24,33,648
Oklahoma,Achille,467,96,192,38,12,31,369
Oklahoma,Valliant,843,203,270,92,20,74,659
Oklahoma,Velma,697,140,322,50,0,25,537
Oklahoma,Vera,164,28,76,16,2,14,136
Oklahoma,Asher,413,83,158,53,8,36,338
Oklahoma,Ashland,39,8,18,9,0,1,36
Oklahoma,Atoka,3077,576,1055,467,85,236,2419
Oklahoma,Atwood,47,9,24,7,0,6,46
Oklahoma,Avant,343,46,137,35,12,24,254
Oklahoma,Badger Lee,96,30,21,4,0,7,62
Oklahoma,Ballou,107,15,62,20,0,0,97
Oklahoma,Barnsdall,1085,146,451,105,25,111,838
Oklahoma,Ada,17149,5178,5230,2134,299,1201,14042
Oklahoma,Kendrick,83,7,29,14,0,14,64
Oklahoma,Washington,689,124,300,76,19,16,535
Oklahoma,Kellyville,1367,280,433,162,32,86,993
Oklahoma,Elk City,12424,2758,4621,1189,276,659,9503
Oklahoma,Elmer,113,12,55,8,7,9,91
Oklahoma,Elm Grove,167,50,79,6,0,12,147
Oklahoma,Elmore City,756,163,286,73,22,42,586
Oklahoma,El Reno,17852,4301,5941,2505,391,1003,14141
Oklahoma,Empire City,810,84,478,51,0,45,658
Oklahoma,Elgin,2702,489,1287,153,43,84,2056
Oklahoma,Enid,50685,9106,21161,5564,781,2948,39560
Oklahoma,Erin Springs,191,15,159,7,0,0,181
Oklahoma,Etowah,85,23,33,14,0,6,76
Oklahoma,Eufaula,2899,518,1100,437,78,278,2411
Oklahoma,Evening Shade,305,39,150,30,31,43,293
Oklahoma,Fairfax,1491,251,621,145,16,125,1158
Oklahoma,Fairfield,580,122,257,51,0,16,446
Oklahoma,Erick,1105,306,312,183,22,84,907
Oklahoma,Fairland,1123,229,408,139,19,55,850
Oklahoma,Eldorado,449,57,180,36,8,42,323
Oklahoma,Edmond,86739,18672,38979,6507,802,3490,68450
Oklahoma,Dripping Springs,29,8,7,6,0,0,21
Oklahoma,Drowning Creek,185,28,30,73,0,23,154
Oklahoma,Drummond,433,108,190,32,2,5,337
Oklahoma,Drumright,2929,583,1004,415,68,241,2311
Oklahoma,Dry Creek,314,68,145,21,0,27,261
Oklahoma,Duchess Landing,258,8,131,0,0,14,153
Oklahoma,Eldon,240,43,112,32,0,14,201
Oklahoma,Duncan,23317,4211,9606,2402,528,1736,18483
Oklahoma,Dustin,295,63,99,48,9,21,240
Oklahoma,Dwight Mission,0,0,0,0,0,0,0
Oklahoma,Eagletown,642,129,249,78,19,48,523
Oklahoma,Eakly,384,89,147,26,8,28,298
Oklahoma,Earlsboro,487,58,242,50,2,33,385
Oklahoma,East Duke,349,46,175,40,4,23,288
Oklahoma,Durant,16767,4446,5492,2046,381,1086,13451
Oklahoma,Fairmont,221,15,143,22,0,14,194
Oklahoma,Fair Oaks,56,14,23,4,0,6,47
Oklahoma,Fairview,2629,409,1139,301,83,174,2106
Oklahoma,Foyil,281,71,90,32,9,16,218
Oklahoma,Francis,323,61,111,42,5,17,236
Oklahoma,Frederick,3804,765,1435,337,97,290,2924
Oklahoma,Freedom,247,46,127,19,1,11,204
Oklahoma,Friendship,16,1,9,0,0,3,13
Oklahoma,Gage,473,75,181,60,21,40,377
Oklahoma,Foster,117,13,62,15,6,5,101
Oklahoma,Gans,331,66,103,44,8,23,244
Oklahoma,Garvin,197,26,57,30,0,20,133
Oklahoma,Gate,132,24,69,10,0,3,106
Oklahoma,Geary,1147,262,357,113,11,76,819
Oklahoma,Gene Autry,135,23,42,28,2,15,110
Oklahoma,Geronimo,983,209,415,95,17,45,781
Oklahoma,Norman,117353,41010,41372,10571,1265,3976,98194
Oklahoma,Garber,683,124,301,71,12,42,550
Oklahoma,Foss,174,26,82,22,0,17,147
Oklahoma,Fort Towson,620,102,300,69,12,37,520
Oklahoma,Fort Supply,447,70,157,60,0,32,319
Oklahoma,Fallis,20,2,13,1,0,4,20
Oklahoma,Fanshawe,347,52,141,42,7,27,269
Oklahoma,Fargo,335,74,159,32,4,14,283
Oklahoma,Faxon,67,15,32,7,0,12,66
Oklahoma,Felt,91,19,45,3,0,5,72
Oklahoma,Fitzhugh,285,33,144,21,0,22,220
Oklahoma,Fletcher,1140,155,492,87,25,50,809
Oklahoma,Flint Creek,810,280,322,91,24,40,757
Oklahoma,Flute Springs,62,19,16,6,2,4,47
Oklahoma,Foraker,6,0,3,0,0,3,6
Oklahoma,Forest Park,1105,255,529,112,0,84,980
Oklahoma,Forgan,382,59,221,29,0,7,316
Oklahoma,Fort Cobb,625,88,256,91,10,27,472
Oklahoma,Fort Coffee,518,134,165,77,14,31,421
Oklahoma,Fort Gibson,4121,768,1752,553,19,154,3246
Oklahoma,Dover,306,38,121,34,9,16,218
Oklahoma,Norge,165,14,102,6,2,3,127
Oklahoma,Verdigris,4203,722,2030,289,100,175,3316
Oklahoma,Ratliff City,131,42,42,14,0,8,106
Oklahoma,Old Eucha,13,1,9,2,0,0,12
Oklahoma,Old Green,582,81,214,82,0,11,388
Oklahoma,Olustee,537,73,235,36,0,15,359
Oklahoma,Oologah,1135,142,531,115,4,61,853
Oklahoma,Optima,501,105,135,54,10,12,316
Oklahoma,Orlando,153,19,53,23,13,2,110
Oklahoma,Oktaha,376,57,165,32,8,23,285
Oklahoma,Osage,113,15,56,25,2,11,109
Oklahoma,Paden,585,67,214,79,17,41,418
Oklahoma,Panama,1284,197,516,206,21,108,1048
Oklahoma,Panola,94,24,20,27,3,4,78
Oklahoma,Paoli,573,122,223,82,12,24,463
Oklahoma,Paradise Hill,56,8,43,0,0,3,54
Oklahoma,Park Hill,3667,880,1204,404,51,159,2698
Oklahoma,Owasso,32650,6602,13915,3185,226,1288,25216
Oklahoma,Pauls Valley,6073,1469,1949,885,106,416,4825
Oklahoma,Okmulgee,12350,3297,3148,1998,338,1047,9828
Oklahoma,Okemah,3276,854,865,457,83,283,2542
Oklahoma,North Enid,880,122,503,44,7,23,699
Oklahoma,North Miami,358,82,143,29,18,34,306
Oklahoma,Notchietown,291,47,142,55,0,13,257
Oklahoma,Nowata,3746,678,1190,550,195,378,2991
Oklahoma,Oak Grove,10,0,10,0,0,0,10
Oklahoma,Oakhurst,2312,447,946,245,24,170,1832
Oklahoma,Oklahoma City,610672,152419,224112,61543,11792,25744,475610
Oklahoma,Oakland,1089,193,426,90,50,31,790
Oklahoma,Oakwood,48,5,10,11,5,0,31
Oklahoma,Ochelata,380,59,182,48,6,26,321
Oklahoma,Oilton,1082,192,459,150,11,68,880
Oklahoma,Okarche,1255,241,575,83,0,96,995
Oklahoma,Okay,581,134,228,79,0,33,474
Oklahoma,Okeene,1014,91,426,114,30,130,791
Oklahoma,Oaks,336,99,84,29,8,25,245
Oklahoma,Pawhuska,3663,806,1220,564,37,324,2951
Oklahoma,Pawnee,2228,582,712,276,27,193,1790
Oklahoma,Peavine,360,48,168,71,0,12,299
Oklahoma,Porum,660,103,198,90,25,62,478
Oklahoma,Poteau,8624,1920,3195,1027,131,505,6778
Oklahoma,Prague,2389,358,990,308,21,209,1886
Oklahoma,Proctor,196,16,53,37,18,29,153
Oklahoma,Prue,508,77,197,50,10,60,394
Oklahoma,Pryor Creek,9484,1861,3613,1184,218,593,7469
Oklahoma,Porter,625,143,238,75,17,28,501
Oklahoma,Pump Back,218,43,86,25,0,42,196
Oklahoma,Putnam,15,0,13,2,0,0,15
Oklahoma,Quapaw,887,155,334,108,11,69,677
Oklahoma,Quinton,1026,171,369,165,19,83,807
Oklahoma,Ralston,347,68,148,34,4,23,277
Oklahoma,Ramona,530,60,218,69,11,38,396
Oklahoma,Randlett,362,77,185,24,10,30,326
Oklahoma,Purcell,6292,1047,2899,655,88,420,5109
Oklahoma,Pond Creek,941,118,421,87,14,52,692
Oklahoma,Ponca City,24846,5132,9152,2923,455,1952,19614
Oklahoma,Pocola,4026,674,1742,474,62,242,3194
Oklahoma,Peggs,753,127,366,87,7,27,614
Oklahoma,Pensacola,134,43,60,7,1,3,114
Oklahoma,Peoria,107,5,49,22,0,10,86
Oklahoma,Perkins,2861,644,932,442,26,156,2200
Oklahoma,Perry,5082,867,2531,322,102,297,4119
Oklahoma,Pettit,916,167,434,56,0,25,682
Oklahoma,Phillips,110,25,37,12,3,11,88
Oklahoma,Piedmont,6502,1111,3034,475,104,111,4835
Oklahoma,Piney,233,56,108,0,8,4,176
Oklahoma,Pinhook Corner,169,65,35,45,0,0,145
Oklahoma,Pink,2281,371,1089,222,44,77,1803
Oklahoma,Pin Oak Acres,409,99,163,63,0,37,362
Oklahoma,Pittsburg,183,57,68,26,2,10,163
Oklahoma,Platter,158,63,64,0,0,31,158
Oklahoma,Pocasset,151,28,67,12,5,3,115
Oklahoma,Verden,582,123,221,69,8,38,459
Oklahoma,Noble,6626,1096,2537,836,328,256,5053
Oklahoma,Ninnekah,1018,143,473,79,15,85,795
Oklahoma,Nicut,244,36,123,31,0,23,213
Oklahoma,Wann,191,30,101,18,2,1,152
Oklahoma,Wapanucka,376,97,122,46,7,23,295
Oklahoma,Wardville,47,3,22,5,0,5,35
Oklahoma,Warner,1844,564,565,192,35,127,1483
Oklahoma,Warr Acres,10342,2608,3697,1334,218,518,8375
Oklahoma,Warwick,125,21,78,5,0,6,110
Oklahoma,Wanette,279,46,96,36,2,16,196
Oklahoma,Bell,445,93,193,29,5,17,337
Oklahoma,Watts,309,56,100,34,24,16,230
Oklahoma,Wauhillau,448,60,128,64,17,25,294
Oklahoma,Waukomis,1477,307,718,89,8,44,1166
Oklahoma,Waurika,2062,376,742,358,53,140,1669
Oklahoma,Wayne,683,106,293,65,9,47,520
Oklahoma,Waynoka,1187,273,387,112,40,97,909
Oklahoma,Watonga,4110,1244,1265,621,87,179,3396
Oklahoma,Weatherford,11663,4159,4236,752,79,425,9651
Oklahoma,Walters,2554,461,1142,257,35,95,1990
Oklahoma,Wainwright,175,34,62,21,6,6,129
Oklahoma,Slick,93,23,25,18,0,12,78
Oklahoma,Smith Village,73,25,35,1,0,8,69
Oklahoma,Smithville,103,20,26,9,0,18,73
Oklahoma,Snake Creek,178,29,106,10,0,6,151
Oklahoma,Snyder,1549,225,617,201,37,113,1193
Oklahoma,Soper,202,36,77,26,4,29,172
Oklahoma,Wakita,313,59,143,34,0,39,275
Oklahoma,Sour John,41,0,30,0,0,11,41
Oklahoma,Sparks,180,33,82,20,2,8,145
Oklahoma,Spaulding,129,30,45,18,3,16,112
Oklahoma,Vian,1270,288,441,183,33,80,1025
Oklahoma,Vici,813,135,330,119,9,70,663
Oklahoma,Vinita,5610,1302,1728,917,168,402,4517
Oklahoma,Wagoner,8583,1675,3071,1110,150,683,6689
Oklahoma,South Coffeyville,781,154,301,104,12,68,639
Oklahoma,Webb City,77,5,30,7,4,5,51
Oklahoma,Webbers Falls,544,80,205,56,27,41,409
Oklahoma,Welch,644,117,271,74,14,43,519
Oklahoma,Woodall,884,200,376,80,14,23,693
Oklahoma,Woodlawn Park,160,19,103,16,0,7,145
Oklahoma,Woodward,12591,2572,4883,1283,161,669,9568
Oklahoma,Wright City,635,150,224,77,12,34,497
Oklahoma,Jefferson,13,0,7,4,0,2,13
Oklahoma,Jenks,19030,2972,8741,1601,94,572,13980
Oklahoma,Wister,1009,168,371,186,12,83,820
Oklahoma,Jennings,250,44,90,44,4,22,204
Oklahoma,Johnson,191,17,111,21,0,11,160
Oklahoma,Jones,2860,539,1246,300,44,133,2262
Oklahoma,Justice,1294,233,651,102,7,53,1046
Oklahoma,Kansas,857,225,301,99,3,35,663
Oklahoma,Katie,259,42,138,19,7,13,219
Oklahoma,Kaw City,314,46,152,44,2,26,270
Oklahoma,Jet,227,51,88,20,0,25,184
Oklahoma,Winchester,522,71,235,97,22,20,445
Oklahoma,Wilson,1581,345,595,177,30,135,1282
Oklahoma,Willow,128,34,63,14,0,11,122
Oklahoma,Weleetka,946,269,288,105,23,80,765
Oklahoma,Welling,841,128,296,115,49,59,647
Oklahoma,Wellston,778,150,341,87,20,41,639
Oklahoma,West Peavine,213,59,70,27,14,18,188
Oklahoma,Westport,440,61,270,15,6,20,372
Oklahoma,West Siloam Springs,982,193,368,128,39,90,818
Oklahoma,Westville,1701,317,587,196,72,91,1263
Oklahoma,Wetumka,1288,371,329,153,17,132,1002
Oklahoma,Wewoka,3436,898,1048,417,73,290,2726
Oklahoma,Whitefield,463,89,170,81,4,20,364
Oklahoma,White Oak,276,45,128,21,4,20,218
Oklahoma,Whitesboro,201,28,89,15,7,18,157
Oklahoma,White Water,26,0,17,9,0,0,26
Oklahoma,Wickliffe,14,0,14,0,0,0,14
Oklahoma,Wilburton,2765,759,927,316,101,189,2292
Oklahoma,Slaughterville,4226,764,1859,439,95,84,3241
Oklahoma,Skiatook,7827,1654,3051,819,106,425,6055
Oklahoma,Skedee,57,14,18,6,2,1,41
Oklahoma,Simms,296,42,177,27,6,25,277
Oklahoma,Redbird Smith,351,63,154,86,9,21,333
Oklahoma,Red Oak,598,96,254,98,20,33,501
Oklahoma,Red Rock,344,39,141,47,3,19,249
Oklahoma,Remy,548,64,312,56,0,15,447
Oklahoma,Renfrow,13,0,13,0,0,0,13
Oklahoma,Rentiesville,141,32,56,18,11,10,127
Oklahoma,Redbird,71,18,21,7,1,7,54
Oklahoma,Reydon,155,11,69,23,2,21,126
Oklahoma,Ringwood,615,136,228,51,2,18,435
Oklahoma,Ripley,315,46,130,54,4,12,246
Oklahoma,River Bottom,164,10,104,29,0,8,151
Oklahoma,Rock Island,774,145,350,76,38,15,624
Oklahoma,Rocky,156,16,92,14,6,10,138
Oklahoma,Rocky Ford,54,7,28,2,0,2,39
Oklahoma,Ringling,1026,160,414,97,13,76,760
Oklahoma,Ravia,452,64,186,69,9,40,368
Oklahoma,Rattan,289,40,114,41,8,32,235
Oklahoma,Murphy,170,69,59,23,0,13,164
Oklahoma,Nicoma Park,2440,461,986,347,5,121,1920
Oklahoma,Nichols Hills,3839,685,2051,237,19,196,3188
Oklahoma,New Woodville,156,41,42,10,0,0,93
Oklahoma,Newkirk,2283,450,826,343,35,147,1801
Oklahoma,New Eucha,554,161,274,31,0,8,474
Oklahoma,New Cordell,2920,499,1296,280,22,178,2275
Oklahoma,Newcastle,8712,1436,4242,603,89,446,6816
Oklahoma,New Alluwe,83,13,36,11,0,11,71
Oklahoma,Nescatunga,93,8,79,0,0,0,87
Oklahoma,Nash,219,18,131,12,1,16,178
Oklahoma,Nardin,92,0,92,0,0,0,92
Oklahoma,Narcissa,73,9,54,0,4,6,73
Oklahoma,Mutual,114,23,51,14,0,1,89
Oklahoma,Mustang,19112,3663,8331,2005,192,938,15129
Oklahoma,Muskogee,38776,8987,12968,4794,894,2466,30109
Oklahoma,Rocky Mountain,379,87,169,31,5,20,312
Oklahoma,Kemp,122,23,51,11,3,18,106
Oklahoma,Roff,658,111,260,72,7,34,484
Oklahoma,Roosevelt,302,78,92,53,2,22,247
Oklahoma,Seiling,833,123,314,124,3,80,644
Oklahoma,Seminole,7508,1713,2322,891,106,559,5591
Oklahoma,Sentinel,865,137,359,88,29,52,665
Oklahoma,Sequoyah,664,112,286,116,9,26,549
Oklahoma,Shady Grove CDP (Cherokee County),465,104,167,41,22,19,353
Oklahoma,Shady Grove CDP (McIntosh County),252,81,72,52,0,20,225
Oklahoma,Scraper,197,32,48,84,0,33,197
Oklahoma,Shady Point,1090,210,433,141,20,64,868
Oklahoma,Sharon,65,16,19,8,0,4,47
Oklahoma,Shattuck,1264,105,577,155,14,74,925
Oklahoma,Shawnee,30866,7002,10814,3827,614,2020,24277
Oklahoma,Shidler,415,61,154,54,15,28,312
Oklahoma,Short,455,41,208,42,0,32,323
Oklahoma,Silo,334,55,161,42,1,15,274
Oklahoma,Shamrock,61,24,15,9,0,4,52
Oklahoma,Schulter,457,57,176,68,11,31,343
Oklahoma,Sayre,4603,1622,1077,759,113,202,3773
Oklahoma,Sawyer,354,69,148,57,13,21,308
Oklahoma,Rose,149,32,56,14,0,9,111
Oklahoma,Rosedale,76,26,33,11,0,3,73
Oklahoma,Rosston,44,3,13,6,3,10,35
Oklahoma,Rush Springs,1312,212,496,226,28,69,1031
Oklahoma,Ryan,795,126,306,100,25,58,615
Oklahoma,St. Louis,115,5,64,11,2,18,100
Oklahoma,Salem,133,64,63,0,1,0,128
Oklahoma,Salina,1304,275,433,195,55,121,1079
Oklahoma,Sallisaw,8698,1669,3323,1126,274,590,6982
Oklahoma,Sams Corner,135,29,99,0,0,0,128
Oklahoma,Sand Hill,368,81,189,34,10,12,326
Oklahoma,Sand Springs,19397,3559,8299,1898,333,1108,15197
Oklahoma,Sapulpa,20399,4066,8038,2534,280,1307,16225
Oklahoma,Sasakwa,126,28,43,9,2,5,87
Oklahoma,Savanna,668,108,312,64,10,25,519
Oklahoma,Roland,3339,725,1028,386,99,243,2481
Oklahoma,Bennington,316,55,118,34,6,33,246
Oklahoma,Tamaha,142,12,79,16,1,14,122
Oklahoma,Bessie,165,28,80,24,0,9,141
Oklahoma,Indianola,0,0,0,0,0,0,0
Oklahoma,Indiahoma,346,49,131,51,7,21,259
Oklahoma,Idabel,7026,1686,2058,878,137,520,5279
Oklahoma,Hydro,976,146,347,142,14,107,756
Oklahoma,Hunter,218,21,116,19,0,8,164
Oklahoma,Hulbert,679,167,177,96,21,52,513
Oklahoma,Indianola,171,37,75,13,1,10,136
Oklahoma,Hugo,5277,1392,1248,741,129,488,3998
Oklahoma,Horntown,102,5,68,5,0,2,80
Oklahoma,Hoot Owl,0,0,0,0,0,0,0
Oklahoma,Hooker,1950,407,859,92,7,113,1478
Oklahoma,Hominy,3556,1155,927,562,125,259,3028
Oklahoma,Hollister,13,0,8,1,0,2,11
Oklahoma,Hollis,2061,371,874,214,32,138,1629
Oklahoma,Howe,916,254,254,129,50,70,757
Oklahoma,Holdenville,5748,1822,1654,729,166,400,4771
Oklahoma,Inola,1934,330,857,176,44,122,1529
Oklahoma,Isabella,199,16,86,3,0,10,115
Oklahoma,Leon,88,16,30,20,3,7,76
Oklahoma,Lequire,160,20,96,10,6,10,142
Oklahoma,Lexington,2397,461,912,314,15,181,1883
Oklahoma,Liberty,331,46,151,59,0,17,273
Oklahoma,Liberty,200,42,97,15,0,10,164
Oklahoma,Lima,62,14,24,3,0,10,51
Oklahoma,Iron Post,82,14,62,0,0,0,76
Oklahoma,Limestone,579,78,361,25,0,32,496
Oklahoma,Loco,118,26,53,13,2,8,102
Oklahoma,Locust Grove,1386,285,387,228,48,130,1078
Oklahoma,Lone Grove,5173,863,2253,618,11,187,3932
Oklahoma,Lone Wolf,450,35,246,47,9,38,375
Oklahoma,Jay,2572,541,737,432,74,162,1946
Oklahoma,IXL,39,11,14,5,0,7,37
Oklahoma,Lindsay,2815,533,1071,383,49,259,2295
Oklahoma,Hoffman,135,25,52,15,8,5,105
Oklahoma,Hobart,3685,637,1407,447,132,233,2856
Oklahoma,Hitchita,107,44,24,7,5,5,85
Oklahoma,Devol,151,22,43,26,9,4,104
Oklahoma,Dewar,898,173,359,87,15,47,681
Oklahoma,Dewey,3497,463,1329,502,47,306,2647
Oklahoma,Dibble,912,179,397,104,8,35,723
Oklahoma,Dickson,1411,219,676,83,5,88,1071
Oklahoma,Dill City,605,76,258,70,11,35,450
Oklahoma,Depew,408,69,156,34,5,51,315
Oklahoma,Disney,197,30,80,39,7,26,182
Oklahoma,Dotyville,97,20,15,0,0,37,72
Oklahoma,Dougherty,244,28,91,32,3,17,171
Oklahoma,Douglas,17,0,9,3,0,0,12
Oklahoma,Long,287,31,103,29,21,28,212
Oklahoma,Longdale,203,38,82,20,9,17,166
Oklahoma,Longtown,2925,252,1759,381,27,234,2653
Oklahoma,Dodge,118,19,83,0,0,0,102
Oklahoma,Dennis,137,22,67,0,8,9,106
Oklahoma,Del City,21898,4800,7122,2885,641,1353,16801
Oklahoma,Delaware,349,64,145,44,12,29,294
Oklahoma,Hitchcock,78,7,47,2,9,4,69
Oklahoma,Hinton,3219,936,1060,494,68,101,2659
Oklahoma,Hillsdale,133,17,71,15,0,5,108
Oklahoma,Hickory,86,14,33,8,4,0,59
Oklahoma,Henryetta,5812,1101,1965,897,93,551,4607
Oklahoma,Hennessey,2297,443,953,268,28,107,1799
Oklahoma,Hendrix,63,17,21,7,4,5,54
Oklahoma,Helena,1452,360,377,498,60,43,1338
Oklahoma,Heavener,3394,700,1232,362,142,129,2565
Oklahoma,Healdton,2784,407,1176,303,20,319,2225
Oklahoma,Davenport,849,189,317,96,8,40,650
Oklahoma,Davidson,343,117,85,57,22,21,302
Oklahoma,Davis,2738,477,1053,296,30,200,2056
Oklahoma,Deer Creek,143,40,33,22,2,17,114
Oklahoma,Deer Lick,30,18,0,12,0,0,30
Oklahoma,Lenapah,258,67,85,28,3,12,195
Oklahoma,Lost City,852,172,383,75,0,44,674
Oklahoma,Lehigh,328,53,128,40,10,21,252
Oklahoma,Leedey,440,54,210,23,0,16,303
Oklahoma,Christie,150,38,54,28,0,0,120
Oklahoma,Cimarron City,153,31,66,27,0,13,137
Oklahoma,Claremore,18922,4156,6696,2638,452,1353,15295
Oklahoma,Clarita,101,24,33,10,0,10,77
Oklahoma,Clayton,729,128,240,145,11,72,596
Oklahoma,Clearview,32,14,5,1,2,7,29
Oklahoma,Chouteau,2011,356,974,148,60,116,1654
Oklahoma,Cleora,1338,154,746,198,20,92,1210
Oklahoma,Cleveland,3238,658,1285,387,68,170,2568
Oklahoma,Clinton,9397,1611,3519,1129,145,528,6932
Oklahoma,Cloud Creek,94,13,61,5,8,0,87
Oklahoma,Coalgate,1998,393,626,309,36,227,1591
Oklahoma,Colbert,1420,229,608,128,40,123,1128
Oklahoma,Colcord,923,192,354,63,21,28,658
Oklahoma,Cleo Springs,359,30,167,35,0,21,253
Oklahoma,Cole,621,91,306,43,19,20,479
Oklahoma,Choctaw,11828,1948,5641,1111,77,510,9287
Oklahoma,Cheyenne,917,130,328,120,22,56,656
Oklahoma,Bernice,518,52,226,127,7,31,443
Oklahoma,Kiowa,616,136,238,60,8,47,489
Oklahoma,Knowles,17,0,14,3,0,0,17
Oklahoma,Konawa,1379,405,492,160,25,86,1168
Oklahoma,Krebs,2105,367,820,285,40,113,1625
Oklahoma,Kremlin,193,19,88,29,0,16,152
Oklahoma,Chickasha,16284,3407,6033,2064,313,1288,13105
Oklahoma,Lahoma,735,96,321,56,8,10,491
Oklahoma,Checotah,3324,702,1180,398,43,283,2606
Oklahoma,Chelsea,1948,310,796,262,38,116,1522
Oklahoma,Cherokee,1564,213,711,195,16,160,1295
Oklahoma,Cherry Tree,866,225,329,51,7,58,670
Oklahoma,Chester,137,41,58,5,0,4,108
Oklahoma,Chewey,84,20,22,15,2,7,66
Oklahoma,Lake Aluma,75,5,55,4,0,7,71
Oklahoma,Coleman,309,22,115,46,14,25,222
Oklahoma,Collinsville,6103,897,2774,454,161,121,4407
Oklahoma,Colony,133,5,66,15,4,12,102
Oklahoma,Dacoma,93,14,56,10,0,6,86
Oklahoma,Dale,185,23,51,38,0,11,123
Oklahoma,Lamar,140,25,59,20,3,10,117
Oklahoma,Lambert,9,5,4,0,0,0,9
Oklahoma,Lamont,298,46,146,27,1,12,232
Oklahoma,Lane,371,39,188,45,5,20,297
Oklahoma,Cyril,1171,169,455,169,15,69,877
Oklahoma,Langley,768,156,281,120,27,61,645
Oklahoma,Latta,1180,172,387,121,30,62,772
Oklahoma,Laverne,1348,243,567,79,0,73,962
Oklahoma,Lawrence Creek,231,21,90,25,11,28,175
Oklahoma,Lawton,97589,26178,32232,11911,1861,4680,76862
Oklahoma,Leach,259,47,121,14,2,12,196
Oklahoma,Lebanon,206,12,110,11,0,36,169
Oklahoma,Langston,1434,1013,219,75,9,35,1351
Oklahoma,Custer City,332,40,173,36,4,28,281
Oklahoma,Cushing,7879,1939,2826,957,126,510,6358
Oklahoma,Crowder,372,67,166,56,9,18,316
Oklahoma,Comanche,1590,269,562,255,40,117,1243
Oklahoma,Commerce,2475,437,824,336,65,206,1868
Oklahoma,Connerville,44,25,0,7,0,12,44
Oklahoma,Cooperton,0,0,0,0,0,0,0
Oklahoma,Copan,768,114,339,87,8,66,614
Oklahoma,Copeland,1490,239,678,271,34,89,1311
Oklahoma,Corn,518,83,221,41,5,102,452
Oklahoma,Cornish,213,54,84,25,0,6,169
Oklahoma,Council Hill,116,18,55,7,4,10,94
Oklahoma,Covington,483,67,215,43,9,16,350
Oklahoma,Coweta,9517,1752,3791,1060,114,436,7153
Oklahoma,Cowlington,142,25,58,9,6,12,110
Oklahoma,Coyle,282,101,95,29,0,14,239
Oklahoma,Crescent,1277,243,487,143,10,179,1062
Oklahoma,Cromwell,270,39,122,33,7,15,216
Oklahoma,Le Flore,177,35,67,17,1,17,137
Oklahoma,Lotsee,3,0,3,0,0,0,3
Oklahoma,Lookeba,154,37,50,10,0,13,110
Oklahoma,Loyal,80,8,45,7,0,0,60
Oklahoma,Greenfield,96,16,50,7,0,7,80
Oklahoma,Gregory,156,57,62,0,6,0,125
Oklahoma,Grove,6685,770,3016,1067,87,700,5640
Oklahoma,Guthrie,10871,2979,3674,1174,251,864,8942
Oklahoma,Guymon,11978,2660,4903,842,133,542,9080
Oklahoma,Haileyville,734,138,240,131,13,57,579
Oklahoma,Hallett,115,21,49,8,4,8,90
Oklahoma,Butler,144,49,58,26,0,0,133
Oklahoma,Byars,198,41,96,11,3,15,166
Oklahoma,Byng,1297,260,626,103,9,55,1053
Oklahoma,Byron,39,3,35,0,0,1,39
Oklahoma,Cache,2919,552,1268,268,27,176,2291
Oklahoma,Caddo,1145,207,437,137,28,84,893
Oklahoma,Calera,2576,592,890,327,40,127,1976
Oklahoma,Calumet,691,145,296,60,11,34,546
Oklahoma,Calvin,288,44,97,44,0,21,206
Oklahoma,Camargo,204,50,92,14,0,0,156
Oklahoma,Greasy,310,49,144,28,0,28,249
Oklahoma,Grayson,139,19,58,28,0,4,109
Oklahoma,Grant,268,52,135,31,3,3,224
Oklahoma,Granite,1835,642,485,353,69,99,1648
Oklahoma,Blanco,127,21,48,16,0,6,91
Oklahoma,Blanchard,8000,1269,3967,566,82,274,6158
Oklahoma,Blair,665,103,276,80,0,38,497
Oklahoma,Blackwell,6932,1076,2701,848,179,620,5424
Oklahoma,Blackgum,60,5,0,16,0,14,35
Oklahoma,Blackburn,76,7,44,5,0,9,65
Oklahoma,Bixby,23171,3422,10870,1669,185,984,17130
Oklahoma,Bison,66,0,34,10,4,0,48
Oklahoma,Cameron,304,73,119,36,3,14,245
Oklahoma,Binger,586,86,259,68,9,52,474
Oklahoma,Big Cabin,258,40,108,17,8,18,191
Oklahoma,Bethel Acres,3021,579,1510,240,22,152,2503
Oklahoma,Loveland,6,0,4,2,0,0,6
Oklahoma,Bethany,19478,4895,6432,2368,270,1381,15346
Oklahoma,Grainola,40,1,24,3,0,1,29
Oklahoma,Grandfield,915,86,391,83,29,66,655
Oklahoma,Grand Lake Towne,137,11,101,5,5,3,125
Oklahoma,Grandview,450,253,119,22,0,0,394
Oklahoma,Billings,519,202,143,70,6,28,449
Oklahoma,Canadian,175,27,85,24,1,5,142
Oklahoma,Hammon,523,134,174,44,2,19,373
Oklahoma,Canton,478,53,203,45,0,34,335
Oklahoma,Goodwell,1287,721,254,97,22,21,1115
Oklahoma,Gore,1024,199,388,138,11,104,840
Oklahoma,Gotebo,167,12,79,20,2,27,140
Oklahoma,Gould,171,23,90,17,1,5,136
Oklahoma,Gowen,295,86,131,0,0,9,226
Oklahoma,Gracemont,220,53,56,39,4,17,169
Oklahoma,Caney,212,34,76,25,4,19,158
Oklahoma,Hardesty,289,63,85,16,27,9,200
Oklahoma,Harrah,5551,720,2343,652,15,358,4088
Oklahoma,Hartshorne,2125,319,877,321,70,110,1697
Oklahoma,Haskell,1904,319,785,227,19,128,1478
Oklahoma,Hastings,51,6,24,11,0,10,51
Oklahoma,Haworth,262,53,83,48,2,19,205
Oklahoma,Headrick,126,30,42,0,6,7,85
Oklahoma,Lyons Switch,355,48,166,26,5,9,254
Oklahoma,Luther,1122,186,469,130,20,39,844
Oklahoma,Lucien,100,20,32,16,0,6,74
Oklahoma,Chattanooga,435,78,140,65,13,31,327
Oklahoma,Chandler,3121,683,986,439,98,221,2427
Oklahoma,Hanna,121,27,38,6,3,10,84
Oklahoma,Centrahoma,71,5,25,12,0,11,53
Oklahoma,Canute,390,42,219,34,0,21,316
Oklahoma,Central High,982,112,634,77,4,20,847
Oklahoma,Capron,3,1,0,0,0,2,3
Oklahoma,Carlisle,451,48,286,25,12,4,375
Oklahoma,Carlton Landing,9,4,3,0,0,0,7
Oklahoma,Carmen,509,87,164,61,28,40,380
Oklahoma,Carnegie,2072,455,739,241,32,99,1566
Oklahoma,Carney,621,117,273,52,14,38,494
Oklahoma,Carter,338,55,124,43,0,12,234
Oklahoma,Cartwright,588,39,249,58,14,40,400
Oklahoma,Carrier,56,4,30,7,6,0,47
Oklahoma,Cedar Crest,166,49,23,54,0,28,154
Oklahoma,Castle,137,22,62,8,2,4,98
Oklahoma,Cement,507,80,215,49,5,33,382
Oklahoma,Catoosa,7406,1649,3053,738,97,349,5886
Oklahoma,Cayuga,95,9,36,8,4,24,81
Oklahoma,Cashion,747,149,318,90,0,38,595
Oklahoma,Cedar Valley,419,36,273,21,0,24,354
Oregon,Ukiah,187,60,65,38,2,2,167
Oregon,Umapine,266,60,98,59,0,24,241
Oregon,Umatilla,6999,2525,1872,998,158,114,5667
Oregon,Union,2109,562,831,233,15,74,1715
Oregon,Vale,1850,416,636,144,27,117,1340
Oregon,Wallowa,733,90,321,82,37,61,591
Oregon,Waldport,1943,429,836,218,45,159,1687
Oregon,Vernonia,1903,406,828,251,16,79,1580
Oregon,Tygh Valley,221,57,106,24,20,14,221
Oregon,Veneta,4687,928,1705,486,51,328,3498
Oregon,Unity,50,4,30,11,1,2,48
Oregon,Tutuilla,497,120,235,31,13,22,421
Oregon,Brookings,6376,1301,2603,1049,87,581,5621
Oregon,Tumalo,537,104,320,57,0,0,481
Oregon,Tualatin,26806,6207,11578,2521,285,827,21418
Oregon,Troutdale,16479,4006,6688,1652,159,348,12853
Oregon,Tri-City,3645,887,1550,464,103,159,3163
Oregon,Trail,478,21,218,183,0,16,438
Oregon,Toledo,3469,739,1401,428,32,148,2748
Oregon,Tillamook,4958,1085,1531,895,79,273,3863
Oregon,Wallowa Lake,78,0,78,0,0,0,78
Oregon,Bunker Hill,1342,302,335,132,0,145,914
Oregon,Bull Mountain,9188,1782,4772,508,88,149,7299
Oregon,Brownsville,1561,319,708,187,27,37,1278
Oregon,Brooks,977,110,389,135,0,101,735
Oregon,Turner,2525,564,1147,218,21,113,2063
Oregon,Wamic,61,0,51,10,0,0,61
Oregon,Cannon Beach,1549,442,619,254,14,99,1428
Oregon,Warren,1776,278,1036,45,26,43,1428
Oregon,Alpine,84,0,54,0,0,8,62
Oregon,Aloha,53879,13353,20896,4637,749,1504,41139
Oregon,Albany,51511,12319,19367,5976,942,2124,40728
Oregon,Adrian,154,32,59,35,0,11,137
Oregon,Adams,370,67,167,37,8,25,304
Oregon,Adair Village,828,154,357,36,20,17,584
Oregon,Cascade Locks,1052,167,415,196,9,93,880
Oregon,Carlton,1869,361,709,202,46,80,1398
Oregon,Cape Meares,143,5,111,0,0,19,135
Oregon,Canyonville,2361,362,1036,218,44,157,1817
Oregon,Canyon City,801,127,396,79,17,51,670
Oregon,Canby,16951,3041,7490,1644,360,667,13202
Oregon,Camp Sherman,323,68,224,15,1,2,310
Oregon,Butteville,150,36,54,0,0,8,98
Oregon,Butte Falls,391,142,99,64,14,14,333
Oregon,Burns,2763,672,1210,358,50,102,2392
Oregon,Brogan,220,23,124,12,0,13,172
Oregon,Alsea,146,16,64,13,0,3,96
Oregon,Warm Springs,3433,1193,672,378,36,104,2383
Oregon,Altamont,19502,4114,7408,2837,189,946,15494
Oregon,Annex,230,53,88,24,6,19,190
Oregon,Warrenton,5143,1035,1839,649,120,226,3869
Oregon,Wasco,431,97,175,56,7,20,355
Oregon,Waterloo,264,67,129,23,1,12,232
Oregon,Westfir,279,64,129,26,1,16,236
Oregon,Condon,561,41,288,80,0,73,482
Oregon,Columbia City,2419,434,1251,210,13,107,2015
Oregon,Coburg,1149,231,532,122,11,38,934
Oregon,Cloverdale,305,22,162,21,0,8,213
Oregon,Clatskanie,1782,383,733,213,12,130,1471
Oregon,Chiloquin,815,175,232,114,36,37,594
Oregon,Chenoweth,1722,358,901,109,13,63,1444
Oregon,Central Point,17604,2961,7657,1989,195,849,13651
Oregon,Cedar Mill,15638,3151,7201,1374,80,330,12136
Oregon,Cedar Hills,8811,2443,3457,943,52,265,7160
Oregon,Cayuse,64,14,21,2,8,3,48
Oregon,Cave Junction,2002,389,733,342,34,103,1601
Oregon,Cascadia,199,54,69,27,5,0,155
Oregon,Amity,1558,271,610,235,29,81,1226
Oregon,Bonanza,506,100,211,33,8,31,383
Oregon,Dayville,150,35,70,14,2,11,132
Oregon,Blodgett,56,0,56,0,0,0,56
Oregon,Prescott,54,5,16,24,0,8,53
Oregon,Prairie City,813,157,379,61,18,50,665
Oregon,Powers,760,221,218,125,22,65,651
Oregon,Port Orford,1312,287,430,304,15,98,1134
Oregon,Portland,612206,207931,210733,64785,10282,21786,515517
Oregon,Plush,45,3,26,9,0,3,41
Oregon,Pistol River,112,0,28,41,0,43,112
Oregon,Prineville,9266,1895,3528,1516,129,682,7750
Oregon,Pine Hollow,544,75,291,83,0,31,480
Oregon,Pilot Rock,1476,375,455,178,45,104,1157
Oregon,Phoenix,4500,947,1600,748,274,374,3943
Oregon,Philomath,4597,988,2105,375,25,167,3660
Oregon,Peoria,130,0,92,14,0,0,106
Oregon,Pendleton,16882,4247,6411,2233,175,627,13693
Oregon,Parkdale,378,111,112,31,0,10,264
Oregon,Paisley,345,54,183,29,0,22,288
Oregon,Pine Grove,89,4,68,13,4,0,89
Oregon,Pronghorn,31,0,31,0,0,0,31
Oregon,Prospect,459,113,225,47,10,28,423
Oregon,Rainier,1961,437,699,291,73,102,1602
Oregon,Ruch,913,183,429,89,0,36,737
Oregon,Rowena,207,40,106,33,0,0,179
Oregon,Rose Lodge,1955,344,927,243,50,112,1676
Oregon,Roseburg North,6439,1396,1954,1294,82,567,5293
Oregon,Roseburg,21937,4901,8390,2933,320,1837,18381
Oregon,Rogue River,2442,419,832,451,83,231,2016
Oregon,Rockcreek,9245,1939,4547,836,5,289,7616
Oregon,Rockaway Beach,1227,208,573,149,14,118,1062
Oregon,Riverside,148,33,41,36,3,12,125
Oregon,Rivergrove,355,63,198,19,0,7,287
Oregon,Riddle,1164,214,412,245,30,88,989
Oregon,Rickreall,75,0,39,0,0,0,39
Oregon,Richland,173,16,101,10,0,13,140
Oregon,Reedsport,4111,749,1680,446,175,374,3424
Oregon,Redwood,2766,401,1429,212,57,218,2317
Oregon,Redmond,27450,5837,10395,2865,590,1204,20891
Oregon,Raleigh Hills,5751,1259,2496,565,134,465,4919
Oregon,Pacific City,963,149,581,128,0,46,904
Oregon,Hood River,7412,2195,2463,654,209,403,5924
Oregon,Oregon City,34480,7498,13990,4319,441,1030,27278
Oregon,Odell,2525,556,1110,78,18,27,1789
Oregon,Myrtle Creek,3422,924,1077,492,99,241,2833
Oregon,Mulino,2661,574,1188,171,37,119,2089
Oregon,Mount Vernon,625,161,239,106,8,28,542
Oregon,Mount Hood Village,5497,1187,2800,628,90,102,4807
Oregon,Mount Hood,235,23,177,0,0,0,200
Oregon,Mount Angel,3389,953,1316,252,39,183,2743
Oregon,Mosier,476,91,215,51,4,29,390
Oregon,Myrtle Point,2495,525,991,334,47,208,2105
Oregon,Bandon,3070,436,1315,553,51,219,2574
Oregon,Aurora,1192,232,576,127,14,23,972
Oregon,Aumsville,3823,747,1373,419,48,208,2795
Oregon,Athena,1069,250,411,120,35,44,860
Oregon,Astoria,9537,2097,3929,1334,215,574,8149
Oregon,Ashland,20556,6450,7114,3085,290,947,17886
Oregon,Arlington,596,124,234,47,37,11,453
Oregon,Antelope,12,0,9,1,0,2,12
Oregon,Baker City,9777,2076,3852,1205,185,733,8051
Oregon,Neahkahnie,80,11,49,0,0,20,80
Oregon,Nehalem,254,42,123,31,6,20,222
Oregon,Nesika Beach,430,81,282,36,17,14,430
Oregon,Oceanside,338,20,86,130,16,70,322
Oregon,O'Brien,116,74,42,0,0,0,116
Oregon,Oatfield,13852,3139,6361,1170,122,999,11791
Oregon,Oakridge,3205,479,1700,479,54,223,2935
Oregon,Oakland,691,153,280,132,15,34,614
Oregon,Oak Hills,11916,2694,5228,936,67,243,9168
Oregon,Oak Grove,17149,3918,6380,2202,388,1254,14142
Oregon,Nyssa,3189,650,1292,231,5,101,2279
Oregon,North Powder,515,63,203,32,31,26,355
Oregon,North Plains,1945,506,866,167,6,73,1618
Oregon,North Bend,9583,1825,3702,1191,172,661,7551
Oregon,Newport,10101,2120,4104,1385,258,576,8443
Oregon,New Pine Creek,151,26,69,14,0,19,128
Oregon,New Hope,1342,322,712,136,0,53,1223
Oregon,Newberg,22566,7061,8209,2049,324,927,18570
Oregon,Netarts,958,221,385,189,0,85,880
Oregon,Neskowin,156,0,111,0,17,28,156
Oregon,Ontario,11089,2613,3514,1277,241,779,8424
Oregon,Holley,285,34,158,23,4,15,234
Oregon,Hines,1402,232,645,149,19,73,1118
Oregon,Hillsboro,97751,22602,40596,8880,1568,2858,76504
Oregon,Donald,1115,191,512,159,23,29,914
Oregon,Drain,1194,268,471,143,41,88,1011
Oregon,Dufur,640,52,282,69,4,38,445
Oregon,Dundee,3184,629,1492,285,25,63,2494
Oregon,Dunes City,1263,174,722,122,13,117,1148
Oregon,Durham,1459,308,662,181,3,42,1196
Oregon,Eagle Crest,1685,77,1285,208,25,15,1610
Oregon,Dillard,434,62,159,14,23,42,300
Oregon,Eagle Point,8701,1992,3185,1118,64,429,6788
Oregon,Elgin,1527,288,653,211,31,89,1272
Oregon,Elkton,225,23,96,26,4,11,160
Oregon,Enterprise,1915,320,793,239,32,190,1574
Oregon,Eola,0,0,0,0,0,0,0
Oregon,Estacada,2968,702,992,426,56,190,2366
Oregon,Eugene,159615,58475,52108,17260,1864,6561,136268
Oregon,Fair Oaks,327,22,227,6,32,8,295
Oregon,Echo,734,156,282,75,11,68,592
Oregon,Detroit,119,35,49,24,6,5,119
Oregon,Deschutes River Woods,5328,935,2644,566,39,145,4329
Oregon,Depoe Bay,1877,455,927,242,20,101,1745
Oregon,Black Butte Ranch,260,14,189,0,0,57,260
Oregon,Biggs Junction,22,22,0,0,0,0,22
Oregon,Bethany,22346,3409,11257,1051,84,635,16436
Oregon,Bend,81780,17976,33955,9902,1110,3355,66298
Oregon,Bellfountain,101,0,23,0,0,17,40
Oregon,Beaverton,93919,24749,36318,9722,1584,3251,75624
Oregon,Beaver,193,11,44,62,0,10,127
Oregon,Beatty,0,0,0,0,0,0,0
Oregon,Bayside Gardens,618,112,248,91,35,70,556
Oregon,Bay City,1466,264,613,237,3,88,1205
Oregon,Barview,1719,305,732,273,99,101,1510
Oregon,Barlow,147,51,55,14,1,5,126
Oregon,Banks,1580,309,664,140,11,34,1158
Oregon,Days Creek,316,58,128,51,3,34,274
Oregon,Dayton,2539,445,1149,163,32,55,1844
Oregon,Tigard,50276,12012,21379,5311,587,2018,41307
Oregon,Deer Island,383,71,214,71,5,0,361
Oregon,Fairview,9181,2112,3676,982,198,307,7275
Oregon,Falls City,994,209,435,102,33,56,835
Oregon,Florence,8545,1426,4025,1221,213,697,7582
Oregon,Foots Creek,623,63,436,57,0,11,567
Oregon,Grants Pass,36378,7498,13241,5065,549,2623,28976
Oregon,Grass Valley,176,34,80,27,0,9,150
Oregon,Green,7895,1563,3436,946,195,277,6417
Oregon,Greenhorn,9,0,9,0,0,0,9
Oregon,Gresham,109308,28861,38797,10972,2093,4723,85446
Oregon,Haines,406,94,194,38,0,23,349
Oregon,Halfway,314,42,124,42,8,38,254
Oregon,Halsey,1128,200,504,109,5,23,841
Oregon,Happy Valley,16462,3078,8399,895,142,359,12873
Oregon,Harbor,1978,419,680,400,76,279,1854
Oregon,Harper,99,9,54,7,0,4,74
Oregon,Harrisburg,3660,653,1738,201,24,91,2707
Oregon,Hayesville,19296,4181,6828,1618,779,793,14199
Oregon,Hebo,218,20,194,0,2,0,216
Oregon,Helix,204,22,82,14,4,13,135
Oregon,Heppner,1151,170,542,116,29,85,942
Oregon,Hermiston,17121,3450,6277,1620,185,646,12178
Oregon,Granite,23,0,7,13,0,3,23
Oregon,Boardman,3320,835,1247,134,41,118,2375
Oregon,Grand Ronde,1636,318,715,157,40,107,1337
Oregon,Gopher Flats,371,73,142,74,5,31,325
Oregon,Forest Grove,22823,5961,8469,2048,260,1128,17866
Oregon,Fort Hill,123,47,23,53,0,0,123
Oregon,Fossil,401,55,233,62,7,35,392
Oregon,Four Corners,16483,4453,6449,1386,189,748,13225
Oregon,Garden Home-Whitford,6138,1665,2661,746,42,305,5419
Oregon,Gardiner,207,88,54,37,0,28,207
Oregon,Garibaldi,782,124,416,82,13,50,685
Oregon,Gaston,616,119,262,103,8,24,516
Oregon,Gates,464,81,181,91,19,36,408
Oregon,Gearhart,1462,271,668,121,29,127,1216
Oregon,Gervais,2562,766,881,81,79,51,1858
Oregon,Gladstone,11741,2912,4295,1643,221,609,9680
Oregon,Glasgow,596,63,293,66,0,93,515
Oregon,Glendale,801,166,324,120,23,31,664
Oregon,Glide,1916,155,936,197,50,66,1404
Oregon,Gold Beach,2346,414,1102,339,8,115,1978
Oregon,Gold Hill,1194,211,452,225,29,47,964
Oregon,Government Camp,120,0,93,0,14,0,107
Oregon,Three Rivers,4232,1119,1968,504,18,45,3654
Oregon,Beavercreek,3945,772,2254,212,16,106,3360
Oregon,Tetherow,128,24,104,0,0,0,128
Oregon,Lakeview,2561,479,1024,342,56,179,2080
Oregon,Langlois,162,48,0,56,0,39,143
Oregon,La Pine,1664,267,705,251,30,138,1391
Oregon,Lebanon,15962,3529,6220,1809,211,984,12753
Oregon,Lexington,189,30,92,17,0,9,148
Oregon,Lincoln Beach,1198,214,489,275,0,205,1183
Oregon,Lincoln City,8386,1765,3160,1323,220,550,7018
Oregon,Lakeside,1539,102,943,170,18,151,1384
Oregon,Lonerock,18,4,8,3,0,3,18
Oregon,Lookingglass,989,106,385,256,16,49,812
Oregon,Lostine,316,56,142,18,16,13,245
Oregon,Lowell,1089,166,426,172,6,79,849
Oregon,Lyons,1174,157,602,71,13,40,883
Oregon,McMinnville,33185,7300,13111,3201,527,1835,25974
Oregon,Madras,6487,1883,1987,729,119,178,4896
Oregon,Malin,731,125,335,56,6,30,552
Oregon,Long Creek,173,42,79,20,0,8,149
Oregon,Manzanita,426,45,216,49,0,56,366
Oregon,Lake Oswego,37628,6987,18291,3749,416,1826,31269
Oregon,Lafayette,3824,829,1677,280,17,86,2889
Oregon,Jefferson,3174,664,1238,303,68,114,2387
Oregon,Jennings Lodge,7691,2029,2638,878,186,352,6083
Oregon,John Day,1717,329,614,227,35,118,1323
Oregon,Johnson City,573,71,209,122,20,44,466
Oregon,Jordan Valley,153,15,87,9,1,22,134
Oregon,Joseph,1053,215,425,140,12,92,884
Oregon,Junction City,5673,1130,2223,838,46,245,4482
Oregon,La Grande,13088,3716,4703,1408,230,777,10834
Oregon,Juntura,37,9,16,3,0,0,28
Oregon,Kerby,709,353,80,148,0,0,581
Oregon,King City,3464,392,1084,687,17,686,2866
Oregon,Kings Valley,72,7,21,7,0,37,72
Oregon,Kirkpatrick,145,48,49,9,0,10,116
Oregon,Klamath Falls,21261,5555,7658,2855,394,1069,17531
Oregon,Labish Village,218,22,129,0,0,0,151
Oregon,Lacomb,633,74,351,45,0,0,470
Oregon,Keizer,37115,8491,14524,3695,438,1837,28985
Oregon,Marion,232,54,144,0,0,0,198
Oregon,Maupin,593,108,276,94,2,45,525
Oregon,Maywood Park,872,167,455,68,11,36,737
Oregon,Wood Village,3971,1027,1326,283,53,116,2805
Oregon,Woodburn,24496,5081,9009,2088,512,1267,17957
Oregon,Winston,5363,1010,2082,467,93,410,4062
Oregon,Winchester Bay,316,22,282,12,0,0,316
Oregon,Wimer,647,62,406,106,1,55,630
Oregon,Wilsonville,20837,4755,8510,2661,452,736,17114
Oregon,Williams,1037,153,578,110,0,49,890
Oregon,Yachats,658,92,330,81,11,78,592
Oregon,Willamina,1811,511,522,306,48,96,1483
Oregon,Wheeler,397,107,133,67,16,26,349
Oregon,West Slope,7536,1671,3417,638,63,232,6021
Oregon,West Scio,127,0,53,0,0,28,81
Oregon,Westport,309,27,200,43,0,15,285
Oregon,Weston,723,163,328,50,0,48,589
Oregon,West Linn,25963,5112,13069,2015,217,756,21169
Oregon,West Haven-Sylvan,7991,2073,3857,979,38,236,7183
Oregon,White City,9296,2328,3301,1072,209,239,7149
Oregon,Yamhill,1132,234,476,91,7,28,836
Oregon,Yoncalla,1155,210,476,185,16,107,994
Oregon,The Dalles,15136,2984,5976,1504,452,1160,12076
Oregon,Medford,77579,18231,28644,9493,1410,4157,61935
Oregon,Mehama,196,24,123,0,0,11,158
Oregon,Melrose,809,306,366,49,0,73,794
Oregon,Merlin,1481,390,674,226,22,132,1444
Oregon,Merrill,885,167,351,58,10,55,641
Oregon,Metolius,1131,189,444,95,26,35,789
Oregon,Metzger,4035,705,1659,715,87,94,3260
Oregon,Mill City,1781,325,782,157,41,103,1408
Oregon,Millersburg,1661,224,835,128,25,86,1298
Oregon,Milton-Freewater,7089,1823,2305,579,106,345,5158
Oregon,Milwaukie,20566,5617,7577,2923,295,1217,17629
Oregon,Mission,970,297,185,112,20,24,638
Oregon,Mitchell,122,16,68,13,3,9,109
Oregon,Molalla,8726,1916,3449,923,64,258,6610
Oregon,Monmouth,9869,4352,2767,624,63,435,8241
Oregon,Monument,89,15,40,7,2,13,77
Oregon,Moro,372,73,142,48,2,27,292
Oregon,Jeffers Gardens,344,119,109,64,0,12,304
Oregon,Jacksonville,2827,319,1645,355,16,287,2622
Oregon,Monroe,677,164,300,69,0,36,569
Oregon,Irrigon,2217,446,863,119,38,81,1547
Oregon,Cove,606,69,294,69,9,38,479
Oregon,Cottage Grove,9819,2015,3351,1207,209,777,7559
Oregon,Corvallis,54981,25458,16938,3789,363,2048,48596
Oregon,Cornelius,12186,3107,4604,721,242,402,9076
Oregon,Coquille,3846,938,1375,834,7,333,3487
Oregon,Coos Bay,16062,3194,6042,2381,297,1347,13261
Oregon,Rufus,242,27,118,44,11,20,220
Oregon,St. Helens,13055,2750,4885,1724,339,576,10274
Oregon,St. Paul,386,58,193,27,0,12,290
Oregon,Salem,160008,41741,57068,18312,2989,6548,126658
Oregon,Sandy,10134,1526,4559,881,157,454,7577
Oregon,Scappoose,6839,1266,2776,756,76,411,5285
Oregon,Sodaville,367,78,180,35,8,14,315
Oregon,Crabtree,526,52,315,0,0,0,367
Oregon,Sisters,2596,647,1154,196,26,64,2087
Oregon,Scio,832,226,285,76,20,20,627
Oregon,Scotts Mills,459,89,218,45,4,9,365
Oregon,Seaside,6483,1526,2318,866,125,614,5449
Oregon,Selma,675,65,387,113,0,87,652
Oregon,Seneca,188,46,90,23,9,11,179
Oregon,Seventh Mountain,203,0,193,0,0,10,203
Oregon,Shady Cove,2960,265,1660,383,50,114,2472
Oregon,Shaniko,6,0,3,3,0,0,6
Oregon,Shedd,161,44,61,0,0,10,115
Oregon,Sheridan,6048,1715,2010,997,257,183,5162
Oregon,Sherwood,18880,3006,8346,1550,141,593,13636
Oregon,Siletz,1736,367,653,196,18,132,1366
Oregon,Silverton,9436,1548,3723,1099,318,497,7185
Oregon,Island City,1186,209,573,109,0,35,926
Oregon,Crane,136,22,71,14,0,5,112
Oregon,Silver Lake,93,0,54,32,0,0,86
Oregon,Creswell,5085,908,2088,736,58,203,3993
Oregon,Crawfordsville,269,94,109,39,9,10,261
Oregon,Independence,8772,2338,3034,870,122,176,6540
Oregon,Imbler,315,61,153,19,6,24,263
Oregon,Idaville,389,82,211,19,0,33,345
Oregon,Idanha,198,62,78,23,3,12,178
Oregon,Huntington,323,62,133,58,7,42,302
Oregon,Hubbard,3219,605,1175,205,39,107,2131
Oregon,Terrebonne,1182,268,407,230,0,88,993
Oregon,Tangent,1022,179,467,108,9,50,813
Oregon,Talent,6244,1440,2264,870,80,363,5017
Oregon,Takilma,266,46,137,13,0,31,227
Oregon,Ione,255,33,143,17,0,20,213
Oregon,Sutherlin,7821,1383,3109,855,187,528,6062
Oregon,Sweet Home,9140,1749,3341,1141,314,514,7059
Oregon,Springfield,60235,16498,20522,7902,919,2782,48623
Oregon,Damascus,10748,2163,5666,812,44,382,9067
Oregon,South Lebanon,1148,255,543,151,7,15,971
Oregon,Spray,148,24,92,2,0,13,131
Oregon,Sunriver,1022,140,609,135,25,42,951
Oregon,Stafford,1892,361,1038,128,0,43,1570
Oregon,Stanfield,2241,505,846,270,17,127,1765
Oregon,Stayton,7809,1632,3105,986,152,181,6056
Oregon,Sublimity,2796,467,1079,390,55,295,2286
Oregon,Summerville,78,5,42,5,1,7,60
Oregon,Summit,98,17,65,16,0,0,98
Oregon,Sumpter,175,8,101,43,5,12,169
Oregon,Dallas,14896,2864,6033,1594,241,939,11671
Oregon,Culver,1414,246,589,136,27,32,1030
Pennsylvania,Bellwood borough,1811,384,737,166,14,112,1413
Pennsylvania,New Berlinville,1453,285,683,197,0,166,1331
Pennsylvania,New Berlin borough,964,129,507,74,2,32,744
Pennsylvania,New Bedford,934,159,509,64,0,132,864
Pennsylvania,New Beaver borough,1554,407,668,171,16,85,1347
Pennsylvania,New Baltimore borough,167,39,91,7,0,10,147
Pennsylvania,Beaver Springs,575,67,244,44,29,40,424
Pennsylvania,New Alexandria borough,635,126,379,25,4,49,583
Pennsylvania,Benson borough,177,56,61,25,6,8,156
Pennsylvania,Bendersville borough,738,141,293,58,3,22,517
Pennsylvania,Ben Avon Heights borough,362,43,206,21,2,10,282
Pennsylvania,Ben Avon borough,1692,296,804,158,32,48,1338
Pennsylvania,Beavertown borough,957,255,425,59,8,41,788
Pennsylvania,Bechtelsville borough,878,235,364,83,12,38,732
Pennsylvania,Bedford borough,2778,661,1130,312,17,249,2369
Pennsylvania,Beech Creek borough,715,165,360,53,0,57,635
Pennsylvania,Beech Mountain Lakes,1723,170,932,266,13,73,1454
Pennsylvania,Belfast,1083,156,516,108,21,125,926
Pennsylvania,Beaver Meadows borough,644,136,260,95,8,47,546
Pennsylvania,Bellefonte borough,6285,1498,2572,438,17,669,5194
Pennsylvania,Belle Vernon borough,1100,386,207,170,34,171,968
Pennsylvania,Belleville,1853,305,867,80,43,295,1590
Pennsylvania,Bellevue borough,8329,3024,2730,1036,174,427,7391
Pennsylvania,Belmont,2665,545,1251,172,41,367,2376
Pennsylvania,Bell Acres borough,1444,294,748,58,34,59,1193
Pennsylvania,Avonia,1087,209,498,124,10,85,926
Pennsylvania,Beaverdale,1144,232,463,53,63,69,880
Pennsylvania,Avonmore borough,985,235,360,83,23,124,825
Pennsylvania,Baden borough,4075,1099,1787,212,98,403,3599
Pennsylvania,Baidland,1637,315,871,145,0,96,1427
Pennsylvania,Baileyville,378,128,90,30,35,61,344
Pennsylvania,Roulette,782,183,258,103,51,67,662
Pennsylvania,Rouseville borough,560,150,194,41,6,50,441
Pennsylvania,Rouzerville,922,154,480,93,10,49,786
Pennsylvania,Rowes Run,456,51,237,78,27,15,408
Pennsylvania,Royalton borough,1031,239,361,125,43,49,817
Pennsylvania,Royersford borough,4782,1521,1273,753,167,194,3908
Pennsylvania,Bainbridge,1623,328,652,112,38,118,1248
Pennsylvania,Bairdford,1101,135,479,147,0,107,868
Pennsylvania,Bakerstown,2328,333,1179,78,12,252,1854
Pennsylvania,Baldwin borough,19803,5207,8336,1243,142,1612,16540
Pennsylvania,Bally borough,1273,246,566,133,23,70,1038
Pennsylvania,Bangor borough,5233,1388,1906,410,118,325,4147
Pennsylvania,Barkeyville borough,245,40,126,21,0,27,214
Pennsylvania,Barrville,269,50,123,0,0,0,173
Pennsylvania,Bath borough,2680,553,854,290,61,227,1985
Pennsylvania,Baumstown,521,55,258,9,0,23,345
Pennsylvania,Beallsville borough,483,87,243,22,11,32,395
Pennsylvania,Bear Creek Village borough,316,48,171,25,1,5,250
Pennsylvania,Bear Lake borough,148,26,62,20,2,13,123
Pennsylvania,Bear Rocks,944,110,553,78,9,46,796
Pennsylvania,Beaver borough,4467,984,1889,477,36,417,3803
Pennsylvania,Beaver Falls,8768,3019,1963,819,318,668,6787
Pennsylvania,New Bethlehem borough,858,191,316,96,8,127,738
Pennsylvania,New Florence borough,806,160,342,54,15,50,621
Pennsylvania,New Britain borough,3026,1176,1063,211,55,97,2602
Pennsylvania,Sheffield,1132,206,573,41,15,96,931
Pennsylvania,Sheatown,720,235,175,63,7,118,598
Pennsylvania,Sheakleyville borough,175,55,41,26,4,7,133
Pennsylvania,Shavertown,2392,467,848,346,66,203,1930
Pennsylvania,Shartlesville,519,136,261,44,0,48,489
Pennsylvania,Sharpsville borough,4320,823,1680,556,76,275,3410
Pennsylvania,Sharpsburg borough,3426,1232,863,609,37,190,2931
Pennsylvania,Sharon Hill borough,5693,1826,1505,623,124,300,4378
Pennsylvania,Sharon,13754,4164,3996,1623,258,1203,11244
Pennsylvania,Shanor-Northvue,5028,823,2508,258,72,425,4086
Pennsylvania,Shanksville borough,240,38,114,37,0,9,198
Pennsylvania,Shamokin Dam borough,1664,289,754,170,39,170,1422
Pennsylvania,Shamokin,7253,2014,2334,918,221,506,5993
Pennsylvania,Shade Gap borough,133,28,42,23,2,2,97
Pennsylvania,Sewickley Hills borough,607,117,310,27,9,37,500
Pennsylvania,Sewickley Heights borough,722,133,396,24,0,30,583
Pennsylvania,Sewickley borough,3837,789,1653,350,7,270,3069
Pennsylvania,Seward borough,420,96,179,62,2,48,387
Pennsylvania,Seven Valleys borough,485,72,247,58,7,19,403
Pennsylvania,Seven Springs borough,11,5,0,1,0,5,11
Pennsylvania,Seven Fields borough,2888,665,1425,151,13,47,2301
Pennsylvania,Seneca,1278,195,724,64,0,44,1027
Pennsylvania,Seltzer,266,34,156,14,0,40,244
Pennsylvania,Sellersville borough,4233,911,1819,587,102,81,3500
Pennsylvania,Selinsgrove borough,5720,2703,1206,513,193,419,5034
Pennsylvania,Scranton,76064,26489,23126,6351,1551,5589,63106
Pennsylvania,New Brighton borough,5958,1717,1750,771,227,403,4868
Pennsylvania,Shelocta borough,157,31,42,32,4,5,114
Pennsylvania,Shenandoah borough,4964,1584,1423,539,160,473,4179
Pennsylvania,New Buffalo borough,111,34,34,13,11,16,108
Pennsylvania,Newburg borough (Clearfield County),89,9,49,4,0,3,65
Pennsylvania,Newburg borough (Cumberland County),280,52,130,27,0,12,221
Pennsylvania,New Castle,22682,6731,6884,2712,590,1689,18606
Pennsylvania,New Castle Northwest,1194,206,623,75,39,133,1076
Pennsylvania,New Centerville borough,148,24,68,11,7,8,118
Pennsylvania,New Columbia,737,141,298,62,12,98,611
Pennsylvania,New Columbus borough,225,55,93,11,1,19,179
Pennsylvania,New Cumberland borough,7274,1591,3038,795,173,394,5991
Pennsylvania,New Eagle borough,2049,468,839,168,48,213,1736
Pennsylvania,Newell borough,586,156,217,74,6,25,478
Pennsylvania,Shrewsbury borough,3841,857,1671,265,85,262,3140
Pennsylvania,Shoemakersville borough,1435,281,652,121,28,104,1186
Pennsylvania,Shirleysburg borough,122,19,54,13,3,13,102
Pennsylvania,Shiremanstown borough,1533,438,647,109,19,51,1264
Pennsylvania,Shippingport borough,172,57,69,14,0,10,150
Pennsylvania,Shippenville borough,583,121,231,62,7,31,452
Pennsylvania,Shippensburg University,2281,2236,33,0,0,0,2269
Pennsylvania,Shippensburg borough,5527,2272,1558,504,62,303,4699
Pennsylvania,Shinglehouse borough,935,220,283,156,4,158,821
Pennsylvania,Shiloh,11652,2799,5086,958,121,943,9907
Pennsylvania,Shillington borough,5268,1467,1976,450,156,336,4385
Pennsylvania,Shickshinny borough,791,173,332,96,12,68,681
Pennsylvania,Sheppton,184,71,71,18,0,5,165
Pennsylvania,Shenandoah Heights,1208,241,568,84,22,93,1008
Pennsylvania,Avondale borough,1506,488,557,46,48,21,1160
Pennsylvania,Avon,1787,396,770,112,90,168,1536
Pennsylvania,Ronks,288,81,168,39,0,0,288
Pennsylvania,Avis borough,1650,387,721,136,20,62,1326
Pennsylvania,Altamont,688,133,290,54,0,104,581
Pennsylvania,Altoona,45814,11748,16324,4758,1070,3105,37005
Pennsylvania,Ambler borough,6513,2093,2244,521,76,419,5353
Pennsylvania,Ambridge borough,6931,2221,1905,770,278,638,5812
Pennsylvania,Amity Gardens,3100,791,1313,262,22,215,2603
Pennsylvania,Ancient Oaks,7359,1001,3620,439,89,375,5524
Pennsylvania,Annville,4828,2402,1387,275,16,238,4318
Pennsylvania,Apollo borough,1566,473,501,191,40,104,1309
Pennsylvania,Applewold borough,323,74,134,30,10,19,267
Pennsylvania,Arcadia University,627,618,3,0,0,6,627
Pennsylvania,Archbald borough,7049,1448,3043,585,103,542,5721
Pennsylvania,Ardmore,12698,3683,4979,954,210,616,10442
Pennsylvania,Arendtsville borough,910,179,304,102,8,49,642
Pennsylvania,Aristes,311,62,140,23,15,21,261
Pennsylvania,Arlington Heights,5371,1361,2496,554,70,162,4643
Pennsylvania,Armagh borough,121,36,65,10,0,10,121
Pennsylvania,Arnold,5053,1506,1192,848,150,297,3993
Pennsylvania,Arnold City,540,233,143,47,63,36,522
Pennsylvania,Mohnton borough,3041,679,1334,272,43,133,2461
Pennsylvania,Mohrsville,618,125,275,16,36,41,493
Pennsylvania,Monaca borough,5706,1245,2384,494,108,498,4729
Pennsylvania,Monessen,7584,1984,2794,701,194,808,6481
Pennsylvania,Monongahela,4235,1104,1322,670,101,344,3541
Pennsylvania,Davidsville,1208,161,733,11,0,112,1017
Pennsylvania,Dawson borough,470,104,210,45,4,27,390
Pennsylvania,Alsace Manor,402,49,176,52,0,71,348
Pennsylvania,Dayton borough,457,82,170,58,12,53,375
Pennsylvania,Almedia,1024,206,496,165,13,45,925
Pennsylvania,Allison Park,21864,4895,10530,1177,140,1333,18075
Pennsylvania,Dauphin borough,1045,208,450,55,5,50,768
Pennsylvania,Aaronsburg CDP (Centre County),523,92,295,17,3,28,435
Pennsylvania,Aaronsburg CDP (Washington County),281,88,143,0,6,39,276
Pennsylvania,Abbottstown borough,943,201,430,88,8,31,758
Pennsylvania,Ackermanville,900,146,399,23,0,43,611
Pennsylvania,Adamsburg borough,203,39,90,11,3,18,161
Pennsylvania,Adamstown borough,1987,368,928,172,19,68,1555
Pennsylvania,Adamsville,52,9,21,4,0,13,47
Pennsylvania,Addison borough,214,33,101,12,8,16,170
Pennsylvania,Akron borough,3949,794,1944,229,77,143,3187
Pennsylvania,Alba borough,118,27,44,24,11,6,112
Pennsylvania,Albion borough,1522,308,637,199,47,72,1263
Pennsylvania,Albrightsville,159,33,74,0,0,7,114
Pennsylvania,Alburtis borough,2411,567,1003,196,22,80,1868
Pennsylvania,Aldan borough,4158,1331,1489,412,74,301,3607
Pennsylvania,Alexandria borough,406,114,147,48,10,17,336
Pennsylvania,Alfarata,159,29,60,5,0,26,120
Pennsylvania,Aliquippa,9296,3069,2458,907,296,886,7616
Pennsylvania,Alleghenyville,1137,218,661,32,5,33,949
Pennsylvania,Allenport,728,199,249,60,16,75,599
Pennsylvania,Allenport borough,496,90,236,53,9,39,427
Pennsylvania,Allensville,448,105,208,6,0,9,328
Pennsylvania,Allentown,119261,42037,32056,10159,3836,5075,93163
Pennsylvania,Allenwood,466,113,186,33,4,31,367
Pennsylvania,Allison,662,92,382,84,17,26,601
Pennsylvania,Allport,282,23,156,14,0,0,193
Pennsylvania,Deemston borough,737,140,363,52,26,36,617
Pennsylvania,Deer Lake,428,26,221,21,0,11,279
Pennsylvania,Deer Lake borough,750,119,380,58,5,19,581
Pennsylvania,Rose Valley borough,921,134,551,36,5,47,773
Pennsylvania,Roseville borough,159,21,97,17,2,6,143
Pennsylvania,Rossiter,621,205,234,19,15,58,531
Pennsylvania,Rosslyn Farms borough,438,70,236,32,0,27,365
Pennsylvania,Rote,674,199,323,48,0,27,597
Pennsylvania,Rothsville,2681,597,1531,79,20,45,2272
Pennsylvania,Arnot,469,77,204,58,2,29,370
Pennsylvania,Arona borough,332,74,139,57,4,19,293
Pennsylvania,Ashland borough,2772,970,845,278,78,260,2431
Pennsylvania,Ashley borough,2753,825,899,321,63,198,2306
Pennsylvania,Ashville borough,199,38,74,14,7,18,151
Pennsylvania,Aspers,447,68,226,8,13,12,327
Pennsylvania,Aspinwall borough,2795,654,1069,298,44,148,2213
Pennsylvania,Atglen borough,1469,384,532,67,36,53,1072
Pennsylvania,Athens borough,3326,573,1439,288,104,251,2655
Pennsylvania,Atkinson Mills,236,61,115,12,0,0,188
Pennsylvania,Atlantic,49,14,27,3,0,0,44
Pennsylvania,Atlas,969,286,340,146,48,89,909
Pennsylvania,Atlasburg,310,49,174,0,0,0,223
Pennsylvania,Atwood borough,108,21,57,12,0,4,94
Pennsylvania,Auburn borough,811,151,361,93,12,51,668
Pennsylvania,Audubon,8801,1798,4102,300,18,872,7090
Pennsylvania,Austin borough,518,159,202,34,0,43,438
Pennsylvania,Avalon borough,4681,1377,1553,618,110,350,4008
Pennsylvania,Avella,915,228,366,80,15,52,741
Pennsylvania,Roseto borough,1675,348,726,121,33,110,1338
Pennsylvania,Roscoe borough,797,214,347,68,17,49,695
Pennsylvania,Scottdale borough,4305,1078,1599,546,102,343,3668
Pennsylvania,Ronco,60,0,29,15,0,16,60
Pennsylvania,Defiance,229,32,85,25,0,0,142
Pennsylvania,Delano,380,91,187,29,0,15,322
Pennsylvania,Rices Landing borough,460,73,205,36,8,50,372
Pennsylvania,Riceville,59,22,31,0,0,3,56
Pennsylvania,Richboro,6322,1294,3458,218,45,324,5339
Pennsylvania,Richfield,448,104,235,19,11,64,433
Pennsylvania,Richland borough,1796,391,720,224,10,131,1476
Pennsylvania,Richlandtown borough,1268,263,536,80,31,109,1019
Pennsylvania,Ridgway borough,3986,843,1589,517,100,279,3328
Pennsylvania,Ridley Park borough,7020,2175,2874,542,98,351,6040
Pennsylvania,Riegelsville borough,838,159,433,78,0,42,712
Pennsylvania,Rimersburg borough,927,252,328,76,18,50,724
Pennsylvania,Avoca borough,2659,778,1049,203,52,206,2288
Pennsylvania,Ringtown borough,686,176,340,38,2,56,612
Pennsylvania,Riverside borough,2049,381,1100,104,35,79,1699
Pennsylvania,Riverview Park,2549,479,1352,241,13,176,2261
Pennsylvania,Roaring Spring borough,2560,591,1013,202,66,145,2017
Pennsylvania,Robesonia borough,2057,502,922,253,22,93,1792
Pennsylvania,Robinson,595,122,335,19,12,24,512
Pennsylvania,Rochester borough,3610,945,1259,520,72,234,3030
Pennsylvania,Rockhill borough,344,59,169,17,2,34,281
Pennsylvania,Rockledge borough,2542,626,965,255,78,129,2053
Pennsylvania,Rockwood borough,862,206,326,83,24,62,701
Pennsylvania,Rogersville,187,51,84,12,3,13,163
Pennsylvania,Rohrsburg,132,42,55,14,4,5,120
Pennsylvania,Rome borough,345,89,119,43,4,25,280
Pennsylvania,Riverside,302,46,114,43,0,44,247
Pennsylvania,Scotland,1119,215,539,99,0,50,903
Pennsylvania,Easton,26996,9805,7651,2712,804,996,21968
Pennsylvania,Schuylkill Haven borough,5321,1515,1990,558,126,209,4398
Pennsylvania,Curwensville borough,2562,508,1039,359,48,165,2119
Pennsylvania,Curtisville,975,367,260,142,29,16,814
Pennsylvania,Cumbola,401,130,124,36,11,23,324
Pennsylvania,Crucible,932,75,466,86,17,0,644
Pennsylvania,Croydon,9853,2962,3668,1022,184,598,8434
Pennsylvania,Crown,212,86,39,8,27,10,170
Pennsylvania,Cross Roads borough,556,153,262,37,4,18,474
Pennsylvania,Cross Creek,139,37,65,12,0,3,117
Pennsylvania,Cressona borough,1841,412,768,176,39,99,1494
Pennsylvania,Cresson borough,1675,459,610,139,15,162,1385
Pennsylvania,Crenshaw,469,97,201,34,28,29,389
Pennsylvania,Creekside borough,320,70,153,22,2,10,257
Pennsylvania,Cranesville borough,546,130,250,36,15,23,454
Pennsylvania,Crafton borough,5920,1828,2240,505,101,344,5018
Pennsylvania,Crabtree,332,55,147,34,0,8,244
Pennsylvania,Courtdale borough,695,165,316,55,5,63,604
Pennsylvania,Coudersport borough,2489,653,828,262,27,258,2028
Pennsylvania,Corsica borough,302,68,113,31,8,14,234
Pennsylvania,Corry,6509,1540,2553,645,139,343,5220
Pennsylvania,Cornwells Heights,1415,518,520,201,0,45,1284
Pennsylvania,Cornwall borough,4177,558,2542,248,21,290,3659
Pennsylvania,Coraopolis borough,5642,1908,1764,597,98,416,4783
Pennsylvania,Coral,578,151,174,103,0,31,459
Pennsylvania,Coplay borough,3216,675,1346,449,51,163,2684
Pennsylvania,Cooperstown borough,519,107,252,40,7,28,434
Pennsylvania,Mont Alto borough,1880,595,726,150,7,56,1534
Pennsylvania,Montandon,935,232,355,126,9,27,749
Pennsylvania,Monroeville municipal,28346,7332,12106,2198,389,2234,24259
Pennsylvania,Montgomery borough,1515,407,564,117,41,48,1177
Pennsylvania,Monroe borough,658,188,276,34,6,16,520
Pennsylvania,Sand Hill,2321,340,1215,283,11,63,1912
Pennsylvania,Connellsville,7550,2053,2586,710,243,433,6025
Pennsylvania,Conneautville borough,931,192,321,93,35,68,709
Pennsylvania,Conneaut Lakeshore,2788,529,1329,319,26,171,2374
Pennsylvania,Conneaut Lake borough,601,124,239,73,6,50,492
Pennsylvania,Confluence borough,716,221,221,110,10,52,614
Pennsylvania,Conestoga,1109,189,596,100,24,44,953
Pennsylvania,Conashaugh Lakes,1350,212,704,71,0,0,987
Pennsylvania,Commodore,397,93,105,83,0,37,318
Pennsylvania,Colwyn borough,2559,891,615,200,133,78,1917
Pennsylvania,Colver,717,190,219,66,30,123,628
Pennsylvania,Columbus,724,150,355,70,13,51,639
Pennsylvania,Columbia borough,10394,2622,3699,862,259,697,8139
Pennsylvania,Colony Park,1419,216,707,49,23,77,1072
Pennsylvania,Colonial Park,13196,3567,4864,1422,207,753,10813
Pennsylvania,St. Clairsville borough,74,10,35,7,0,5,57
Pennsylvania,St. Lawrence borough,1915,514,819,131,37,95,1596
Pennsylvania,St. Marys,12845,2902,5591,1135,171,1042,10841
Pennsylvania,St. Michael,577,147,211,109,14,54,535
Pennsylvania,St. Petersburg borough,280,61,127,42,0,8,238
Pennsylvania,St. Vincent College,1266,1254,0,0,0,0,1254
Pennsylvania,Salisbury borough,805,169,428,54,20,44,715
Pennsylvania,Salix,1167,223,558,93,0,121,995
Pennsylvania,Salladasburg borough,254,84,105,12,4,6,211
Pennsylvania,Saltillo borough,297,67,134,10,3,17,231
Pennsylvania,Saltsburg borough,799,197,284,117,17,45,660
Pennsylvania,Salunga,2850,426,1417,269,18,232,2362
Pennsylvania,Sanatoga,8480,1899,3500,633,131,449,6612
Pennsylvania,Sandy,1205,182,545,222,0,109,1058
Pennsylvania,Montgomeryville,13104,3034,6256,742,117,441,10590
Pennsylvania,Montoursville borough,4591,910,2052,437,131,384,3914
Pennsylvania,Montrose borough,1716,452,623,261,14,158,1508
Pennsylvania,Muir,519,84,261,24,0,60,429
Pennsylvania,Muncy borough,2476,642,1026,213,69,86,2036
Pennsylvania,Mundys Corner,1896,342,1024,91,0,100,1557
Pennsylvania,Munhall borough,11351,3331,3985,1169,161,935,9581
Pennsylvania,Murrysville municipal,20181,3725,10740,931,104,1415,16915
Pennsylvania,Muse,2622,502,1272,90,37,128,2029
Pennsylvania,Myerstown borough,3111,861,1147,207,64,183,2462
Pennsylvania,Nanticoke,10356,3038,3541,980,197,765,8521
Pennsylvania,Nanty-Glo borough,2657,627,1057,198,54,189,2125
Pennsylvania,Daisytown borough,352,69,160,24,4,25,282
Pennsylvania,Dale borough,1138,341,313,137,69,78,938
Pennsylvania,Dallas borough,2793,791,1150,251,76,104,2372
Pennsylvania,Dallastown borough,4019,919,1249,599,91,341,3199
Pennsylvania,Dalmatia,467,63,203,57,24,33,380
Pennsylvania,Dalton borough,1318,244,743,79,4,34,1104
Pennsylvania,Danville borough,4686,1843,1002,587,43,425,3900
Pennsylvania,Darby borough,10693,3746,1803,717,641,645,7552
Pennsylvania,Darlington borough,398,116,102,24,15,14,271
Pennsylvania,Dauberville,928,286,451,0,27,19,783
Pennsylvania,New Albany borough,320,66,88,34,12,29,229
Pennsylvania,Nesquehoning borough,3295,927,1152,307,121,220,2727
Pennsylvania,Nescopeck borough,1744,460,726,146,35,102,1469
Pennsylvania,Nemacolin,728,277,149,82,58,116,682
Pennsylvania,Needmore,102,23,51,9,0,13,96
Pennsylvania,Nazareth borough,5701,1312,2489,345,34,615,4795
Pennsylvania,Narberth borough,4292,1021,1988,342,49,167,3567
Pennsylvania,Naomi,32,0,19,13,0,0,32
Pennsylvania,Muhlenberg Park,2052,377,998,147,10,151,1683
Pennsylvania,Mount Wolf borough,1790,381,748,149,24,129,1431
Pennsylvania,Mountville borough,2837,792,1032,307,81,88,2300
Pennsylvania,Mount Union borough,2436,505,901,246,75,190,1917
Pennsylvania,Montrose Manor,550,86,328,37,0,36,487
Pennsylvania,Monument,204,59,85,21,0,19,184
Pennsylvania,Moosic borough,5718,1433,2421,414,119,446,4833
Pennsylvania,Morgantown,1111,318,480,42,39,8,887
Pennsylvania,Morrisdale,750,113,371,75,0,67,626
Pennsylvania,Morrisville borough,8666,2115,3173,870,204,380,6742
Pennsylvania,Morrisville,754,100,300,95,9,119,623
Pennsylvania,Morton borough,2681,716,1016,276,33,184,2225
Pennsylvania,Moscow borough,2239,571,1057,167,25,95,1915
Pennsylvania,Moshannon,254,41,128,45,0,9,223
Pennsylvania,Mount Aetna,336,84,204,10,0,0,298
Pennsylvania,Mountainhome,1075,433,527,39,0,45,1044
Pennsylvania,Mountain Top,11378,2186,5622,930,75,566,9379
Pennsylvania,Connoquenessing borough,527,101,256,27,4,27,415
Pennsylvania,Mount Carbon borough,88,27,39,5,3,8,82
Pennsylvania,Mount Cobb,1554,308,723,117,0,62,1210
Pennsylvania,Mount Eagle,74,18,28,17,0,5,68
Pennsylvania,Mount Gretna borough,256,37,177,7,3,8,232
Pennsylvania,Mount Gretna Heights,211,32,105,55,0,0,192
Pennsylvania,Mount Holly Springs borough,1794,379,811,151,57,81,1479
Pennsylvania,Mount Jewett borough,928,229,331,126,9,62,757
Pennsylvania,Mount Joy borough,7891,2036,3285,564,306,276,6467
Pennsylvania,Mount Morris,844,169,434,22,26,67,718
Pennsylvania,Mount Oliver borough,3399,1594,521,242,149,221,2727
Pennsylvania,Mount Penn borough,3160,690,1094,331,108,166,2389
Pennsylvania,Mount Pleasant borough,4428,937,1742,606,53,405,3743
Pennsylvania,Mount Pleasant Mills,580,92,259,55,14,13,433
Pennsylvania,Mount Pocono borough,3106,643,1053,296,88,158,2238
Pennsylvania,Mount Carmel borough,5810,1375,2152,563,139,649,4878
Pennsylvania,Conshohocken borough,7890,3528,2394,596,82,346,6946
Pennsylvania,Conway borough,2198,441,974,198,23,196,1832
Pennsylvania,Conyngham borough,1996,407,926,170,44,173,1720
Pennsylvania,Eagleville CDP (Centre County),373,108,198,16,0,10,332
Pennsylvania,Eagleview,1824,212,1073,153,7,98,1543
Pennsylvania,Eagles Mere borough,121,12,85,0,0,9,106
Pennsylvania,Eagle Lake,0,0,0,0,0,0,0
Pennsylvania,Dushore borough,640,143,230,105,20,67,565
Pennsylvania,Duryea borough,4935,804,2438,415,56,287,4000
Pennsylvania,Duquesne,5556,2076,1154,481,82,347,4140
Pennsylvania,Dupont borough,2711,765,1010,251,41,253,2320
Pennsylvania,Dunnstown,1362,235,679,94,34,97,1139
Pennsylvania,Dunmore borough,13810,4452,4981,1120,239,746,11538
Pennsylvania,Dunlo,114,31,41,10,0,13,95
Pennsylvania,Dunlevy borough,378,64,147,58,8,32,309
Pennsylvania,Duncansville borough,1283,266,517,166,17,120,1086
Pennsylvania,Duncannon borough,1598,345,551,218,37,153,1304
Pennsylvania,Dunbar borough,1085,274,385,160,22,73,914
Pennsylvania,Dudley borough,171,48,77,10,7,10,152
Pennsylvania,Duboistown borough,1195,274,571,110,7,81,1043
Pennsylvania,DuBois,7672,1866,3093,887,91,469,6406
Pennsylvania,Dublin borough,2120,617,797,169,46,97,1726
Pennsylvania,Dryville,627,221,233,52,0,33,539
Pennsylvania,Dry Tavern,569,52,335,51,4,28,470
Pennsylvania,Driftwood borough,74,15,40,11,0,6,72
Pennsylvania,Drexel Hill,27999,7903,10865,1981,389,1448,22586
Pennsylvania,Dravosburg borough,1864,526,787,178,25,107,1623
Pennsylvania,Doylestown borough,8344,2157,3230,903,141,918,7349
Pennsylvania,Downingtown borough,7930,2632,2626,769,109,578,6714
Pennsylvania,Douglassville,780,179,146,96,63,190,674
Pennsylvania,Eagleville CDP (Montgomery County),4726,2285,1340,321,87,148,4181
Pennsylvania,Earlston,1021,96,558,60,28,105,847
Pennsylvania,East Bangor borough,1182,292,452,89,22,59,914
Pennsylvania,East Berlin borough,1418,242,661,116,30,80,1129
Pennsylvania,Schubert,104,13,59,15,0,17,104
Pennsylvania,Schoeneck,806,122,499,14,0,32,667
Pennsylvania,Schnecksville,2774,537,1220,303,43,100,2203
Pennsylvania,Schlusser,5228,882,2411,568,29,340,4230
Pennsylvania,Schellsburg borough,325,95,164,13,4,20,296
Pennsylvania,Schaefferstown,1137,93,602,82,36,70,883
Pennsylvania,Scalp Level borough,801,187,341,51,23,65,667
Pennsylvania,Sayre borough,5513,1338,2015,636,154,397,4540
Pennsylvania,Saylorsburg,334,65,144,91,0,17,317
Pennsylvania,Saxton borough,738,211,230,91,5,45,582
Pennsylvania,Saxonburg borough,1477,259,644,158,47,158,1266
Pennsylvania,Saw Creek,3455,976,1409,356,83,46,2870
Pennsylvania,Sankertown borough,659,151,250,93,14,33,541
Pennsylvania,Dorneyville,4530,831,2687,245,0,213,3976
Pennsylvania,Sandy Ridge,237,136,101,0,0,0,237
Pennsylvania,East Prospect borough,1139,255,393,75,10,45,778
Pennsylvania,East Pittsburgh borough,1827,619,444,177,12,80,1332
Pennsylvania,East Petersburg borough,4518,870,2246,332,104,109,3661
Pennsylvania,East McKeesport borough,2140,565,739,221,51,193,1769
Pennsylvania,Eastlawn Gardens,3275,709,1627,69,102,184,2691
Pennsylvania,East Lansdowne borough,2672,769,997,289,65,79,2199
Pennsylvania,East Greenville borough,2968,629,1323,236,60,98,2346
Pennsylvania,East Freedom,1027,171,462,76,0,50,759
Pennsylvania,East Earl,952,60,542,0,0,0,602
Pennsylvania,East Conemaugh borough,1141,287,397,81,18,96,879
Pennsylvania,East Butler borough,699,102,335,65,13,36,551
Pennsylvania,East Brady borough,1053,229,408,99,16,106,858
Pennsylvania,East Berwick,1922,358,1007,249,16,121,1751
Pennsylvania,Sandy Lake borough,642,147,267,68,15,32,529
Pennsylvania,Schwenksville borough,1376,387,417,238,57,53,1152
Pennsylvania,Dormont borough,8555,3026,3133,640,129,465,7393
Pennsylvania,Donegal borough,173,30,86,11,12,12,151
Pennsylvania,Rupert,179,50,80,24,3,7,164
Pennsylvania,Rural Valley borough,866,135,424,40,17,73,689
Pennsylvania,Russell,1242,192,708,75,9,95,1079
Pennsylvania,Russellton,1661,396,826,87,44,120,1473
Pennsylvania,Rutherford,4817,1279,1706,335,110,209,3639
Pennsylvania,Rutledge borough,771,212,338,54,18,23,645
Pennsylvania,Saegertown borough,993,320,326,161,10,50,867
Pennsylvania,St. Clair borough,2950,980,957,212,77,246,2472
Pennsylvania,New Schaefferstown,268,71,115,15,15,7,223
Pennsylvania,New Stanton borough,2414,598,1040,228,18,96,1980
Pennsylvania,Newton Hamilton borough,212,51,79,22,6,7,165
Pennsylvania,Newtown borough,2110,483,1014,186,43,98,1824
Pennsylvania,Newtown,214,38,104,29,2,8,181
Pennsylvania,Newtown Grant,3709,744,1803,363,55,145,3110
Pennsylvania,New Tripoli,719,111,264,57,37,17,486
Pennsylvania,Newville borough,1358,378,417,172,39,57,1063
Pennsylvania,New Washington borough,49,11,21,8,0,2,42
Pennsylvania,New Wilmington borough,2377,1348,571,75,17,153,2164
Pennsylvania,Nicholson borough,736,158,319,44,18,59,598
Pennsylvania,Nittany,568,184,178,35,39,51,487
Pennsylvania,Nixon,1313,273,763,18,16,49,1119
Pennsylvania,Noblestown,494,81,221,36,17,14,369
Pennsylvania,Norristown borough,34500,13021,8787,2855,704,1459,26826
Pennsylvania,Northampton borough,9895,2339,3930,903,150,801,8123
Pennsylvania,North Apollo borough,1419,316,589,97,78,76,1156
Pennsylvania,North Belle Vernon borough,1989,634,690,252,53,118,1747
Pennsylvania,Coopersburg borough,2309,481,1046,222,36,167,1952
Pennsylvania,New Salem borough,835,138,464,59,1,42,704
Pennsylvania,New Salem,410,139,173,9,0,9,330
Pennsylvania,Newry borough,317,98,89,40,3,19,249
Pennsylvania,New Ringgold borough,287,50,134,35,1,15,235
Pennsylvania,Donaldson,289,92,114,18,13,8,245
Pennsylvania,Dillsburg borough,2572,646,998,243,67,148,2102
Pennsylvania,Dicksonville,445,70,150,0,59,26,305
Pennsylvania,Dewart,1463,284,733,91,15,58,1181
Pennsylvania,Devon,1930,309,976,62,12,0,1359
Pennsylvania,DeSales University,937,937,0,0,0,0,937
Pennsylvania,Derry borough,2629,597,1050,259,37,198,2141
Pennsylvania,Denver borough,3864,829,1723,423,30,109,3114
Pennsylvania,Delta borough,632,190,228,52,29,24,523
Pennsylvania,Delmont borough,2657,487,1230,245,39,155,2156
Pennsylvania,Delaware Water Gap borough,678,178,292,70,3,21,564
Pennsylvania,New Freedom borough,4542,738,2134,240,122,233,3467
Pennsylvania,New Freeport,84,37,31,4,2,4,78
Pennsylvania,Donora borough,4697,1379,1412,558,97,425,3871
Pennsylvania,New Galilee borough,451,116,162,40,21,23,362
Pennsylvania,New Hope borough,2519,748,952,301,24,110,2135
Pennsylvania,New Jerusalem,624,111,179,90,0,43,423
Pennsylvania,New Kensington,12874,3537,4721,1353,142,929,10682
Pennsylvania,New Kingstown,342,55,185,31,0,10,281
Pennsylvania,New Lebanon borough,174,34,79,8,3,3,127
Pennsylvania,Newmanstown,2658,616,892,266,0,145,1919
Pennsylvania,New Market,623,151,192,49,34,52,478
Pennsylvania,New Milford borough,891,210,331,72,37,45,695
Pennsylvania,New Morgan borough,67,55,6,4,1,0,66
Pennsylvania,New Oxford borough,2286,580,795,169,35,134,1713
Pennsylvania,New Paris borough,199,51,105,20,0,4,180
Pennsylvania,New Philadelphia borough,1035,281,354,99,38,91,863
Pennsylvania,Newport borough,1450,413,436,221,25,71,1166
Pennsylvania,New Holland borough,5408,1206,2605,365,198,186,4560
Pennsylvania,Dover borough,1992,537,742,163,66,81,1589
Pennsylvania,Gilbertsville,4926,1082,2345,262,60,345,4094
Pennsylvania,East Salem,243,16,117,17,0,9,159
Pennsylvania,Wellersburg borough,232,27,120,10,1,16,174
Pennsylvania,Weissport East,1388,208,761,105,30,90,1194
Pennsylvania,Weissport borough,368,138,90,52,15,16,311
Pennsylvania,Weigelstown,12684,2573,5832,1187,231,581,10404
Pennsylvania,Weedville,611,101,341,24,12,36,514
Pennsylvania,Webster,318,92,100,17,44,0,253
Pennsylvania,Weatherly borough,2472,581,1093,136,38,323,2171
Pennsylvania,Wellsboro borough,3313,745,1447,281,60,233,2766
Pennsylvania,Waynesburg borough,4109,1959,1048,358,128,94,3587
Pennsylvania,Wayne Heights,2912,443,1262,208,113,135,2161
Pennsylvania,Waymart borough,1369,352,510,82,6,183,1133
Pennsylvania,Waverly,568,110,386,34,0,8,538
Pennsylvania,Wattsburg borough,508,118,219,29,5,20,391
Pennsylvania,Watsontown borough,2222,524,950,171,90,152,1887
Pennsylvania,Waterford borough,1374,289,573,160,29,78,1129
Pennsylvania,Washingtonville borough,213,74,49,50,2,11,186
Pennsylvania,Waynesboro borough,10731,2768,3694,1141,304,701,8608
Pennsylvania,Washington Boro,704,193,298,77,31,26,625
Pennsylvania,Wellsville borough,282,80,117,25,2,11,235
Pennsylvania,Wescosville,5807,1128,3054,151,44,307,4684
Pennsylvania,Hollidaysburg borough,5812,1248,2305,535,131,747,4966
Pennsylvania,Holiday Pocono,510,111,201,42,29,49,432
Pennsylvania,Hokendauqua,3191,763,1442,320,62,213,2800
Pennsylvania,Hiller,1066,173,492,168,15,132,980
Pennsylvania,West Grove borough,2860,681,1050,222,130,92,2175
Pennsylvania,Westfield borough,1143,249,427,121,44,105,946
Pennsylvania,West Falls,395,86,178,79,2,21,366
Pennsylvania,Wernersville borough,2515,597,1087,172,50,215,2121
Pennsylvania,West Fairview,1380,422,408,141,0,44,1015
Pennsylvania,West Easton borough,1304,340,487,162,26,81,1096
Pennsylvania,West Decatur,468,77,238,36,0,42,393
Pennsylvania,West Conshohocken borough,1306,502,549,77,27,38,1193
Pennsylvania,West Chester borough,19181,11541,3830,1237,157,531,17296
Pennsylvania,West Brownsville borough,861,152,344,116,45,94,751
Pennsylvania,West Alexander,447,67,207,48,0,56,378
Pennsylvania,Wesleyville borough,3270,836,1314,335,37,124,2646
Pennsylvania,West Elizabeth borough,565,124,202,55,30,36,447
Pennsylvania,Homeacre-Lyndora,6979,1712,2949,681,108,522,5972
Pennsylvania,Washington,13642,5435,3358,1856,380,752,11781
Pennsylvania,Warren,9478,2143,3497,996,364,696,7696
Pennsylvania,Verona borough,2560,922,625,353,55,233,2188
Pennsylvania,Venango borough,272,53,116,29,5,12,215
Pennsylvania,Van Voorhis,151,16,85,21,0,29,151
Pennsylvania,Vandling borough,786,191,338,65,18,52,664
Pennsylvania,Vandergrift borough,5095,1335,1624,435,165,453,4012
Pennsylvania,Vanderbilt borough,527,114,225,69,7,33,448
Pennsylvania,Hilldale,1005,205,676,29,0,59,969
Pennsylvania,Versailles borough,1682,555,436,210,66,189,1456
Pennsylvania,Highspire borough,2249,521,946,193,73,123,1856
Pennsylvania,Hickory Hills,644,190,264,19,15,36,524
Pennsylvania,Hickory,776,152,307,105,0,38,602
Pennsylvania,Hershey,14469,4994,5577,972,201,775,12519
Pennsylvania,Herndon borough,377,53,172,28,12,14,279
Pennsylvania,Hermitage,16185,3109,7728,1167,294,1471,13769
Pennsylvania,Herminie,860,205,258,94,9,63,629
Pennsylvania,Hereford,658,123,376,48,27,43,617
Pennsylvania,Highland Park,1139,151,509,84,0,202,946
Pennsylvania,Warrior Run borough,546,156,187,80,18,38,479
Pennsylvania,Vicksburg,420,91,197,0,0,29,317
Pennsylvania,Village Shires,4066,994,1573,349,67,434,3417
Pennsylvania,Warminster Heights,4164,1420,1155,354,96,205,3230
Pennsylvania,Wanamie,744,157,342,83,0,32,614
Pennsylvania,Wampum borough,578,160,225,48,20,66,519
Pennsylvania,Walnuttown,416,169,182,26,0,23,400
Pennsylvania,Walnutport borough,2164,494,964,155,20,166,1799
Pennsylvania,Waller,105,23,70,0,0,9,102
Pennsylvania,Wallenpaupack Lake Estates,1315,137,691,44,13,106,991
Pennsylvania,Village Green-Green Ridge,7569,1597,3453,484,94,539,6167
Pennsylvania,Wallaceton borough,333,83,148,38,7,11,287
Pennsylvania,Wakefield,657,175,269,28,16,11,499
Pennsylvania,Wagner,221,89,74,0,7,6,176
Pennsylvania,Vowinckel,151,34,77,0,0,11,122
Pennsylvania,Volant borough,108,32,46,12,0,4,94
Pennsylvania,Virginville,264,7,170,17,0,17,211
Pennsylvania,Vintondale borough,395,94,175,27,1,37,334
Pennsylvania,Vinco,1192,188,591,90,31,84,984
Pennsylvania,Wall borough,779,231,249,91,9,44,624
Pennsylvania,Hendersonville,356,88,209,6,0,7,310
Pennsylvania,Homer City borough,1745,373,740,194,20,121,1448
Pennsylvania,Hometown,1291,97,883,35,0,36,1051
Pennsylvania,West Hazleton borough,4549,1614,1279,386,87,224,3590
Pennsylvania,West Hamburg,2020,431,718,285,38,255,1727
Pennsylvania,Jefferson borough (Greene County),257,61,93,39,2,35,230
Pennsylvania,Jeddo borough,138,39,50,10,4,19,122
Pennsylvania,Jeannette,9464,2780,3423,1064,194,633,8094
Pennsylvania,Jamison City,94,16,37,14,3,9,79
Pennsylvania,Jamestown borough,602,108,224,98,16,50,496
Pennsylvania,West Hills,1119,183,616,71,13,112,995
Pennsylvania,James City,206,43,106,15,2,19,185
Pennsylvania,Jacksonwald,3223,399,1737,198,93,82,2509
Pennsylvania,Jacksonville CDP (Indiana County),623,172,225,66,27,37,527
Pennsylvania,Jacksonville CDP (Centre County),94,23,39,5,0,2,69
Pennsylvania,Jackson Center borough,205,46,86,23,2,7,164
Pennsylvania,Ivyland borough,1026,175,453,51,10,105,794
Pennsylvania,Irwin borough,3906,1051,1577,301,30,314,3273
Pennsylvania,Irvona borough,759,169,340,59,8,54,630
Pennsylvania,Jacobus borough,1813,283,841,152,12,83,1371
Pennsylvania,Iola,200,37,109,4,0,10,160
Pennsylvania,West Homestead borough,1784,558,710,138,22,149,1577
Pennsylvania,Westland,95,39,0,28,0,0,67
Pennsylvania,West Reading borough,4191,1271,1077,602,70,353,3373
Pennsylvania,West Pittston borough,4814,1364,1959,393,57,360,4133
Pennsylvania,West Pittsburg,953,215,447,76,0,57,795
Pennsylvania,Westover borough,341,121,127,24,11,25,308
Pennsylvania,Weston,357,123,127,22,9,13,294
Pennsylvania,West Newton borough,2585,609,1032,207,83,274,2205
Pennsylvania,West Nanticoke,711,166,328,58,11,57,620
Pennsylvania,West Kittanning borough,1176,205,511,135,41,98,990
Pennsylvania,Westmont borough,5039,1010,2381,375,73,351,4190
Pennsylvania,West Mifflin borough,20237,5892,7571,1832,353,1760,17408
Pennsylvania,West Middletown borough,113,24,48,15,1,11,99
Pennsylvania,West Middlesex borough,901,238,339,88,17,58,740
Pennsylvania,West Mayfield borough,1286,336,469,153,22,33,1013
Pennsylvania,West Liberty borough,357,78,156,29,15,23,301
Pennsylvania,West Leechburg borough,1303,227,647,111,32,112,1129
Pennsylvania,West Lawn,1790,474,555,230,32,129,1420
Pennsylvania,West Milton,839,93,454,50,0,37,634
Pennsylvania,Homestead borough,3144,1411,614,295,25,241,2586
Pennsylvania,Intercourse,1728,305,805,67,0,99,1276
Pennsylvania,Ingram borough,3308,888,1185,414,74,192,2753
Pennsylvania,Hublersburg,58,17,0,0,20,0,37
Pennsylvania,Howard borough,806,155,371,77,4,56,663
Pennsylvania,Houtzdale borough,783,182,353,37,17,64,653
Pennsylvania,Houston borough,1328,357,497,147,29,92,1122
Pennsylvania,Houserville,1962,612,910,121,0,45,1688
Pennsylvania,Hostetter,952,294,423,59,14,82,872
Pennsylvania,Horsham,14587,3481,6628,986,388,564,12047
Pennsylvania,Hudson,1571,270,712,217,14,173,1386
Pennsylvania,Hopwood,1937,732,712,116,11,160,1731
Pennsylvania,Hopeland,562,149,260,24,31,23,487
Pennsylvania,Hop Bottom borough,295,90,66,50,6,26,238
Pennsylvania,Hooversville borough,613,134,304,24,11,59,532
Pennsylvania,Hookstown borough,119,26,41,20,7,8,102
Pennsylvania,Honey Brook borough,1689,384,667,180,22,97,1350
Pennsylvania,Honesdale borough,4315,893,1363,539,207,508,3510
Pennsylvania,Homewood borough,101,25,43,17,1,15,101
Pennsylvania,Hopewell borough,239,46,102,15,2,19,184
Pennsylvania,Inkerman,1802,377,652,102,46,427,1604
Pennsylvania,Hughestown borough,1566,431,633,152,13,131,1360
Pennsylvania,Hulmeville borough,926,223,366,125,8,52,774
Pennsylvania,Industry borough,1896,419,853,187,31,89,1579
Pennsylvania,Indian Mountain Lake,4249,968,1733,229,222,172,3324
Pennsylvania,Indian Lake borough,403,43,286,25,0,28,382
Pennsylvania,Indiana borough,14050,9926,2167,704,104,284,13185
Pennsylvania,Imperial,2616,955,892,273,37,74,2231
Pennsylvania,Idaville,199,43,97,17,0,23,180
Pennsylvania,Hyndman borough,831,140,385,63,14,78,680
Pennsylvania,Hughesville borough,1982,400,794,290,30,115,1629
Pennsylvania,Hydetown borough,491,75,259,42,0,49,425
Pennsylvania,Hyde Park,3367,993,995,323,21,115,2447
Pennsylvania,Hyde,1228,267,542,92,24,51,976
Pennsylvania,Huntingdon borough,7060,2715,2206,523,117,469,6030
Pennsylvania,Hunterstown,521,132,235,30,37,22,456
Pennsylvania,Hunker borough,318,71,166,21,0,24,282
Pennsylvania,Hummels Wharf,1536,315,685,178,0,89,1267
Pennsylvania,Hummelstown borough,4555,1083,1723,441,34,255,3536
Pennsylvania,Hyde Park borough,426,92,166,51,8,52,369
Pennsylvania,West Sunbury borough,146,48,43,24,1,5,121
Pennsylvania,Hemlock Farms,3470,710,1848,187,69,205,3019
Pennsylvania,Heilwood,601,170,244,19,9,55,497
Pennsylvania,Manor borough,3281,707,1481,221,17,222,2648
Pennsylvania,Manorville borough,403,65,177,49,9,18,318
Pennsylvania,Mansfield borough,3521,1823,882,189,62,168,3124
Pennsylvania,Maple Glen,6801,1500,3496,314,120,150,5580
Pennsylvania,Mapleton borough,472,64,231,24,10,33,362
Pennsylvania,Mapletown,165,18,84,2,0,17,121
Pennsylvania,Marcus Hook borough,2434,882,514,287,80,109,1872
Pennsylvania,Manns Choice borough,300,82,121,31,5,12,251
Pennsylvania,Marianna borough,510,103,184,40,17,39,383
Pennsylvania,Marienville,4308,2912,681,337,126,187,4243
Pennsylvania,Marietta borough,2594,683,1077,232,35,88,2115
Pennsylvania,Marion,939,205,469,46,0,13,733
Pennsylvania,Marion Center borough,456,91,188,62,5,15,361
Pennsylvania,Park Crest,587,148,294,35,0,30,507
Pennsylvania,Paris,808,206,410,121,6,34,777
Pennsylvania,Pardeesville,371,76,126,10,10,114,336
Pennsylvania,Marianne,1227,276,559,116,7,80,1038
Pennsylvania,Paradise,1110,288,487,63,0,47,885
Pennsylvania,Manheim borough,4864,1292,1677,765,109,235,4078
Pennsylvania,Mammoth,472,57,286,41,0,33,417
Pennsylvania,McKean borough,453,70,187,77,5,26,365
Pennsylvania,McKeansburg,159,24,81,10,3,7,125
Pennsylvania,McKeesport,19637,6963,4968,2150,452,1686,16219
Pennsylvania,McKees Rocks borough,6075,2426,1377,649,261,273,4986
Pennsylvania,McKnightstown,151,0,111,19,0,21,151
Pennsylvania,McMurray,4745,634,2617,279,17,151,3698
Pennsylvania,McSherrystown borough,3049,709,976,345,60,214,2304
Pennsylvania,Manchester borough,2753,677,853,381,103,171,2185
Pennsylvania,Macungie borough,3111,895,1024,474,174,147,2714
Pennsylvania,Madison borough,377,42,215,28,5,44,334
Pennsylvania,Madisonburg,265,38,145,14,0,3,200
Pennsylvania,Mahaffey borough,330,69,141,26,12,18,266
Pennsylvania,Mahanoy City borough,4089,1299,1019,367,70,429,3184
Pennsylvania,Mainville,122,23,66,3,0,12,104
Pennsylvania,Maitland,247,113,82,13,0,0,208
Pennsylvania,Malvern borough,3263,810,1203,279,43,256,2591
Pennsylvania,McVeytown borough,341,92,129,46,12,25,304
Pennsylvania,McGovern,2594,448,1175,357,11,148,2139
Pennsylvania,Paoli,5652,1277,2270,546,122,535,4750
Pennsylvania,Palmyra borough,7432,1607,2790,1083,193,425,6098
Pennsylvania,Oley,1288,217,568,75,43,106,1009
Pennsylvania,Old Orchard,2275,475,1123,208,43,133,1982
Pennsylvania,Old Forge borough,8225,1975,3229,894,306,653,7057
Pennsylvania,Oklahoma borough,677,148,325,80,9,58,620
Pennsylvania,East Rochester borough,547,160,165,85,14,45,469
Pennsylvania,Oil City,10296,2797,3243,1277,327,673,8317
Pennsylvania,Ohioville borough,3497,612,1835,327,49,210,3033
Pennsylvania,Oliver,2931,780,901,334,14,212,2241
Pennsylvania,Ohiopyle borough,33,7,19,0,0,2,28
Pennsylvania,Oakwood,2168,446,988,161,60,207,1862
Pennsylvania,Oakmont borough,6398,1675,2714,518,59,583,5549
Pennsylvania,Oakland borough,636,144,259,65,13,39,520
Pennsylvania,Oakland CDP (Lawrence County),1379,384,431,150,26,113,1104
Pennsylvania,Oakland CDP (Cambria County),1464,390,740,132,10,129,1401
Pennsylvania,Oak Hills,2280,554,938,248,90,119,1949
Pennsylvania,Oakdale borough,1432,258,668,153,43,104,1226
Pennsylvania,Oberlin,440,165,114,11,19,14,323
Pennsylvania,Palo Alto borough,1044,234,488,80,17,73,892
Pennsylvania,Olyphant borough,5166,1275,2149,438,114,397,4373
Pennsylvania,Orangeville borough,460,65,216,56,2,65,404
Pennsylvania,Palmerton borough,5352,1324,2017,474,77,570,4462
Pennsylvania,Palmer Heights,3657,601,1792,285,39,417,3134
Pennsylvania,Palmdale,1153,291,395,125,10,73,894
Pennsylvania,Paint borough,905,207,349,40,4,216,816
Pennsylvania,Oxford borough,5163,935,1594,519,111,387,3546
Pennsylvania,Oval,426,73,212,29,0,10,324
Pennsylvania,Oswayo borough,176,58,75,10,3,5,151
Pennsylvania,Oneida,165,48,32,51,0,14,145
Pennsylvania,Osceola Mills borough,1135,239,437,71,28,103,878
Pennsylvania,Orwigsburg borough,3041,706,1336,270,48,270,2630
Pennsylvania,Orviston,83,30,33,10,0,3,76
Pennsylvania,Orrtanna,196,13,102,25,2,2,144
Pennsylvania,Orrstown borough,252,69,80,14,7,37,207
Pennsylvania,Oreland,5817,1641,2534,204,33,206,4618
Pennsylvania,Orchard Hills,1891,415,651,379,34,167,1646
Pennsylvania,Orbisonia borough,523,145,166,66,10,53,440
Pennsylvania,Orwin,346,88,127,53,15,14,297
Pennsylvania,Hellertown borough,5858,1383,2222,702,58,451,4816
Pennsylvania,McEwensville borough,367,117,141,33,0,21,312
Pennsylvania,McDonald borough,2159,491,924,196,76,123,1810
Pennsylvania,Harrison City,151,33,60,37,0,21,151
Pennsylvania,Harrisburg,49232,19970,10413,4538,1436,2134,38491
Pennsylvania,Harmony borough,823,137,416,76,10,42,681
Pennsylvania,Harmonsburg,168,11,70,39,0,28,148
Pennsylvania,Harleysville,9285,2119,4457,485,36,579,7676
Pennsylvania,Harleigh,988,270,510,63,0,43,886
Pennsylvania,Hanover borough,15403,3663,5474,1658,493,1114,12402
Pennsylvania,Harrisville borough,910,244,334,92,5,74,749
Pennsylvania,Hannasville,174,34,80,12,4,7,137
Pennsylvania,Hamburg borough,4316,1080,1603,480,85,435,3683
Pennsylvania,Hallstead borough,1114,292,403,140,19,81,935
Pennsylvania,Hallam borough,2670,783,972,386,18,117,2276
Pennsylvania,Halifax borough,952,220,342,90,41,56,749
Pennsylvania,Halfway House,2806,529,1423,175,32,90,2249
Pennsylvania,Guys Mills,119,52,47,0,0,8,107
Pennsylvania,Guilford,2552,407,1375,159,16,115,2072
Pennsylvania,Hampton,812,212,290,53,0,14,569
Pennsylvania,Grove City borough,8210,3833,2183,761,100,412,7289
Pennsylvania,Hartleton borough,249,35,127,2,6,20,190
Pennsylvania,Harveys Lake borough,2793,512,1469,280,52,79,2392
Pennsylvania,Heidlersburg,786,164,358,48,13,15,598
Pennsylvania,Heidelberg borough,1324,390,409,182,53,114,1148
Pennsylvania,Hegins,871,152,458,24,16,82,732
Pennsylvania,Heckscherville,113,22,50,17,5,5,99
Pennsylvania,Hebron,987,201,257,162,25,206,851
Pennsylvania,Hazleton,25087,8503,7346,1980,780,1350,19959
Pennsylvania,Haysville borough,79,27,33,8,0,3,71
Pennsylvania,Hartstown,169,36,65,26,0,12,139
Pennsylvania,Hawthorn borough,449,89,187,65,4,18,363
Pennsylvania,Hawk Run,648,147,294,14,0,48,503
Pennsylvania,Haverford College,1310,1188,72,9,11,0,1280
Pennsylvania,Hatfield borough,3302,726,1470,208,124,114,2642
Pennsylvania,Hatboro borough,7405,2211,2863,700,104,358,6236
Pennsylvania,Hastings borough,1253,239,514,143,18,89,1003
Pennsylvania,Hasson Heights,1630,367,684,131,42,126,1350
Pennsylvania,Harwick,885,226,374,92,24,96,812
Pennsylvania,Hawley borough,1364,438,496,138,32,63,1167
Pennsylvania,McElhattan,593,99,270,60,0,66,495
Pennsylvania,Grindstone,461,74,165,34,9,44,326
Pennsylvania,Grier City,378,74,196,14,0,13,297
Pennsylvania,Loretto borough,1238,1099,80,7,2,13,1201
Pennsylvania,Lower Allen,6919,1591,2915,810,37,505,5858
Pennsylvania,Lower Burrell,11593,2106,5606,1070,111,831,9724
Pennsylvania,Loyalhanna,3551,806,1568,297,95,294,3060
Pennsylvania,Lucerne Mines,617,138,248,130,8,45,569
Pennsylvania,Lumber City borough,78,17,45,5,6,0,73
Pennsylvania,Lumber City,198,43,71,11,29,9,163
Pennsylvania,Lorane,4070,947,2077,275,42,228,3569
Pennsylvania,Luzerne borough,2853,890,919,353,8,268,2438
Pennsylvania,Lynnwood-Pricedale,1976,333,1056,129,25,163,1706
Pennsylvania,Lyons borough,583,217,217,65,8,39,546
Pennsylvania,McAdoo borough,2522,689,808,221,69,184,1971
Pennsylvania,McAlisterville,1148,224,385,199,0,36,844
Pennsylvania,McClure borough,1016,175,521,74,22,47,839
Pennsylvania,McConnellsburg borough,1045,265,335,160,12,94,866
Pennsylvania,McConnellstown,1233,183,757,63,4,48,1055
Pennsylvania,Lykens borough,1680,384,663,131,55,109,1342
Pennsylvania,Grill,1587,259,713,132,12,129,1245
Pennsylvania,Lorain borough,801,167,284,92,36,50,629
Pennsylvania,Long Branch borough,456,108,227,29,10,19,393
Pennsylvania,Greenwood,2151,468,810,264,12,223,1777
Pennsylvania,Greenville borough,5892,2082,1811,541,177,248,4859
Pennsylvania,Green Tree borough,4653,1102,2242,288,83,311,4026
Pennsylvania,Greens Landing,817,227,294,74,0,0,595
Pennsylvania,Greensburg,14669,4892,4275,1703,356,1286,12512
Pennsylvania,Greensboro borough,222,51,92,27,2,11,183
Pennsylvania,Greenock,1905,350,879,189,15,149,1582
Pennsylvania,Longfellow,216,13,133,36,3,10,195
Pennsylvania,Green Lane borough,473,84,240,29,4,20,377
Pennsylvania,Greenfields,1000,360,400,64,23,99,946
Pennsylvania,Littlestown borough,4442,1009,1901,445,17,202,3574
Pennsylvania,Liverpool borough,763,193,303,84,21,61,662
Pennsylvania,Lock Haven,9790,4676,2075,804,124,491,8170
Pennsylvania,Locustdale,166,25,88,9,4,27,153
Pennsylvania,Loganton borough,559,92,263,37,4,19,415
Pennsylvania,Loganville borough,1147,192,569,79,6,40,886
Pennsylvania,Green Hills borough,41,13,13,6,0,2,34
Pennsylvania,West View borough,6735,1712,2689,696,137,315,5549
Pennsylvania,West Waynesburg,296,82,125,21,7,8,243
Pennsylvania,Westwood,1224,384,291,237,19,0,931
Pennsylvania,Kutztown borough,5018,1926,1998,159,19,423,4525
Pennsylvania,Kulpsville,8864,1673,4140,561,137,619,7130
Pennsylvania,Kulpmont borough,2894,571,1258,158,47,341,2375
Pennsylvania,Kreamer,797,138,444,73,17,18,690
Pennsylvania,Kratzerville,448,97,248,20,4,26,395
Pennsylvania,Koppel borough,696,160,222,96,16,70,564
Pennsylvania,Knoxville borough,635,148,280,73,1,29,531
Pennsylvania,Kutztown University,3822,3763,58,1,0,0,3822
Pennsylvania,Knox borough,1110,194,469,121,30,87,901
Pennsylvania,Kittanning borough,3947,995,1281,636,174,321,3407
Pennsylvania,Kistler borough,360,119,108,26,9,23,285
Pennsylvania,Kiskimere,67,4,36,7,0,12,59
Pennsylvania,Kirkwood,345,43,161,12,6,7,229
Pennsylvania,Kingston borough,13074,4073,4686,1468,232,962,11421
Pennsylvania,King of Prussia,19761,5113,8945,1200,254,1147,16659
Pennsylvania,Kersey,858,260,273,86,53,38,710
Pennsylvania,Klingerstown,66,10,32,2,7,4,55
Pennsylvania,Kerrtown,271,137,33,14,0,11,195
Pennsylvania,Kylertown,355,9,187,15,0,69,280
Pennsylvania,Laflin borough,1539,329,764,110,8,115,1326
Pennsylvania,Woodbury borough,218,46,114,22,1,9,192
Pennsylvania,Lanesboro borough,437,87,190,20,18,29,344
Pennsylvania,Landisville,1810,334,1029,85,0,49,1497
Pennsylvania,Landisburg borough,241,56,70,28,8,17,179
Pennsylvania,Landingville borough,94,30,32,8,0,11,81
Pennsylvania,Lancaster,59344,23302,14505,5337,1530,2058,46732
Pennsylvania,Lampeter,1549,452,636,112,0,76,1276
Pennsylvania,Laceyville borough,466,105,152,64,12,32,365
Pennsylvania,Lamar,611,169,265,51,13,52,550
Pennsylvania,Lake Winola,705,167,351,62,0,50,630
Pennsylvania,Lakemont,2338,546,979,282,55,118,1980
Pennsylvania,Lake Meade,2470,306,1585,65,0,78,2034
Pennsylvania,Lake Latonka,869,107,517,33,16,42,715
Pennsylvania,Lake Heritage,1646,364,974,103,6,42,1489
Pennsylvania,Lake City borough,3001,757,1115,247,66,147,2332
Pennsylvania,Lake Arthur Estates,713,160,250,157,5,42,614
Pennsylvania,Lake Wynonah,2430,383,1349,177,32,85,2026
Pennsylvania,Woodcock borough,130,20,69,14,0,8,111
Pennsylvania,Kennett Square borough,6117,1574,2561,370,167,286,4958
Pennsylvania,Kenmar,4557,931,1694,401,120,386,3532
Pennsylvania,Jennerstown borough,631,92,339,63,0,25,519
Pennsylvania,Jenkintown borough,4444,1112,1592,471,69,314,3558
Pennsylvania,Jefferson Hills borough,11115,2049,5589,714,120,712,9184
Pennsylvania,Jefferson borough (York County),571,101,259,42,13,44,459
Pennsylvania,Carrolltown borough,859,193,353,68,29,82,725
Pennsylvania,Carroll Valley borough,3900,746,1957,193,18,99,3013
Pennsylvania,Cashtown,290,38,104,36,0,52,230
Pennsylvania,Jermyn borough,2251,551,841,218,60,193,1863
Pennsylvania,Cassandra borough,155,32,66,6,8,11,123
Pennsylvania,Cassville borough,114,21,61,4,0,12,98
Pennsylvania,Castanea,1195,293,557,104,35,69,1058
Pennsylvania,Castle Shannon borough,8293,2349,3329,957,156,524,7315
Pennsylvania,Catasauqua borough,6505,1985,2199,569,184,372,5309
Pennsylvania,Catawissa borough,1473,323,482,149,54,176,1184
Pennsylvania,Cecil-Bishop,2561,589,1266,216,27,103,2201
Pennsylvania,Cedar Crest,354,65,127,39,6,35,272
Pennsylvania,Casselman borough,92,22,41,5,0,2,70
Pennsylvania,Kennerdell,217,24,103,27,3,40,197
Pennsylvania,Jerome,973,106,584,40,0,113,843
Pennsylvania,Jerseytown,131,13,70,18,0,11,112
Pennsylvania,Kenilworth,1786,298,882,85,24,136,1425
Pennsylvania,Kenhorst borough,2870,616,1160,413,65,130,2384
Pennsylvania,Kempton,103,44,49,0,0,10,103
Pennsylvania,Kelayres,475,76,201,57,27,30,391
Pennsylvania,Karns City borough,204,27,89,25,6,14,161
Pennsylvania,Kapp Heights,1062,224,556,61,0,44,885
Pennsylvania,Kane borough,3658,760,1344,413,125,304,2946
Pennsylvania,Jersey Shore borough,4333,990,1485,558,104,234,3371
Pennsylvania,Juniata Terrace borough,730,176,249,50,17,30,522
Pennsylvania,Jonestown borough,1702,348,680,113,38,71,1250
Pennsylvania,Jonestown,57,0,37,0,11,0,48
Pennsylvania,Johnstown,20369,6263,5343,2927,527,1422,16482
Pennsylvania,Johnsonburg borough,2465,544,977,251,31,195,1998
Pennsylvania,Joffre,697,107,280,61,8,72,528
Pennsylvania,Jim Thorpe borough,4712,1282,1781,542,124,246,3975
Pennsylvania,Jessup borough,4609,1268,1802,295,43,317,3725
Pennsylvania,Julian,193,65,61,44,0,3,173
Pennsylvania,Cementon,1356,332,503,216,25,133,1209
Pennsylvania,Woodland Heights,1160,149,566,108,13,55,891
Pennsylvania,Woodside,2485,309,1422,87,0,111,1929
Pennsylvania,Buck Run,185,40,89,10,7,13,159
Pennsylvania,Buffington,332,125,22,71,0,113,331
Pennsylvania,Bulger,305,76,113,25,0,18,232
Pennsylvania,Burgettstown borough,1388,381,476,187,4,94,1142
Pennsylvania,Burlington borough,178,24,68,7,4,7,110
Pennsylvania,Burnham borough,2044,378,804,206,56,192,1636
Pennsylvania,Burnside borough,216,46,99,23,2,7,177
Pennsylvania,Buckhorn,404,96,166,36,0,37,335
Pennsylvania,Butler,13517,3841,3654,2159,438,769,10861
Pennsylvania,Cairnbrook,584,87,293,40,0,69,489
Pennsylvania,California borough,6657,3271,1991,425,48,409,6144
Pennsylvania,Callensburg borough,171,25,61,15,2,14,117
Pennsylvania,Callery borough,415,76,180,43,0,10,309
Pennsylvania,Callimont borough,40,6,29,0,0,2,37
Pennsylvania,Caln,1554,396,617,32,55,40,1140
Pennsylvania,Calumet,1327,337,638,86,30,103,1194
Pennsylvania,Byrnedale,498,75,202,60,5,5,347
Pennsylvania,Cambridge Springs borough,2532,724,742,383,139,211,2199
Pennsylvania,Bryn Mawr,3436,2130,653,246,32,130,3191
Pennsylvania,Bruin borough,446,89,209,42,14,19,373
Pennsylvania,Bridgeport borough,4571,2017,1205,397,85,247,3951
Pennsylvania,Bridgeville borough,5135,1516,1705,611,139,462,4433
Pennsylvania,Bridgewater borough,722,175,265,81,26,50,597
Pennsylvania,Brisbin borough,308,42,158,19,12,19,250
Pennsylvania,Bristol borough,9634,2812,3013,1085,267,651,7828
Pennsylvania,Brittany Farms-The Highlands,3894,723,1818,290,68,277,3176
Pennsylvania,Broad Top City borough,455,99,253,17,6,35,410
Pennsylvania,Bryn Athyn borough,1360,432,596,71,0,51,1150
Pennsylvania,Brockway borough,1975,481,765,197,51,206,1700
Pennsylvania,Brookhaven borough,8054,1898,3610,702,56,589,6855
Pennsylvania,Brookville borough,3888,909,1499,518,61,280,3267
Pennsylvania,Broomall,10859,2515,5215,663,90,793,9276
Pennsylvania,Brownstown borough,766,167,303,55,22,69,616
Pennsylvania,Brownstown,2788,457,1586,60,0,110,2213
Pennsylvania,Brownsville borough,2407,622,786,258,43,238,1947
Pennsylvania,Browntown,1451,402,538,143,58,107,1248
Pennsylvania,Brodheadsville,1769,612,669,108,15,71,1475
Pennsylvania,Woodlyn,10249,2745,3558,892,237,753,8185
Pennsylvania,Campbelltown,4053,572,2062,251,127,188,3200
Pennsylvania,Canadohta Lake,536,113,266,59,18,26,482
Pennsylvania,Yeadon borough,11506,3965,3348,962,458,768,9501
Pennsylvania,Yatesville borough,658,157,333,52,0,39,581
Pennsylvania,Yardley borough,2406,651,974,226,35,108,1994
Pennsylvania,Wyomissing borough,10475,2390,4583,978,149,788,8888
Pennsylvania,Wyoming borough,3066,886,1270,278,27,295,2756
Pennsylvania,Wyndmoor,5611,1441,2275,409,160,403,4688
Pennsylvania,Wyncote,3207,854,1293,223,25,322,2717
Pennsylvania,Yeagertown,1053,304,406,122,0,111,943
Pennsylvania,Wylandville,323,123,127,20,12,9,291
Pennsylvania,Wyalusing borough,472,105,180,63,17,47,412
Pennsylvania,Wrightsville borough,2436,528,802,327,86,165,1908
Pennsylvania,Woxall,1288,276,632,78,0,54,1040
Pennsylvania,Worthville borough,69,10,41,3,0,3,57
Pennsylvania,Worthington borough,648,156,262,55,19,45,537
Pennsylvania,Wormleysburg borough,3066,997,1175,237,42,98,2549
Pennsylvania,Woodward,158,13,65,10,0,15,103
Pennsylvania,Wyano,430,125,198,36,0,48,407
Pennsylvania,Camp Hill borough,7886,1477,3813,501,125,520,6436
Pennsylvania,Yoe borough,1067,227,396,142,6,50,821
Pennsylvania,Yorkana borough,242,50,107,25,12,4,198
Pennsylvania,Canonsburg borough,8944,1833,3297,1301,197,695,7323
Pennsylvania,Canton borough,1984,515,675,245,32,148,1615
Pennsylvania,Carbondale,8773,2302,3019,909,194,824,7248
Pennsylvania,Carlisle borough,18945,6775,6110,1625,393,1143,16046
Pennsylvania,Carmichaels borough,360,56,149,67,15,32,319
Pennsylvania,Carnegie borough,7953,2553,2667,775,93,508,6596
Pennsylvania,Carnot-Moon,12546,4778,4415,923,253,567,10936
Pennsylvania,York,43853,16369,9389,4314,1444,1847,33363
Pennsylvania,Zion,1977,321,947,144,42,107,1561
Pennsylvania,Yukon,669,190,287,88,9,95,669
Pennsylvania,Youngwood borough,2998,799,908,377,46,322,2452
Pennsylvania,Youngsville borough,1818,377,792,150,50,131,1500
Pennsylvania,Youngstown borough,338,78,141,28,2,21,270
Pennsylvania,York Springs borough,692,181,241,39,12,13,486
Pennsylvania,Yorklyn,2046,917,662,74,37,111,1801
Pennsylvania,York Haven borough,698,187,190,82,25,39,523
Pennsylvania,Zelienople borough,3766,875,1510,397,145,340,3267
Pennsylvania,Centerport borough,292,68,123,30,3,21,245
Pennsylvania,Centerville borough (Crawford County),188,28,85,16,2,17,148
Pennsylvania,Parker,685,141,300,52,18,51,562
Pennsylvania,Ligonier borough,1483,297,702,156,57,127,1339
Pennsylvania,Lilly borough,802,181,364,61,9,74,689
Pennsylvania,Lima,2170,410,969,154,0,551,2084
Pennsylvania,Lime Ridge,780,129,270,145,20,38,602
Pennsylvania,Lincoln borough,1021,220,436,89,24,100,869
Pennsylvania,Lincoln Park,1598,208,706,51,67,112,1144
Pennsylvania,Lincoln University,1787,1716,42,9,5,0,1772
Pennsylvania,Lightstreet,919,122,495,86,0,84,787
Pennsylvania,Lincolnville,156,35,70,3,14,0,122
Pennsylvania,Linglestown,6338,1417,2874,687,122,212,5312
Pennsylvania,Linntown,1303,221,793,93,0,45,1152
Pennsylvania,Linwood,3449,1114,967,368,82,105,2636
Pennsylvania,Lionville,6637,1649,3025,446,0,311,5431
Pennsylvania,Lititz borough,9208,1810,4256,737,71,840,7714
Pennsylvania,Little Britain,244,79,97,38,0,17,231
Pennsylvania,Little Meadows borough,218,41,126,31,0,12,210
Pennsylvania,Linesville borough,843,161,359,124,19,95,758
Pennsylvania,Plymouth borough,5895,1711,1878,590,200,431,4810
Pennsylvania,Liberty borough (Tioga County),200,25,93,17,0,15,150
Pennsylvania,Lewistown borough,8326,2391,2382,1251,272,422,6718
Pennsylvania,Leetsdale borough,1281,270,544,102,35,91,1042
Pennsylvania,Lehighton borough,5388,1368,1908,718,106,361,4461
Pennsylvania,Leith-Hatfield,2745,579,1456,135,46,273,2489
Pennsylvania,Lemont,2346,605,1052,149,21,23,1850
Pennsylvania,Lemont Furnace,847,229,278,41,11,35,594
Pennsylvania,Lemoyne borough,4614,1130,1620,518,104,307,3679
Pennsylvania,Lenape Heights,1145,393,305,97,45,207,1047
Pennsylvania,Liberty borough (Allegheny County),2537,687,1036,208,50,206,2187
Pennsylvania,Lenhartsville borough,182,43,64,18,12,12,149
Pennsylvania,Leola,7104,1412,3198,493,110,286,5499
Pennsylvania,Le Raysville borough,275,40,131,23,7,1,202
Pennsylvania,Level Green,4043,620,2073,233,10,289,3225
Pennsylvania,Levittown,51805,14273,21223,3183,1077,2957,42713
Pennsylvania,Lewisberry borough,418,87,216,39,3,20,365
Pennsylvania,Lewisburg borough,5781,3103,1202,471,77,359,5212
Pennsylvania,Lewis Run borough,611,146,279,45,21,42,533
Pennsylvania,Lenkerville,550,203,245,47,10,0,505
Pennsylvania,Leesport borough,1844,375,808,197,43,54,1477
Pennsylvania,Plymouth Meeting,5796,1524,2557,457,92,372,5002
Pennsylvania,Pocono Mountain Lake Estates,741,128,353,132,0,61,674
Pennsylvania,Wilkes-Barre,41108,15910,10255,3612,1068,2671,33516
Pennsylvania,Wilcox,407,71,174,29,15,36,325
Pennsylvania,Wilburton Number Two,89,9,35,8,7,6,65
Pennsylvania,Wilburton Number One,178,56,63,15,10,18,162
Pennsylvania,Wiconsico,850,130,363,73,22,47,635
Pennsylvania,Wickerham Manor-Fisher,2223,503,1043,167,0,229,1942
Pennsylvania,Whitfield,4785,921,2464,296,9,291,3981
Pennsylvania,Wilkinsburg borough,15866,6907,3127,2134,306,978,13452
Pennsylvania,White Oak borough,7842,1577,3648,747,32,832,6836
Pennsylvania,White Haven borough,1173,308,484,129,32,41,994
Pennsylvania,Whitehall borough,13920,3204,6029,1037,139,1167,11576
Pennsylvania,Whitaker borough,1211,477,401,73,29,57,1037
Pennsylvania,Wheatland borough,838,222,282,112,12,80,708
Pennsylvania,West York borough,4583,1270,1307,556,198,211,3542
Pennsylvania,West Wyomissing,3147,679,1572,228,78,159,2716
Pennsylvania,West Wyoming borough,2706,750,1134,213,48,217,2362
Pennsylvania,White Mills,738,165,238,148,19,11,581
Pennsylvania,Plymptonville,1087,338,502,89,12,39,980
Pennsylvania,Williamsburg borough,1271,336,407,155,11,99,1008
Pennsylvania,Williamstown borough,1279,270,502,154,27,74,1027
Pennsylvania,Pocono Pines,942,162,451,77,26,85,801
Pennsylvania,Woodbourne,3768,790,1940,255,86,68,3139
Pennsylvania,Womelsdorf borough,2850,457,1271,163,21,252,2164
Pennsylvania,Wolfdale,2958,532,1423,403,0,170,2528
Pennsylvania,Witmer,617,141,353,8,3,0,505
Pennsylvania,Winterstown borough,520,79,278,62,6,35,460
Pennsylvania,Winfield,805,81,474,68,2,41,666
Pennsylvania,Williamsport,29339,10873,7607,2907,870,1628,23885
Pennsylvania,Windsor borough,1401,431,340,155,20,105,1051
Pennsylvania,Wind Gap borough,2709,573,1024,321,73,284,2275
Pennsylvania,Windber borough,4062,827,1787,321,126,309,3370
Pennsylvania,Wilson borough,7838,2172,2579,934,234,389,6308
Pennsylvania,Wilmore borough,252,55,106,21,0,7,189
Pennsylvania,Wilmerding borough,1766,686,214,268,131,136,1435
Pennsylvania,Willow Street,7562,1084,4163,454,17,1050,6768
Pennsylvania,Willow Grove,15545,3670,6918,984,276,846,12694
Pennsylvania,Wind Ridge,207,26,106,22,5,7,166
Pennsylvania,Leeper,156,30,99,14,0,13,156
Pennsylvania,Leechburg borough,2056,469,654,262,123,134,1642
Pennsylvania,Lebanon South,2427,317,1042,292,38,237,1926
Pennsylvania,Pennside,4094,1035,1506,416,126,206,3289
Pennsylvania,Penn State Erie (Behrend),1651,1643,6,0,0,2,1651
Pennsylvania,Pennville,1637,387,752,133,22,168,1462
Pennsylvania,Pennwyn,714,106,406,9,0,46,567
Pennsylvania,Penn Wynne,5568,928,2519,433,34,517,4431
Pennsylvania,Penryn,872,125,570,83,14,15,807
Pennsylvania,Perkasie borough,8498,2115,3801,772,87,305,7080
Pennsylvania,Penns Creek,586,172,231,77,14,31,525
Pennsylvania,Perryopolis borough,1797,261,839,184,27,168,1479
Pennsylvania,Petrolia borough,243,51,89,35,4,14,193
Pennsylvania,Philadelphia,1555072,653416,370737,114667,43356,82375,1264551
Pennsylvania,Philipsburg borough,2740,686,1039,343,58,213,2339
Pennsylvania,Phoenixville borough,16562,5406,5574,1569,362,800,13711
Pennsylvania,Picture Rocks borough,815,151,405,20,13,31,620
Pennsylvania,Pikes Creek,287,46,125,12,10,5,198
Pennsylvania,Pillow borough,280,55,142,14,0,6,217
Pennsylvania,Petersburg borough,541,104,187,60,18,23,392
Pennsylvania,Pine Glen,217,55,62,32,6,11,166
Pennsylvania,Pennsbury Village borough,743,276,210,124,22,24,656
Pennsylvania,Penn Lake Park borough,291,48,163,21,6,19,257
Pennsylvania,Parkesburg borough,3659,770,1506,280,63,251,2870
Pennsylvania,Park Forest Village,9457,4076,3488,471,84,203,8322
Pennsylvania,Parkside borough,2280,656,775,195,41,70,1737
Pennsylvania,Parkville,7141,1784,2622,783,87,332,5608
Pennsylvania,Parryville borough,629,154,277,42,11,10,494
Pennsylvania,Patterson Heights borough,630,160,295,39,12,43,549
Pennsylvania,Patton borough,1920,389,912,160,47,111,1619
Pennsylvania,Pennsburg borough,3872,974,1534,332,104,150,3094
Pennsylvania,Paxtang borough,1519,324,688,130,14,78,1234
Pennsylvania,Paxtonville,194,22,130,0,0,17,169
Pennsylvania,Pen Argyl borough,3557,956,1394,246,81,132,2809
Pennsylvania,Penbrook borough,2983,846,1005,302,49,88,2290
Pennsylvania,Pen Mar,1075,136,565,46,26,82,855
Pennsylvania,Penn borough,545,179,158,40,11,23,411
Pennsylvania,Penndel borough,2785,1099,832,176,72,136,2315
Pennsylvania,Penn Estates,6318,1837,2844,254,112,10,5057
Pennsylvania,Paxtonia,4998,1519,2354,238,34,155,4300
Pennsylvania,Pine Grove borough,2081,508,745,201,84,124,1662
Pennsylvania,Pine Grove Mills,940,151,582,35,44,40,852
Pennsylvania,Pine Ridge,2652,694,1028,342,39,226,2329
Pennsylvania,Laporte borough,331,83,138,41,0,55,317
Pennsylvania,Larksville borough,4453,1077,2011,345,30,338,3801
Pennsylvania,Latrobe borough,8191,1925,3166,875,197,635,6798
Pennsylvania,Lattimer,714,207,207,97,0,93,604
Pennsylvania,Laureldale borough,3884,906,1604,386,90,221,3207
Pennsylvania,Laurel Mountain borough,208,42,85,16,0,23,166
Pennsylvania,Laurel Run borough,517,152,194,76,9,40,471
Pennsylvania,Lansford borough,3871,1051,1303,373,154,322,3203
Pennsylvania,Laurelton,262,33,133,24,0,3,193
Pennsylvania,Lavelle,529,60,286,111,0,41,498
Pennsylvania,Lawnton,3794,933,1442,429,41,198,3043
Pennsylvania,Lawrence,343,70,140,70,31,7,318
Pennsylvania,Lawrence Park,3902,861,1613,395,77,254,3200
Pennsylvania,Lawrenceville borough,565,128,217,61,7,49,462
Pennsylvania,Lawson Heights,2192,366,1148,313,0,149,1976
Pennsylvania,Lebanon,25555,8161,6529,3048,677,1485,19900
Pennsylvania,Laurys Station,1095,352,542,85,8,13,1000
Pennsylvania,Lansdowne borough,10614,3346,3897,710,202,467,8622
Pennsylvania,Lansdale borough,16441,4812,5809,1692,190,914,13417
Pennsylvania,Langhorne Manor borough,1494,735,459,63,8,69,1334
Pennsylvania,Pitcairn borough,3270,951,994,435,46,283,2709
Pennsylvania,Pittsburgh,305928,135866,82643,23843,5654,16730,264736
Pennsylvania,Pittston,7698,2436,2468,798,215,614,6531
Pennsylvania,Plainfield,338,92,57,88,0,55,292
Pennsylvania,Plains,3900,1024,1452,425,132,359,3392
Pennsylvania,Platea borough,461,101,230,21,3,20,375
Pennsylvania,Pleasant Gap,2849,558,1206,413,28,141,2346
Pennsylvania,Pleasant Hill,2648,728,769,257,62,91,1907
Pennsylvania,Pleasant Hills borough,8284,1669,4074,458,93,781,7075
Pennsylvania,Pleasant View,967,147,452,132,0,92,823
Pennsylvania,Pleasantville borough (Bedford County),208,49,92,11,1,22,175
Pennsylvania,Pleasantville borough (Venango County),866,160,363,98,19,55,695
Pennsylvania,Plum borough,27458,5490,13324,1973,225,1771,22783
Pennsylvania,Plumsteadville,3256,846,1371,217,0,16,2450
Pennsylvania,Plumville borough,305,46,162,19,5,8,240
Pennsylvania,Langeloth,608,113,229,136,41,18,537
Pennsylvania,Langhorne borough,1488,469,587,76,7,181,1320
Pennsylvania,Nuremberg,423,146,140,19,0,30,335
Pennsylvania,Numidia,224,48,96,11,3,12,170
Pennsylvania,Oklahoma,1032,254,429,110,0,57,850
Pennsylvania,Noxen,678,150,302,68,12,60,592
Pennsylvania,Sugar Notch borough,944,266,341,117,11,70,805
Pennsylvania,Sugar Grove borough,554,96,286,29,0,36,447
Pennsylvania,Sugarcreek borough,5200,763,2690,382,15,431,4281
Pennsylvania,Sturgeon,1370,175,594,145,16,101,1031
Pennsylvania,Stroudsburg borough,5516,2009,1248,668,227,354,4506
Pennsylvania,Strong,18,13,0,0,0,5,18
Pennsylvania,Strodes Mills,535,62,257,73,9,54,455
Pennsylvania,Summerhill borough,451,83,214,27,8,39,371
Pennsylvania,Strausstown borough,270,58,126,24,10,13,231
Pennsylvania,Strasburg borough,2864,462,1398,201,19,158,2238
Pennsylvania,Stoystown borough,287,49,140,27,0,43,259
Pennsylvania,Stowe,3763,915,1264,428,87,264,2958
Pennsylvania,Stouchsburg,537,129,256,51,11,22,469
Pennsylvania,Stormstown,2410,350,1378,125,10,28,1891
Pennsylvania,Stony Creek Mills,841,188,330,155,0,15,688
Pennsylvania,Stonybrook,1999,224,1064,231,42,158,1719
Pennsylvania,Strattanville borough,720,180,316,75,5,30,606
Pennsylvania,Stonerstown,499,138,202,38,11,31,420
Pennsylvania,Summerville borough,511,98,224,61,15,21,419
Pennsylvania,Summit Station,163,0,139,0,0,24,163
Pennsylvania,Millville borough,942,160,427,97,13,58,755
Pennsylvania,Millwood,629,136,163,57,7,74,437
Pennsylvania,Milroy,1556,305,775,116,12,123,1331
Pennsylvania,Milton borough,6993,1613,2891,554,331,417,5806
Pennsylvania,Minersville borough,4310,1197,1489,338,170,348,3542
Pennsylvania,Mingoville,707,145,296,66,0,62,569
Pennsylvania,Mocanaqua,717,151,287,73,17,54,582
Pennsylvania,Summit Hill borough,2981,643,1356,244,28,159,2430
Pennsylvania,Modena borough,625,275,153,43,10,9,490
Pennsylvania,Swarthmore borough,6195,2338,2157,328,43,238,5104
Pennsylvania,Sutersville borough,610,167,223,51,13,44,498
Pennsylvania,Susquehanna Trails,2910,689,1123,209,19,90,2130
Pennsylvania,Susquehanna Depot borough,1558,409,462,177,55,124,1227
Pennsylvania,Sun Valley,2261,501,892,286,84,87,1850
Pennsylvania,Sunrise Lake,1625,406,706,95,3,87,1297
Pennsylvania,Sunbury,9758,3113,2816,966,429,616,7940
Pennsylvania,Swartzville,2038,465,1032,221,0,34,1752
Pennsylvania,Mill Village borough,422,108,190,32,15,18,363
Pennsylvania,Stoneboro borough,1005,171,454,149,16,53,843
Pennsylvania,Stockdale borough,354,95,179,21,0,33,328
Pennsylvania,Foxburg borough,212,48,73,28,5,19,173
Pennsylvania,Fountain Springs,390,67,125,119,0,57,368
Pennsylvania,Fountain Hill borough,4614,1356,1434,489,177,481,3937
Pennsylvania,Foundryville,108,9,81,11,0,7,108
Pennsylvania,Foster Brook,1052,301,335,153,9,72,870
Pennsylvania,Forty Fort borough,4170,919,1836,384,127,240,3506
Pennsylvania,Fort Washington,5931,1309,2865,291,46,253,4764
Pennsylvania,Fox Chapel borough,5413,768,3115,130,39,178,4230
Pennsylvania,Fort Loudon,928,60,511,114,42,15,742
Pennsylvania,Forksville borough,97,34,26,24,4,9,97
Pennsylvania,Forestville,363,86,214,20,0,28,348
Pennsylvania,Forest Hills borough,6491,1703,2827,403,164,579,5676
Pennsylvania,Forest City borough,2162,558,654,229,75,280,1796
Pennsylvania,Ford Cliff borough,435,73,213,36,7,42,371
Pennsylvania,Ford City borough,2928,739,953,466,40,240,2438
Pennsylvania,Force,273,60,91,15,0,19,185
Pennsylvania,Fort Indiantown Gap,39,19,20,0,0,0,39
Pennsylvania,Stockertown borough,1156,147,595,57,8,67,874
Pennsylvania,Fox Chase,1344,224,827,55,11,90,1207
Pennsylvania,Frankfort Springs borough,102,20,57,5,1,8,91
Pennsylvania,Stillwater borough,199,41,97,20,6,6,170
Pennsylvania,Stiles,1099,355,359,129,33,41,917
Pennsylvania,Stewartstown borough,2126,411,851,261,15,174,1712
Pennsylvania,Stevens,375,50,229,38,0,27,344
Pennsylvania,Steelton borough,5956,1992,1382,530,89,214,4207
Pennsylvania,State Line,2372,447,1049,252,68,202,2018
Pennsylvania,State College borough,42129,32552,5969,998,259,568,40346
Pennsylvania,Frackville borough,3757,781,1448,308,101,311,2949
Pennsylvania,Starrucca borough,223,41,75,32,12,17,177
Pennsylvania,Starbrick,498,91,235,56,21,30,433
Pennsylvania,Spry,4896,927,2390,464,57,251,4089
Pennsylvania,Fredericksburg CDP (Crawford County),771,47,393,48,27,40,555
Pennsylvania,Franklintown borough,527,145,146,79,6,19,395
Pennsylvania,Franklin Park borough,14062,2222,7537,629,85,545,11018
Pennsylvania,Franklin,6401,1719,2316,724,113,435,5307
Pennsylvania,Franklin borough,299,77,94,40,2,33,246
Pennsylvania,Star Junction,455,130,183,61,8,23,405
Pennsylvania,Foot of Ten,791,130,509,40,0,28,707
Pennsylvania,Millvale borough,3721,1247,1002,469,125,265,3108
Pennsylvania,Millheim borough,890,168,402,85,4,58,717
Pennsylvania,Sylvania borough,237,72,95,18,4,4,193
Pennsylvania,Sykesville borough,1131,310,385,110,21,81,907
Pennsylvania,Swoyersville borough,5025,1431,2035,584,82,268,4400
Pennsylvania,Swissvale borough,8932,3536,2645,855,172,505,7713
Pennsylvania,Sweden Valley,200,34,106,12,0,8,160
Pennsylvania,Marion Heights borough,709,175,297,31,13,43,559
Pennsylvania,Marklesburg borough,250,57,100,19,0,15,191
Pennsylvania,Table Rock,56,13,26,4,0,0,43
Pennsylvania,Markleysburg borough,259,50,107,41,0,37,235
Pennsylvania,Mars borough,1276,267,523,143,17,146,1096
Pennsylvania,Marshallton,1301,332,429,167,52,81,1061
Pennsylvania,Martinsburg borough,1776,349,799,211,25,206,1590
Pennsylvania,Martins Creek,504,144,202,23,16,97,482
Pennsylvania,Marysville borough,2525,602,978,259,9,208,2056
Pennsylvania,Masontown borough,3416,822,1092,384,68,341,2707
Pennsylvania,Masthope,682,52,435,5,31,51,574
Pennsylvania,Marlin,491,69,217,69,4,57,416
Pennsylvania,Matamoras borough,2310,557,890,214,65,149,1875
Pennsylvania,Tamaqua borough,6949,1872,2353,743,213,399,5580
Pennsylvania,Tatamy borough,992,141,539,57,3,29,769
Pennsylvania,Republic,1005,317,309,81,24,40,771
Pennsylvania,Revloc,660,159,233,23,0,111,526
Pennsylvania,Rew,67,17,14,7,21,8,67
Pennsylvania,Reynolds Heights,1858,556,600,347,46,74,1623
Pennsylvania,Reynoldsville borough,2734,678,1116,287,92,121,2294
Pennsylvania,Rheems,1610,80,767,96,0,124,1067
Pennsylvania,Thompsontown borough,794,167,346,96,6,67,682
Pennsylvania,Tarentum borough,4507,1480,1450,431,79,283,3723
Pennsylvania,Thompson borough,343,116,131,23,0,25,295
Pennsylvania,Tharptown (Uniontown),495,35,256,59,15,57,422
Pennsylvania,Nuangola borough,778,158,364,51,16,57,646
Pennsylvania,Templeton,310,59,154,21,6,16,256
Pennsylvania,Temple,1487,310,447,287,8,167,1219
Pennsylvania,Telford borough,4881,1017,2045,501,63,352,3978
Pennsylvania,Taylorstown,151,26,69,13,0,13,121
Pennsylvania,Taylor borough,6176,1657,2256,713,77,322,5025
Pennsylvania,The Hideout,2662,562,1427,148,27,251,2415
Pennsylvania,Millsboro,542,194,199,35,8,14,450
Pennsylvania,Mather,505,65,191,79,6,65,406
Pennsylvania,Mayfield borough,1764,407,742,143,34,136,1462
Pennsylvania,Midway,1880,479,966,82,34,136,1697
Pennsylvania,Midway borough,886,208,357,51,29,49,694
Pennsylvania,Mifflin borough,626,171,258,29,10,53,521
Pennsylvania,Mifflinburg borough,3530,695,1416,387,100,235,2833
Pennsylvania,Mifflintown borough,1084,290,335,134,31,44,834
Pennsylvania,Mifflinville,1377,239,732,103,0,75,1149
Pennsylvania,Milesburg borough,855,232,314,111,9,33,699
Pennsylvania,Midland borough,2589,783,616,173,105,258,1935
Pennsylvania,Milford borough,1067,268,413,138,19,94,932
Pennsylvania,Millbourne borough,1155,357,502,34,12,11,916
Pennsylvania,Mill Creek borough,373,81,148,37,10,32,308
Pennsylvania,Millersburg borough,2544,619,971,245,29,221,2085
Pennsylvania,Millerstown borough,741,139,356,75,5,32,607
Pennsylvania,Millersville borough,8358,4971,2008,389,54,312,7734
Pennsylvania,Millerton,347,50,199,15,8,12,284
Pennsylvania,Mill Hall borough,1565,353,606,209,44,114,1326
Pennsylvania,Milford Square,1115,244,576,104,19,0,943
Pennsylvania,Mattawana,399,153,118,26,2,15,314
Pennsylvania,Middletown,7380,1521,3668,536,105,434,6264
Pennsylvania,Middleport borough,399,97,178,52,9,38,374
Pennsylvania,Maytown,4095,836,1867,227,14,83,3027
Pennsylvania,Meadowlands,999,221,371,65,41,95,793
Pennsylvania,Meadowood,2620,364,1168,377,52,303,2264
Pennsylvania,Meadville,13224,4814,3771,1670,316,649,11220
Pennsylvania,Mechanicsburg borough,8984,2135,3841,948,150,404,7478
Pennsylvania,Mechanicsville borough,496,127,199,63,5,29,423
Pennsylvania,Media borough,5336,1964,1476,824,85,347,4696
Pennsylvania,Middletown borough,8942,2716,2671,911,434,721,7453
Pennsylvania,Mercer borough,1964,586,664,220,80,98,1648
Pennsylvania,Meridian,3605,587,1726,297,54,307,2971
Pennsylvania,Mertztown,838,325,145,119,31,51,671
Pennsylvania,Meshoppen borough,450,131,143,49,9,20,352
Pennsylvania,Messiah College,2371,2325,46,0,0,0,2371
Pennsylvania,Mexico,308,49,140,61,4,34,288
Pennsylvania,Meyersdale borough,1933,405,830,136,21,226,1618
Pennsylvania,Middleburg borough,1408,297,496,129,25,102,1049
Pennsylvania,Mercersburg borough,1417,331,576,199,33,55,1194
Pennsylvania,Renovo borough,1229,297,391,132,51,75,946
Pennsylvania,Folsom,8163,2117,3515,597,100,368,6697
Pennsylvania,Flying Hills,2356,562,822,510,13,239,2146
Pennsylvania,Etna borough,3432,1191,1179,365,33,151,2919
Pennsylvania,Espy,1735,402,777,143,18,85,1425
Pennsylvania,Ernest borough,355,103,124,42,0,10,279
Pennsylvania,Erie,100678,34616,29334,9315,2637,5328,81230
Pennsylvania,Ephrata borough,13617,3137,6048,1054,216,527,10982
Pennsylvania,Enon Valley borough,359,104,159,27,2,16,308
Pennsylvania,Enola,6235,1892,2146,659,128,183,5008
Pennsylvania,Evansburg,2371,494,1139,132,17,84,1866
Pennsylvania,Enlow,1247,200,630,98,0,19,947
Pennsylvania,Englewood,720,66,391,0,46,50,553
Pennsylvania,Emsworth borough,2429,826,851,174,65,121,2037
Pennsylvania,Emporium borough,1917,477,665,273,56,193,1664
Pennsylvania,Emmaus borough,11342,2591,4724,1123,328,760,9526
Pennsylvania,Emlenton borough,706,184,271,35,11,59,560
Pennsylvania,Emigsville,2933,554,1229,209,180,83,2255
Pennsylvania,Emerald Lakes,3822,1095,1631,64,102,210,3102
Pennsylvania,Enhaut,877,133,467,56,9,72,737
Pennsylvania,Elysburg,1892,310,830,152,99,122,1513
Pennsylvania,Evans City borough,1760,351,705,231,48,144,1479
Pennsylvania,Everson borough,736,211,269,102,9,43,634
Pennsylvania,Sligo borough,620,152,242,49,17,57,517
Pennsylvania,Slickville,313,103,129,55,4,14,305
Pennsylvania,Slatington borough,4263,1076,1411,590,112,238,3427
Pennsylvania,Slatedale,612,164,232,50,0,65,511
Pennsylvania,Slabtown,115,20,50,27,4,3,104
Pennsylvania,Skyline View,3895,795,1995,218,74,225,3307
Pennsylvania,Skippack,3977,502,1894,418,33,81,2928
Pennsylvania,Everett borough,1769,431,597,233,42,121,1424
Pennsylvania,Sinking Spring borough,4042,1027,1344,443,119,186,3119
Pennsylvania,Silverdale borough,923,221,463,40,18,38,780
Pennsylvania,Silkworth,979,175,478,76,1,79,809
Pennsylvania,Siglerville,97,0,81,0,0,0,81
Pennsylvania,Sierra View,5088,917,2375,411,193,238,4134
Pennsylvania,Sidman,556,98,284,0,0,42,424
Pennsylvania,Export borough,990,252,349,87,12,68,768
Pennsylvania,Exeter borough,5625,1428,2119,503,119,525,4694
Pennsylvania,Simpson,1267,261,525,163,3,116,1068
Pennsylvania,Slippery Rock borough,3633,2453,610,167,24,160,3414
Pennsylvania,Elverson borough,1353,163,712,111,30,130,1146
Pennsylvania,Ellwood City borough,7836,2008,2844,922,148,628,6550
Pennsylvania,Edgewood borough,3093,1005,1214,240,10,117,2586
Pennsylvania,Edenburg,803,150,396,63,0,46,655
Pennsylvania,Edenborn,226,80,92,0,13,0,185
Pennsylvania,Eddystone borough,2521,780,732,213,105,64,1894
Pennsylvania,Eddington,1937,392,838,140,15,132,1517
Pennsylvania,Economy borough,9189,1373,5406,493,92,448,7812
Pennsylvania,Ebensburg borough,3265,898,1161,377,48,314,2798
Pennsylvania,Edgewood,2232,529,768,247,84,190,1818
Pennsylvania,Eau Claire borough,353,115,142,30,2,19,308
Pennsylvania,East Waterford,178,31,65,25,2,11,134
Pennsylvania,East Washington borough,2244,803,878,169,13,58,1921
Pennsylvania,East Vandergrift borough,742,242,247,83,13,65,650
Pennsylvania,Eastvale borough,237,43,88,29,8,9,177
Pennsylvania,East Uniontown,2532,751,797,348,56,230,2182
Pennsylvania,East Stroudsburg borough,9967,4581,2217,932,401,561,8692
Pennsylvania,East Side borough,247,78,97,34,2,18,229
Pennsylvania,East York,8247,1647,3628,860,85,714,6934
Pennsylvania,Elrama,290,56,52,63,0,53,224
Pennsylvania,Edgeworth borough,1657,258,913,55,7,51,1284
Pennsylvania,Edinboro borough,6443,3452,1430,196,312,221,5611
Pennsylvania,Ellsworth borough,741,184,283,81,18,45,611
Pennsylvania,Ellport borough,1108,265,438,142,6,91,942
Pennsylvania,Elkland borough,1928,459,722,259,34,100,1574
Pennsylvania,Elizabethville borough,1736,423,678,137,35,113,1386
Pennsylvania,Elizabethtown borough,11591,4182,4121,948,190,399,9840
Pennsylvania,Elizabeth borough,1391,396,450,158,24,125,1153
Pennsylvania,Elim,3760,1087,1773,258,16,315,3449
Pennsylvania,Edie,44,0,15,20,0,9,44
Pennsylvania,Elgin borough,168,35,91,7,3,8,144
Pennsylvania,Elderton borough,342,61,185,20,4,34,304
Pennsylvania,Elco borough,303,83,121,27,8,14,253
Pennsylvania,Eighty Four,764,179,280,26,43,74,602
Pennsylvania,Ehrenfeld borough,211,46,88,26,0,16,176
Pennsylvania,Egypt,2512,546,1273,193,34,93,2139
Pennsylvania,Effort,2312,371,1000,194,0,42,1607
Pennsylvania,Edwardsville borough,4773,1437,1294,455,171,395,3752
Pennsylvania,Eldred borough,648,136,251,85,2,49,523
Pennsylvania,Folcroft borough,6630,2135,2116,567,90,244,5152
Pennsylvania,Slippery Rock University,2138,2117,21,0,0,0,2138
Pennsylvania,Smethport borough,1587,301,650,187,31,162,1331
Pennsylvania,Fallston borough,217,69,81,20,5,20,195
Pennsylvania,Falls Creek borough,1160,251,484,118,19,63,935
Pennsylvania,Fairview-Ferndale,1689,493,611,178,48,175,1505
Pennsylvania,Fairview,2668,456,1270,168,23,310,2227
Pennsylvania,Fairview borough,200,48,83,13,4,5,153
Pennsylvania,Fairless Hills,8789,2149,3288,911,246,664,7258
Pennsylvania,Fairhope,1258,244,586,142,0,39,1011
Pennsylvania,Falmouth,269,50,129,0,18,23,220
Pennsylvania,Fairfield borough,543,107,272,35,20,40,474
Pennsylvania,Fairchance borough,1820,469,718,198,51,96,1532
Pennsylvania,Factoryville borough,1119,518,300,117,16,28,979
Pennsylvania,Eyers Grove,82,15,40,17,0,6,78
Pennsylvania,Exton,4772,966,2212,564,14,215,3971
Pennsylvania,Spring Ridge,844,91,369,149,0,141,750
Pennsylvania,Spring Mount,2361,322,1273,204,36,56,1891
Pennsylvania,Springmont,620,80,264,52,0,58,454
Pennsylvania,Fairdale,1772,462,667,125,45,189,1488
Pennsylvania,Spring Mills,268,86,89,26,14,29,244
Pennsylvania,Farmersville,945,268,297,27,0,218,810
Pennsylvania,Farrell,4852,1303,1513,543,77,489,3925
Pennsylvania,Flourtown,4845,949,2378,236,53,192,3808
Pennsylvania,Flora Dale,26,0,26,0,0,0,26
Pennsylvania,Flemington borough,1342,328,532,176,0,118,1154
Pennsylvania,Fleetwood borough,4082,805,1898,368,22,197,3290
Pennsylvania,Fivepointville,1380,186,702,61,38,86,1073
Pennsylvania,Finleyville borough,434,177,120,51,5,24,377
Pennsylvania,Fernville,496,76,288,20,10,23,417
Pennsylvania,Farmington,867,204,402,37,0,40,683
Pennsylvania,Ferndale borough,1578,327,678,150,28,100,1283
Pennsylvania,Fellsburg,1107,225,584,72,22,119,1022
Pennsylvania,Feasterville,3349,818,1200,326,104,146,2594
Pennsylvania,Fayetteville,3007,713,1275,270,105,200,2563
Pennsylvania,Fayette City borough,567,158,154,59,25,52,448
Pennsylvania,Faxon,1264,240,581,65,21,179,1086
Pennsylvania,Fawn Lake Forest,523,26,378,33,0,8,445
Pennsylvania,Fawn Grove borough,427,63,195,43,11,25,337
Pennsylvania,Felton borough,603,121,272,59,3,16,471
Pennsylvania,Slovan,461,113,215,16,0,37,381
Pennsylvania,Spring House,3541,787,1640,160,0,477,3064
Pennsylvania,Spring Grove borough,2308,585,827,224,64,111,1811
Pennsylvania,South Fork borough,960,233,373,90,35,52,783
Pennsylvania,South Connellsville borough,1819,365,883,146,19,122,1535
Pennsylvania,South Coatesville borough,1408,458,344,171,32,82,1087
Pennsylvania,South Bethlehem borough,446,83,189,36,14,42,364
Pennsylvania,Souderton borough,6697,1583,2915,516,97,286,5397
Pennsylvania,Soudersburg,414,235,131,28,0,0,394
Pennsylvania,Somerset borough,6127,1412,2228,732,94,567,5033
Pennsylvania,South Greensburg borough,2067,511,822,251,75,177,1836
Pennsylvania,Snydertown borough,335,55,187,38,0,18,298
Pennsylvania,S.N.P.J. borough,18,5,8,2,0,1,16
Pennsylvania,Snow Shoe borough,905,210,354,79,0,43,686
Pennsylvania,Smoketown,395,50,237,0,0,0,287
Pennsylvania,Smock,543,146,253,9,4,45,457
Pennsylvania,Smithton borough,409,88,153,61,0,26,328
Pennsylvania,Smithfield borough,1017,250,369,71,28,60,778
Pennsylvania,Smicksburg borough,41,5,25,3,0,2,35
Pennsylvania,Snydertown,341,24,225,19,0,0,268
Pennsylvania,Spring Hill,891,167,414,30,31,40,682
Pennsylvania,South Heights borough,449,92,198,58,30,16,394
Pennsylvania,South New Castle borough,742,194,278,93,25,34,624
Pennsylvania,Springdale borough,3407,939,1228,332,107,248,2854
Pennsylvania,Spring City borough,3331,899,1065,515,50,140,2669
Pennsylvania,Springboro borough,425,122,177,32,0,10,341
Pennsylvania,Spinnerstown,1941,316,972,134,0,79,1501
Pennsylvania,Speers borough,1163,271,490,159,20,78,1018
Pennsylvania,Spartansburg borough,281,33,153,20,6,25,237
Pennsylvania,South Williamsport borough,6354,1642,2428,587,172,305,5134
Pennsylvania,Southmont borough,2204,490,1040,136,28,119,1813
Pennsylvania,Southwest Greensburg borough,2021,457,823,221,53,118,1672
Pennsylvania,Southview,110,58,19,22,0,8,107
Pennsylvania,South Uniontown,1200,233,578,112,13,74,1010
Pennsylvania,South Temple,1635,480,578,155,81,51,1345
Pennsylvania,South Renovo borough,422,78,185,45,0,60,368
Pennsylvania,South Pottstown,1924,435,722,201,55,111,1524
Pennsylvania,South Philipsburg,336,45,165,17,0,60,287
Pennsylvania,South Park Township,13504,2794,6688,872,242,647,11243
Pennsylvania,South Waverly borough,1217,190,659,88,13,97,1047
Pennsylvania,Renningers,511,109,204,41,0,47,401
Pennsylvania,Terre Hill borough,1492,366,634,52,9,64,1125
Pennsylvania,Reinholds,1914,671,859,87,0,0,1617
Pennsylvania,Chevy Chase Heights,1626,391,697,167,35,89,1379
Pennsylvania,Chewton,444,107,211,53,18,18,407
Pennsylvania,Cheyney University,866,833,33,0,0,0,866
Pennsylvania,Chicora borough,942,213,347,96,42,66,764
Pennsylvania,Chinchilla,2182,545,1028,180,0,62,1815
Pennsylvania,Christiana borough,962,221,342,76,13,115,767
Pennsylvania,Church Hill,1415,332,765,71,17,115,1300
Pennsylvania,Cheswick borough,1758,367,860,135,5,142,1509
Pennsylvania,Churchill borough,3009,601,1672,150,27,146,2596
Pennsylvania,Churchville,3855,737,2057,94,19,177,3084
Pennsylvania,Clairton,6752,2394,1998,660,88,599,5739
Pennsylvania,Clarence,625,94,315,65,7,36,517
Pennsylvania,Clarendon borough,506,112,140,61,30,44,387
Pennsylvania,Clarion borough,5298,2841,1298,340,90,226,4795
Pennsylvania,Clark borough,535,97,324,31,0,19,471
Pennsylvania,Clarks Green borough,1450,246,722,114,5,102,1189
Pennsylvania,Churchtown,418,91,199,8,10,0,308
Pennsylvania,Clarks Summit borough,5067,597,2509,573,148,349,4176
Pennsylvania,Chest Springs borough,196,31,65,28,7,7,138
Pennsylvania,Chester Heights borough,2573,561,1058,289,40,140,2088
Pennsylvania,Central City borough,1018,220,484,68,15,110,897
Pennsylvania,Centralia borough,11,2,5,4,0,0,11
Pennsylvania,Centre Hall borough,1244,197,666,51,15,73,1002
Pennsylvania,Cetronia,1684,373,718,242,13,207,1553
Pennsylvania,Chalfant borough,897,208,457,81,7,41,794
Pennsylvania,Chalfont borough,4054,871,1873,196,58,162,3160
Pennsylvania,Chalkhill,153,27,116,10,0,0,153
Pennsylvania,Chester Hill borough,909,234,334,60,15,67,710
Pennsylvania,Chambersburg borough,20519,5550,6704,2205,396,1287,16142
Pennsylvania,Charleroi borough,4062,1168,1214,441,85,319,3227
Pennsylvania,Chase,833,191,464,30,0,23,708
Pennsylvania,Cherry Tree borough,409,106,172,19,11,11,319
Pennsylvania,Cherry Valley borough,53,3,27,7,1,5,43
Pennsylvania,Cherryville,1444,302,872,54,0,82,1310
Pennsylvania,Chester,34016,16806,4917,2504,1109,1789,27125
Pennsylvania,Chesterbrook,4478,841,2018,562,150,166,3737
Pennsylvania,Chapman borough,172,37,74,26,5,7,149
Pennsylvania,Centerville borough (Washington County),3221,759,1377,301,45,235,2717
Pennsylvania,Clarksville borough,201,87,77,8,0,4,176
Pennsylvania,Claysburg,1881,299,706,122,32,161,1320
Pennsylvania,Pocono Ranch Lands,1073,218,461,66,15,64,824
Pennsylvania,Pocono Springs,1080,231,558,82,25,79,975
Pennsylvania,Pocono Woodland Lakes,3019,509,1310,267,82,59,2227
Pennsylvania,Point Marion borough,998,293,370,115,22,98,898
Pennsylvania,Polk borough,745,383,175,62,5,22,647
Pennsylvania,Rennerdale,766,101,454,11,31,52,649
Pennsylvania,Portage borough,2561,684,940,217,28,225,2094
Pennsylvania,Collinsburg,1128,387,416,158,16,72,1049
Pennsylvania,Port Allegany borough,2096,474,832,179,43,123,1651
Pennsylvania,Valley View CDP (Schuylkill County),1458,236,676,231,22,114,1279
Pennsylvania,Valley-Hi borough,6,6,0,0,0,0,6
Pennsylvania,Valley Green,4171,779,1938,381,49,62,3209
Pennsylvania,Valencia borough,553,129,232,47,7,110,525
Pennsylvania,Utica borough,166,31,66,22,6,4,129
Pennsylvania,Ursina borough,267,80,83,35,3,21,222
Pennsylvania,Upper St. Clair,19385,2915,10414,836,141,834,15140
Pennsylvania,Valley View CDP (York County),2547,545,1152,174,62,151,2084
Pennsylvania,Clay,1976,393,841,90,29,107,1460
Pennsylvania,Collingdale borough,8786,2784,2578,866,225,441,6894
Pennsylvania,Cokeburg borough,588,139,230,65,10,63,507
Pennsylvania,Claysville borough,1035,282,360,70,28,95,835
Pennsylvania,Clearfield borough,6106,1378,2381,769,122,435,5085
Pennsylvania,Cleona borough,2125,418,986,233,10,149,1796
Pennsylvania,Clifton Heights borough,6658,2002,2277,369,244,196,5088
Pennsylvania,Clinton,524,120,143,165,0,57,485
Pennsylvania,Clintonville borough,435,46,203,54,0,32,335
Pennsylvania,Clymer borough,1237,277,460,114,36,100,987
Pennsylvania,Collegeville borough,5296,2671,1678,172,25,91,4637
Pennsylvania,Coal Center borough,83,45,18,6,0,2,71
Pennsylvania,Coaldale borough (Schuylkill County),2222,631,683,222,99,169,1804
Pennsylvania,Coalmont borough,127,27,59,9,1,6,102
Pennsylvania,Coalport borough,495,141,194,30,8,26,399
Pennsylvania,Coatesville,13152,4689,3077,856,303,594,9519
Pennsylvania,Coburn,142,26,53,6,0,8,93
Pennsylvania,Cochranton borough,1303,236,554,117,25,70,1002
Pennsylvania,Cochranville,657,161,281,74,6,40,562
Pennsylvania,Coaldale borough (Bedford County),159,8,85,7,6,11,117
Pennsylvania,Upper Exeter,629,111,371,27,7,23,539
Pennsylvania,Bentleyville borough,2554,557,891,346,25,210,2029
Pennsylvania,Berlin borough,1922,372,884,203,19,211,1689
Pennsylvania,Breinigsville,5018,814,2334,347,26,164,3685
Pennsylvania,Brave,189,25,105,10,0,5,145
Pennsylvania,Brandonville,220,59,87,28,3,13,190
Pennsylvania,Branchdale,434,133,156,42,7,11,349
Pennsylvania,Bradford Woods borough,1202,167,688,54,3,62,974
Pennsylvania,Bradford,8608,2730,2050,1292,260,617,6949
Pennsylvania,Bradenville,767,266,190,87,0,27,570
Pennsylvania,Brentwood borough,9598,2923,3499,850,205,584,8061
Pennsylvania,Braddock Hills borough,1733,551,523,261,0,200,1535
Pennsylvania,Brackenridge borough,3244,780,1146,330,64,350,2670
Pennsylvania,Boyertown borough,4053,896,1295,603,121,429,3344
Pennsylvania,Bowmansville,2082,583,971,19,38,52,1663
Pennsylvania,Bowmanstown borough,1119,174,550,111,12,104,951
Pennsylvania,Bowers,240,53,146,8,0,24,231
Pennsylvania,Boswell borough,1282,233,558,152,32,89,1064
Pennsylvania,Boston,374,120,116,35,0,67,338
Pennsylvania,Braddock borough,1989,871,281,230,59,225,1666
Pennsylvania,Boothwyn,5345,1517,1629,692,162,362,4362
Pennsylvania,Bressler,1307,308,582,81,23,76,1070
Pennsylvania,Brickerville,1533,346,793,41,0,51,1231
Pennsylvania,Norwood borough,5897,1801,1997,583,93,419,4893
Pennsylvania,Norvelt,1173,221,621,54,50,95,1041
Pennsylvania,North York borough,1671,578,415,309,49,73,1424
Pennsylvania,Northwood,386,80,205,33,0,27,345
Pennsylvania,Northwest Harborcreek,9216,1669,4516,681,124,595,7585
Pennsylvania,North Warren,1780,425,805,223,2,181,1636
Pennsylvania,North Wales borough,3248,908,1168,404,66,146,2692
Pennsylvania,Briar Creek borough,704,155,207,94,37,134,627
Pennsylvania,North Vandergrift,426,127,162,37,15,15,356
Pennsylvania,North Philipsburg,778,168,251,103,11,147,680
Pennsylvania,North Irwin borough,801,192,311,103,16,44,666
Pennsylvania,Northern Cambria borough,3716,781,1510,393,80,217,2981
Pennsylvania,North East borough,4229,1345,1245,326,84,311,3311
Pennsylvania,North Charleroi borough,1305,373,419,168,18,159,1137
Pennsylvania,North Catasauqua borough,2833,589,1241,310,39,158,2337
Pennsylvania,North Braddock borough,4829,1589,1178,448,102,464,3781
Pennsylvania,Northumberland borough,3756,889,1672,459,6,176,3202
Pennsylvania,Benton borough,1087,208,418,71,30,73,800
Pennsylvania,Bonneauville borough,1881,427,743,199,20,44,1433
Pennsylvania,Boiling Springs,2929,753,1567,189,5,89,2603
Pennsylvania,Birchwood Lakes,1570,455,606,87,28,106,1282
Pennsylvania,Big Run borough,605,115,256,55,16,36,478
Pennsylvania,Biglerville borough,1195,315,443,124,16,55,953
Pennsylvania,Bigler,464,79,193,49,0,6,327
Pennsylvania,Big Beaver borough,1918,438,1019,112,18,133,1720
Pennsylvania,Big Bass Lake,1453,325,716,91,41,75,1248
Pennsylvania,Beurys Lake,122,32,54,17,6,7,116
Pennsylvania,Bird-in-Hand,616,89,347,0,2,0,438
Pennsylvania,Bethlehem,75004,27320,23258,6653,2058,4122,63411
Pennsylvania,Bethel,736,127,377,45,0,19,568
Pennsylvania,Bethany borough,227,58,97,18,2,15,190
Pennsylvania,Bessemer borough,1186,328,497,108,3,57,993
Pennsylvania,Berwyn,3113,707,1354,153,19,242,2475
Pennsylvania,Berwick borough,10328,2586,3908,1015,195,742,8446
Pennsylvania,Berrysburg borough,377,107,156,30,0,35,328
Pennsylvania,Bernville borough,814,179,351,78,31,30,669
Pennsylvania,Bethel Park municipal,32322,6978,15371,1932,401,2405,27087
Pennsylvania,Bolivar borough,440,98,185,45,5,29,362
Pennsylvania,Birdsboro borough,5155,1261,2363,416,67,173,4280
Pennsylvania,Black Lick,1523,234,515,202,28,115,1094
Pennsylvania,Bobtown,778,170,363,47,19,76,675
Pennsylvania,Boalsburg,4017,765,2064,261,49,79,3218
Pennsylvania,Blue Ridge Summit,994,282,438,104,19,34,877
Pennsylvania,Blue Bell,5985,1183,3215,316,66,319,5099
Pennsylvania,Blue Ball,1056,345,490,29,0,26,890
Pennsylvania,Blossburg borough,1568,322,602,198,30,90,1242
Pennsylvania,Bloomsburg,14631,8586,2870,1158,221,465,13300
Pennsylvania,Birmingham borough,109,18,61,4,0,3,86
Pennsylvania,Blooming Valley borough,331,73,174,18,7,17,289
Pennsylvania,Blawnox borough,1570,403,569,144,71,84,1271
Pennsylvania,Blandon,7231,1368,3294,482,181,312,5637
Pennsylvania,Blandburg,369,89,127,40,18,26,300
Pennsylvania,Blanchard,693,111,315,48,24,55,553
Pennsylvania,Blakely borough,6496,1769,2836,513,62,639,5819
Pennsylvania,Blairsville borough,3356,824,1408,162,97,256,2747
Pennsylvania,Blain borough,276,62,103,19,5,12,201
Pennsylvania,Bloomfield borough,1347,277,533,135,33,107,1085
Pennsylvania,Upland borough,3234,1289,658,228,54,185,2414
Pennsylvania,Pomeroy,245,86,87,22,20,30,245
Pennsylvania,Unionville borough,221,60,87,27,0,9,183
Pennsylvania,Friendsville borough,147,32,77,11,1,7,128
Pennsylvania,Friedensburg,833,195,362,41,61,71,730
Pennsylvania,Friedens,1758,418,784,101,25,110,1438
Pennsylvania,Freeport borough,1790,420,577,193,87,140,1417
Pennsylvania,Freemansburg borough,2618,713,901,281,57,151,2103
Pennsylvania,Freeland borough,3498,984,1094,321,71,332,2802
Pennsylvania,Freedom borough,1621,358,560,210,34,57,1219
Pennsylvania,Frizzleburg,613,180,249,77,50,29,585
Pennsylvania,Freeburg borough,639,184,233,50,10,48,525
Pennsylvania,Fredericktown,504,159,198,60,4,21,442
Pennsylvania,Fredericksburg CDP (Lebanon County),1374,257,610,98,0,119,1084
Pennsylvania,Port Carbon borough,1779,408,743,136,32,132,1451
Pennsylvania,Port Clinton borough,210,35,104,33,4,8,184
Pennsylvania,Portersville borough,267,40,147,28,0,5,220
Pennsylvania,Portland borough,431,123,182,38,2,25,370
Pennsylvania,Port Matilda borough,698,207,251,89,5,26,578
Pennsylvania,Fredonia borough,526,116,187,63,15,25,406
Pennsylvania,Port Royal borough,861,124,353,101,31,75,684
Pennsylvania,Frystown,258,0,193,0,0,0,193
Pennsylvania,Galeton borough,1241,279,526,104,39,70,1018
Pennsylvania,Girard borough,3054,664,1316,156,70,181,2387
Pennsylvania,Gilberton borough,799,207,300,98,5,42,652
Pennsylvania,Gibsonia,2801,397,1454,171,26,60,2108
Pennsylvania,Gibraltar,682,117,320,180,0,40,657
Pennsylvania,Gettysburg borough,7615,4172,1552,598,89,346,6757
Pennsylvania,Georgetown CDP (Luzerne County),1782,592,586,83,81,83,1425
Pennsylvania,Georgetown CDP (Lancaster County),986,183,420,30,5,49,687
Pennsylvania,Fullerton,15662,4242,5613,1334,503,815,12507
Pennsylvania,Georgetown borough,164,24,72,26,0,8,130
Pennsylvania,Geistown borough,2368,462,1071,212,34,200,1979
Pennsylvania,University of Pittsburgh Johnstown,1523,1521,2,0,0,0,1523
Pennsylvania,Garrett borough,414,72,174,29,15,42,332
Pennsylvania,Gardners,214,120,44,13,6,23,206
Pennsylvania,Garden View,2504,651,1108,185,26,239,2209
Pennsylvania,Gap,1865,301,949,95,49,20,1414
Pennsylvania,Gallitzin borough,1495,353,608,146,22,65,1194
Pennsylvania,Geneva,154,32,62,19,4,19,136
Pennsylvania,Girardville borough,1298,295,477,150,51,105,1078
Pennsylvania,Port Trevorton,725,97,361,33,13,24,528
Pennsylvania,Potlicker Flats,152,34,40,33,0,29,136
Pennsylvania,Ramey borough,434,107,200,35,0,21,363
Pennsylvania,Rankin borough,2190,921,361,219,52,108,1661
Pennsylvania,Ranshaw,401,91,198,46,4,25,364
Pennsylvania,Raubsville,935,187,602,72,0,0,861
Pennsylvania,Rauchtown,649,127,314,73,0,38,552
Pennsylvania,Ravine,598,145,286,61,9,46,547
Pennsylvania,Reading,88057,30771,20269,7681,3396,3430,65547
Pennsylvania,Ramblewood,1110,275,559,0,28,16,878
Pennsylvania,Reamstown,3666,474,1764,261,56,402,2957
Pennsylvania,Red Hill borough,2508,559,1038,263,60,198,2118
Pennsylvania,Red Lion borough,6332,1491,2095,855,180,480,5101
Pennsylvania,Reedsville,499,136,189,80,0,42,447
Pennsylvania,Refton,153,19,92,11,0,13,135
Pennsylvania,Rehrersburg,381,107,128,9,36,16,296
Pennsylvania,Reiffton,5028,918,2377,284,41,344,3964
Pennsylvania,Reinerton,370,55,218,24,11,23,331
Pennsylvania,Rebersburg,500,139,228,13,10,37,427
Pennsylvania,Port Vue borough,3785,841,1496,419,51,374,3181
Pennsylvania,Rainsburg borough,138,27,53,10,0,4,94
Pennsylvania,Quentin,459,163,138,51,10,6,368
Pennsylvania,Pottsgrove,3344,812,1732,196,62,89,2891
Pennsylvania,Pottstown borough,22586,5958,7523,2652,444,1130,17707
Pennsylvania,Pottsville,14025,4031,4871,1190,489,1160,11741
Pennsylvania,Pringle borough,956,283,400,86,14,62,845
Pennsylvania,Progress,9294,2847,3261,888,307,453,7756
Pennsylvania,Prompton borough,272,58,111,19,5,15,208
Pennsylvania,Prospect borough,1258,207,571,165,3,89,1035
Pennsylvania,Railroad borough,222,83,75,24,3,15,200
Pennsylvania,Prospect Park,277,63,104,53,2,36,258
Pennsylvania,Punxsutawney borough,5899,1786,1922,629,217,456,5010
Pennsylvania,Pymatuning Central,2223,376,1187,190,41,176,1970
Pennsylvania,Pymatuning North,276,52,113,48,5,35,253
Pennsylvania,Pymatuning South,450,95,214,47,9,16,381
Pennsylvania,Quakertown borough,8917,2370,3262,798,282,540,7252
Pennsylvania,Quarryville borough,2687,417,1222,206,31,112,1988
Pennsylvania,Queens Gate,1328,619,340,136,39,84,1218
Pennsylvania,Prospect Park borough,6468,1989,2451,579,47,419,5485
Pennsylvania,Glasgow borough,76,30,13,13,2,6,64
Pennsylvania,Gastonville,2740,625,1238,295,54,207,2419
Pennsylvania,Glenburn,905,167,464,60,4,46,741
Pennsylvania,Troutville borough,186,35,99,19,0,13,166
Pennsylvania,Trooper,5959,1386,2817,305,83,211,4802
Pennsylvania,Trexlertown,2251,420,982,216,81,86,1785
Pennsylvania,Trevose,3516,910,1672,194,31,136,2943
Pennsylvania,Trevorton,1494,292,649,154,76,120,1291
Pennsylvania,Glassport borough,4454,1198,1554,418,188,384,3742
Pennsylvania,Tremont borough,1807,454,664,158,12,185,1473
Pennsylvania,Troxelville,254,68,120,0,2,10,200
Pennsylvania,Treasure Lake,3621,798,1785,271,0,107,2961
Pennsylvania,Trainer borough,1805,459,511,109,83,118,1280
Pennsylvania,Trafford borough,3335,825,1438,264,21,291,2839
Pennsylvania,Townville borough,379,73,170,39,8,18,308
Pennsylvania,Tower City borough,1283,347,503,118,25,74,1067
Pennsylvania,Towanda borough,2878,808,811,495,87,113,2314
Pennsylvania,Towamensing Trails,1889,412,895,217,47,80,1651
Pennsylvania,Toughkenamon,1797,587,682,39,23,29,1360
Pennsylvania,Trappe borough,3550,830,1575,218,56,135,2814
Pennsylvania,Topton borough,2119,506,871,157,75,137,1746
Pennsylvania,Troy borough,1505,437,564,180,18,73,1272
Pennsylvania,Trumbauersville borough,1016,220,447,58,20,37,782
Pennsylvania,Unionville,1108,218,437,197,0,45,897
Pennsylvania,Uniontown,10150,3548,2898,1228,224,829,8727
Pennsylvania,Union Deposit,604,103,236,67,0,33,439
Pennsylvania,Union Dale borough,267,56,138,16,11,22,243
Pennsylvania,Union City borough,3252,692,1293,277,26,271,2559
Pennsylvania,Ulysses borough,635,135,266,46,17,44,508
Pennsylvania,Tyrone borough,5415,1384,1804,588,108,477,4361
Pennsylvania,Trucksville,2108,485,1153,83,0,76,1797
Pennsylvania,Tylersburg,82,10,54,6,0,10,80
Pennsylvania,Twilight borough,201,22,111,19,6,6,164
Pennsylvania,Tuscarora,1022,263,397,79,6,73,818
Pennsylvania,Turtle Creek borough,5324,1651,1439,570,142,515,4317
Pennsylvania,Turbotville borough,654,138,296,40,11,21,506
Pennsylvania,Tunnelhill borough,368,86,177,30,5,17,315
Pennsylvania,Tunkhannock borough,1906,531,665,229,72,164,1661
Pennsylvania,Tullytown borough,1857,535,711,163,39,167,1615
Pennsylvania,Tyler Run,1521,162,847,138,12,167,1326
Pennsylvania,Toftrees,2875,1402,1190,112,0,86,2790
Pennsylvania,Tresckow,890,244,383,73,11,63,774
Pennsylvania,Tipton,908,174,453,98,0,55,780
Pennsylvania,Gouglersville,534,167,233,77,0,18,495
Pennsylvania,Gordonville,428,77,264,15,0,38,394
Pennsylvania,Gordon borough,865,219,310,60,5,63,657
Pennsylvania,Goodville,835,136,357,0,0,0,493
Pennsylvania,Goldsboro borough,1003,213,389,67,19,57,745
Pennsylvania,Gold Key Lake,1794,318,876,181,22,89,1486
Pennsylvania,Glenside,7667,2310,3088,462,71,315,6246
Pennsylvania,Gouldsboro,641,112,324,73,0,64,573
Pennsylvania,Glenshaw,8773,1539,5039,367,27,573,7545
Pennsylvania,Glen Osborne borough,582,91,290,31,10,36,458
Pennsylvania,Titusville,5438,1363,1964,473,160,454,4414
Pennsylvania,Glen Lyon,1732,358,426,268,158,79,1289
Pennsylvania,Glen Hope borough,149,27,80,11,0,17,135
Pennsylvania,Glenfield borough,197,36,90,14,0,7,147
Pennsylvania,Glendon borough,424,100,195,28,7,19,349
Pennsylvania,Glen Campbell borough,227,26,103,20,1,14,164
Pennsylvania,Glen Rock borough,1863,396,767,176,79,69,1487
Pennsylvania,Graceton,161,26,14,52,16,41,149
Pennsylvania,Glenolden borough,7159,2297,2370,784,202,452,6105
Pennsylvania,Grantley,3895,2229,982,87,30,196,3524
Pennsylvania,Grampian borough,410,88,147,31,8,21,295
Pennsylvania,Tionesta borough,405,72,216,28,3,61,380
Pennsylvania,Tioga borough,664,175,206,69,26,46,522
Pennsylvania,Timblin borough,207,52,75,11,3,8,149
Pennsylvania,Timber Hills,265,14,160,0,0,52,226
Pennsylvania,Tidioute borough,770,153,324,54,36,80,647
Pennsylvania,Throop borough,4052,1212,1449,318,84,323,3386
Pennsylvania,Three Springs borough,455,49,254,32,2,33,370
Pennsylvania,Thorndale,3765,1341,1367,375,145,94,3322
Pennsylvania,Dickson City borough,6005,1672,2283,557,77,460,5049
Pennsylvania,Thompsonville,3748,604,2011,183,24,322,3144
Pennsylvania,Greencastle borough,4031,901,1495,516,74,281,3267
Pennsylvania,Great Bend borough,787,177,371,49,11,67,675
Pennsylvania,Grazierville,615,143,287,46,0,20,496
Pennsylvania,Gratz borough,827,124,368,46,17,81,636
Pennsylvania,Grassflat,647,180,284,51,7,31,553
Pennsylvania,Grapeville,550,141,184,52,11,8,396
Pennsylvania,Thornburg borough,507,74,303,18,6,23,424
Pennsylvania,Granville,493,44,165,44,0,96,349
Puerto Rico,G. L. García comunidad,1303,,,,,,0
Puerto Rico,Rafael González comunidad,2102,,,,,,0
Puerto Rico,Antón Ruíz comunidad,2636,,,,,,0
Puerto Rico,San Germán zona urbana,12202,,,,,,0
Puerto Rico,María Antonia comunidad,1059,,,,,,0
Puerto Rico,Corazón comunidad,2192,,,,,,0
Puerto Rico,Rafael Capó comunidad,1666,,,,,,0
Puerto Rico,Bayamón zona urbana,177709,,,,,,0
Puerto Rico,Loíza zona urbana,3465,,,,,,0
Puerto Rico,Manatí zona urbana,13606,,,,,,0
Puerto Rico,Palomas comunidad (Comerío Municipio),1636,,,,,,0
Puerto Rico,Suárez comunidad,2108,,,,,,0
Puerto Rico,Rafael Hernández comunidad,1459,,,,,,0
Puerto Rico,San José comunidad,2664,,,,,,0
Puerto Rico,Luis M. Cintrón comunidad,2130,,,,,,0
Puerto Rico,El Mangó comunidad,1693,,,,,,0
Puerto Rico,Mayagüez zona urbana,67110,,,,,,0
Puerto Rico,Río Cañas Abajo comunidad,926,,,,,,0
Puerto Rico,Añasco zona urbana,5025,,,,,,0
Puerto Rico,Santa Bárbara comunidad,5691,,,,,,0
Puerto Rico,Imbéry comunidad,4103,,,,,,0
Puerto Rico,H. Rivera Colón comunidad,2156,,,,,,0
Puerto Rico,Guánica zona urbana,7404,,,,,,0
Puerto Rico,Río Grande zona urbana,13013,,,,,,0
Puerto Rico,Coquí comunidad,2562,,,,,,0
Puerto Rico,Búfalo comunidad,953,,,,,,0
Puerto Rico,Las Marías zona urbana,677,,,,,,0
Puerto Rico,Breñas comunidad,2741,,,,,,0
Puerto Rico,Vega Alta zona urbana,10033,,,,,,0
Puerto Rico,Vega Baja zona urbana,25251,,,,,,0
Puerto Rico,Vieques comunidad,2949,,,,,,0
Puerto Rico,Vieques zona urbana,2365,,,,,,0
Puerto Rico,Villalba zona urbana,3513,,,,,,0
Puerto Rico,Yabucoa zona urbana,6604,,,,,,0
Puerto Rico,Yauco zona urbana,17815,,,,,,0
Puerto Rico,Yaurel comunidad,1063,,,,,,0
Puerto Rico,Comerío zona urbana,4031,,,,,,0
Puerto Rico,Aceitunas comunidad,2103,,,,,,0
Puerto Rico,Adjuntas zona urbana,4129,,,,,,0
Puerto Rico,Vayas comunidad,562,,,,,,0
Puerto Rico,Aguada zona urbana,2707,,,,,,0
Puerto Rico,Aguas Buenas zona urbana,3483,,,,,,0
Puerto Rico,Aguas Claras comunidad,2573,,,,,,0
Puerto Rico,Aguilita comunidad,4530,,,,,,0
Puerto Rico,Aibonito zona urbana,8541,,,,,,0
Puerto Rico,Alianza comunidad,2581,,,,,,0
Puerto Rico,Animas comunidad,1389,,,,,,0
Puerto Rico,Anon Raices comunidad,216,,,,,,0
Puerto Rico,Arecibo zona urbana,43152,,,,,,0
Puerto Rico,Arroyo zona urbana,6540,,,,,,0
Puerto Rico,Bairoa La Veinticinco comunidad,202,,,,,,0
Puerto Rico,Bajadero comunidad,3414,,,,,,0
Puerto Rico,Aguadilla zona urbana,11690,,,,,,0
Puerto Rico,Utuado zona urbana,8075,,,,,,0
Puerto Rico,Trujillo Alto zona urbana,47679,,,,,,0
Puerto Rico,Toa Baja zona urbana,1582,,,,,,0
Puerto Rico,Quebradillas zona urbana,4834,,,,,,0
Puerto Rico,Ramos comunidad,1866,,,,,,0
Puerto Rico,Rodriguez Hevia comunidad,141,,,,,,0
Puerto Rico,Sabana comunidad,860,,,,,,0
Puerto Rico,Sabana Eneas comunidad,1260,,,,,,0
Puerto Rico,Sabana Grande zona urbana,10043,,,,,,0
Puerto Rico,Sabana Hoyos comunidad,2036,,,,,,0
Puerto Rico,Sabana Seca comunidad,8867,,,,,,0
Puerto Rico,Salinas zona urbana,4791,,,,,,0
Puerto Rico,San Antonio comunidad (Aguadilla Municipio),1533,,,,,,0
Puerto Rico,San Antonio comunidad (Dorado Municipio),7945,,,,,,0
Puerto Rico,San Antonio comunidad (Quebradillas Municipio),1856,,,,,,0
Puerto Rico,San Isidro comunidad,6743,,,,,,0
Puerto Rico,San Juan zona urbana,357627,,,,,,0
Puerto Rico,San Lorenzo zona urbana,8255,,,,,,0
Puerto Rico,Santa Clara comunidad,1103,,,,,,0
Puerto Rico,Santa Isabel zona urbana,6223,,,,,,0
Puerto Rico,Santo Domingo comunidad,3630,,,,,,0
Puerto Rico,Stella comunidad,1146,,,,,,0
Puerto Rico,Tallaboa comunidad,873,,,,,,0
Puerto Rico,Tallaboa Alta comunidad,1826,,,,,,0
Puerto Rico,Tibes comunidad,574,,,,,,0
Puerto Rico,Tiburones comunidad,1860,,,,,,0
Puerto Rico,Tierras Nuevas Poniente comunidad,3513,,,,,,0
Puerto Rico,Toa Alta zona urbana,3387,,,,,,0
Puerto Rico,Bajandas comunidad,730,,,,,,0
Puerto Rico,Quebrada del Agua comunidad,1221,,,,,,0
Puerto Rico,Barahona comunidad,1918,,,,,,0
Puerto Rico,Barranquitas zona urbana,2095,,,,,,0
Puerto Rico,Comunas comunidad,1392,,,,,,0
Puerto Rico,Corcovado comunidad,1622,,,,,,0
Puerto Rico,Corozal zona urbana,9550,,,,,,0
Puerto Rico,Corral Viejo comunidad,422,,,,,,0
Puerto Rico,Coto Laurel comunidad,2209,,,,,,0
Puerto Rico,Coto Norte comunidad,1296,,,,,,0
Puerto Rico,Culebra zona urbana,1401,,,,,,0
Puerto Rico,Daguao comunidad,1396,,,,,,0
Puerto Rico,Dorado zona urbana,12773,,,,,,0
Puerto Rico,Duque comunidad,1429,,,,,,0
Puerto Rico,El Combate comunidad,264,,,,,,0
Puerto Rico,Coco comunidad,6151,,,,,,0
Puerto Rico,El Negro comunidad,1226,,,,,,0
Puerto Rico,El Paraiso comunidad,1775,,,,,,0
Puerto Rico,El Tumbao comunidad,2115,,,,,,0
Puerto Rico,Emajagua comunidad,2940,,,,,,0
Puerto Rico,Esperanza comunidad,1153,,,,,,0
Puerto Rico,Espino comunidad,1357,,,,,,0
Puerto Rico,Fajardo zona urbana,26777,,,,,,0
Puerto Rico,Florida zona urbana,4585,,,,,,0
Puerto Rico,Fuig comunidad,1024,,,,,,0
Puerto Rico,Galateo comunidad,2361,,,,,,0
Puerto Rico,Garrochales comunidad,1131,,,,,,0
Puerto Rico,Río Blanco comunidad,1525,,,,,,0
Puerto Rico,El Ojo comunidad,1190,,,,,,0
Puerto Rico,Coamo zona urbana,11604,,,,,,0
Puerto Rico,Cidra zona urbana,5519,,,,,,0
Puerto Rico,Ciales zona urbana,2154,,,,,,0
Puerto Rico,Bartolo comunidad,1289,,,,,,0
Puerto Rico,Betances comunidad,974,,,,,,0
Puerto Rico,Boqueron comunidad (Cabo Rojo Municipio),2677,,,,,,0
Puerto Rico,Buena Vista comunidad (Arroyo Municipio),990,,,,,,0
Puerto Rico,Buena Vista comunidad (Humacao Municipio),989,,,,,,0
Puerto Rico,Cabo Rojo zona urbana,10132,,,,,,0
Puerto Rico,Cacao comunidad,1102,,,,,,0
Puerto Rico,Caguas zona urbana,80556,,,,,,0
Puerto Rico,Calzada comunidad,241,,,,,,0
Puerto Rico,Campanilla comunidad,5781,,,,,,0
Puerto Rico,Campo Rico comunidad,2619,,,,,,0
Puerto Rico,Camuy zona urbana,3108,,,,,,0
Puerto Rico,Candelaria comunidad,15586,,,,,,0
Puerto Rico,Candelaria Arenas comunidad,5021,,,,,,0
Puerto Rico,Candelero Abajo comunidad,671,,,,,,0
Puerto Rico,Candelero Arriba comunidad,1634,,,,,,0
Puerto Rico,Capitanejo comunidad,3901,,,,,,0
Puerto Rico,Carolina zona urbana,150712,,,,,,0
Puerto Rico,Carrizales comunidad,2539,,,,,,0
Puerto Rico,Cayey zona urbana,16727,,,,,,0
Puerto Rico,Cayuco comunidad,1224,,,,,,0
Puerto Rico,Ceiba zona urbana,5704,,,,,,0
Puerto Rico,Ceiba comunidad,3135,,,,,,0
Puerto Rico,Celada comunidad,4612,,,,,,0
Puerto Rico,Central Aguirre comunidad,1222,,,,,,0
Puerto Rico,Barceloneta zona urbana,3841,,,,,,0
Puerto Rico,Quebrada comunidad,1012,,,,,,0
Puerto Rico,Cerrillos Hoyos comunidad,952,,,,,,0
Puerto Rico,Puerto Real comunidad,6408,,,,,,0
Puerto Rico,Jobos comunidad,2286,,,,,,0
Puerto Rico,Jayuya zona urbana,2950,,,,,,0
Puerto Rico,Jauca comunidad,1676,,,,,,0
Puerto Rico,Jagual comunidad,1096,,,,,,0
Puerto Rico,Isabela zona urbana,11201,,,,,,0
Puerto Rico,Ingenio comunidad,4485,,,,,,0
Puerto Rico,Indios comunidad,1568,,,,,,0
Puerto Rico,Humacao zona urbana,18061,,,,,,0
Puerto Rico,Hormigueros zona urbana,11825,,,,,,0
Puerto Rico,Hato Candal comunidad,1520,,,,,,0
Puerto Rico,Hato Arriba comunidad,704,,,,,,0
Puerto Rico,Juncal comunidad,850,,,,,,0
Puerto Rico,Hatillo zona urbana,4139,,,,,,0
Puerto Rico,Gurabo zona urbana,7943,,,,,,0
Puerto Rico,Guaynabo zona urbana,72972,,,,,,0
Puerto Rico,Guayanilla zona urbana,4160,,,,,,0
Puerto Rico,Levittown comunidad,26786,,,,,,0
Puerto Rico,Guayama zona urbana,23379,,,,,,0
Puerto Rico,Guayabal comunidad,2141,,,,,,0
Puerto Rico,Pueblito del Río comunidad,1672,,,,,,0
Puerto Rico,Pájaros comunidad,10711,,,,,,0
Puerto Rico,Palomas comunidad (Yauco Municipio),2067,,,,,,0
Puerto Rico,Palmer comunidad,1058,,,,,,0
Puerto Rico,Palmas del Mar comunidad,1653,,,,,,0
Puerto Rico,Hacienda San Jose comunidad,3152,,,,,,0
Puerto Rico,Juncos zona urbana,8463,,,,,,0
Puerto Rico,La Alianza comunidad,2071,,,,,,0
Puerto Rico,La Dolores comunidad,3516,,,,,,0
Puerto Rico,Lluveras comunidad,1639,,,,,,0
Puerto Rico,Lomas comunidad,1068,,,,,,0
Puerto Rico,Los Llanos comunidad,2252,,,,,,0
Puerto Rico,Los Panes comunidad,384,,,,,,0
Puerto Rico,Los Prados comunidad,2296,,,,,,0
Puerto Rico,Luquillo zona urbana,8352,,,,,,0
Puerto Rico,Luyando comunidad,3223,,,,,,0
Puerto Rico,Magas Arriba comunidad,1269,,,,,,0
Puerto Rico,Maguayo comunidad,1205,,,,,,0
Puerto Rico,Maricao zona urbana,747,,,,,,0
Puerto Rico,Martorell comunidad,2434,,,,,,0
Puerto Rico,Las Piedras zona urbana,6099,,,,,,0
Puerto Rico,Las Ollas comunidad,1936,,,,,,0
Puerto Rico,Las Ochenta comunidad,654,,,,,,0
Puerto Rico,Las Croabas comunidad,866,,,,,,0
Puerto Rico,Las Carolinas comunidad,2453,,,,,,0
Puerto Rico,Lares zona urbana,5059,,,,,,0
Puerto Rico,La Plena comunidad,603,,,,,,0
Puerto Rico,La Playa comunidad,2428,,,,,,0
Puerto Rico,La Parguera comunidad,855,,,,,,0
Puerto Rico,Lamboglia comunidad,1387,,,,,,0
Puerto Rico,La Luisa comunidad,1847,,,,,,0
Puerto Rico,La Liga comunidad,246,,,,,,0
Puerto Rico,Lajas zona urbana,4306,,,,,,0
Puerto Rico,La Fermina comunidad,2899,,,,,,0
Puerto Rico,Palmas comunidad,1713,,,,,,0
Puerto Rico,Palmarejo comunidad (Lajas Municipio),1390,,,,,,0
Puerto Rico,La Yuca comunidad,581,,,,,,0
Puerto Rico,Pajonal comunidad,581,,,,,,0
Puerto Rico,Liborio Negrón Torres comunidad,1534,,,,,,0
Puerto Rico,Cabán comunidad,3419,,,,,,0
Puerto Rico,Juana Díaz zona urbana,7396,,,,,,0
Puerto Rico,Las Marías comunidad,1902,,,,,,0
Puerto Rico,San Sebastián zona urbana,9843,,,,,,0
Puerto Rico,Vázquez comunidad,1841,,,,,,0
Puerto Rico,Rosa Sánchez comunidad,849,,,,,,0
Puerto Rico,Benítez comunidad,1379,,,,,,0
Puerto Rico,Parcelas Peñuelas comunidad,808,,,,,,0
Puerto Rico,Peñuelas zona urbana,5453,,,,,,0
Puerto Rico,Fránquez comunidad,2837,,,,,,0
Puerto Rico,Río Lajas comunidad,2788,,,,,,0
Puerto Rico,Boquerón comunidad,1431,,,,,,0
Puerto Rico,Bayamón comunidad,1893,,,,,,0
Puerto Rico,Canóvanas zona urbana,7762,,,,,,0
Puerto Rico,Mariano Colón comunidad,2476,,,,,,0
Puerto Rico,Marueño comunidad,906,,,,,,0
Puerto Rico,Luis Lloréns Torres comunidad,3193,,,,,,0
Puerto Rico,Maunabo zona urbana,1520,,,,,,0
Puerto Rico,Miranda comunidad,1603,,,,,,0
Puerto Rico,Moca zona urbana,3772,,,,,,0
Puerto Rico,Monte Verde comunidad,108,,,,,,0
Puerto Rico,Monserrate comunidad,2261,,,,,,0
Puerto Rico,Monte Grande comunidad,3003,,,,,,0
Puerto Rico,Cataño zona urbana,26680,,,,,,0
Puerto Rico,Peña Pobre comunidad,966,,,,,,0
Puerto Rico,Rincón zona urbana,1355,,,,,,0
Puerto Rico,Palo Seco comunidad,850,,,,,,0
Puerto Rico,Punta Santiago comunidad,5514,,,,,,0
Puerto Rico,Olimpo comunidad,1547,,,,,,0
Puerto Rico,Naranjito zona urbana,1805,,,,,,0
Puerto Rico,Naguabo zona urbana,4790,,,,,,0
Puerto Rico,Mucarabones comunidad,972,,,,,,0
Puerto Rico,Morovis zona urbana,2406,,,,,,0
Puerto Rico,Mora comunidad,2245,,,,,,0
Puerto Rico,Pueblito del Carmen comunidad,439,,,,,,0
Puerto Rico,Potala Pastillo comunidad,2891,,,,,,0
Puerto Rico,Ponce zona urbana,126302,,,,,,0
Puerto Rico,Pole Ojea comunidad,2021,,,,,,0
Puerto Rico,Playita Cortada comunidad,1339,,,,,,0
Puerto Rico,Orocovis zona urbana,991,,,,,,0
Puerto Rico,Playita comunidad (Salinas Municipio),450,,,,,,0
Puerto Rico,Playita comunidad (Yabucoa Municipio),1750,,,,,,0
Puerto Rico,Parcelas de Navarro comunidad,1551,,,,,,0
Puerto Rico,Parcelas La Milagrosa comunidad,1075,,,,,,0
Puerto Rico,Parcelas Mandry comunidad,654,,,,,,0
Puerto Rico,Parcelas Nuevas comunidad,1406,,,,,,0
Puerto Rico,Parcelas Viejas Borinquen comunidad,658,,,,,,0
Puerto Rico,Palmarejo comunidad (Coamo Municipio),1131,,,,,,0
Puerto Rico,Patillas zona urbana,4380,,,,,,0
Puerto Rico,Piedra Aguza comunidad,2537,,,,,,0
Puerto Rico,Piedra Gorda comunidad,2082,,,,,,0
Puerto Rico,Playa Fortuna comunidad,1190,,,,,,0
Puerto Rico,Pastos comunidad,1336,,,,,,0
Rhode Island,Newport East,11091,2939,4409,1100,107,724,9279
Rhode Island,Newport,24459,9933,7397,2764,263,1036,21393
Rhode Island,Narragansett Pier,3957,1344,1562,394,27,228,3555
Rhode Island,Misquamicut,349,97,178,14,5,31,325
Rhode Island,Melville,1327,112,645,13,0,37,807
Rhode Island,Kingston,6969,5567,865,118,0,90,6640
Rhode Island,Hopkinton,396,41,260,40,18,0,359
Rhode Island,Hope Valley,1733,334,895,113,17,17,1376
Rhode Island,Harrisville,1833,379,652,185,60,150,1426
Rhode Island,Harmony,876,172,468,70,0,80,790
Rhode Island,Greenville,8419,2159,3472,813,96,816,7356
Rhode Island,Foster Center,325,29,174,30,0,37,270
Rhode Island,East Providence,47266,12685,17054,5062,759,3451,39011
Rhode Island,Cumberland Hill,8439,1573,4259,606,37,406,6881
Rhode Island,Cranston,80761,23653,30656,7826,1211,4483,67829
Rhode Island,Pascoag,4583,1281,1552,565,96,259,3753
Rhode Island,Chepachet,1656,323,741,263,19,117,1463
Rhode Island,Charlestown,1207,262,666,104,0,95,1127
Rhode Island,Central Falls,19378,6714,4741,1519,709,713,14396
Rhode Island,Carolina,787,93,505,92,17,12,719
Rhode Island,Bradford,1158,334,377,89,39,108,947
Rhode Island,Ashaway,1108,173,540,171,0,104,988
Rhode Island,Greene,863,230,417,112,6,3,768
Rhode Island,Clayville,159,29,85,9,0,9,132
Rhode Island,Pawtucket,71395,22899,22210,7259,1616,3368,57352
Rhode Island,Quonochontaug,558,99,296,43,10,66,514
Rhode Island,Providence,178680,77875,43569,12451,4870,6698,145463
Rhode Island,Woonsocket,41213,12761,13252,4443,889,2327,33672
Rhode Island,Westerly,17957,4257,7189,2457,331,1053,15287
Rhode Island,Weekapaug,430,55,294,22,0,25,396
Rhode Island,Watch Hill,184,20,112,52,0,0,184
Rhode Island,Wyoming,96,0,22,74,0,0,96
Rhode Island,Wakefield-Peacedale,8862,2619,3499,872,23,424,7437
Rhode Island,Valley Falls,12088,3364,4889,1251,46,599,10149
Rhode Island,Tiverton,7407,1350,3761,680,65,564,6420
Rhode Island,Warwick,81855,19648,34605,8991,753,5602,69599
South Carolina,Clemson,14664,7424,4107,639,89,478,12737
South Carolina,Modoc,241,18,185,26,4,8,241
South Carolina,Monarch Mill,1941,366,879,219,48,79,1591
South Carolina,Moncks Corner,9108,2367,3425,846,301,346,7285
South Carolina,Monetta,171,35,73,6,4,19,137
South Carolina,Mount Carmel,204,89,68,0,7,22,186
South Carolina,Mount Croghan,122,18,56,6,15,5,100
South Carolina,Mount Pleasant,74952,15243,33642,6141,1640,3194,59860
South Carolina,Mountville,115,22,46,25,7,0,100
South Carolina,Mulberry,424,84,138,13,8,15,258
South Carolina,Mullins,4560,1350,1095,534,241,423,3643
South Carolina,Myrtle Beach,29198,8421,10557,3626,847,1547,24998
South Carolina,Murrells Inlet,8823,1892,4295,705,91,728,7711
South Carolina,Oak Grove,10183,2248,4093,994,266,518,8119
South Carolina,Norway,300,155,76,21,7,28,287
South Carolina,North Myrtle Beach,14824,2667,7501,2015,406,1174,13763
South Carolina,Northlake,4168,607,2141,341,57,192,3338
South Carolina,North Hartsville,3282,917,1381,268,117,107,2790
South Carolina,North Charleston,104146,34511,29656,9853,3582,4147,81749
South Carolina,North Augusta,22037,4926,8816,2409,599,1311,18061
South Carolina,Murphys Estates,1496,285,544,67,0,145,1041
South Carolina,North,800,251,236,61,27,72,647
South Carolina,Ninety Six,2011,463,768,140,32,165,1568
South Carolina,Nichols,355,89,132,41,4,43,309
South Carolina,Newry,113,9,73,20,0,11,113
South Carolina,Newport,3795,432,2212,249,53,84,3030
South Carolina,New Ellenton,2431,530,886,216,64,212,1908
South Carolina,Newberry,10279,3811,2271,511,576,813,7982
South Carolina,Neeses,278,82,90,16,18,29,235
South Carolina,Norris,818,171,309,75,33,83,671
South Carolina,Clearwater,4497,1285,1630,403,103,361,3782
South Carolina,Chesterfield,1410,407,482,118,54,60,1121
South Carolina,City View,1672,463,379,196,75,86,1199
South Carolina,Lowndesville,126,33,30,8,10,5,86
South Carolina,Loris,2500,731,803,149,123,220,2026
South Carolina,Lodge,96,12,67,5,0,7,91
South Carolina,Lockhart,544,110,166,57,36,61,430
South Carolina,Livingston,152,32,48,23,2,6,111
South Carolina,Little River,9617,1735,4435,1564,175,733,8642
South Carolina,Little Mountain,259,18,149,19,0,5,191
South Carolina,Lincolnville,1299,309,401,153,43,104,1010
South Carolina,Liberty,3254,533,1167,484,171,275,2630
South Carolina,Lexington,19447,4282,7990,1922,484,801,15479
South Carolina,Lesslie,2218,491,1132,136,11,89,1859
South Carolina,Laurens,9122,2688,2844,803,223,941,7499
South Carolina,Laurel Bay,6318,959,2742,279,32,70,4082
South Carolina,Latta,1242,291,420,89,35,121,956
South Carolina,Langley,1116,284,423,146,87,68,1008
South Carolina,Lowrys,202,36,93,20,2,18,169
South Carolina,Lugoff,8248,1760,3180,806,187,385,6318
South Carolina,Luray,176,42,47,36,0,6,131
South Carolina,Lydia,404,153,137,41,7,7,345
South Carolina,Chester,5527,1862,1168,542,281,422,4275
South Carolina,Meggett,1432,246,769,158,12,67,1252
South Carolina,Mayo,1119,174,402,122,54,153,905
South Carolina,Mayesville,544,188,158,32,37,40,455
South Carolina,Mauldin,24396,6699,9361,2151,522,1243,19976
South Carolina,Marion,6793,2147,1875,380,264,407,5073
South Carolina,Manning,4056,1257,1068,220,141,397,3083
South Carolina,Clarks Hill,330,136,87,10,5,10,248
South Carolina,McCormick,2707,1199,612,348,124,130,2413
South Carolina,McClellanville,517,75,284,35,0,39,433
South Carolina,McBee,775,142,301,68,26,40,577
South Carolina,Lancaster,8853,3032,1957,1061,386,695,7131
South Carolina,Landrum,2642,695,906,372,86,120,2179
South Carolina,Lane,472,126,107,56,68,32,389
South Carolina,Lynchburg,297,101,86,37,14,34,272
South Carolina,Lyman,3350,522,1632,243,91,283,2771
South Carolina,McConnells,264,61,125,17,2,11,216
South Carolina,McColl,2399,730,673,262,84,168,1917
South Carolina,Wellford,2472,621,764,340,93,170,1988
South Carolina,West Columbia,15757,5228,5105,1483,456,1325,13597
South Carolina,Gaffney,12562,4226,3304,1337,588,882,10337
South Carolina,Gantt,14693,4316,4216,1149,546,877,11104
South Carolina,Garden City,9246,1420,4471,915,135,1320,8261
South Carolina,Gaston,1466,431,541,140,56,49,1217
South Carolina,Gayle Mill,893,259,202,49,5,125,640
South Carolina,Georgetown,9079,2793,2627,748,254,595,7017
South Carolina,Gifford,363,138,48,37,11,51,285
South Carolina,Gilbert,715,132,365,34,2,24,557
South Carolina,Glendale,175,9,119,35,0,12,175
South Carolina,Gloverville,2925,633,1006,294,138,181,2252
South Carolina,Golden Grove,2404,566,1134,355,0,113,2168
South Carolina,Goose Creek,39408,9861,15866,2863,1021,1328,30939
South Carolina,Govan,59,6,29,8,2,12,57
South Carolina,Gramling,0,0,0,0,0,0,0
South Carolina,Graniteville,2516,842,563,309,88,115,1917
South Carolina,Gray Court,711,235,223,78,25,52,613
South Carolina,Great Falls,1944,598,517,167,47,160,1489
South Carolina,Greeleyville,485,127,145,33,17,37,359
South Carolina,Greenville,61734,21475,19320,5986,2024,2636,51441
South Carolina,Gadsden,2143,690,717,199,102,201,1909
South Carolina,Greenwood,23254,8592,5052,2100,828,1775,18347
South Carolina,Furman,264,50,130,18,8,14,220
South Carolina,Fort Mill,12525,2395,5247,1064,233,559,9498
South Carolina,Ehrhardt,636,235,232,28,37,42,574
South Carolina,Elgin,1542,327,698,90,20,67,1202
South Carolina,Elgin,2781,662,746,324,112,413,2257
South Carolina,Elko,168,54,46,18,4,4,126
South Carolina,Elloree,712,238,266,42,20,61,627
South Carolina,Enoree,652,51,311,54,45,43,504
South Carolina,Estill,2244,779,677,89,64,268,1877
South Carolina,Eureka Mill,1451,549,290,150,50,118,1157
South Carolina,Eutawville,332,55,148,53,10,22,288
South Carolina,Fairfax,1908,681,451,179,41,177,1529
South Carolina,Fairforest,2090,477,751,101,80,48,1457
South Carolina,Fair Play,645,231,354,11,0,36,632
South Carolina,Fingerville,24,0,24,0,0,0,24
South Carolina,Five Forks,16398,2481,8220,495,189,570,11955
South Carolina,Florence,38000,10027,13172,3021,1350,2408,29978
South Carolina,Folly Beach,2715,1039,1090,415,21,19,2584
South Carolina,Forest Acres,10545,2647,3946,1121,131,787,8632
South Carolina,Forestbrook,5111,1274,2358,378,149,85,4244
South Carolina,Fort Lawn,940,344,281,56,13,67,761
South Carolina,Fountain Inn,8399,1757,3290,678,133,411,6269
South Carolina,Greer,27186,6756,9748,2728,606,1335,21173
South Carolina,Hampton,2726,546,988,257,27,208,2026
South Carolina,Hanahan,19707,5106,7461,1834,551,904,15856
South Carolina,Jenkinsville,71,28,20,7,0,10,65
South Carolina,Jefferson,757,218,279,79,11,29,616
South Carolina,Jamestown,123,24,61,9,9,5,108
South Carolina,James Island,11544,2710,4643,1135,219,990,9697
South Carolina,Jacksonboro,558,248,159,38,0,43,488
South Carolina,Jackson,1661,391,627,132,73,136,1359
South Carolina,Iva,1085,202,360,146,30,159,897
South Carolina,Isle of Palms,4274,831,2475,297,78,182,3863
South Carolina,Islandton,42,9,19,0,0,3,31
South Carolina,Irwin,1518,329,590,226,71,93,1309
South Carolina,Irmo,11704,3165,4541,1046,174,544,9470
South Carolina,Inman Mills,1793,295,508,183,79,229,1294
South Carolina,Inman,2182,546,711,217,41,239,1754
South Carolina,India Hook,4118,461,2014,514,43,123,3155
South Carolina,Hopkins,2985,1337,800,163,130,290,2720
South Carolina,Honea Path,3649,928,1467,243,73,339,3050
South Carolina,Homeland Park,6419,1414,2217,818,318,622,5389
South Carolina,Hollywood,4872,906,2340,581,123,358,4308
South Carolina,Holly Hill,1407,345,423,88,105,115,1076
South Carolina,Joanna,1307,332,549,51,54,56,1042
South Carolina,Johnsonville,2011,482,797,150,28,121,1578
South Carolina,Johnston,2284,695,617,202,106,167,1787
South Carolina,Jonesville,833,199,267,109,46,80,701
South Carolina,Hardeeville,4353,1342,1709,237,103,145,3536
South Carolina,Harleyville,657,166,254,59,19,26,524
South Carolina,Hartsville,7851,2742,1946,595,291,788,6362
South Carolina,Heath Springs,713,223,223,74,8,50,578
South Carolina,Hemingway,460,113,197,32,6,26,374
South Carolina,Hickory Grove,443,100,174,48,22,28,372
South Carolina,Hilda,439,140,169,36,0,26,371
South Carolina,Lamar,913,203,313,97,36,104,753
South Carolina,Lake Wylie,10738,1618,5245,903,155,301,8222
South Carolina,Edisto Beach,600,39,443,52,2,55,591
South Carolina,Lakewood,2670,554,1081,245,29,130,2039
South Carolina,Lake Secession,1310,239,595,113,95,80,1122
South Carolina,Lake Murray of Richland,5915,621,3375,393,8,292,4689
South Carolina,Lake City,6728,1706,2040,422,257,564,4989
South Carolina,Ladson,14770,3443,5531,1441,457,597,11469
South Carolina,Kline,189,51,40,23,1,8,123
South Carolina,Kingstree,3233,985,942,304,119,168,2518
South Carolina,Kiawah Island,1432,48,1233,83,0,58,1422
South Carolina,Kershaw,2303,537,773,174,43,163,1690
South Carolina,Judson,1916,739,385,256,55,143,1578
South Carolina,Lake View,818,255,305,50,18,79,707
South Carolina,Edisto,2321,632,580,167,183,117,1679
South Carolina,Edgefield,4723,1620,1160,724,303,396,4203
South Carolina,East Sumter,1315,288,399,178,84,63,1012
South Carolina,Timmonsville,2283,688,566,282,101,207,1844
South Carolina,Tigerville,2060,1973,50,0,19,0,2042
South Carolina,Tega Cay,8609,1413,4576,283,142,155,6569
South Carolina,Taylors,22475,4846,9335,2290,532,1030,18033
South Carolina,Tatum,129,40,44,28,0,8,120
South Carolina,Sycamore,217,86,62,32,8,10,198
South Carolina,Swansea,746,211,200,102,36,81,630
South Carolina,Surfside Beach,4090,961,1705,693,62,243,3664
South Carolina,Sumter,40851,11628,13406,3472,1196,2641,32343
South Carolina,Summit,564,85,237,48,28,15,413
South Carolina,Summerville,46200,10338,18019,4733,856,2187,36133
South Carolina,Summerton,1093,311,350,50,64,100,875
South Carolina,Sullivan's Island,2067,494,915,180,5,139,1733
South Carolina,Stuckey,262,95,65,24,13,13,210
South Carolina,Stateburg,1714,264,907,127,0,17,1315
South Carolina,Startex,1137,141,356,121,44,36,698
South Carolina,Starr,150,29,68,15,4,9,125
South Carolina,Springfield,588,115,245,40,7,75,482
South Carolina,Springdale,2727,626,1181,244,41,191,2283
South Carolina,Travelers Rest,4834,1161,1645,484,128,258,3676
South Carolina,Trenton,286,48,137,16,15,29,245
South Carolina,Troy,92,14,47,9,5,5,80
South Carolina,Turbeville,1052,268,305,81,28,57,739
South Carolina,Hodges,132,34,70,7,0,6,117
South Carolina,Welcome,6390,1946,2019,656,163,556,5340
South Carolina,Wedgefield,1553,198,678,116,114,70,1176
South Carolina,Watts Mills,1822,454,653,142,176,17,1442
South Carolina,Waterloo,160,51,70,12,3,11,147
South Carolina,Warrenville,1008,214,389,141,15,84,843
South Carolina,Ware Shoals,2459,676,714,294,118,155,1957
South Carolina,Ware Place,143,26,16,58,38,5,143
South Carolina,Ward,90,14,51,14,6,3,88
South Carolina,Springdale,2151,499,736,142,143,171,1691
South Carolina,Walterboro,5312,1428,1220,616,336,583,4183
South Carolina,Walhalla,4234,752,1346,595,136,228,3057
South Carolina,Wagener,774,303,230,60,49,42,684
South Carolina,Wade Hampton,20205,4675,8363,2243,533,1264,17078
South Carolina,Varnville,2277,648,742,164,32,235,1821
South Carolina,Vance,82,31,23,7,5,7,73
South Carolina,Valley Falls,5885,2732,1826,429,91,301,5379
South Carolina,Utica,1388,303,420,177,128,60,1088
South Carolina,Union,8144,2290,2177,915,371,727,6480
South Carolina,Ulmer,45,10,27,4,0,1,42
South Carolina,Wallace,860,251,246,124,34,80,735
South Carolina,Westminster,2435,546,950,302,81,169,2048
South Carolina,Spartanburg,37465,12532,10085,3386,1559,2705,30267
South Carolina,Southern Shops,4533,1303,1024,416,154,254,3151
South Carolina,Cordova,231,26,78,6,6,37,153
South Carolina,Coronaca,165,16,81,0,0,0,97
South Carolina,Cottageville,853,181,343,100,24,37,685
South Carolina,Coward,708,161,258,111,9,42,581
South Carolina,Cowpens,1702,417,618,172,35,197,1439
South Carolina,Cross Anchor,180,93,13,35,0,0,141
South Carolina,Cross Hill,523,153,201,42,25,25,446
South Carolina,Dalzell,4462,1320,1592,131,72,134,3249
South Carolina,Darlington,6212,1858,1789,567,200,552,4966
South Carolina,Denmark,3425,1571,643,108,163,256,2741
South Carolina,Dentsville,14151,5021,3627,1532,444,939,11563
South Carolina,Dillon,6705,1794,2269,341,210,511,5125
South Carolina,Donalds,335,67,110,37,15,33,262
South Carolina,Due West,1214,680,273,31,21,55,1060
South Carolina,Duncan,3231,1044,1210,241,46,114,2655
South Carolina,Dunean,4048,1355,1289,373,111,238,3366
South Carolina,Easley,20374,4287,7968,2130,517,1495,16397
South Carolina,East Gaffney,3274,1129,732,588,142,204,2795
South Carolina,Eastover,765,297,138,57,3,69,564
South Carolina,Cope,56,17,26,4,7,2,56
South Carolina,Conway,19356,7398,5566,1339,468,1252,16023
South Carolina,Converse,607,133,176,13,48,71,441
South Carolina,Columbia,131958,62506,32039,10139,3846,5058,113588
South Carolina,South Congaree,2246,487,812,287,102,111,1799
South Carolina,Society Hill,560,156,216,59,5,36,472
South Carolina,Socastee,21641,5557,7966,2476,507,1062,17568
South Carolina,Snelling,281,56,123,18,10,16,223
South Carolina,Smyrna,49,12,21,6,2,4,45
South Carolina,Smoaks,143,32,81,10,6,9,138
South Carolina,Slater-Marietta,2386,452,701,215,234,101,1703
South Carolina,Six Mile,918,147,422,72,17,36,694
South Carolina,Simpsonville,19706,4163,8950,2018,267,642,16040
South Carolina,South Sumter,2255,774,377,286,98,125,1660
South Carolina,Silverstreet,158,32,59,17,8,17,133
South Carolina,Shell Point,2331,632,891,198,81,53,1855
South Carolina,Sharon,486,66,209,53,23,24,375
South Carolina,Seven Oaks,16185,4330,6112,1377,419,795,13033
South Carolina,Seneca,8184,1723,2798,1103,332,743,6699
South Carolina,Clifton,433,147,148,29,9,66,399
South Carolina,Clinton,8561,3389,1752,736,220,770,6867
South Carolina,Clio,665,201,229,72,30,61,593
South Carolina,Clover,5442,1181,1879,527,136,326,4049
South Carolina,Cokesbury,142,16,88,9,12,8,133
South Carolina,Shiloh,104,39,24,21,0,13,97
South Carolina,Chesnee,717,148,262,96,41,61,608
South Carolina,Hilton Head Island,39071,7054,20303,3197,881,2517,33952
South Carolina,Cheraw,5800,1705,1788,584,177,480,4734
South Carolina,Santee,1009,256,313,67,64,70,770
South Carolina,Sans Souci,8288,2255,2616,988,181,435,6475
South Carolina,Sangaree,8157,1809,3047,1132,125,289,6402
South Carolina,Saluda,3585,1156,1047,231,78,157,2669
South Carolina,Salley,329,67,131,10,10,54,272
South Carolina,Salem,137,33,69,11,0,9,122
South Carolina,St. Stephen,1640,406,539,100,80,145,1270
South Carolina,St. Matthews,1947,582,551,156,64,247,1600
South Carolina,St. George,2192,761,570,227,131,127,1816
South Carolina,St. Andrews,21779,8521,4873,2083,765,975,17217
South Carolina,Russellville,437,90,210,68,38,13,419
South Carolina,Ruby,379,50,176,31,2,34,293
South Carolina,Rowesville,321,57,87,39,25,31,239
South Carolina,Cherryvale,2051,294,737,207,48,94,1380
South Carolina,York,7945,2452,2444,767,229,448,6340
South Carolina,Yemassee,893,235,287,93,51,60,726
South Carolina,Roebuck,2670,697,1014,265,38,178,2192
South Carolina,Rockville,156,12,99,20,2,12,145
South Carolina,Rock Hill,69196,22149,22057,6053,1927,3519,55705
South Carolina,Riverview,404,16,338,41,0,0,395
South Carolina,Ridgeway,456,142,140,18,17,19,336
South Carolina,Saxon,3623,1296,752,448,181,106,2783
South Carolina,Scotia,163,34,86,15,5,13,153
South Carolina,Scranton,839,293,222,77,22,101,715
South Carolina,Seabrook Island,1688,102,1331,98,5,122,1658
South Carolina,Beaufort,12839,2873,4708,1336,356,675,9948
South Carolina,Batesburg-Leesville,5251,1354,1710,514,148,330,4056
South Carolina,Barnwell,4664,1226,1123,306,179,398,3232
South Carolina,Bamberg,3501,1348,1067,217,121,300,3053
South Carolina,Aynor,713,181,232,85,7,56,561
South Carolina,Awendaw,1415,326,512,120,64,94,1116
South Carolina,Atlantic Beach,285,100,58,28,22,12,220
South Carolina,Arial,2155,360,872,342,41,110,1725
South Carolina,Arcadia Lakes,956,181,468,86,9,98,842
South Carolina,Arcadia,3159,891,896,137,106,116,2146
South Carolina,Ridgeville,1929,990,446,271,61,57,1825
South Carolina,Antreville,120,5,36,38,0,41,120
South Carolina,Anderson,26978,7909,8144,2451,1061,2129,21694
South Carolina,Allendale,3261,1358,527,255,130,282,2552
South Carolina,Alcolu,470,57,268,24,20,14,383
South Carolina,Aiken,30183,8611,12196,2213,448,2407,25875
South Carolina,Abbeville,5197,1699,1384,386,202,562,4233
South Carolina,Woodford,160,49,50,14,10,18,141
South Carolina,West Pelzer,921,145,294,117,52,84,692
South Carolina,West Union,316,63,101,47,10,26,247
South Carolina,Whitmire,1357,413,359,155,101,107,1135
South Carolina,Sellers,191,55,45,41,18,26,185
South Carolina,Andrews,2842,875,815,225,123,204,2242
South Carolina,Belton,4247,925,1709,371,193,294,3492
South Carolina,Ridge Spring,921,320,306,61,12,67,766
South Carolina,Richburg,445,156,79,32,29,23,319
South Carolina,Pawleys Island,97,8,71,10,2,6,97
South Carolina,Patrick,439,93,152,52,14,44,355
South Carolina,Parksville,128,11,70,15,0,6,102
South Carolina,Parker,12571,3419,3816,1218,396,527,9376
South Carolina,Pamplico,1181,327,402,58,52,67,906
South Carolina,Pageland,2745,714,964,277,108,275,2338
South Carolina,Pacolet,2453,627,727,332,58,181,1925
South Carolina,Oswego,11,0,0,0,0,11,11
South Carolina,Orangeburg,13685,6410,2689,964,495,891,11449
South Carolina,Olar,213,41,95,23,8,22,189
South Carolina,Olanta,544,85,183,74,11,53,406
South Carolina,Oakland,1081,275,315,128,51,68,837
South Carolina,Wilkinson Heights,2723,1158,454,257,120,400,2389
South Carolina,Williams,131,29,63,6,7,7,112
South Carolina,Williamston,4029,536,1735,346,83,473,3173
South Carolina,Willington,126,72,39,8,0,7,126
South Carolina,Williston,3069,691,1224,145,113,133,2306
South Carolina,Windsor,71,9,44,1,0,4,58
South Carolina,Winnsboro,3419,1017,1149,276,131,229,2802
South Carolina,Winnsboro Mills,2111,763,485,214,81,217,1760
South Carolina,Woodfield,9776,2786,2925,906,404,659,7680
South Carolina,Paxville,215,67,58,17,9,12,163
South Carolina,Peak,51,19,16,6,0,4,45
South Carolina,Pelion,705,167,254,86,34,39,580
South Carolina,Pelzer,82,7,39,9,0,6,61
South Carolina,Rembert,220,79,97,37,0,7,220
South Carolina,Reidville,764,115,349,84,16,27,591
South Carolina,Reevesville,261,79,114,6,11,7,217
South Carolina,Red Hill,14357,4123,5410,1252,539,885,12209
South Carolina,Red Bank,8920,1915,3915,937,111,437,7315
South Carolina,Ravenel,2544,668,899,148,101,164,1980
South Carolina,Quinby,1253,309,578,74,7,64,1032
South Carolina,Prosperity,1112,323,346,122,26,65,882
South Carolina,Promised Land,496,198,148,34,38,78,496
South Carolina,Privateer,2805,430,910,342,155,119,1956
South Carolina,Ridgeland,4030,1330,1209,323,140,190,3192
South Carolina,Princeton,57,11,26,20,0,0,57
South Carolina,Port Royal,11513,4921,3219,757,337,171,9405
South Carolina,Pomaria,102,27,58,2,1,5,93
South Carolina,Plum Branch,106,18,32,16,1,18,85
South Carolina,Pinopolis,1098,51,753,134,51,16,1005
South Carolina,Pinewood,686,135,188,64,58,34,479
South Carolina,Pine Ridge,1990,414,905,164,85,95,1663
South Carolina,Piedmont,5648,1331,2504,408,88,334,4665
South Carolina,Pickens,3148,843,932,457,50,195,2477
South Carolina,Perry,303,114,58,34,19,19,244
South Carolina,Pendleton,3089,817,1033,368,172,299,2689
South Carolina,Powdersville,8230,1901,3624,562,222,298,6607
South Carolina,Belvedere,5706,1101,1957,753,192,361,4364
South Carolina,Woodruff,4104,927,1325,414,215,413,3294
South Carolina,Berea,14091,3411,4512,1569,382,882,10756
South Carolina,Burnettown,2753,699,1086,215,89,107,2196
South Carolina,Burton,6266,1349,2247,632,285,360,4873
South Carolina,Calhoun Falls,1733,502,525,149,88,176,1440
South Carolina,Camden,6982,1660,2651,830,114,616,5871
South Carolina,Cameron,472,85,213,27,13,62,400
South Carolina,Campobello,525,81,250,41,23,23,418
South Carolina,Cane Savannah,805,184,331,71,30,122,738
South Carolina,Carlisle,360,108,102,30,26,37,303
South Carolina,Catawba,1044,285,317,144,31,33,810
South Carolina,Cayce,13554,5238,4038,1049,362,837,11524
South Carolina,Centerville,6806,1352,3317,596,133,307,5705
South Carolina,Bennettsville,8834,3042,2309,738,304,808,7201
South Carolina,Central Pacolet,155,33,47,7,6,18,111
South Carolina,Chapin,1605,353,633,135,38,104,1263
South Carolina,Charleston,127694,45704,42172,11944,2443,5725,107988
South Carolina,Buffalo,1544,544,450,96,108,47,1245
South Carolina,Bucksport,839,218,200,127,39,117,701
South Carolina,Central,5160,2956,941,267,109,239,4512
South Carolina,Boykin,103,7,88,0,0,0,95
South Carolina,Bethune,290,47,120,27,5,39,238
South Carolina,Brunson,547,79,261,45,25,27,437
South Carolina,Briarcliffe Acres,493,73,287,25,13,41,439
South Carolina,Branchville,1255,377,372,91,45,80,965
South Carolina,Bradley,149,15,56,40,0,12,123
South Carolina,Bowman,816,269,281,71,33,37,691
South Carolina,Bonneau Beach,2170,261,920,394,67,111,1753
South Carolina,Bonneau,487,96,168,51,25,25,365
South Carolina,Boiling Springs,8743,1777,4071,550,169,313,6880
South Carolina,Blythewood,2479,438,1255,140,75,49,1957
South Carolina,Bluffton,14607,2876,6146,1211,231,602,11066
South Carolina,Blenheim,137,27,70,4,0,14,115
South Carolina,Brookdale,4289,1491,741,289,333,371,3225
South Carolina,Blackville,2203,929,420,167,130,189,1835
South Carolina,Bishopville,3342,1061,678,255,136,300,2430
South Carolina,Blacksburg,1975,518,600,117,54,193,1482
South Dakota,Agency Village,170,45,27,17,0,0,89
South Dakota,Agar,71,1,29,18,0,4,52
South Dakota,Aberdeen,27418,6926,10920,2449,201,1491,21987
South Dakota,Davis,49,8,14,12,0,1,35
South Dakota,Dante,101,14,43,1,1,2,61
South Dakota,Dallas,98,21,46,9,10,5,91
South Dakota,Dakota Dunes,2970,424,1351,244,88,115,2222
South Dakota,Akaska,31,5,9,10,0,7,31
South Dakota,Custer,1899,378,694,306,18,175,1571
South Dakota,Crooks,1329,209,667,33,9,26,944
South Dakota,Crocker,0,0,0,0,0,0,0
South Dakota,Cresbard,148,38,63,27,0,10,138
South Dakota,Cow Creek,20,10,10,0,0,0,20
South Dakota,Albee,10,0,6,3,0,1,10
South Dakota,Java,137,29,48,9,0,22,108
South Dakota,Cottonwood,6,0,3,2,0,1,6
South Dakota,Alexandria,671,107,294,27,12,28,468
South Dakota,Deadwood,1211,303,468,226,19,93,1109
South Dakota,Allen,658,268,99,15,0,17,399
South Dakota,Alpena,261,37,120,30,4,12,203
South Dakota,Altamont,28,7,8,6,0,0,21
South Dakota,Anderson,325,37,218,12,0,6,273
South Dakota,Andover,94,20,22,24,3,5,74
South Dakota,Antelope,1126,333,188,114,11,55,701
South Dakota,Arlington,1013,139,478,68,3,99,787
South Dakota,Armour,870,106,458,62,7,69,702
South Dakota,Artas,5,0,2,2,0,1,5
South Dakota,Artesian,168,40,81,21,0,2,144
South Dakota,Ashland Heights,891,242,186,214,14,24,680
South Dakota,Alcester,847,136,314,88,28,79,645
South Dakota,Corsica,610,87,330,13,2,86,518
South Dakota,Corn Creek,72,37,11,3,0,8,59
South Dakota,Ashton,142,29,64,12,1,5,111
South Dakota,Butler,14,1,11,2,0,0,14
South Dakota,Bushnell,100,38,34,14,2,0,88
South Dakota,Burke,635,111,309,54,5,74,553
South Dakota,Bullhead,298,144,28,22,0,7,201
South Dakota,Buffalo Gap,103,13,27,42,4,9,95
South Dakota,Buffalo,359,98,138,31,4,21,292
South Dakota,Bryant,372,46,157,36,1,46,286
South Dakota,Bruce,168,32,92,10,0,13,147
South Dakota,Brookings,22974,11097,6931,977,72,630,19707
South Dakota,Broadland,37,11,19,2,0,0,32
South Dakota,Winfred,52,1,49,0,0,0,50
South Dakota,Winner,2855,825,1033,238,8,232,2336
South Dakota,Wolsey,462,58,240,31,0,30,359
South Dakota,Wood,23,10,10,0,2,1,23
South Dakota,Woonsocket,597,85,251,83,16,75,510
South Dakota,Worthing,930,183,384,96,0,20,683
South Dakota,Wounded Knee,590,263,89,24,0,6,382
South Dakota,Yale,110,16,42,22,1,8,89
South Dakota,Yankton,14531,3724,5513,1741,122,839,11939
South Dakota,Camp Crook,85,35,26,8,0,12,81
South Dakota,Canistota,592,143,175,56,13,62,449
South Dakota,Canova,88,9,39,9,0,15,72
South Dakota,Canton,3258,896,1289,328,56,175,2744
South Dakota,Conde,134,20,81,8,2,14,125
South Dakota,Columbia,136,31,49,22,1,13,116
South Dakota,Colton,705,132,312,60,16,45,565
South Dakota,Colonial Pine Hills,1906,217,1117,101,12,62,1509
South Dakota,Colome,320,39,130,37,0,17,223
South Dakota,Colman,665,123,286,56,8,22,495
South Dakota,Clear Lake,1284,258,581,101,3,106,1049
South Dakota,Clark,1141,224,479,108,17,151,979
South Dakota,Claremont,139,14,54,26,0,17,111
South Dakota,Corona,113,35,52,10,0,5,102
South Dakota,Claire City,80,19,39,4,0,4,66
South Dakota,Chelsea,34,7,17,5,0,0,29
South Dakota,Chancellor,315,52,125,34,3,18,232
South Dakota,Chamberlain,2582,683,997,202,0,159,2041
South Dakota,Central City,170,64,23,39,0,20,146
South Dakota,Centerville,804,112,374,83,0,65,634
South Dakota,Cavour,118,23,48,15,6,1,93
South Dakota,Castlewood,668,97,316,47,13,33,506
South Dakota,Carthage,173,28,77,27,0,16,148
South Dakota,Caputa,0,0,0,0,0,0,0
South Dakota,Chester,334,60,168,33,0,10,271
South Dakota,Astoria,141,20,61,30,0,4,115
South Dakota,Bath,251,17,118,13,0,7,155
South Dakota,Aurora Center,62,0,26,8,0,0,34
South Dakota,Henry,355,108,111,30,0,17,266
South Dakota,Hecla,176,17,112,18,0,17,164
South Dakota,Hazel,81,9,32,12,3,2,58
South Dakota,Hayti,371,58,165,33,1,18,275
South Dakota,Hartford,2887,550,1189,275,19,97,2130
South Dakota,Harrison,113,14,58,12,0,4,88
South Dakota,Harrisburg,4942,615,2143,353,63,29,3203
South Dakota,Hermosa,412,87,199,45,8,11,350
South Dakota,Hamill,0,0,0,0,0,0,0
South Dakota,Dolton,29,6,12,6,0,1,25
South Dakota,Draper,71,21,33,6,0,8,68
South Dakota,Dupree,586,155,139,50,1,26,371
South Dakota,Eagle Butte,1271,419,212,164,13,50,858
South Dakota,Eden,93,24,48,6,1,2,81
South Dakota,Edgemont,827,95,407,165,0,78,745
South Dakota,Egan,310,65,117,38,4,12,236
South Dakota,Groton,1873,271,928,115,9,116,1439
South Dakota,Herreid,534,66,258,24,0,44,392
South Dakota,Herrick,119,7,72,6,0,7,92
South Dakota,Hetland,35,8,3,12,0,0,23
South Dakota,Isabel,132,34,34,19,0,5,92
South Dakota,Iroquois,270,48,118,26,1,12,205
South Dakota,Irene,543,146,159,64,0,51,420
South Dakota,Ipswich,1002,147,405,119,8,90,769
South Dakota,Interior,70,4,41,5,0,0,50
South Dakota,Huron,13159,2749,5204,1147,187,870,10157
South Dakota,Hurley,374,62,172,39,3,24,300
South Dakota,Humboldt,653,113,344,42,14,22,535
South Dakota,Hudson,318,61,143,38,7,24,273
South Dakota,Howard,1094,171,444,110,7,119,851
South Dakota,Hoven,400,51,182,42,2,52,329
South Dakota,Hot Springs,3542,678,1108,682,109,369,2946
South Dakota,Hosmer,227,22,94,36,7,29,188
South Dakota,Hitchcock,107,34,36,7,4,9,90
South Dakota,Hillsview,0,0,0,0,0,0,0
South Dakota,Hill City,1422,317,483,138,0,37,975
South Dakota,Highmore,898,202,408,71,0,55,736
South Dakota,Elk Point,2080,448,907,144,26,148,1673
South Dakota,Aurora,705,189,294,39,3,23,548
South Dakota,Elkton,728,117,287,45,8,37,494
South Dakota,Erwin,67,3,30,18,1,2,54
South Dakota,Belvidere,68,14,25,12,0,6,57
South Dakota,Belle Fourche,5702,1151,2279,639,60,445,4574
South Dakota,Johnson Siding,736,154,439,95,0,29,717
South Dakota,Kadoka,777,136,345,42,9,72,604
South Dakota,Doland,194,39,87,24,0,12,162
South Dakota,Dimock,155,10,79,8,0,7,104
South Dakota,De Smet,1171,121,649,85,0,114,969
South Dakota,Beresford,2211,401,920,169,0,125,1615
South Dakota,Delmont,255,58,100,16,5,14,193
South Dakota,Bath Corner,129,72,44,0,0,13,129
South Dakota,Jefferson,577,129,268,55,2,20,474
South Dakota,Batesland,136,50,26,7,0,2,85
South Dakota,Bancroft,20,5,7,0,3,2,17
South Dakota,Baltic,1070,171,518,79,0,34,802
South Dakota,Badger,68,13,33,12,0,4,62
South Dakota,Avon,690,122,330,16,5,40,513
South Dakota,Dell Rapids,3693,793,1567,304,19,215,2898
South Dakota,Big Stone City,566,100,272,43,9,43,467
South Dakota,Bijou Hills,0,0,0,0,0,0,0
South Dakota,Bison,317,62,152,32,4,29,279
South Dakota,Estelline,901,189,351,66,8,76,690
South Dakota,Ethan,352,65,153,29,0,18,265
South Dakota,Eureka,771,105,345,64,19,140,673
South Dakota,Britton,1522,336,526,215,1,118,1196
South Dakota,Bristol,325,31,145,47,8,61,292
South Dakota,Bridgewater,540,106,219,30,0,63,418
South Dakota,Brentford,78,13,23,10,4,1,51
South Dakota,Brant Lake,192,16,124,25,0,3,168
South Dakota,Brandt,85,21,36,7,0,5,69
South Dakota,Brandon,9497,1805,4070,540,17,347,6779
South Dakota,Bradley,78,9,37,8,7,0,61
South Dakota,Box Elder,8959,2292,3794,496,67,215,6864
South Dakota,Bowdle,561,56,283,38,0,45,422
South Dakota,Bonesteel,299,61,136,10,10,37,254
South Dakota,Blunt,324,69,123,37,0,14,243
South Dakota,Blucksberg Mountain,541,29,445,0,0,0,474
South Dakota,Blackhawk,2893,551,1397,360,39,90,2437
South Dakota,Emery,491,63,191,29,9,24,316
South Dakota,Harrold,98,13,60,13,0,5,91
South Dakota,Gayville,392,102,187,33,4,17,343
South Dakota,Gregory,1479,275,569,194,12,138,1188
South Dakota,Oglala,1404,687,232,70,48,8,1045
South Dakota,Okaton,6,0,6,0,0,0,6
South Dakota,Okreek,373,171,63,29,0,8,271
South Dakota,Ola,0,0,0,0,0,0,0
South Dakota,Oldham,160,26,59,2,1,18,106
South Dakota,Olivet,53,6,13,9,2,11,41
South Dakota,Onaka,12,2,5,3,0,1,11
South Dakota,Oelrichs,137,16,66,16,11,10,119
South Dakota,Onida,750,162,350,62,0,10,584
South Dakota,Ortley,36,10,14,4,0,4,32
South Dakota,Parker,1142,135,639,66,5,54,899
South Dakota,Parkston,1691,333,768,54,10,144,1309
South Dakota,Parmelee,729,289,114,16,8,11,438
South Dakota,Peever,208,58,50,23,0,18,149
South Dakota,Philip,718,130,289,79,1,114,613
South Dakota,Pickstown,192,38,83,30,2,5,158
South Dakota,Orient,63,18,32,3,0,5,58
South Dakota,Oacoma,556,149,232,56,0,26,463
South Dakota,Nunda,64,0,43,4,0,2,49
South Dakota,Northville,181,35,77,6,0,2,120
South Dakota,Sturgis,6657,1312,2702,675,13,557,5259
South Dakota,Stratford,72,21,23,8,0,0,52
South Dakota,Strandburg,79,9,41,6,6,1,63
South Dakota,Storla,11,11,0,0,0,0,11
South Dakota,Stockholm,112,21,49,13,0,5,88
South Dakota,Stickney,257,30,127,31,0,26,214
South Dakota,Springfield,1942,867,478,352,80,39,1816
South Dakota,Spring Creek,211,110,0,15,0,9,134
South Dakota,Spencer,113,7,66,2,0,11,86
South Dakota,Spearfish,10980,3206,4185,978,70,759,9198
South Dakota,South Shore,179,27,71,36,0,3,137
South Dakota,Soldier Creek,115,34,16,37,0,0,87
South Dakota,Sisseton,2668,854,650,249,32,221,2006
South Dakota,Sioux Falls,164341,43750,62330,14816,1817,6758,129471
South Dakota,North Eagle Butte,2091,725,314,267,29,87,1422
South Dakota,North Sioux City,2597,641,932,417,41,166,2197
South Dakota,North Spearfish,2054,444,983,198,28,161,1814
South Dakota,Piedmont,930,78,319,112,7,9,525
South Dakota,Summerset,2221,340,1037,104,13,21,1515
South Dakota,Pierpont,125,6,70,8,3,8,95
South Dakota,Pine Lakes Addition,291,44,171,13,0,0,228
South Dakota,Rosebud,1665,591,219,186,20,58,1074
South Dakota,Rosholt,495,90,213,40,5,48,396
South Dakota,Roslyn,195,26,75,24,1,31,157
South Dakota,Roswell,7,0,3,4,0,0,7
South Dakota,Running Water,63,30,23,0,0,0,53
South Dakota,St. Charles,20,0,17,0,0,0,17
South Dakota,St. Francis,610,228,74,57,6,32,397
South Dakota,Roscoe,330,62,145,25,2,20,254
South Dakota,St. Lawrence,169,27,96,1,0,12,136
South Dakota,Salem,1476,215,703,152,6,104,1180
South Dakota,Scotland,859,146,342,89,2,119,698
South Dakota,Selby,857,124,353,104,0,99,680
South Dakota,Seneca,13,2,5,2,0,1,10
South Dakota,Sherman,76,10,34,9,0,2,55
South Dakota,Shindler,601,154,304,0,0,0,458
South Dakota,Sinai,130,30,61,3,0,0,94
South Dakota,St. Onge,31,0,31,0,0,0,31
South Dakota,Rockham,94,0,35,0,0,0,35
South Dakota,Richland,66,8,28,30,0,0,66
South Dakota,Revillo,100,29,30,18,0,7,84
South Dakota,Pine Ridge,3562,1466,480,342,36,83,2407
South Dakota,Plankinton,654,78,359,39,5,31,512
South Dakota,Pollock,155,18,60,23,6,37,144
South Dakota,Porcupine,1369,562,255,78,0,41,936
South Dakota,Prairie City,4,4,0,0,0,0,4
South Dakota,Presho,522,63,216,54,0,60,393
South Dakota,Pringle,165,16,89,26,0,9,140
South Dakota,Pukwana,235,45,98,31,0,12,186
South Dakota,Quinn,92,8,49,12,0,2,71
South Dakota,Ramona,144,16,69,16,0,22,123
South Dakota,Rapid City,71692,18841,26227,7779,908,3442,57197
South Dakota,Ravinia,114,22,29,10,0,0,61
South Dakota,Raymond,55,10,33,4,0,6,53
South Dakota,Redfield,2581,492,970,308,36,276,2082
South Dakota,Ree Heights,64,16,34,9,0,2,61
South Dakota,Reliance,223,30,101,10,0,18,159
South Dakota,Renner Corner,270,17,180,54,0,0,251
South Dakota,Pierre,13938,3397,5968,1200,101,736,11402
South Dakota,Grenville,90,19,56,7,0,4,86
South Dakota,Summit,338,75,112,29,5,8,229
South Dakota,Tea,4427,719,1979,232,81,96,3107
South Dakota,Ferney,30,0,0,0,0,30,30
South Dakota,Fedora,23,8,6,0,0,9,23
South Dakota,Faulkton,782,79,291,78,9,141,598
South Dakota,Farmer,2,0,2,0,0,0,2
South Dakota,Faith,387,86,176,25,0,19,306
South Dakota,Fairview,52,16,21,7,0,2,46
South Dakota,Fairfax,138,46,67,4,0,19,136
South Dakota,Flandreau,2082,480,721,225,16,220,1662
South Dakota,Fairburn,60,10,21,13,0,10,54
South Dakota,Willow Lake,334,68,128,22,1,39,258
South Dakota,Whitewood,925,160,354,81,9,50,654
South Dakota,White Rock,2,0,0,2,0,0,2
South Dakota,White River,572,156,166,36,10,25,393
South Dakota,White Lake,421,109,169,19,0,44,341
South Dakota,White Horse,202,100,15,21,0,6,142
South Dakota,Whitehorse,162,53,29,8,3,0,93
South Dakota,Wilmot,433,66,209,47,0,47,369
South Dakota,Florence,377,43,176,17,7,28,271
South Dakota,Forestburg,128,59,56,0,0,4,119
South Dakota,Fort Pierre,2244,380,1041,217,7,96,1741
South Dakota,Green Valley,599,127,281,128,0,38,574
South Dakota,Green Grass,14,5,5,0,0,0,10
South Dakota,Goodwin,176,44,82,5,5,8,144
South Dakota,Goodwill,623,240,61,92,8,33,434
South Dakota,Glenham,91,26,42,0,0,12,80
South Dakota,Gettysburg,1260,213,569,144,7,95,1028
South Dakota,Geddes,204,41,70,27,0,37,175
South Dakota,Gary,260,49,131,28,0,21,229
South Dakota,Garretson,1210,246,512,99,7,69,933
South Dakota,Garden City,45,5,30,5,1,0,41
South Dakota,Gann Valley,18,5,10,0,0,3,18
South Dakota,Fulton,78,10,30,9,3,7,59
South Dakota,Fruitdale,42,3,23,1,0,6,33
South Dakota,Freeman,1298,235,615,53,4,130,1037
South Dakota,Frederick,284,50,137,37,2,14,240
South Dakota,Frankfort,92,19,48,7,0,6,80
South Dakota,Fort Thompson,1286,451,262,93,18,23,847
South Dakota,White,490,95,225,35,0,45,400
South Dakota,Tabor,405,77,200,18,0,29,324
South Dakota,Wetonka,3,1,2,0,0,0,3
South Dakota,Wessington Springs,842,125,405,63,0,103,696
South Dakota,Vermillion,10746,5824,2595,639,112,219,9389
South Dakota,Verdon,4,0,4,0,0,0,4
South Dakota,Veblen,508,223,142,21,6,15,407
South Dakota,Valley Springs,778,137,371,79,0,22,609
South Dakota,Vale,128,19,70,0,0,19,108
South Dakota,Utica,86,6,36,8,0,3,53
South Dakota,Tyndall,1043,215,430,124,0,107,876
South Dakota,Viborg,840,175,326,80,13,120,714
South Dakota,Two Strike,298,144,54,24,0,0,222
South Dakota,Turton,43,6,17,6,0,3,32
South Dakota,Tulare,239,54,111,14,2,8,189
South Dakota,Tripp,646,142,250,56,2,95,545
South Dakota,Trent,278,53,151,26,0,0,230
South Dakota,Toronto,205,28,87,16,5,17,153
South Dakota,Tolstoy,24,2,9,11,0,2,24
South Dakota,Timber Lake,476,126,174,44,7,23,374
South Dakota,Twin Brooks,54,1,33,2,0,1,37
South Dakota,Vienna,48,19,9,7,0,2,37
South Dakota,Vilas,12,1,11,0,0,0,12
South Dakota,Virgil,14,0,12,0,0,2,14
South Dakota,Wessington,293,19,112,26,8,12,177
South Dakota,Wentworth village,164,19,85,29,4,5,142
South Dakota,Webster,1798,397,654,239,7,172,1469
South Dakota,Waverly,9,3,6,0,0,0,9
South Dakota,Waubay,645,91,266,58,15,41,471
South Dakota,Watertown,21919,5304,8475,2340,181,1255,17555
South Dakota,Wasta,104,22,43,12,2,12,91
South Dakota,Warner,441,84,240,35,0,7,366
South Dakota,Ward,50,14,19,4,0,1,38
South Dakota,Wanblee,801,294,131,62,37,32,556
South Dakota,Wallace,104,22,31,3,0,4,60
South Dakota,Wall,724,183,264,74,7,45,573
South Dakota,Wakonda,329,51,138,50,0,23,262
South Dakota,Wagner,1572,461,481,166,2,136,1246
South Dakota,Volin,220,51,104,13,3,0,171
South Dakota,Volga,2401,479,985,129,21,110,1724
South Dakota,Vivian,52,3,35,0,0,5,43
South Dakota,Westport,118,38,55,4,0,13,110
South Dakota,Rapid Valley,8516,1787,3654,777,38,206,6462
South Dakota,Platte,1543,166,839,108,3,118,1234
South Dakota,Mansfield,111,34,48,9,0,2,93
South Dakota,Marty,479,179,51,48,12,13,303
South Dakota,Martin,954,221,352,100,13,77,763
South Dakota,Marion,784,92,378,61,22,95,648
South Dakota,Manderson-White Horse Creek,681,333,32,71,0,9,445
South Dakota,Madison,6972,2224,2400,402,169,540,5735
South Dakota,McLaughlin,551,189,157,55,12,16,429
South Dakota,McIntosh,230,35,89,16,2,24,166
South Dakota,Lowry,7,0,7,0,0,0,7
South Dakota,Lower Brule,587,224,96,40,7,27,394
South Dakota,Loomis,7,0,0,7,0,0,7
South Dakota,Marvin,23,1,17,2,0,3,23
South Dakota,Long Lake,26,7,16,0,0,0,23
South Dakota,Little Eagle,332,107,82,14,7,6,216
South Dakota,Lily,2,0,2,0,0,0,2
South Dakota,Letcher,205,41,67,31,6,12,157
South Dakota,Lesterville,122,36,55,10,0,17,118
South Dakota,Leola,505,119,182,54,7,41,403
South Dakota,Lennox,2371,445,842,277,20,195,1779
South Dakota,Lemmon,1309,254,534,129,14,167,1098
South Dakota,Lebanon,34,1,9,6,0,6,22
South Dakota,Lead,3082,479,1456,494,20,117,2566
South Dakota,La Plant,193,50,8,27,5,20,110
South Dakota,Long Hollow,298,61,48,57,0,9,175
South Dakota,Meadow View Addition,382,53,141,143,0,8,345
South Dakota,Mellette,192,35,72,34,1,10,152
South Dakota,Menno,601,78,331,39,12,80,540
South Dakota,Norris,165,44,24,10,3,10,91
South Dakota,Nisland,328,110,127,31,5,20,293
South Dakota,New Witten,57,12,26,11,0,3,52
South Dakota,New Underwood,543,151,188,78,0,66,483
South Dakota,New Holland,38,0,38,0,0,0,38
South Dakota,Newell,721,188,266,101,24,35,614
South Dakota,New Effington,197,34,57,31,1,25,148
South Dakota,Naples,28,2,11,1,1,0,15
South Dakota,Murdo,393,82,156,49,6,50,343
South Dakota,Mount Vernon,541,86,254,22,0,18,380
South Dakota,Mound City,71,6,50,5,0,10,71
South Dakota,Morristown,45,11,19,4,1,6,41
South Dakota,Morningside,72,20,48,0,0,4,72
South Dakota,Montrose,469,94,213,33,2,21,363
South Dakota,Monroe,162,55,57,12,0,2,126
South Dakota,Mobridge,3302,707,1321,511,18,263,2820
South Dakota,Mitchell,15543,3799,6116,1089,267,1310,12581
South Dakota,Mission Hill,245,64,97,8,3,5,177
South Dakota,Mission,1211,352,205,105,10,40,712
South Dakota,Milltown,11,0,11,0,0,0,11
South Dakota,Miller,1537,305,626,145,3,216,1295
South Dakota,Milbank,3269,744,1570,211,0,258,2783
South Dakota,Midland,152,36,76,9,0,14,135
South Dakota,Langford,395,82,155,29,3,16,285
South Dakota,Lane,90,34,28,7,0,3,72
South Dakota,Lake Preston,581,103,230,91,11,52,487
South Dakota,Keystone,318,110,97,60,3,13,283
South Dakota,Lake Norden,586,92,294,22,1,55,464
South Dakota,Lake Madison,859,80,580,76,12,36,784
South Dakota,Lake City,32,3,14,8,1,2,28
South Dakota,Lake Andes,874,241,176,67,35,76,595
South Dakota,La Bolt,101,19,51,2,0,2,74
South Dakota,Kyle,983,376,157,100,0,35,668
South Dakota,Kranzburg,157,37,75,15,0,5,132
South Dakota,Kimball,549,116,223,74,7,32,452
South Dakota,Kidder,0,0,0,0,0,0,0
South Dakota,Kennebec,326,56,135,12,5,38,246
South Dakota,Kaylor,77,16,61,0,0,0,77
South Dakota,Lake Poinsett,441,39,302,56,0,8,405
Tennessee,Grand Junction,446,133,180,25,14,26,378
Tennessee,Graball,196,39,110,8,0,6,163
Tennessee,Gordonsville,1444,276,630,136,31,50,1123
Tennessee,Fairfield Glade,8216,614,5809,665,40,726,7854
Tennessee,Gleason,1428,311,558,118,65,77,1129
Tennessee,Gilt Edge,535,109,204,63,13,36,425
Tennessee,Gray,1811,470,773,154,0,114,1511
Tennessee,Goodlettsville,16672,4304,6471,2177,353,926,14231
Tennessee,Graysville,1934,419,652,225,55,78,1429
Tennessee,Grimsley,1373,281,624,105,0,95,1105
Tennessee,Greenbrier,6611,1144,2738,722,57,411,5072
Tennessee,Greeneville,15031,3413,5219,2101,303,1119,12155
Tennessee,Greenfield,2262,431,857,231,50,200,1769
Tennessee,Green Hill,6741,1278,3394,750,111,260,5793
Tennessee,Gibson,356,55,169,28,7,14,273
Tennessee,Gruetli-Laager,1966,384,865,112,82,134,1577
Tennessee,Guys,504,107,143,79,38,37,404
Tennessee,Halls,2547,467,946,236,51,162,1862
Tennessee,Greenback,1021,197,427,130,13,34,801
Tennessee,Germantown,39262,6221,20881,2614,206,1637,31559
Tennessee,Gadsden,458,130,164,51,9,36,390
Tennessee,Gates,792,243,147,124,10,59,583
Tennessee,Fairmount,2984,468,1357,210,112,50,2197
Tennessee,Fairview,8121,1468,3812,744,107,158,6289
Tennessee,Fall Branch,1557,303,722,93,0,107,1225
Tennessee,Falling Water,1277,314,583,213,0,48,1158
Tennessee,Farragut,21374,3331,11467,907,73,960,16738
Tennessee,Fayetteville,7060,1649,1856,846,292,1083,5726
Tennessee,Fincastle,1315,259,613,235,9,76,1192
Tennessee,Finger,376,41,171,34,3,15,264
Tennessee,Gatlinburg,4099,820,1695,628,216,309,3668
Tennessee,Flat Top Mountain,331,51,204,30,0,29,314
Tennessee,Forest Hills,4969,792,2881,232,0,143,4048
Tennessee,Franklin,68549,12734,32212,5344,417,2788,53495
Tennessee,Friendship,775,159,239,64,28,61,551
Tennessee,Friendsville,912,175,446,80,25,46,772
Tennessee,Gainesboro,962,182,223,160,70,96,731
Tennessee,Gallatin,32518,6679,13051,3333,702,1455,25220
Tennessee,Gallaway,828,274,176,93,41,98,682
Tennessee,Garland,310,56,161,23,6,11,257
Tennessee,Fairgarden,347,12,230,17,0,43,302
Tennessee,Fairfield,271,28,132,0,0,66,226
Tennessee,Trenton,4188,1019,1285,590,74,519,3487
Tennessee,Etowah,3493,475,1355,460,85,376,2751
Tennessee,Dover,1894,342,763,228,19,173,1525
Tennessee,Dodson Branch,1342,169,840,68,17,49,1143
Tennessee,Dickson,14951,3505,5346,1968,225,794,11838
Tennessee,Decherd,2703,539,1018,254,37,195,2043
Tennessee,Decaturville,983,222,334,130,0,108,794
Tennessee,Decatur,1523,238,620,192,27,176,1253
Tennessee,Dayton,7355,2040,2311,1184,172,364,6071
Tennessee,Darden,364,52,173,26,0,9,260
Tennessee,Dowelltown,355,71,129,57,5,21,283
Tennessee,Dandridge,2860,804,1190,256,28,226,2504
Tennessee,Cumberland City,353,114,105,49,9,20,297
Tennessee,Crump,1166,227,465,189,30,100,1011
Tennessee,Crossville,11245,1911,4126,1470,459,738,8704
Tennessee,Cross Plains,1928,378,800,206,28,103,1515
Tennessee,Crab Orchard,786,195,310,73,26,40,644
Tennessee,Cowan,1436,287,492,217,52,154,1202
Tennessee,Covington,9036,3032,2087,1081,367,840,7407
Tennessee,Cottontown,439,117,241,18,0,25,401
Tennessee,Cumberland Gap,427,256,114,28,2,18,418
Tennessee,Eva,191,12,96,52,0,16,176
Tennessee,Doyle,474,70,245,61,10,22,408
Tennessee,Ducktown,411,56,165,62,11,94,388
Tennessee,Harriman,6267,1434,2012,939,97,681,5163
Tennessee,Ethridge,613,104,219,57,36,42,458
Tennessee,Estill Springs,2142,351,987,240,43,159,1780
Tennessee,Erwin,6028,916,2568,715,62,536,4797
Tennessee,Erin,1346,345,383,167,20,184,1099
Tennessee,Enville,203,41,89,24,4,21,179
Tennessee,Englewood,1869,344,739,192,84,110,1469
Tennessee,Elkton,633,140,289,41,19,47,536
Tennessee,Dresden,2924,490,1138,362,17,352,2359
Tennessee,Elizabethton,14058,3163,5272,1846,287,1361,11929
Tennessee,Eastview,885,145,375,124,5,52,701
Tennessee,East Ridge,21275,5169,7434,2796,391,1269,17059
Tennessee,East Cleveland,1612,328,501,291,91,85,1296
Tennessee,Eagleville,714,162,332,63,24,28,609
Tennessee,Eagleton Village,4360,1216,1593,593,24,312,3738
Tennessee,Dyersburg,16932,3866,5973,2305,428,1420,13992
Tennessee,Dyer,2330,495,880,258,66,240,1939
Tennessee,Dunlap,5022,763,2095,875,91,341,4165
Tennessee,Elgin,261,53,118,44,9,9,233
Tennessee,Cottage Grove,89,17,48,11,1,3,80
Tennessee,Harrison,7601,1670,3607,849,36,466,6628
Tennessee,Hartsville/Trousdale,7884,1853,3169,809,206,402,6439
Tennessee,Medina,3944,573,1636,365,6,135,2715
Tennessee,Maynardville,2425,538,717,289,66,290,1900
Tennessee,Maury City,665,171,199,98,46,44,558
Tennessee,Mason,1384,626,249,151,33,98,1157
Tennessee,Mascot,2666,309,1279,344,73,93,2098
Tennessee,Maryville,27993,6098,11644,2786,284,1777,22589
Tennessee,Martin,11199,5238,3212,644,145,518,9757
Tennessee,Manchester,10298,1889,4061,1476,182,700,8308
Tennessee,Madisonville,4743,685,1769,577,124,331,3486
Tennessee,McMinnville,13651,2714,4735,2330,348,928,11055
Tennessee,McLemoresville,325,63,136,53,5,19,276
Tennessee,McKenzie,5551,1400,1815,668,49,419,4351
Tennessee,McEwen,1812,350,708,257,64,128,1507
Tennessee,Lynnville,334,72,120,27,0,33,252
Tennessee,Lyles,593,114,231,37,84,117,583
Tennessee,Medon,238,30,88,57,2,11,188
Tennessee,Luttrell,880,203,338,105,20,74,740
Tennessee,Memphis,657167,237015,162516,63241,22275,32899,517946
Tennessee,Middleton,647,112,300,51,7,31,501
Tennessee,Moscow,626,290,106,104,21,35,556
Tennessee,Morristown,29247,6571,10175,3644,492,2096,22978
Tennessee,Morrison,613,132,234,71,8,35,480
Tennessee,Mooresburg,966,141,424,107,26,121,819
Tennessee,Monterey,2863,425,1182,348,63,177,2195
Tennessee,Monteagle,1436,251,512,249,66,97,1175
Tennessee,Tracy City,1440,232,511,230,21,145,1139
Tennessee,Mitchellville,153,51,57,23,0,5,136
Tennessee,Minor Hill,615,110,192,124,4,37,467
Tennessee,Millington,11113,2637,3899,1351,284,796,8967
Tennessee,Millersville,6579,1313,2521,987,199,330,5350
Tennessee,Milledgeville,204,11,79,41,16,35,182
Tennessee,Milan,7817,1584,2816,1014,174,598,6186
Tennessee,Midtown,1669,528,584,220,52,78,1462
Tennessee,Middle Valley,12235,2105,6129,1330,197,430,10191
Tennessee,Michie,622,76,274,87,30,68,535
Tennessee,Mosheim,2632,531,1072,450,31,88,2172
Tennessee,Louisville,4092,590,2047,425,116,121,3299
Tennessee,Loretto,2092,337,1045,184,65,169,1800
Tennessee,Lafayette,4819,847,1748,647,272,450,3964
Tennessee,Knoxville,183066,64246,54725,21687,3708,10354,154720
Tennessee,Kingston Springs,2767,650,1128,274,39,121,2212
Tennessee,Kingston,5865,930,2539,857,108,487,4921
Tennessee,Kingsport,52898,9430,22196,6785,1148,4113,43672
Tennessee,Kimball,1392,240,629,172,10,89,1140
Tennessee,Kenton,1100,238,421,147,33,146,985
Tennessee,Jonesborough,5189,1222,2458,550,97,188,4515
Tennessee,Johnson City,64978,18949,23472,7439,1226,3326,54412
Tennessee,Jellico,2391,496,862,298,36,324,2016
Tennessee,Jefferson City,8396,2706,2723,853,168,633,7083
Tennessee,Jasper,3278,849,1361,321,2,215,2748
Tennessee,Jamestown,1816,405,390,393,37,253,1478
Tennessee,Jackson,67161,20305,21624,6858,1394,3458,53639
Tennessee,Jacksboro,1981,453,905,244,24,146,1772
Tennessee,La Follette,7218,1563,2480,908,205,800,5956
Tennessee,Loudon,5653,853,2145,454,158,580,4190
Tennessee,La Grange,99,11,63,5,0,14,93
Tennessee,Lakeland,12556,2111,6091,867,55,461,9585
Tennessee,Lookout Mountain,1871,223,1026,103,30,98,1480
Tennessee,Lone Oak,971,165,479,123,15,76,858
Tennessee,Lobelville,957,144,380,146,6,55,731
Tennessee,Livingston,4067,845,1555,557,47,346,3350
Tennessee,Linden,948,189,286,128,9,145,757
Tennessee,Liberty,267,71,116,16,5,20,228
Tennessee,Lexington,7802,1548,3010,863,241,456,6118
Tennessee,Lewisburg,11321,2639,3872,1540,205,770,9026
Tennessee,Lenoir City,8943,1962,2983,1214,56,458,6673
Tennessee,Lebanon,28638,6907,9933,3430,600,1795,22665
Tennessee,Lawrenceburg,10487,2066,3815,1494,162,860,8397
Tennessee,La Vergne,34081,7873,12163,3284,479,974,24773
Tennessee,Lakewood Park,783,100,226,185,22,36,569
Tennessee,Lake Tansi,3972,501,2170,309,21,267,3268
Tennessee,Lakesite,1912,329,1007,159,11,68,1574
Tennessee,Lake City,1812,334,568,256,45,196,1399
Tennessee,Mountain City,2543,536,1010,389,73,230,2238
Tennessee,Mount Carmel,5441,1194,2456,454,58,282,4444
Tennessee,Mount Juliet,28395,5136,12205,3038,393,743,21515
Tennessee,Ramer,317,59,123,29,12,36,259
Tennessee,Puryear,677,89,310,126,7,57,589
Tennessee,Pulaski,7648,2024,2445,982,250,559,6260
Tennessee,Powells Crossroads,1359,167,731,105,22,75,1100
Tennessee,Portland,11963,2240,4902,1136,153,664,9095
Tennessee,Pleasant View,4215,793,2076,242,81,88,3280
Tennessee,Pleasant Hill,492,53,196,82,4,120,455
Tennessee,Plainview,1851,353,885,157,77,111,1583
Tennessee,Pittman Center,423,58,209,91,4,24,386
Tennessee,Piperton,1709,308,953,90,27,91,1469
Tennessee,Pine Crest,2330,529,977,366,32,158,2062
Tennessee,Pikeville,2018,493,526,351,97,177,1644
Tennessee,Pigeon Forge,6039,1112,2657,636,134,418,4957
Tennessee,Philadelphia,1020,256,414,52,22,46,790
Tennessee,Petros,473,97,192,100,15,54,458
Tennessee,Red Bank,11793,3365,4059,1491,233,705,9853
Tennessee,Petersburg,698,136,273,73,16,53,551
Tennessee,Iron City,208,51,68,29,4,15,167
Tennessee,Huntland,723,125,319,79,21,68,612
Tennessee,Helenwood,686,289,248,105,0,0,642
Tennessee,Henderson,6474,2551,1662,561,60,469,5303
Tennessee,Hendersonville,54168,10899,24102,5317,889,2715,43922
Tennessee,Henning,879,253,263,127,47,87,777
Tennessee,Henry,545,114,220,45,16,30,425
Tennessee,Hickory Valley,211,58,129,12,7,1,207
Tennessee,Hillsboro,305,47,179,8,0,0,234
Tennessee,Hohenwald,3699,780,1416,462,14,449,3121
Tennessee,Hollow Rock,633,109,227,97,13,49,495
Tennessee,Hopewell,1922,309,1142,185,20,118,1774
Tennessee,Hornbeak,392,44,179,51,2,41,317
Tennessee,Hornsby,309,42,127,35,5,12,221
Tennessee,Humboldt,8325,1881,2539,1130,307,831,6688
Tennessee,Hunter,1684,267,783,273,13,77,1413
Tennessee,Huntingdon,3962,1004,1390,496,34,378,3302
Tennessee,Huntsville,1401,354,423,229,20,153,1179
Tennessee,Pelham,428,113,197,46,0,25,381
Tennessee,Pegram,2166,497,1000,226,15,105,1843
Tennessee,Parsons,2542,425,979,325,73,259,2061
Tennessee,Nolensville,6361,896,3213,193,53,99,4454
Tennessee,Niota,875,199,346,94,6,50,695
Tennessee,New Union,1801,319,970,51,0,104,1444
Tennessee,New Tazewell,2984,674,989,580,65,322,2630
Tennessee,Newport,6874,1092,2378,1147,299,647,5563
Tennessee,New Market,1418,198,673,172,35,76,1154
Tennessee,New Johnsonville,1960,356,857,225,41,120,1599
Tennessee,New Hope,961,152,453,97,7,35,744
Tennessee,New Deal,352,38,171,34,0,16,259
Tennessee,Newbern,3314,511,1320,418,15,144,2408
Tennessee,Nashville-Davidson metropolitan government (balance),634512,206914,206220,65626,11991,25742,516493
Tennessee,Murfreesboro,117983,35948,43666,10608,1739,3697,95658
Tennessee,Munford,6044,1210,2466,516,93,278,4563
Tennessee,Mowbray Mountain,1537,225,811,156,26,75,1293
Tennessee,Mount Pleasant,4657,1076,1842,542,87,245,3792
Tennessee,Normandy,79,6,41,11,0,6,64
Tennessee,Norris,2036,327,959,181,67,220,1754
Tennessee,Oakdale,198,31,82,21,1,11,146
Tennessee,Oak Grove CDP (Sumner County),245,56,90,9,0,32,187
Tennessee,Parrottsville,274,55,100,37,5,24,221
Tennessee,Parker's Crossroads,310,76,124,48,9,26,283
Tennessee,Park City,2734,310,1191,200,8,225,1934
Tennessee,Paris,10166,2026,3515,1639,182,725,8087
Tennessee,Palmer,695,160,243,75,25,70,573
Tennessee,Orme,125,19,69,16,2,9,115
Tennessee,Orlinda,1016,189,420,102,30,48,789
Tennessee,Harrogate,4355,1219,1904,328,87,282,3820
Tennessee,Ooltewah,323,78,126,25,0,80,309
Tennessee,Olivet,1413,189,688,246,0,55,1178
Tennessee,Oliver Springs,3767,781,1518,299,139,106,2843
Tennessee,Obion,1071,288,442,131,9,85,955
Tennessee,Oak Ridge,29310,6684,11657,3381,513,1731,23966
Tennessee,Oakland,7106,913,3878,541,58,223,5613
Tennessee,Oak Hill,4658,611,2819,155,0,195,3780
Tennessee,Oak Grove CDP (Washington County),5099,1397,1836,515,64,304,4116
Tennessee,Oneida,3730,738,1236,509,83,246,2812
Tennessee,Cornersville,1315,249,570,166,33,62,1080
Tennessee,Flintville,614,47,376,17,0,73,513
Tennessee,Coopertown,4343,852,2169,300,14,176,3511
Tennessee,Bruceton,1641,321,629,236,23,124,1333
Tennessee,Clarksburg,395,76,161,42,9,37,325
Tennessee,Clarkrange,701,94,308,55,14,65,536
Tennessee,Church Hill,6725,1068,3180,758,111,408,5525
Tennessee,Christiana,2781,365,1435,152,14,129,2095
Tennessee,Chesterfield,366,79,170,33,0,29,311
Tennessee,Chattanooga,174483,54723,55338,20218,3119,9972,143370
Tennessee,Charlotte,1577,316,573,180,44,140,1253
Tennessee,Charleston,834,153,310,118,15,30,626
Tennessee,Chapel Hill,1573,224,690,191,3,111,1219
Tennessee,Central,2258,306,1087,269,9,182,1853
Tennessee,Centerville,3572,657,1437,514,62,379,3049
Tennessee,Centertown,249,15,117,40,4,10,186
Tennessee,Adams,840,151,378,93,2,28,652
Tennessee,Adamsville,2306,261,988,359,59,191,1858
Tennessee,Alamo,2281,456,909,230,78,142,1815
Tennessee,Alcoa,8737,1952,3174,1227,139,470,6962
Tennessee,Alexandria,988,174,447,104,6,50,781
Tennessee,Algood,3581,710,1387,398,36,320,2851
Tennessee,Allardt,610,87,321,74,7,43,532
Tennessee,Altamont,1174,193,500,137,47,89,966
Tennessee,Andersonville,347,94,169,20,21,0,304
Tennessee,Apison,2505,639,1220,233,7,89,2188
Tennessee,Ardmore,1182,242,446,165,47,117,1017
Tennessee,Arlington,11635,2045,5195,413,101,269,8023
Tennessee,Townsend,426,30,239,63,2,53,387
Tennessee,Ashland City,4650,999,1492,706,158,263,3618
Tennessee,Toone,443,130,135,95,2,16,378
Tennessee,Three Way,1641,263,964,124,14,69,1434
Tennessee,Sneedville,1309,286,353,211,59,89,998
Tennessee,Soddy-Daisy,13158,2330,6074,1471,266,724,10865
Tennessee,Somerville,3115,641,1003,470,106,226,2446
Tennessee,South Carthage,1487,250,629,198,31,86,1194
Tennessee,South Cleveland,6458,1012,3206,495,78,394,5185
Tennessee,South Fulton,2448,645,846,350,104,148,2093
Tennessee,South Pittsburg,3107,617,1006,450,73,309,2455
Tennessee,Sparta,5074,1201,1761,640,32,625,4259
Tennessee,Spencer,1726,354,575,281,64,171,1445
Tennessee,Spring City,2248,352,669,311,107,314,1753
Tennessee,Springfield,16639,4107,5632,2011,255,940,12945
Tennessee,Spring Hill,32831,4870,15314,2086,249,594,23113
Tennessee,Spurgeon,3961,691,1789,536,32,219,3267
Tennessee,Stanton,396,147,67,46,7,25,292
Tennessee,Stantonville,291,63,139,44,3,17,266
Tennessee,Summertown,721,90,290,72,36,63,551
Tennessee,Sunbright,454,78,191,49,10,23,351
Tennessee,Surgoinsville,1986,293,952,215,47,79,1586
Tennessee,Sweetwater,5872,887,2917,751,34,440,5029
Tennessee,Tazewell,2293,418,755,253,51,344,1821
Tennessee,Telford,810,68,502,56,0,44,670
Tennessee,Tellico Plains,820,139,305,117,26,74,661
Tennessee,Tellico Village,6136,439,4843,176,21,534,6013
Tennessee,Tennessee Ridge,1459,269,693,156,15,75,1208
Tennessee,Thompson's Station,2862,651,1427,172,7,33,2290
Tennessee,Tiptonville,4396,1928,864,740,141,281,3954
Tennessee,Athens,13634,3299,4376,1839,239,1203,10956
Tennessee,Atoka,8845,1652,4333,718,91,247,7041
Tennessee,Atwood,905,157,378,131,34,101,801
Tennessee,Wildwood,1314,269,529,79,57,122,1056
Tennessee,Whitwell,1978,343,761,228,59,205,1596
Tennessee,Whiteville,4568,2232,835,914,195,190,4366
Tennessee,White Pine,2274,480,930,172,59,128,1769
Tennessee,White House,10810,2155,4911,705,178,417,8366
Tennessee,White Bluff,3299,695,1422,485,44,194,2840
Tennessee,Benton,1897,373,703,261,13,127,1477
Tennessee,Berry Hill,668,376,194,51,8,23,652
Tennessee,Bethel Springs,772,155,313,77,2,48,595
Tennessee,Bethpage,309,73,141,86,0,9,309
Tennessee,Big Sandy,533,118,141,139,13,64,475
Tennessee,Blaine,1943,385,926,190,43,101,1645
Tennessee,Bloomingdale,9730,1676,4441,1032,260,703,8112
Tennessee,Blountville,2364,624,1008,293,157,187,2269
Tennessee,Bluff City,1863,321,759,264,13,86,1443
Tennessee,Bolivar,5219,1628,1538,503,220,257,4146
Tennessee,Bon Aqua Junction,994,276,363,173,10,58,880
Tennessee,Bowman,301,44,198,0,0,0,242
Tennessee,Braden,259,49,118,24,3,34,228
Tennessee,Bradford,1295,219,558,114,30,88,1009
Tennessee,Bransford,217,0,162,0,0,9,171
Tennessee,Brentwood,39974,6130,21749,1569,153,903,30504
Tennessee,Brighton,2954,561,1213,262,22,92,2150
Tennessee,Bristol,26674,5335,10819,3514,545,2058,22271
Tennessee,Brownsville,10016,2725,2945,1190,403,692,7955
Tennessee,Wildwood Lake,3475,380,1751,320,123,267,2841
Tennessee,Williston,413,110,150,44,7,19,330
Tennessee,Winchester,8502,1468,3447,1229,199,646,6989
Tennessee,Winfield,799,115,288,161,35,67,666
Tennessee,Auburntown,311,65,120,48,5,8,246
Tennessee,Baileyton,531,85,179,122,18,42,446
Tennessee,Baneberry,534,44,341,52,3,45,485
Tennessee,Banner Hill,1529,329,659,218,45,139,1390
Tennessee,Bartlett,58107,11578,26510,4703,672,3013,46476
Tennessee,Baxter,1517,286,557,157,3,118,1121
Tennessee,Bean Station,3089,520,1284,456,39,279,2578
Tennessee,Beersheba Springs,573,132,249,43,26,47,497
Tennessee,Bell Buckle,400,78,180,64,2,11,335
Tennessee,Belle Meade,2857,283,1556,149,8,106,2102
Tennessee,Bells,2552,508,783,394,103,226,2014
Tennessee,Yorkville,448,53,231,15,2,29,330
Tennessee,Smyrna,43580,9269,16808,5157,603,1766,33603
Tennessee,Wrigley,174,42,30,32,33,13,150
Tennessee,Woodbury,2720,501,714,442,197,297,2151
Tennessee,Copperhill,428,47,151,96,4,24,322
Tennessee,Celina,1674,351,398,312,27,172,1260
Tennessee,Cedar Hill,394,83,148,38,15,5,289
Tennessee,Castalian Springs,923,230,351,129,42,28,780
Tennessee,Caryville,2418,417,1023,287,54,134,1915
Tennessee,Carthage,2025,402,776,288,19,247,1732
Tennessee,Camden,3578,668,1241,548,13,471,2941
Tennessee,Calhoun,503,104,208,56,7,45,420
Tennessee,Byrdstown,996,207,375,107,19,130,838
Tennessee,Burns,1536,296,587,221,10,132,1246
Tennessee,Burlison,409,74,221,31,8,19,353
Tennessee,Woodland Mills,443,75,231,43,1,19,369
Tennessee,Smithville,4611,1312,1220,815,115,286,3748
Tennessee,Clarksville,143618,31415,56974,13935,2910,4458,109692
Tennessee,Bulls Gap,593,112,264,89,1,37,503
Tennessee,Viola,56,6,24,19,4,1,54
Tennessee,Vanleer,338,71,107,45,6,45,274
Tennessee,Unionville,1396,116,686,87,30,132,1051
Tennessee,Union City,10722,2575,3769,1004,390,775,8513
Tennessee,Unicoi,3598,822,1418,365,113,289,3007
Tennessee,Tusculum,2677,1002,1011,156,17,131,2317
Tennessee,Vonore,1775,287,818,165,28,116,1414
Tennessee,Tullahoma,19022,3664,7291,2427,649,1320,15351
Tennessee,Trimble,502,92,226,61,4,34,417
Tennessee,Trezevant,923,170,324,125,11,76,706
Tennessee,Seymour,11059,2177,5129,1313,204,529,9352
Tennessee,Slayden,174,44,73,26,9,5,157
Tennessee,Sewanee,2642,1823,566,122,0,12,2523
Tennessee,Sevierville,15903,3834,5804,1784,230,1322,12974
Tennessee,Troy,1450,291,624,161,33,118,1227
Tennessee,Selmer,4491,1066,1553,750,77,316,3762
Tennessee,Walden,2052,320,1106,168,14,65,1673
Tennessee,Walnut Grove CDP (Hardin County),259,60,160,0,0,29,249
Tennessee,Signal Mountain,8456,1176,4361,508,74,548,6667
Tennessee,Shelbyville,20779,4670,7667,1992,552,956,15837
Tennessee,Sharon,989,197,396,102,19,141,855
Tennessee,Shackle Island,3029,641,1660,147,0,47,2495
Tennessee,Westmoreland,2003,303,749,270,25,147,1494
Tennessee,Waynesboro,2425,592,812,298,62,296,2060
Tennessee,Walland,240,50,144,17,0,7,218
Tennessee,Waverly,4111,800,1627,596,25,304,3352
Tennessee,Watauga,376,85,167,40,14,21,327
Tennessee,Wartrace,653,122,242,109,7,61,541
Tennessee,Wartburg,804,170,238,147,14,118,687
Tennessee,Walterhill,326,94,182,17,0,0,293
Tennessee,Walnut Hill,2301,346,1221,259,0,167,1993
Tennessee,Walnut Grove CDP (Sumner County),987,130,479,120,40,31,800
Tennessee,Watertown,1462,288,538,291,34,111,1262
Tennessee,Scotts Hill,825,161,303,120,32,66,682
Tennessee,Silerton,84,17,41,13,0,6,77
Tennessee,Saulsbury,191,63,34,13,25,19,154
Tennessee,Ridgeside,563,89,300,33,0,20,442
Tennessee,Ridgetop,2338,356,1192,235,9,87,1879
Tennessee,Ripley,8291,2551,2051,1036,210,520,6368
Tennessee,Rives,232,49,111,14,7,15,196
Tennessee,Robbins,180,34,130,9,0,0,173
Tennessee,Rockford,789,151,466,51,3,18,689
Tennessee,Rockvale,753,111,407,26,0,8,552
Tennessee,Ridgely,1902,336,700,192,118,135,1481
Tennessee,Rockwood,5466,1160,2124,782,78,407,4551
Tennessee,Sale Creek,2657,534,1329,401,17,148,2429
Tennessee,Rossville,662,155,342,55,8,43,603
Tennessee,Rural Hill,1716,339,1074,78,0,65,1556
Tennessee,Rutherford,1199,359,449,126,5,86,1025
Tennessee,Rutledge,1286,287,472,177,19,139,1094
Tennessee,St. Joseph,986,252,397,81,12,106,848
Tennessee,Savannah,7032,1349,2378,1051,140,812,5730
Tennessee,Rogersville,4400,737,1612,730,195,472,3746
Tennessee,Riceville,671,82,313,135,27,24,581
Tennessee,Roan Mountain,1591,348,685,173,43,52,1301
Tennessee,Cleveland,42895,11259,15046,5228,632,2510,34675
Tennessee,Sardis,460,77,211,79,4,31,402
Tennessee,Samburg,180,31,77,51,0,11,170
Tennessee,Red Boiling Springs,1314,216,413,158,55,130,972
Tennessee,Cookeville,31831,11428,9468,4038,425,1623,26982
Tennessee,Columbia,35627,8442,11654,4730,765,2116,27707
Tennessee,Colonial Heights,3512,665,1629,468,5,255,3022
Tennessee,Collinwood,1029,201,452,90,12,84,839
Tennessee,Saltillo,557,86,270,79,14,55,504
Tennessee,Clifton,2666,1240,629,462,66,110,2507
Tennessee,Collierville,47434,9077,23537,2626,407,1367,37014
Tennessee,Collegedale,9918,2817,4138,600,68,796,8419
Tennessee,Coalmont,668,150,274,65,9,58,556
Tennessee,Coalfield,2690,309,1512,146,37,113,2117
Tennessee,Clinton,9918,2182,3634,1530,179,873,8398
Texas,Runge,1128,241,505,85,3,116,950
Texas,Rosharon,2120,593,736,53,13,217,1612
Texas,Rosita,2824,540,789,216,184,53,1782
Texas,Ross,249,64,101,26,5,12,208
Texas,Rosser village,312,67,116,34,11,28,256
Texas,Rotan,1459,359,565,106,70,134,1234
Texas,Round Mountain,166,23,72,25,6,12,138
Texas,Round Rock,109690,24554,44367,9352,1328,2534,82135
Texas,Roxton,518,105,167,81,13,51,417
Texas,Rowlett,58296,12432,27588,4523,450,1827,46820
Texas,Runaway Bay,1598,203,855,159,28,90,1335
Texas,Royse City,10128,1825,4059,688,103,458,7133
Texas,Rule,608,63,273,76,2,54,468
Texas,Rosenberg,33600,9087,10537,3098,1088,1343,25153
Texas,Sabinal,1981,404,715,151,66,81,1417
Texas,Rusk,5594,1695,1647,885,146,227,4600
Texas,Round Top,73,4,57,2,0,10,73
Texas,Rose Hill Acres,448,99,220,37,2,19,377
Texas,Ropesville,358,78,142,28,9,38,295
Texas,Rosebud,1401,440,459,116,23,75,1113
Texas,Berryville,1123,185,481,111,20,86,883
Texas,Benjamin Perez,0,0,0,0,0,0,0
Texas,Benjamin,258,21,110,33,11,36,211
Texas,Benbrook,22144,4198,9875,2387,343,1196,17999
Texas,Benavides,1705,538,604,92,15,119,1368
Texas,Belton,19766,6348,6363,1493,450,951,15605
Texas,Bellville,4171,818,1819,723,0,249,3609
Texas,Bells,1538,276,678,98,27,81,1160
Texas,Bellmead,10022,2104,3298,1037,195,481,7115
Texas,Bertram,1461,291,507,216,44,92,1150
Texas,Bellevue,307,55,129,35,9,32,260
Texas,Beeville,13192,3400,4265,1526,306,565,10062
Texas,Bee Cave,5362,635,2667,391,0,203,3896
Texas,Bedias,310,78,145,29,11,17,280
Texas,Bedford,48559,11318,19983,6405,818,2508,41032
Texas,Beckville,966,196,387,56,14,52,705
Texas,Beaumont,117676,34342,36252,12713,2722,6922,92951
Texas,Beasley,572,159,170,65,6,29,429
Texas,Granite Shoals,4988,897,1795,366,144,310,3512
Texas,Granjeno,288,96,142,7,0,12,257
Texas,Bellaire,17869,2854,9167,976,38,621,13656
Texas,Beverly Hills,1827,453,610,185,51,84,1383
Texas,Bevil Oaks,1308,238,796,75,0,52,1161
Texas,Bigfoot,234,29,134,54,0,17,234
Texas,Roscoe,1394,311,559,161,22,61,1114
Texas,Roman Forest,2068,424,967,123,20,63,1597
Texas,Roma Creek,425,37,195,0,22,0,254
Texas,Roma,10041,2397,3929,304,205,896,7731
Texas,Rollingwood,1603,202,831,56,3,66,1158
Texas,Rogers,957,222,380,84,34,79,799
Texas,Rocky Mound,68,6,25,5,0,8,44
Texas,Rockwall,40830,7109,18645,3705,239,1455,31153
Texas,Rocksprings,1285,248,482,94,20,195,1039
Texas,Rockport,9992,1886,4487,924,354,466,8117
Texas,Rockdale,5507,952,1972,781,198,373,4276
Texas,Rochester,322,32,126,38,9,27,232
Texas,Roby,772,162,235,76,33,49,555
Texas,Combes,3019,631,1331,156,40,167,2325
Texas,Comanche,4224,799,1554,407,111,412,3283
Texas,Columbus,3631,760,1384,475,53,354,3026
Texas,Colorado City,4122,800,1844,269,91,219,3223
Texas,Colmesneil,643,92,248,114,3,60,517
Texas,Big Spring,28054,7390,9045,3477,972,1635,22519
Texas,Big Sandy,1843,427,567,231,51,84,1360
Texas,Big Lake,3146,499,1545,187,70,99,2400
Texas,Rose City,386,82,158,40,4,44,328
Texas,Colorado Acres,98,13,41,0,0,0,54
Texas,San Carlos I,180,35,62,0,0,0,97
Texas,Sadler,403,34,193,52,14,18,311
Texas,Westworth Village,2584,519,1043,267,64,139,2032
Texas,Westwood Shores,1391,267,627,117,55,133,1199
Texas,Westway,3868,1027,1263,180,155,166,2791
Texas,West University Place,15412,2200,8101,864,27,371,11563
Texas,West Tawakoni,1707,306,620,262,49,154,1391
Texas,West Sharyland,1986,488,630,43,50,90,1301
Texas,Highlands,7515,1583,2809,648,195,420,5655
Texas,Highland Park,8916,1291,4534,682,51,292,6850
Texas,Highland Haven,451,14,313,28,0,54,409
Texas,Horseshoe Bay,3557,248,2339,397,25,250,3259
Texas,Higgins,466,82,167,62,18,31,360
Texas,Hidalgo,13287,2995,4677,732,351,369,9124
Texas,Hico,1408,307,527,172,31,145,1182
Texas,Hickory Creek,3774,624,1989,367,38,58,3076
Texas,Hewitt,14022,2928,7180,1049,126,364,11647
Texas,Hermleigh,384,33,221,14,3,17,288
Texas,Hereford,15257,3312,5720,784,353,707,10876
Texas,Henrietta,3047,609,1236,316,101,229,2491
Texas,Henderson,13695,3623,4410,1553,483,992,11061
Texas,Hempstead,6432,2729,1534,460,87,116,4926
Texas,Hideaway,3026,287,2085,200,0,315,2887
Texas,Hemphill,1441,331,433,199,36,81,1080
Texas,Hornsby Bend,7441,2640,2154,629,122,18,5563
Texas,Hooks,2757,578,1006,232,106,166,2088
Texas,Highland Village,15793,2629,8491,1067,86,269,12542
Texas,Hill Country Village,793,173,438,59,0,20,690
Texas,Hillcrest village,762,122,480,38,7,43,690
Texas,Hillsboro,8360,2320,2529,699,249,480,6277
Texas,Hillside Acres,0,0,0,0,0,0,0
Texas,Hilltop CDP (Frio County),226,12,185,29,0,0,226
Texas,Hilltop CDP (Starr County),29,0,16,0,0,13,29
Texas,Hilltop Lakes,985,51,579,151,0,119,900
Texas,Hilshire Village,727,95,356,64,22,50,587
Texas,Horizon City,18981,3635,7115,815,365,411,12341
Texas,Hitchcock,7325,1458,2620,665,263,343,5349
Texas,Holiday Lakes,948,232,300,59,29,44,664
Texas,Holland,1038,293,288,118,23,71,793
Texas,Holliday,1614,322,798,138,26,99,1383
Texas,Holly Lake Ranch,2926,185,1996,265,29,176,2651
Texas,Hollywood Park,3218,326,2023,181,0,266,2796
Texas,Homestead Meadows North,4564,884,1915,177,136,78,3190
Texas,Homestead Meadows South,5811,1571,2470,547,86,66,4740
Texas,Hondo,8987,3287,2706,752,244,465,7454
Texas,Honey Grove,1975,464,823,166,32,123,1608
Texas,Holiday Beach,453,19,321,75,0,38,453
Texas,Helotes,8125,1431,3863,588,49,386,6317
Texas,Heidelberg,1806,364,563,71,85,34,1117
Texas,Hedwig Village,2653,504,1169,234,22,78,2007
Texas,Sanderson,828,110,382,97,9,103,701
Texas,Sanctuary,380,76,152,40,16,20,304
Texas,San Carlos II,225,80,31,0,24,0,135
Texas,Grape Creek,2935,552,1040,418,119,175,2304
Texas,San Carlos,3731,990,1351,167,99,91,2698
Texas,San Benito,24486,6320,7421,1794,859,1279,17673
Texas,San Augustine,2481,718,654,214,97,246,1929
Texas,San Antonio,1413881,406264,469813,137589,35595,58784,1108045
Texas,San Angelo,97595,26019,34301,10966,1803,4950,78039
Texas,Sandia,648,0,265,8,21,0,294
Texas,Sam Rayburn,1060,136,428,235,74,68,941
Texas,Sammy Martinez,96,32,19,6,0,0,57
Texas,Saline?o North,26,8,5,0,13,0,26
Texas,Saline?o,117,48,19,29,4,5,105
Texas,Salado village,1642,230,1027,101,23,82,1463
Texas,St. Paul,670,108,315,51,0,39,513
Texas,St. Paul,1183,169,630,33,7,28,867
Texas,St. Jo,1113,182,524,121,28,34,889
Texas,St. Hedwig,2149,476,1008,218,17,113,1832
Texas,Saginaw,21270,4487,8795,1917,251,586,16036
Texas,Samnorwood,13,0,5,2,0,0,7
Texas,San Diego,4528,1415,1414,421,118,345,3713
Texas,Sandoval,9,0,6,0,0,0,6
Texas,Sand Springs,920,156,371,143,27,87,784
Texas,Hedley,392,74,101,84,0,43,302
Texas,Hebron,475,100,223,23,11,11,368
Texas,Hebbronville,4583,1236,1613,342,50,333,3574
Texas,Heath,7793,1363,4578,231,0,90,6262
Texas,Hearne,4439,1298,1311,441,138,293,3481
Texas,H. Cuellar Estates,27,10,11,0,0,0,21
Texas,Hays,333,71,148,31,9,17,276
Texas,Hawley,612,78,296,27,4,27,432
Texas,Hawkins,1441,346,520,176,17,65,1124
Texas,Hawk Cove,396,68,136,75,11,40,330
Texas,Havana,516,87,188,49,0,35,359
Texas,San Juan,182,45,0,38,0,37,120
Texas,San Juan,35692,7640,13218,1515,1163,1085,24621
Texas,San Isidro,351,156,117,4,8,9,294
Texas,Sanger,7410,1333,2733,966,135,272,5439
Texas,Sanford,157,24,63,17,0,19,123
Texas,San Fernando,39,0,16,23,0,0,39
Texas,San Felipe,709,199,255,89,22,54,619
Texas,San Elizario,9158,2221,2752,348,314,413,6048
Texas,Sandy Point,138,38,61,26,0,10,135
Texas,Sandy Hollow-Escondidas,582,251,186,47,13,0,497
Texas,Sachse,22585,4265,10897,1284,153,588,17187
Texas,Grapeland,1784,442,589,210,38,159,1438
Texas,Hutchins,5669,1818,1890,585,127,155,4575
Texas,Grays Prairie village,349,30,222,17,2,13,284
Texas,Anacua,14,14,0,0,0,0,14
Texas,Amistad,10,0,3,5,0,2,10
Texas,Horseshoe Bend,662,129,132,209,0,95,565
Texas,Amherst,957,164,440,38,5,95,742
Texas,Ames,1216,319,340,108,40,65,872
Texas,Amaya,25,4,5,11,0,5,25
Texas,Amarillo,196571,44549,73294,20305,3999,9277,151424
Texas,Amargosa,15,0,15,0,0,0,15
Texas,Amada Acres,0,0,0,0,0,0,0
Texas,Alvord,1554,237,684,132,25,42,1120
Texas,Bayview,424,64,230,27,3,23,347
Texas,Beach City,2447,481,1185,279,35,37,2017
Texas,Bear Creek village,407,79,231,23,6,12,351
Texas,Haslet,1565,223,880,50,5,51,1209
Texas,Haskell,3284,882,1349,215,126,307,2879
Texas,Hartley,637,73,347,18,7,23,468
Texas,Hart,1216,275,421,136,52,128,1012
Texas,Harper,1035,101,539,111,0,24,775
Texas,Harlingen,65801,16632,22318,4524,1401,3391,48266
Texas,Harker Heights,28199,5995,11226,2492,388,843,20944
Texas,Hargill,380,92,98,16,16,65,287
Texas,Anahuac,2056,545,884,111,23,85,1648
Texas,Anderson,248,47,109,14,10,10,190
Texas,Andrews,12696,2364,5334,971,224,458,9351
Texas,Angleton,19153,4579,6835,1903,375,1321,15013
Texas,Atascocita,70773,15497,30445,5037,899,1568,53446
Texas,Aspermont,996,121,388,78,2,129,718
Texas,Asherton,967,313,348,29,27,85,802
Texas,Arroyo Gardens,403,127,179,0,0,43,349
Texas,Arroyo Colorado Estates,575,205,235,38,0,0,478
Texas,Arp,961,230,404,92,16,40,782
Texas,Arlington,379716,106210,136863,32824,7538,12095,295530
Texas,Argyle,3612,528,2063,203,43,65,2902
Texas,Arcola,2638,605,940,106,126,89,1866
Texas,Archer City,1662,292,615,233,39,112,1291
Texas,Hardin,854,124,379,86,24,73,686
Texas,Aransas Pass,8067,1735,3502,772,172,498,6679
Texas,Appleby,565,107,242,58,7,21,435
Texas,Anton,1236,279,453,103,10,84,929
Texas,Anthony,5305,1523,1707,695,245,92,4262
Texas,Anson,2148,182,898,196,33,179,1488
Texas,Annona,375,130,121,45,15,8,319
Texas,Annetta South,620,81,334,36,2,19,472
Texas,Annetta North,469,82,273,39,1,23,418
Texas,Annetta,1394,213,714,127,4,42,1100
Texas,Anna,9733,1142,4826,543,163,104,6778
Texas,Angus,502,101,217,60,18,15,411
Texas,Aquilla,166,25,74,43,0,12,154
Texas,Happy,754,97,369,47,8,28,549
Texas,Hamlin,1627,183,688,129,59,148,1207
Texas,Hamilton,2985,365,1429,387,84,223,2488
Texas,Irving,228776,58476,86721,18149,4818,6555,174719
Texas,Iredell,377,95,156,31,9,43,334
Texas,Iraan,1208,306,487,86,9,44,932
Texas,Iowa Park,6386,887,2955,719,15,364,4940
Texas,Iowa Colony village,1232,269,564,101,16,63,1013
Texas,Iola,486,94,178,58,4,28,362
Texas,Ingram,2044,403,705,249,69,118,1544
Texas,Ingleside on the Bay,565,95,315,56,13,20,499
Texas,Ingleside,9554,2085,3774,851,142,279,7131
Texas,Inez,2148,394,1044,173,0,93,1704
Texas,Italy,1864,444,680,226,12,86,1448
Texas,Industry,231,51,99,7,13,30,200
Texas,Indian Springs,807,188,238,135,13,24,598
Texas,Indian Lake,913,128,386,85,18,27,644
Texas,Indian Hills,2876,808,880,106,39,143,1976
Texas,Imperial,345,89,153,9,26,7,284
Texas,Impact,11,2,0,0,9,0,11
Texas,Iglesia Antigua,421,129,148,40,0,22,339
Texas,Idalou,2373,491,988,175,31,121,1806
Texas,Iago,76,6,25,8,0,7,46
Texas,Huxley,377,27,193,42,3,46,311
Texas,Hutto,20052,3119,8752,1709,205,508,14293
Texas,Indio,0,0,0,0,0,0,0
Texas,Athens,12777,2831,4722,1095,226,628,9502
Texas,Itasca,1660,275,598,203,63,131,1270
Texas,Jacinto City,10751,2274,4123,645,284,722,8048
Texas,Haltom City,43625,10096,15462,4493,1428,1539,33018
Texas,Hallsville,3888,503,1959,254,22,184,2922
Texas,Hallsburg,548,86,234,84,14,27,445
Texas,Hallettsville,2582,556,967,351,37,239,2150
Texas,Hale Center,2486,457,1028,205,54,157,1901
Texas,Hackberry,1530,316,702,92,11,38,1159
Texas,Gutierrez,21,7,0,0,6,0,13
Texas,Guthrie,147,40,78,8,0,9,135
Texas,Gustine,574,142,228,67,10,32,479
Texas,Gunter,1441,172,625,127,38,155,1117
Texas,Ivanhoe,1184,230,441,183,43,109,1006
Texas,Gun Barrel City,5856,821,2692,685,63,681,4942
Texas,Guadalupe Guerra,13,2,8,0,0,0,10
Texas,Gruver,1112,192,516,30,25,55,818
Texas,Groveton,1365,349,358,63,78,146,994
Texas,Groves,15845,2825,6688,1605,408,1117,12643
Texas,Groom,561,71,256,71,0,32,430
Texas,Groesbeck,4326,737,1461,694,9,284,3185
Texas,Grey Forest,540,70,249,74,3,19,415
Texas,Houston,2217706,695562,722869,179592,59193,82937,1740153
Texas,Howardwick,440,73,196,54,7,41,371
Texas,Jacksboro,4461,1286,1679,604,81,149,3799
Texas,Guerra,0,0,0,0,0,0,0
Texas,Grapevine,49609,10240,21406,4826,783,1557,38812
Texas,Atlanta,5635,1149,1843,804,134,557,4487
Texas,Aurora,1561,220,596,165,44,37,1062
Texas,Chula Vista CDP (Zavala County),363,80,111,0,26,0,217
Texas,Chula Vista CDP (Maverick County),3438,736,1092,193,113,258,2392
Texas,Chula Vista CDP (Cameron County),491,53,214,0,0,24,291
Texas,Christoval,309,31,118,50,0,51,250
Texas,Christine,392,99,153,17,7,19,295
Texas,Chireno,408,69,179,44,8,21,321
Texas,China Spring,1345,327,574,58,42,82,1083
Texas,China Grove,1299,322,735,89,6,58,1210
Texas,China,891,185,386,120,22,59,772
Texas,Chilton,640,104,232,55,0,25,416
Texas,Chillicothe,796,208,331,81,40,54,714
Texas,Childress,6085,1818,2250,671,26,239,5004
Texas,Chico,1217,288,490,134,29,40,981
Texas,Chester,329,46,147,26,6,7,232
Texas,Charlotte,2031,514,698,159,57,130,1558
Texas,Chapeno,60,5,18,0,10,0,33
Texas,Chaparrito,31,0,7,0,24,0,31
Texas,Channing,207,32,77,18,16,20,163
Texas,Channelview,39379,10712,12899,3158,1007,1054,28830
Texas,Chandler,2820,353,1275,283,49,260,2220
Texas,Cesar Chavez,1700,270,753,28,80,11,1142
Texas,Cibolo,23977,4858,11175,1434,174,540,18181
Texas,Cienegas Terrace,2888,723,1058,279,0,108,2168
Texas,Cinco Ranch,17015,3119,9019,797,97,386,13418
Texas,Circle D-KC Estates,1962,381,763,240,38,127,1549
Texas,Collinsville,1744,354,658,198,25,83,1318
Texas,Colleyville,24453,3731,14205,1042,135,615,19728
Texas,College Station,101141,54168,26669,4462,609,1840,87748
Texas,Coleman,4508,692,2349,269,50,310,3670
Texas,Coldspring,911,158,378,73,22,60,691
Texas,Coffee City,281,50,100,61,15,26,252
Texas,Cockrell Hill,4284,1186,1362,238,85,216,3087
Texas,Coahoma,749,90,362,75,11,37,575
Texas,Clyde,3733,664,1392,336,20,257,2669
Texas,Clute,11324,2813,4103,921,342,478,8657
Texas,Central Gardens,4317,714,2334,349,18,256,3671
Texas,Cloverleaf,23285,5728,7844,1271,714,829,16386
Texas,Hurst,38458,8697,15050,4220,548,2091,30606
Texas,Cleveland,7728,2290,2103,723,281,483,5880
Texas,Cleburne,29780,6047,11296,3147,741,1695,22926
Texas,Clear Lake Shores,1235,300,552,171,2,61,1086
Texas,Claude,1214,175,590,127,8,54,954
Texas,Clarksville City,768,109,400,76,20,30,635
Texas,Clarksville,3204,951,908,333,98,226,2516
Texas,Clarendon,1993,594,654,227,63,136,1674
Texas,Citrus City,4141,742,1460,19,113,27,2361
Texas,Cisco,3833,1213,1239,604,44,311,3411
Texas,Clint,820,217,337,63,10,67,694
Texas,Centerville,958,160,360,81,30,152,783
Texas,Center,5262,1226,1705,339,259,401,3930
Texas,Celina,6894,1104,3286,316,64,148,4918
Texas,Barstow,462,107,173,32,7,31,350
Texas,Barry,360,35,123,70,2,14,244
Texas,Barrett,4720,1328,1551,317,386,83,3665
Texas,Barrera,0,0,0,0,0,0,0
Texas,Bardwell,626,131,255,33,4,35,458
Texas,Banquete,684,246,255,40,16,37,594
Texas,Bangs,1674,214,799,205,26,134,1378
Texas,Bandera,1207,152,385,212,0,111,860
Texas,B and E,698,177,218,23,48,21,487
Texas,Balmorhea,584,102,179,116,0,39,436
Texas,Bartlett,2226,775,689,226,53,130,1873
Texas,Ballinger,3732,763,1218,577,120,324,3002
Texas,Balch Springs,24948,6151,7829,1497,766,764,17007
Texas,Baird,1841,397,691,286,51,106,1531
Texas,Bailey's Prairie village,780,150,361,48,11,33,603
Texas,Bailey,214,40,106,25,0,11,182
Texas,Bacliff,8753,2277,2843,718,273,453,6564
Texas,Azle,10860,1972,4313,1721,153,977,9136
Texas,Avinger,393,91,130,55,5,27,308
Texas,Avery,434,75,138,78,14,35,340
Texas,Austwell,124,23,66,22,5,4,120
Texas,Austin,887061,313978,287567,81597,15952,23260,722354
Texas,Balcones Heights,2930,984,593,492,147,84,2300
Texas,Aubrey,2852,607,1244,236,58,57,2202
Texas,Carthage,6856,1524,2270,817,310,550,5471
Texas,Casas,42,27,15,0,0,0,42
Texas,Celeste,779,170,298,86,2,40,596
Texas,Cedar Point,762,55,532,64,0,21,672
Texas,Cedar Park,60841,12041,26106,4955,688,1589,45379
Texas,Cedar Hill,47089,11786,17154,4156,1014,1422,35532
Texas,Catarina,139,66,41,0,17,15,139
Texas,Castroville,2860,561,1198,250,62,309,2380
Texas,Castle Hills,4311,634,1988,402,79,434,3537
Texas,Cashion Community,275,40,137,33,0,17,227
Texas,Greatwood,12198,1473,6373,620,60,291,8817
Texas,Green Valley Farms,451,117,208,12,28,32,397
Texas,Casa Blanca,31,14,17,0,0,0,31
Texas,Greenville,26058,5333,9273,2878,846,1719,20049
Texas,Hudson,4775,879,1532,514,87,199,3211
Texas,Hudson Bend,2823,368,1458,310,32,119,2287
Texas,Hudson Oaks,2123,394,1051,281,6,62,1794
Texas,Hughes Springs,1902,321,660,138,41,203,1363
Texas,Hull,529,37,291,35,8,114,485
Texas,Humble,15516,4016,5469,1516,177,680,11858
Texas,Hungerford,64,8,40,8,0,8,64
Texas,Hunters Creek Village,4620,684,2550,118,7,212,3571
Texas,Huntington,2268,367,722,353,75,171,1688
Texas,Huntsville,40129,18217,10515,4385,760,1287,35164
Texas,Gregory,2137,685,677,144,71,94,1671
Texas,Clifton,3385,589,1289,364,97,332,2671
Texas,Yznaga,23,0,0,0,23,0,23
Texas,Wheeler,1593,281,697,151,4,31,1164
Texas,Cranfills Gap,265,45,115,24,5,27,216
Texas,Crawford,671,139,315,58,0,33,545
Texas,Creedmoor,177,64,59,22,3,10,158
Texas,Cresson,785,112,365,107,28,37,649
Texas,Crockett,6616,1907,1987,458,127,770,5249
Texas,Crosby,2600,421,1137,177,52,67,1854
Texas,Crosbyton,1770,366,709,169,42,90,1376
Texas,Cross Mountain,2725,246,1756,75,0,50,2127
Texas,Cross Plains,1187,286,358,122,28,79,873
Texas,Cross Roads,1016,167,518,110,9,28,832
Texas,Cross Timber,295,37,193,13,1,7,251
Texas,Crowell,773,172,223,162,8,95,660
Texas,Crowley,14174,2556,5685,1553,164,426,10384
Texas,Crystal City,7381,2071,2020,590,373,305,5359
Texas,Cuero,7024,1544,2452,592,164,654,5406
Texas,Cuevitas,0,0,0,0,0,0,0
Texas,Cumby,811,214,358,53,20,43,688
Texas,Cumings,1408,363,616,130,0,0,1109
Texas,Cuney,88,20,17,24,0,6,67
Texas,Cushing,589,159,209,77,11,50,506
Texas,Cut and Shoot,1327,326,562,141,16,54,1099
Texas,Crane,3756,604,1569,297,90,226,2786
Texas,Daingerfield,2815,506,1166,244,124,175,2215
Texas,Crandall,3059,615,1390,205,19,90,2319
Texas,Coyote Acres,447,162,166,33,0,12,373
Texas,Conroe,63521,16554,22331,5569,1761,2977,49192
Texas,Converse,20450,4667,7807,1984,453,645,15556
Texas,Cool,241,58,99,20,9,19,205
Texas,Coolidge,727,170,256,57,37,61,581
Texas,Cooper,2096,468,740,300,20,224,1752
Texas,Coppell,40602,7595,20780,2317,294,863,31849
Texas,Copperas Cove,33005,5862,14143,3091,659,1331,25086
Texas,Copper Canyon,1128,169,766,58,0,19,1012
Texas,Corinth,20614,3382,9822,1564,71,520,15359
Texas,Corpus Christi,316513,81009,114699,32275,7371,14391,249745
Texas,Corral City,16,0,12,0,0,0,12
Texas,Corrigan,1742,353,561,153,69,126,1262
Texas,Corsicana,23945,5863,8425,2306,377,1379,18350
Texas,Cottonwood,140,24,83,6,3,6,122
Texas,Cottonwood Shores,1414,287,526,163,52,70,1098
Texas,Cotulla,3963,1111,1404,109,0,260,2884
Texas,Country Acres,133,60,46,13,0,0,119
Texas,Coupland,207,30,86,30,0,6,152
Texas,Cove,451,68,232,26,5,34,365
Texas,Covington,267,57,114,26,0,16,213
Texas,Coyanosa,211,37,121,0,15,0,173
Texas,Coyote Flats,404,21,233,57,14,20,345
Texas,Daisetta,738,111,391,49,0,40,591
Texas,Dalhart,8254,1826,3075,680,175,340,6096
Texas,Dallas,1260688,400295,387874,110609,35183,46775,980736
Texas,Santa Cruz,136,45,43,0,0,48,136
Texas,Santa Fe,12700,2245,5628,1530,137,518,10058
Texas,Santa Maria,822,216,276,31,26,39,588
Texas,Santa Monica,90,45,31,14,0,0,90
Texas,Santa Rosa,2893,780,953,145,84,98,2060
Texas,Santa Rosa,237,97,64,0,12,32,205
Texas,Santel,0,0,0,0,0,0,0
Texas,San Ygnacio,461,84,246,10,29,9,378
Texas,Sarita,425,96,134,42,0,31,303
Texas,Savannah,4557,779,2031,329,29,0,3168
Texas,Savoy,642,110,268,75,6,123,582
Texas,Scenic Oaks,5468,767,2964,210,0,123,4064
Texas,Schertz,36535,7299,16030,3196,404,1494,28423
Texas,Schulenburg,2892,565,1191,250,22,226,2254
Texas,Scissors,3234,917,937,172,78,135,2239
Texas,Scotland,555,145,254,25,2,28,454
Texas,Scottsville,341,51,126,40,2,25,244
Texas,Scurry,654,103,303,83,9,41,539
Texas,Seabrook,12774,3109,4979,1780,80,292,10240
Texas,Seadrift,1534,329,638,168,11,40,1186
Texas,Seagoville,15558,3546,5627,1727,392,662,11954
Texas,Santa Clara,723,141,400,53,11,12,617
Texas,Santa Anna,47,0,23,11,0,0,34
Texas,Santa Anna,1357,311,495,177,49,62,1094
Texas,Sansom Park,4796,947,1554,582,151,225,3459
Texas,Dalworthington Gardens,2119,512,1206,80,3,83,1884
Texas,Damon,549,109,138,48,29,67,391
Texas,Danbury,1463,300,637,144,14,77,1172
Texas,Darrouzett,389,58,184,34,5,28,309
Texas,Dawson,801,177,291,112,16,46,642
Texas,Dayton,7413,1421,3101,610,147,425,5704
Texas,Dayton Lakes,182,33,78,13,0,3,127
Texas,Dean,543,96,281,23,4,29,433
Texas,Decatur,6301,1076,2298,747,132,424,4677
Texas,DeCordova,2763,148,1676,307,0,238,2369
Texas,Concepcion,39,0,15,0,0,24,39
Texas,Deer Park,33313,7202,14121,2902,529,1144,25898
Texas,De Leon,2221,434,929,263,9,170,1805
Texas,Dell City,321,58,130,28,28,25,269
Texas,Del Mar Heights,230,108,0,15,0,5,128
Texas,San Leanna village,599,138,312,57,12,34,553
Texas,San Leon,5299,956,2393,702,116,283,4450
Texas,San Marcos,54712,32091,9965,3601,641,1741,48039
Texas,San Patricio,448,110,234,32,10,14,400
Texas,San Pedro,473,61,200,64,0,12,337
Texas,San Perlita,664,152,201,44,24,32,453
Texas,San Saba,3020,836,996,305,56,203,2396
Texas,De Kalb,1665,448,588,156,28,167,1387
Texas,Como,770,106,302,77,0,44,529
Texas,Commerce,8558,3930,1937,722,354,291,7234
Texas,Comfort,3091,956,1074,160,73,292,2555
Texas,Keller,43107,6780,21856,2479,314,1498,32927
Texas,Kemah,2125,527,851,200,121,60,1759
Texas,Kemp,1522,405,400,181,51,131,1168
Texas,Kempner,1326,262,549,170,6,130,1117
Texas,Kendleton,296,107,44,67,5,31,254
Texas,Kenedy,3410,958,1137,308,83,167,2653
Texas,Kenefick,485,65,218,49,32,19,383
Texas,Kennard,348,87,110,28,12,45,282
Texas,Kennedale,7273,1651,3611,469,79,324,6134
Texas,Kerens,1651,324,488,171,117,147,1247
Texas,Kermit,6057,983,2509,491,131,337,4451
Texas,Kerrville,22687,5304,8212,3039,520,2034,19109
Texas,Kilgore,14442,3399,5118,1552,498,946,11513
Texas,Killeen,136378,28874,53464,11939,3263,3336,100876
Texas,Kingsbury,799,145,332,92,15,56,640
Texas,Kingsland,6756,924,2809,915,206,489,5343
Texas,Kingsville,26285,9276,7593,2132,541,1108,20650
Texas,Kirby,8332,2100,3093,794,220,429,6636
Texas,Kirbyville,2409,477,678,266,62,279,1762
Texas,Kirvin,117,21,72,9,0,5,107
Texas,Knippa,788,162,270,55,14,77,578
Texas,Keene,6091,1624,2110,609,42,231,4616
Texas,K-Bar Ranch,701,333,121,95,0,47,596
Texas,Kaufman,6947,1620,1999,871,392,346,5228
Texas,Katy,15796,3214,7074,1077,376,730,12471
Texas,Jacksonville,14743,4307,4116,1013,266,801,10503
Texas,Jamaica Beach,1008,198,512,151,10,59,930
Texas,Jardin de San Julian,27,10,11,0,0,0,21
Texas,Jarrell,927,168,460,80,11,33,752
Texas,Jasper,7684,2082,1968,649,231,514,5444
Texas,Jayton,614,57,264,67,9,84,481
Texas,Jefferson,2305,590,848,273,66,194,1971
Texas,Jersey Village,7849,1871,3732,832,54,391,6880
Texas,Jewett,1318,258,554,79,45,48,984
Texas,J.F. Villareal,37,13,0,24,0,0,37
Texas,Knollwood,394,95,144,70,1,50,360
Texas,Joaquin,913,157,251,117,28,106,659
Texas,Jolly,162,12,109,7,0,12,140
Texas,Jones Creek village,2506,431,1191,190,38,106,1956
Texas,Jonestown,1945,306,903,322,6,94,1631
Texas,Josephine,809,159,419,33,5,10,626
Texas,Joshua,5966,1011,2433,522,275,353,4594
Texas,Jourdanton,4120,863,1329,501,60,260,3013
Texas,Juarez,294,55,170,0,19,50,294
Texas,Junction,2643,505,990,370,76,243,2184
Texas,Justin,3351,475,1590,359,27,151,2602
Texas,Karnes City,3216,916,973,318,74,236,2517
Texas,Johnson City,1738,263,672,273,43,108,1359
Texas,Seagraves,2606,538,927,189,29,123,1806
Texas,Knox City,1179,193,448,111,42,74,868
Texas,Kountze,2037,454,717,201,105,155,1632
Texas,Olton,1852,392,718,159,49,142,1460
Texas,Olney,3215,687,1267,250,20,280,2504
Texas,Olmos Park,1990,319,1025,117,20,57,1538
Texas,Olmito and Olmito,275,38,122,0,0,14,174
Texas,Olmito,948,147,475,48,56,31,757
Texas,Olivia Lopez de Gutierrez,0,0,0,0,0,0,0
Texas,Olivarez,3800,968,1295,34,180,58,2535
Texas,Old River-Winfree,1894,448,819,143,21,86,1517
Texas,Oilton,362,88,141,24,0,34,287
Texas,Oglesby,590,99,232,71,21,31,454
Texas,O'Donnell,982,187,366,114,22,39,728
Texas,Odessa,111330,26138,40690,10127,2053,5195,84203
Texas,Baytown,74897,17565,26323,6808,2163,3345,56204
Texas,Bayside,417,104,177,48,6,41,376
Texas,Bayou Vista,1861,305,993,285,16,123,1722
Texas,Bay City,17499,4063,6188,1640,478,1019,13388
Texas,Batesville,1122,384,284,93,117,67,945
Texas,Bastrop,7669,1582,2870,870,150,749,6221
Texas,Bartonville,2101,321,1063,123,0,55,1562
Texas,Barton Creek,3373,560,1989,73,20,256,2898
Texas,Combine,2091,351,1059,159,13,114,1696
Texas,Omaha,931,177,330,171,7,86,771
Texas,Onalaska,1719,288,685,229,28,133,1363
Texas,Opdyke West,112,25,21,15,10,10,81
Texas,Orange,18945,4983,6452,2185,427,1321,15368
Texas,Kress,623,145,283,55,0,31,514
Texas,Krugerville,1555,201,885,113,3,46,1248
Texas,Krum,4625,787,2345,224,0,96,3452
Texas,Kurten,341,51,155,32,3,13,254
Texas,Kyle,32078,6595,13488,2137,350,473,23043
Texas,La Blanca,2421,770,920,113,29,113,1945
Texas,La Carla,179,43,52,0,0,0,95
Texas,La Casita,0,0,0,0,0,0,0
Texas,La Chuparosa,0,0,0,0,0,0,0
Texas,Lackland AFB,7714,5306,1600,57,0,0,6963
Texas,Kosse,378,73,143,68,5,45,334
Texas,La Coma,25,0,16,0,0,0,16
Texas,Lacy-Lakeview,6561,1771,1960,705,185,373,4994
Texas,Ladonia,537,140,121,59,7,62,389
Texas,La Escondida,23,11,8,0,0,0,19
Texas,La Esperanza,30,0,30,0,0,0,30
Texas,La Feria,7325,1684,2745,477,306,209,5421
Texas,La Feria North,86,0,86,0,0,0,86
Texas,Lago,126,57,0,0,43,26,126
Texas,Lago Vista,134,10,52,0,0,0,62
Texas,Orason,106,0,56,26,24,0,106
Texas,Orange Grove,1422,206,611,105,43,69,1034
Texas,LaCoste,1299,295,504,128,9,75,1011
Texas,Wharton,8733,2309,2596,1072,292,480,6749
Texas,Orchard,322,69,140,27,8,9,253
Texas,Overton,2426,573,913,319,19,128,1952
Texas,Shady Hollow,5187,976,2800,401,47,185,4409
Texas,Shady Shores,2776,296,1466,306,14,57,2139
Texas,Shallowater,2529,485,1136,229,7,91,1948
Texas,Shamrock,1861,277,905,169,55,157,1563
Texas,Shavano Park,3326,689,1800,204,17,110,2820
Texas,Sheldon,1615,634,575,57,57,80,1403
Texas,Shenandoah,2523,382,1267,326,63,171,2209
Texas,Shepherd,2887,317,1166,305,37,166,1991
Texas,Sherman,39569,9857,14179,4305,931,2091,31363
Texas,Sherwood Shores,1087,100,677,120,0,93,990
Texas,Shiner,2088,364,814,195,23,220,1616
Texas,Shoreacres,1767,357,774,199,2,63,1395
Texas,Sienna Plantation,15720,2506,7901,706,219,165,11497
Texas,Sierra Blanca,453,90,163,49,6,59,367
Texas,Siesta Acres,2260,453,1021,127,102,20,1723
Texas,Siesta Shores,1457,263,375,173,26,35,872
Texas,Silsbee,6687,1416,2483,582,119,688,5288
Texas,Silverton,722,120,309,50,7,59,545
Texas,Simonton,786,144,338,70,17,35,604
Texas,Sinton,5701,1428,2002,548,235,315,4528
Texas,Skellytown,475,44,198,75,6,33,356
Texas,Shadybrook,1585,223,871,165,61,50,1370
Texas,Skidmore,934,254,403,116,20,70,863
Texas,Seymour,2484,375,993,258,69,306,2001
Texas,Seven Oaks,175,39,64,25,0,7,135
Texas,La Presa,330,81,123,0,8,0,212
Texas,La Pryor,1568,406,484,60,58,84,1092
Texas,La Puerta,391,124,119,18,4,36,301
Texas,Laredo,248855,63284,82815,15414,7061,8964,177538
Texas,Laredo Ranchettes,58,26,0,0,21,0,47
Texas,Laredo Ranchettes West,0,0,0,0,0,0,0
Texas,La Rosita,106,31,41,0,23,0,95
Texas,Lasana,67,0,48,0,0,0,48
Texas,Lasara,994,305,373,38,18,34,768
Texas,Las Haciendas,0,0,0,0,0,0,0
Texas,Las Lomas,3743,1199,894,224,147,29,2493
Texas,Las Lomitas,312,92,113,0,0,0,205
Texas,Las Palmas,17,0,0,0,0,17,17
Texas,Las Palmas II,1765,444,514,21,120,60,1159
Texas,Las Pilas,0,0,0,0,0,0,0
Texas,Las Quintas Fronterizas,2251,610,760,159,53,92,1674
Texas,Latexo,337,46,132,44,3,9,234
Texas,La Tina Ranch,730,282,191,79,0,12,564
Texas,Laughlin AFB,2163,592,1013,8,0,0,1613
Texas,Laureles,5087,1417,1462,344,275,91,3589
Texas,Seth Ward,1838,444,662,153,14,101,1374
Texas,Seven Points,1360,238,540,212,21,109,1120
Texas,Slaton,6097,1427,2150,632,216,481,4906
Texas,Smiley,578,121,201,63,39,41,465
Texas,Zuehl,468,105,289,9,0,50,453
Texas,Windthorst,318,43,188,27,2,16,276
Texas,Windom,177,48,76,13,0,8,145
Texas,Windcrest,5648,1157,2886,395,54,688,5180
Texas,Wimberley,2625,379,1304,372,28,108,2191
Texas,Wilson,518,101,249,29,9,21,409
Texas,Wilmer,3826,1138,1073,268,78,121,2678
Texas,Wills Point,3518,688,1175,434,137,299,2733
Texas,Willow Park,4478,743,2064,452,31,204,3494
Texas,Willis,6127,1195,1855,502,301,276,4129
Texas,Wildwood,711,62,481,64,0,9,616
Texas,Wild Peach Village,2367,501,1080,177,0,76,1834
Texas,Wickett,452,51,212,27,9,38,337
Texas,Wichita Falls,104926,30942,35595,10870,2109,5360,84876
Texas,Whitney,2349,352,841,213,68,239,1713
Texas,Whitewright,1868,382,608,279,65,120,1454
Texas,White Settlement,16733,3824,5680,2251,526,955,13236
Texas,Whitesboro,3842,867,1310,726,14,192,3109
Texas,White Oak,6409,1108,2800,458,113,247,4726
Texas,Whitehouse,7994,1022,3767,478,129,339,5735
Texas,Whiteface,404,80,141,33,7,27,288
Texas,White Deer,930,145,482,45,10,47,729
Texas,Winfield,487,101,202,18,17,14,352
Texas,Wink,1001,246,405,51,13,47,762
Texas,Winnie,3238,740,1061,522,41,358,2722
Texas,Winnsboro,3273,606,914,475,64,271,2330
Texas,Zavalla,771,197,305,63,28,49,642
Texas,Zarate,26,0,0,0,26,0,26
Texas,Zapata Ranch,200,46,61,15,0,5,127
Texas,Zapata,4222,571,1918,336,26,398,3249
Texas,Yorktown,2053,443,836,140,26,206,1651
Texas,Yoakum,5483,1408,1977,427,99,301,4212
Texas,Yantis,571,163,173,100,19,25,480
Texas,Wylie,44461,8335,19682,3241,660,1249,33167
Texas,Wyldwood,3912,881,1874,195,213,27,3190
Texas,Wortham,1044,198,377,106,12,69,762
Texas,La Porte,34746,7091,14688,4046,532,1263,27620
Texas,Woodway,8667,1866,4699,447,53,530,7595
Texas,Woodson,272,73,97,25,12,7,214
Texas,Woodsboro,1500,340,636,112,41,85,1214
Texas,Woodloch,213,65,83,13,9,12,182
Texas,Woodcreek,1288,127,751,160,14,128,1180
Texas,Woodbranch,1431,242,685,151,7,84,1169
Texas,Wolfforth,3996,755,1686,259,19,94,2813
Texas,Wolfe City,1636,277,593,196,20,135,1221
Texas,Wixon Valley,257,43,123,19,15,4,204
Texas,Winters,2551,466,928,221,7,205,1827
Texas,Winona,893,218,287,119,28,29,681
Texas,Woodville,2738,559,898,352,44,262,2115
Texas,La Paloma Ranchettes,497,124,146,60,0,0,330
Texas,La Paloma-Lost Creek,637,97,237,60,0,20,414
Texas,La Paloma Addition,101,62,0,39,0,0,101
Texas,Palo Pinto,216,70,66,46,11,10,203
Texas,Pampa,18216,3208,7499,1810,407,1191,14115
Texas,Panhandle,2549,479,1047,251,66,93,1936
Texas,Panorama Village,2013,373,1026,238,21,215,1873
Texas,Pantego,2475,515,1063,227,53,226,2084
Texas,Paradise,415,82,172,56,7,31,348
Texas,Paris,24903,6079,8579,3024,565,1720,19967
Texas,Parker,4118,647,2151,123,38,99,3058
Texas,Big Thicket Lake Estates,659,198,147,30,35,110,520
Texas,Pasadena,153036,37989,53808,12521,4976,5849,115143
Texas,Pattison,586,65,312,59,2,32,470
Texas,Patton Village,1925,444,673,152,90,76,1435
Texas,Pawnee,168,8,102,13,0,10,133
Texas,Payne Springs,626,112,296,67,2,62,539
Texas,Pearland,101725,17699,47293,7243,1265,3024,76524
Texas,Pearsall,9651,3182,3087,722,153,423,7567
Texas,Pecan Acres,5437,885,2696,259,29,108,3977
Texas,Pecan Gap,231,53,137,9,13,2,214
Texas,Pecan Grove,16399,3447,8330,980,103,437,13297
Texas,Pecan Hill,763,161,355,82,10,31,639
Texas,Pecan Plantation,5755,515,3926,405,0,433,5279
Texas,Paloma Creek South,5141,1023,2173,363,108,125,3792
Texas,Paloma Creek,3780,303,1461,433,15,82,2294
Texas,Palo Blanco,170,53,28,30,0,24,135
Texas,Palmview South,5476,1222,2459,159,83,272,4195
Texas,Ovilla,3616,344,2023,143,70,109,2689
Texas,Owl Ranch,126,0,0,43,11,33,87
Texas,Oyster Creek,1088,238,443,123,2,53,859
Texas,Ozona,3101,549,1502,267,57,126,2501
Texas,Pablo Pena,0,0,0,0,0,0,0
Texas,Paducah,1219,143,588,53,25,131,940
Texas,Paint Rock,357,24,156,50,3,16,249
Texas,Paisano Park,81,0,81,0,0,0,81
Texas,Palacios,4659,948,2079,426,71,86,3610
Texas,Palestine,18488,3937,6854,1829,434,1009,14063
Texas,Pecos,9074,2413,3240,547,283,543,7026
Texas,Palisades village,286,14,162,35,9,16,236
Texas,Palmhurst,2642,547,1158,124,11,100,1940
Texas,Sealy,6222,1436,2494,446,0,372,4748
Texas,Sebastian,1676,521,612,65,65,76,1339
Texas,Seco Mines,477,92,247,0,0,9,348
Texas,Seguin,27095,7545,8885,2835,399,1937,21601
Texas,Selma,7743,1378,3478,383,84,361,5684
Texas,Seminole,7018,940,2949,716,162,484,5251
Texas,Serenada,1399,243,867,93,0,42,1245
Texas,Palm Valley,1720,229,896,161,26,83,1395
Texas,Palmview,5626,1330,2069,349,285,245,4278
Texas,Palmer,2302,400,855,189,60,112,1616
Texas,Ore City,981,206,370,78,16,72,742
Texas,Pelican Bay,1867,419,525,296,65,71,1376
Texas,Penelope,204,30,100,7,5,12,154
Texas,Lake Meredith Estates,146,0,77,69,0,0,146
Texas,Lakeport,1097,253,412,190,24,60,939
Texas,Lakeshore Gardens-Hidden Acres,845,118,315,94,34,48,609
Texas,Lakeside town (San Patricio County),294,26,143,29,0,28,226
Texas,Lakeside town (Tarrant County),1592,337,940,100,13,96,1486
Texas,Lakeside City,1036,140,616,41,3,44,844
Texas,Lake Tanglewood village,694,54,460,48,4,47,613
Texas,Lakeview,89,21,41,18,0,9,89
Texas,Lake View,127,34,84,0,0,9,127
Texas,Lakeway,13212,1967,7432,818,93,468,10778
Texas,Lakewood Village,584,99,292,52,9,30,482
Texas,Lake Worth,4718,862,1858,532,102,424,3778
Texas,La Loma de Falcon,115,19,32,14,19,0,84
Texas,Lamar,1040,24,835,39,7,79,984
Texas,La Marque,15230,3686,5295,1909,319,989,12198
Texas,Lamesa,9343,1932,3630,704,177,628,7071
Texas,La Minita,127,38,73,0,0,0,111
Texas,Lampasas,7096,1300,2887,708,202,514,5611
Texas,Lancaster,38152,11154,11567,3712,1017,1234,28684
Texas,Lantana,8585,946,4404,530,0,91,5971
Texas,La Paloma,2704,576,899,184,92,186,1937
Texas,Lake Medina Shores,896,198,255,259,89,21,822
Texas,Lake Kiowa,2522,270,1626,221,78,155,2350
Texas,Lake Jackson,27352,5712,11794,2627,297,1300,21730
Texas,Lakehills,4900,845,2027,780,153,297,4102
Texas,Penitas,4551,1091,1810,99,188,235,3423
Texas,Perezville,4680,773,1977,125,188,400,3463
Texas,Perrin,415,63,277,44,0,0,384
Texas,Perryton,9358,1841,3721,629,235,319,6745
Texas,Petersburg,1137,224,531,99,0,53,907
Texas,Lago Vista,6443,1200,3791,560,0,132,5683
Texas,La Grange,4666,1006,1515,468,36,283,3308
Texas,La Grulla,1319,348,448,114,39,126,1075
Texas,Laguna Heights,3240,819,892,78,42,172,2003
Texas,Laguna Park,1446,200,712,210,40,127,1289
Texas,Pena,185,59,75,0,0,0,134
Texas,Laguna Seca,383,218,63,0,15,14,310
Texas,La Homa,13406,2855,5031,355,436,468,9145
Texas,La Joya,4183,580,1785,134,118,178,2795
Texas,Lake Bridgeport,422,59,167,72,17,51,366
Texas,Lake Brownwood,1264,148,410,91,147,180,976
Texas,Lake Bryan,2262,394,916,187,20,37,1554
Texas,Lake Cherokee,2665,288,1434,287,41,203,2253
Texas,Lake City,442,94,189,37,18,34,372
Texas,Lake Colorado City,518,51,273,71,4,43,442
Texas,Lake Dallas,7465,1247,2943,1170,201,286,5847
Texas,Lake Dunlap,2688,550,888,304,59,106,1907
Texas,Laguna Vista,3211,489,1504,372,0,248,2613
Texas,Big Wells,737,143,275,60,21,28,527
Texas,Lolita,589,29,256,55,0,89,429
Texas,Bishop Hills,285,49,143,16,0,12,220
Texas,Bullard,2677,435,1019,292,45,157,1948
Texas,Buffalo Springs village,375,76,173,57,4,31,341
Texas,Buffalo Gap,408,75,200,32,12,30,349
Texas,Buffalo,2129,546,590,273,35,145,1589
Texas,Buena Vista,144,3,58,0,0,0,61
Texas,Buda,10655,1755,4406,1322,14,226,7723
Texas,Buckholts,471,120,165,39,14,12,350
Texas,Buchanan Lake Village,722,36,399,116,0,92,643
Texas,Buchanan Dam,1145,89,659,297,0,98,1143
Texas,Bryson,536,147,160,42,11,23,383
Texas,Bryan,79411,25249,25335,6380,1982,3294,62240
Texas,Brushy Creek,21254,4314,9833,1466,143,439,16195
Texas,Bulverde,4761,649,2422,372,92,251,3786
Texas,Bruni,261,63,96,23,0,28,210
Texas,Bruceville-Eddy,1616,276,715,117,15,70,1193
Texas,Brownwood,19021,4341,7008,2117,243,1196,14905
Texas,Brownsville,181487,44711,64010,10375,5808,8474,133378
Texas,Brownsboro,1039,245,372,81,17,30,745
Texas,Brownfield,9688,2444,3113,1232,214,544,7547
Texas,Browndell,189,43,49,28,8,23,151
Texas,Brookside Village,1532,346,716,112,36,65,1275
Texas,Brookshire,4879,1594,1274,338,146,419,3771
Texas,Bronte,860,87,464,81,28,102,762
Texas,Broaddus,194,49,60,33,1,11,154
Texas,Bristol,275,25,215,0,0,35,275
Texas,Bridgeport,6192,1337,2253,669,180,343,4782
Texas,Brundage,0,0,0,0,0,0,0
Texas,Buna,2600,415,896,319,30,268,1928
Texas,Bunker Hill Village,3842,498,2200,83,13,136,2930
Texas,Burkburnett,10960,1992,4681,1166,172,596,8607
Texas,Canyon Creek,1438,141,607,123,120,112,1103
Texas,Canyon,14248,5280,4866,855,125,543,11669
Texas,Canutillo,6110,1981,1935,416,177,202,4711
Texas,Cantu Addition,428,227,34,20,0,37,318
Texas,Canton,3578,932,1355,545,44,267,3143
Texas,Caney City,212,40,108,32,5,20,205
Texas,Canadian,2999,479,1319,173,39,104,2114
Texas,Camp Wood,910,229,331,105,0,106,771
Texas,Camp Swift,6461,1618,2007,1096,65,187,4973
Texas,Campo Verde,183,41,103,0,0,0,144
Texas,Campbell,515,95,228,50,13,28,414
Texas,Cameron Park,6972,1521,2916,222,133,119,4911
Texas,Cameron,5448,1407,1860,460,83,452,4262
Texas,Camargito,433,93,168,0,17,33,311
Texas,Calvert,1327,534,210,108,5,130,987
Texas,Callisburg,345,53,125,35,10,34,257
Texas,Callender Lake,1201,120,525,257,136,81,1119
Texas,Caldwell,4214,637,1959,338,14,335,3283
Texas,Caddo Mills,1772,319,565,249,45,68,1246
Texas,Cactus,3210,911,1140,144,85,57,2337
Texas,Bynum,191,35,98,22,2,2,159
Texas,Byers,506,89,224,12,12,48,385
Texas,Butterfield,83,11,40,5,8,6,70
Texas,Burton,393,34,179,47,0,28,288
Texas,Burnet,6104,1423,2143,562,73,364,4565
Texas,Burleson,40652,6856,17914,3551,583,1346,30250
Texas,Burke,703,114,335,79,11,47,586
Texas,Bridge City,7907,1601,3237,812,56,293,5999
Texas,Briaroaks,548,101,296,32,6,29,464
Texas,Briarcliff village,1565,200,865,171,14,62,1312
Texas,Talco,558,122,179,62,26,21,410
Texas,Stanton,2738,609,864,215,87,185,1960
Texas,Stamford,3004,585,1072,365,70,219,2311
Texas,Stagecoach,596,130,287,70,7,19,513
Texas,Stafford,18097,4755,7713,1699,401,701,15269
Texas,Spur,1157,291,386,155,29,62,923
Texas,Spring Valley Village,4031,605,2051,272,0,147,3075
Texas,Springtown,2741,544,1107,406,79,96,2232
Texas,Springlake,111,20,50,18,0,0,88
Texas,Spring Gardens,627,214,174,55,0,0,443
Texas,Spring,56369,12928,22728,4714,899,1448,42717
Texas,Odem,2671,540,1033,231,109,82,1995
Texas,O'Brien,116,27,42,10,6,16,101
Texas,Oakwood,515,100,223,44,14,62,443
Texas,Oak Valley,444,60,234,47,6,17,364
Texas,Oak Trail Shores,2880,638,913,404,104,161,2220
Texas,Oak Ridge North,3127,668,1484,191,62,166,2571
Texas,Oak Ridge town (Kaufman County),454,80,210,51,15,26,382
Texas,Oak Ridge town (Cooke County),126,23,51,28,3,3,108
Texas,Oak Point,3107,435,1781,189,20,53,2478
Texas,Oak Leaf,1467,359,736,118,12,43,1268
Texas,Oak Island,282,48,140,31,0,11,230
Texas,Oakhurst,481,69,208,0,0,36,313
Texas,Oak Grove,862,211,422,30,17,37,717
Texas,Novice,80,10,20,18,0,11,59
Texas,North San Pedro,589,211,199,46,0,33,489
Texas,Northridge,0,0,0,0,0,0,0
Texas,North Richland Hills,66950,14410,29175,6366,527,3029,53507
Texas,Staples,289,113,104,39,0,8,264
Texas,Canyon Lake,22759,4416,11280,2261,368,1143,19468
Texas,Star Harbor,436,76,282,21,0,19,398
Texas,Sterling City,1026,150,344,142,22,54,712
Texas,Tahoka,2605,511,1033,208,19,178,1949
Texas,Taft Southwest,1301,236,468,151,38,64,957
Texas,Taft,3063,860,1112,242,71,218,2503
Texas,Sweetwater,10794,2255,3925,1078,289,817,8364
Texas,Sweeny,3738,812,1234,311,59,325,2741
Texas,Surfside Beach,588,119,247,102,15,34,517
Texas,Sun Valley,153,28,86,8,4,2,128
Texas,Sunset Valley,821,115,416,58,1,19,609
Texas,Sunset Acres,0,0,0,0,0,0,0
Texas,Sunset CDP (Starr County),30,3,6,0,18,0,27
Texas,Sunset CDP (Montague County),255,23,106,43,0,37,209
Texas,Sunrise Beach Village,747,106,431,67,3,71,678
Texas,Sunray,2071,275,1021,116,45,92,1549
Texas,Sunnyvale,5677,1216,2974,311,4,106,4611
Texas,Sundown,1312,263,536,53,27,53,932
Texas,Sulphur Springs,15780,3135,6265,1608,224,1138,12370
Texas,Sullivan City,4125,846,1612,166,143,144,2911
Texas,Sugar Land,84268,16743,43631,4190,794,2958,68316
Texas,Sudan,978,203,365,83,26,49,726
Texas,Study Butte,252,42,78,36,0,25,181
Texas,Streetman,255,32,127,28,2,4,193
Texas,Strawn,533,104,180,94,10,80,468
Texas,Stratford,2145,340,922,149,71,83,1565
Texas,Stowell,1504,281,787,48,23,0,1139
Texas,Stonewall,445,74,181,63,0,50,368
Texas,Stockdale,1530,322,437,176,12,135,1082
Texas,Stinnett,1498,284,663,124,42,76,1189
Texas,Stephenville,19074,8007,5621,1365,257,870,16120
Texas,North Pearsall,963,214,363,114,17,0,708
Texas,Cape Royale,575,10,453,79,0,33,575
Texas,Carlsbad,655,215,145,33,14,46,453
Texas,Emory,1017,217,297,204,36,108,862
Texas,Emhouse,108,17,45,27,0,9,98
Texas,Emerald Bay,1006,158,721,17,0,73,969
Texas,El Socio,137,26,46,18,0,0,90
Texas,Elsa,6444,1251,1841,469,336,494,4391
Texas,El Refugio,377,109,93,40,19,14,275
Texas,El Rancho Vela,224,12,63,21,4,53,153
Texas,El Quiote,208,12,82,8,37,0,139
Texas,El Paso,676325,167990,243732,60114,18328,30053,520217
Texas,E. Lopez,75,11,56,0,0,0,67
Texas,Elmo,792,45,483,0,0,13,541
Texas,El Mesquite,0,0,0,0,0,0,0
Texas,Encantada-Ranchito-El Calaboz,1756,430,797,114,41,38,1420
Texas,Elmendorf,1234,340,494,140,32,59,1065
Texas,El Lago,2754,471,1241,380,25,95,2212
Texas,Robstown,11616,3011,3489,865,320,807,8492
Texas,Robinson,11214,2206,5458,872,120,386,9042
Texas,Robert Lee,1071,69,608,75,25,51,828
Texas,Roaring Springs,311,88,105,41,17,21,272
Texas,Roanoke,6770,1345,2762,718,342,204,5371
Texas,Riviera,760,212,274,56,46,10,598
Texas,Riverside,600,96,234,49,7,101,487
Texas,River Oaks,7641,1717,2837,600,162,316,5632
Texas,Rivereno,0,0,0,0,0,0,0
Texas,Rising Star,1047,268,294,119,41,70,792
Texas,Rio Vista,1174,176,503,64,16,44,803
Texas,Elm Creek,2840,732,1220,89,0,65,2106
Texas,Enchanted Oaks,370,49,217,32,3,56,357
Texas,Encinal,904,253,246,148,14,30,691
Texas,Encino,53,15,0,4,0,28,47
Texas,Falman,125,24,40,27,0,20,111
Texas,Falls City,581,102,264,41,9,53,469
Texas,Falfurrias,4512,1613,1182,314,127,324,3560
Texas,Falcon Village,45,14,0,10,0,21,45
Texas,Falcon Mesa,663,320,258,8,0,12,598
Texas,Falcon Lake Estates,1620,375,638,10,32,17,1072
Texas,Falcon Heights,30,0,30,0,0,0,30
Texas,Falconaire,115,17,45,0,19,0,81
Texas,Fairview,8109,1498,4891,210,21,335,6955
Texas,Fair Oaks Ranch,7315,1077,4227,312,29,258,5903
Texas,Fairfield,2897,575,1136,346,34,213,2304
Texas,Fairchilds village,817,117,368,81,17,20,603
Texas,Fabrica,851,304,233,91,0,24,652
Texas,Fabens,7846,2085,2629,434,201,291,5640
Texas,Everman,6279,1749,2083,568,218,320,4938
Texas,Evergreen,10,10,0,0,0,0,10
Texas,Evant,423,75,175,57,2,25,334
Texas,Evadale,1553,225,800,119,46,63,1253
Texas,Eustace,1089,302,385,126,25,43,881
Texas,Alvin,25224,6228,9614,2516,419,988,19765
Texas,Eureka,359,45,154,64,6,19,288
Texas,Euless,53220,13518,19124,6513,1332,1801,42288
Texas,Eugenio Saenz,39,16,15,0,0,0,31
Texas,Hubbard,1640,336,578,197,64,81,1256
Texas,Estelline,76,6,34,19,0,7,66
Texas,Escobares,1690,455,573,189,54,54,1325
Texas,Ennis,18758,4046,7043,1513,405,991,13998
Texas,Rio Hondo,2005,470,828,184,48,108,1638
Texas,Rio Grande City,14154,3212,4378,1189,785,625,10189
Texas,Rio Bravo,4860,1096,1613,258,248,138,3353
Texas,Riesel,1028,216,384,100,20,59,779
Texas,Rangerville village,52,8,33,11,0,0,52
Texas,Ranger,3238,770,681,387,195,266,2299
Texas,Randolph AFB,1120,169,467,24,11,6,677
Texas,Rancho Viejo,231,31,54,88,0,13,186
Texas,Rancho Viejo,2277,389,1043,240,37,110,1819
Texas,Ranchos Penitas West,819,286,270,19,17,0,592
Texas,Rancho Chico,572,204,123,141,10,0,478
Texas,Rancho Banquete,602,158,230,15,37,0,440
Texas,Rancho Alegre,1612,525,603,97,34,98,1357
Texas,Ranchitos Las Lomas,127,18,35,8,9,0,70
Texas,Ranchitos East,353,106,137,11,22,0,276
Texas,Ranchitos del Norte,0,0,0,0,0,0,0
Texas,Ranchette Estates,80,32,30,0,0,0,62
Texas,Ramos,235,58,97,7,0,0,162
Texas,Ramirez-Perez,41,19,0,22,0,0,41
Texas,Ramireno,76,46,30,0,0,0,76
Texas,Ralls,1946,411,740,156,40,122,1469
Texas,Rafael Pena,0,0,0,0,0,0,0
Texas,Radar Base,610,310,188,44,52,12,606
Texas,Quitman,2019,362,769,328,61,176,1696
Texas,Quitaque,478,136,198,42,0,16,392
Texas,Quintana,44,7,11,19,1,0,38
Texas,Carrollton,127279,30289,54545,10785,2244,4060,101923
Texas,Carrizo Springs,5740,1539,1417,848,245,336,4385
Texas,Carrizo Hill,1046,206,414,50,0,15,685
Texas,Carmine,211,38,106,24,0,23,191
Texas,Carl's Corner,155,14,107,2,4,2,129
Texas,Rankin,811,118,444,49,24,38,673
Texas,Carbon,396,85,110,30,16,34,275
Texas,Ransom Canyon,1319,111,793,73,9,44,1030
Texas,Ravenna,184,32,91,22,3,23,171
Texas,Richwood,3686,619,1448,441,82,97,2687
Texas,Richmond,11895,3309,3925,867,447,703,9251
Texas,Richland Springs,295,33,145,13,0,28,219
Texas,Richland Hills,7992,2119,3022,867,123,602,6733
Texas,Richland,222,22,124,23,5,10,184
Texas,Richardson,106123,25951,46783,7987,1547,4354,86622
Texas,Rice,989,216,398,59,29,28,730
Texas,Ricardo,693,169,248,165,8,21,611
Texas,Rhome,1572,261,664,191,37,68,1221
Texas,Retreat,389,52,187,21,9,32,301
Texas,Reno city (Parker and Tarrant Counties),2597,512,1070,250,22,153,2007
Texas,Reno city (Lamar County),3245,458,1662,213,49,142,2524
Texas,Rendon,14114,2677,6744,984,213,371,10989
Texas,Relampago,44,14,0,0,0,30,44
Texas,Reklaw,397,74,174,25,0,33,306
Texas,Reid Hope King,889,79,402,0,0,11,492
Texas,Regino Ramirez,102,0,24,0,12,0,36
Texas,Refugio,2846,748,924,269,115,274,2330
Texas,Redwood,4044,1389,1241,375,129,116,3250
Texas,Redwater,1124,211,384,172,31,62,860
Texas,Red Oak,11360,2466,4699,1070,274,326,8835
Texas,Red Lick,1044,117,561,74,7,45,804
Texas,Redland,1594,305,487,112,53,66,1023
Texas,Redford,89,8,21,0,12,6,47
Texas,Redfield,516,113,83,76,0,35,307
Texas,Realitos,413,37,156,26,0,38,257
Texas,Raymondville,11191,3591,3749,974,495,533,9342
Texas,Ratamosa,257,0,0,0,60,0,60
Texas,Fannett,1742,252,959,125,0,74,1410
Texas,Northlake,2655,663,993,350,29,34,2069
Texas,North Cleveland,168,24,85,12,11,9,141
Texas,Devers,416,97,173,20,5,23,318
Texas,Devine,4529,985,1942,368,102,195,3592
Texas,Deweyville,1075,188,538,71,105,23,925
Texas,D'Hanis,899,257,441,3,15,71,787
Texas,Diboll,5370,1250,1652,661,221,312,4096
Texas,Dickens,192,22,113,11,12,26,184
Texas,Dickinson,19355,4455,8159,1537,237,725,15113
Texas,Dilley,4090,1636,1006,307,182,90,3221
Texas,Dimmitt,4354,798,1725,389,67,137,3116
Texas,DISH,259,33,127,37,3,13,213
Texas,Dodd City,375,38,164,45,1,8,256
Texas,Dodson,94,12,48,8,2,4,74
Texas,Detroit,767,193,261,111,15,38,618
Texas,Doffing,5629,1305,2009,416,98,79,3907
Texas,Donna,16292,3548,5641,930,479,859,11457
Texas,Doolittle,3746,783,1192,121,145,137,2378
Texas,Dorchester,101,10,57,4,0,5,76
Texas,Double Oak,3013,588,1662,100,11,81,2442
Texas,Douglassville,150,22,70,23,2,10,127
Texas,Doyle,507,241,226,40,0,0,507
Texas,Driftwood,107,0,37,50,11,9,107
Texas,Dripping Springs,2415,482,951,245,14,210,1902
Texas,Driscoll,697,144,260,59,3,48,514
Texas,Dublin,3671,844,1089,454,49,187,2623
Texas,Dumas,14997,2754,6461,846,268,475,10804
Texas,Duncanville,39567,9509,14406,3896,897,1804,30512
Texas,Domino,102,33,23,12,2,7,77
Texas,DeSoto,51478,12951,19553,5494,1048,2321,41367
Texas,Deport,495,85,195,89,9,31,409
Texas,Denver City,4673,837,1932,256,46,274,3345
Texas,Murillo,7374,1933,2599,396,175,284,5387
Texas,Alice Acres,340,59,162,0,0,0,221
Texas,Alice,19425,4253,7240,1640,369,1144,14646
Texas,Alfred,108,57,51,0,0,0,108
Texas,Aledo,2999,569,1340,166,30,57,2162
Texas,Aldine,15310,4505,5021,820,327,389,11062
Texas,Albany,2203,327,1071,189,15,132,1734
Texas,Alba,861,146,238,90,8,72,554
Texas,Alamo Heights,7593,1133,3561,641,126,313,5774
Texas,Alamo,18943,3652,7650,1108,498,1140,14048
Texas,Airport Road Addition,111,14,11,36,0,15,76
Texas,Airport Heights,102,29,9,0,0,25,63
Texas,Aguilares,44,19,11,8,0,0,38
Texas,Agua Dulce,832,181,348,49,19,47,644
Texas,Agua Dulce,2926,923,868,109,4,113,2017
Texas,Adrian,183,22,73,16,0,33,144
Texas,Addison,15087,5549,5253,1731,407,337,13277
Texas,Ackerly,183,14,79,0,7,11,111
Texas,Abram,1910,384,796,133,19,132,1464
Texas,Abilene,122226,34903,42844,11775,2858,5965,98345
Texas,Abernathy,3290,561,1551,168,54,249,2583
Texas,Abbott,390,66,181,24,6,19,296
Texas,Delmita,108,32,41,2,8,5,88
Texas,Del Rio,36119,7772,13559,2435,1074,2104,26944
Texas,Del Sol,309,68,146,0,0,0,214
Texas,Denison,22846,4697,8248,2927,532,1741,18145
Texas,Denton,125734,49353,38885,10672,1633,4373,104916
Texas,Eagle Lake,3612,1018,1249,208,133,136,2744
Texas,Eagle Pass,27956,5999,10897,1512,782,1490,20680
Texas,Early,2804,456,1172,256,88,216,2188
Texas,Earth,832,130,418,72,17,34,671
Texas,Elkhart,1386,241,461,235,16,128,1081
Texas,Smithville,3967,890,1379,383,89,351,3092
Texas,Smyer,634,141,284,31,12,11,479
Texas,Snook,482,121,151,28,50,49,399
Texas,Snyder,11484,2473,4568,784,292,579,8696
Texas,Socorro,32877,8739,11098,2113,1294,1355,24599
Texas,Solis,396,68,158,11,16,25,278
Texas,Somerset,1474,368,506,165,49,76,1164
Texas,Somerville,1629,400,528,192,22,120,1262
Texas,Sonora,3024,510,1442,215,10,114,2291
Texas,Sour Lake,1751,279,786,202,25,120,1412
Texas,South Alamo,3868,1070,1054,75,108,39,2346
Texas,South Fork Estates,136,0,93,0,0,0,93
Texas,South Houston,17430,4447,6411,777,368,450,12453
Texas,Southlake,28361,3967,15308,1314,87,593,21269
Texas,South La Paloma,326,71,119,44,0,0,234
Texas,Southmayd,1019,187,446,82,28,43,786
Texas,South Mountain,403,73,219,44,2,14,352
Texas,South Padre Island,2888,511,1428,458,41,195,2633
Texas,South Point,1363,473,411,93,33,81,1091
Texas,Southside Place,1762,331,879,89,6,47,1352
Texas,South Toledo Bend,388,21,275,35,0,12,343
Texas,Spade,101,29,43,0,7,0,79
Texas,Sparks,3980,736,1313,72,378,171,2670
Texas,Spearman,3387,590,1600,261,29,178,2658
Texas,Splendora,1635,274,701,200,20,73,1268
Texas,Spofford,95,33,35,6,0,0,74
Texas,El Indio,209,0,146,0,0,36,182
Texas,Murchison,518,76,238,81,11,19,425
Texas,Elias-Fela Solis,29,0,29,0,0,0,29
Texas,Electra,2737,546,1223,296,71,281,2417
Texas,East Alto Bonito,978,137,497,12,28,20,694
Texas,East Bernard,2779,619,1113,234,80,164,2210
Texas,Eastland,3881,1004,1481,488,86,330,3389
Texas,East Mountain,985,147,397,151,37,79,811
Texas,Easton,501,154,152,69,18,35,428
Texas,East Tawakoni,868,161,387,128,8,62,746
Texas,Ector,778,145,312,87,13,27,584
Texas,Edcouch,3244,954,1092,66,178,190,2480
Texas,Eden,2485,829,1040,328,52,72,2321
Texas,Edgecliff Village,2934,560,1286,295,16,204,2361
Texas,Edgewater Estates,85,18,33,0,0,18,69
Texas,Edgewood,1392,278,527,164,49,121,1139
Texas,Edinburg,80924,22486,28294,4999,1440,2638,59857
Texas,Edmonson,109,28,25,17,1,7,78
Texas,Edna,5661,1340,2041,439,150,340,4310
Texas,Edom,347,91,162,26,0,7,286
Texas,Edroy,307,136,96,0,13,0,245
Texas,Eidson Road,9983,2674,3701,419,260,233,7287
Texas,Elbert,52,7,13,10,0,0,30
Texas,El Brazil,36,0,36,0,0,0,36
Texas,El Camino Angosto,272,146,60,10,0,0,216
Texas,El Campo,11545,2679,4144,717,236,708,8484
Texas,El Castillo,368,28,214,0,0,0,242
Texas,El Cenizo,567,131,165,66,0,23,385
Texas,El Cenizo,3307,912,828,159,159,106,2164
Texas,El Chaparral,212,57,97,0,0,8,162
Texas,Eldorado,1897,329,879,73,64,94,1439
Texas,Elgin,8249,1726,3069,724,210,418,6147
Texas,North Escobares,245,20,42,0,37,48,147
Texas,Muniz,1645,540,589,71,13,94,1307
Texas,Mullin,136,43,37,27,0,11,118
Texas,Nesbitt,174,20,82,43,14,15,174
Texas,Needville,3025,608,1091,446,56,233,2434
Texas,Nederland,17063,3599,7365,2012,190,971,14137
Texas,Nazareth,281,55,122,29,0,7,213
Texas,Navasota,7281,1934,2427,511,225,522,5619
Texas,Navarro,267,71,114,23,0,15,223
Texas,Natalia,1398,337,404,137,80,116,1074
Texas,Nassau Bay,4085,1031,1285,784,124,186,3410
Texas,Nash,3083,575,1050,318,64,232,2239
Texas,Narciso Pena,0,0,0,0,0,0,0
Texas,Naples,1443,250,494,289,49,91,1173
Texas,Nacogdoches,33774,14184,8817,2440,573,1544,27558
Texas,Netos,17,0,0,0,0,17,17
Texas,Myrtle Springs,473,138,223,0,39,29,429
Texas,Mustang,15,0,5,1,0,0,6
Texas,Murphy,19691,3551,9680,684,281,251,14447
Texas,Alvarado,3868,916,1419,446,103,247,3131
Texas,Alton,15092,4077,5425,560,318,301,10681
Texas,Alto Bonito Heights,116,48,25,0,0,31,104
Texas,Alto,1279,365,438,97,59,59,1018
Texas,Alpine,6000,1634,1987,963,53,253,4890
Texas,Alma,448,129,230,13,3,27,402
Texas,Allen,92502,17491,42693,6476,641,1718,69019
Texas,Melvin,181,26,92,16,10,2,146
Texas,Memphis,2217,479,826,288,13,156,1762
Texas,Menard,1628,270,708,168,22,75,1243
Texas,Mustang Ridge,1232,413,426,79,14,7,939
Texas,Nevada,1043,231,504,57,11,22,825
Texas,Newark,1108,229,545,91,13,14,892
Texas,New Berlin,538,53,348,21,0,33,455
Texas,North Alamo,4095,670,1622,159,132,55,2638
Texas,Normanna,101,23,38,5,17,13,96
Texas,Normangee,576,138,147,92,14,55,446
Texas,Nordheim,250,45,124,13,4,23,209
Texas,Noonday,719,66,390,83,22,37,598
Texas,Nome,448,79,211,29,13,50,382
Texas,Nolanville,4533,1060,1062,641,56,176,2995
Texas,Nocona Hills,738,55,445,116,15,50,681
Texas,Nocona,2984,508,1084,397,91,271,2351
Texas,Nixon,2529,533,847,205,35,134,1754
Texas,Nina,274,122,76,0,0,0,198
Texas,Niederwald,607,124,264,62,21,9,480
Texas,Neylandville,111,27,41,13,0,6,87
Texas,New Waverly,1335,345,439,123,51,70,1028
Texas,Newton,2227,616,604,301,121,127,1769
Texas,New Territory,15494,3149,8335,485,77,295,12341
Texas,New Summerfield,1351,388,500,87,32,25,1032
Texas,New London,1182,218,451,147,13,75,904
Texas,New Hope,775,145,383,96,0,28,652
Texas,New Home,386,119,145,21,5,25,315
Texas,New Falcon,223,30,18,49,0,28,125
Texas,New Fairview,1010,169,443,144,8,35,799
Texas,New Deal,875,148,312,112,6,45,623
Texas,New Chapel Hill,657,97,337,66,11,18,529
Texas,Newcastle,485,90,219,45,0,50,404
Texas,New Braunfels,64076,13264,26587,5426,883,2950,49110
Texas,New Boston,4730,1343,1447,603,142,316,3851
Texas,Mentone,37,2,22,13,0,0,37
Texas,Mercedes,16425,3985,5129,888,727,792,11521
Texas,Meridian,1714,330,540,212,54,129,1265
Texas,Merkel,2617,515,1100,322,66,177,2180
Texas,Mobile City,291,91,88,34,21,2,236
Texas,Monahans,7349,1508,2628,884,99,500,5619
Texas,Montague,308,68,130,42,17,19,276
Texas,Mont Belvieu,4585,804,2344,126,39,91,3404
Texas,Monte Alto,1836,591,584,89,80,49,1393
Texas,Montgomery,750,149,270,60,21,45,545
Texas,Moody,1628,348,621,230,16,120,1335
Texas,Moore,404,84,212,55,0,17,368
Texas,Moore Station,251,65,106,17,14,14,216
Texas,Moraida,194,97,0,0,0,38,135
Texas,Morales-Sanchez,46,0,17,0,13,16,46
Texas,Moran,347,79,137,41,14,26,297
Texas,Morgan,615,118,230,52,13,21,434
Texas,Morgan Farm,348,65,139,89,0,8,301
Texas,Morgan's Point,322,85,105,37,8,21,256
Texas,Morgan's Point Resort,4223,737,2079,220,13,199,3248
Texas,Morning Glory,423,112,82,44,41,0,279
Texas,Morse,206,34,114,10,1,3,162
Texas,Morton,1841,425,693,92,43,149,1402
Texas,Moulton,930,154,396,69,0,119,738
Texas,Mountain City,771,158,402,25,6,14,605
Texas,Mount Calm,265,43,105,53,12,10,223
Texas,Mount Enterprise,436,46,201,40,31,26,344
Texas,Mount Pleasant,16007,3836,5598,1120,384,810,11748
Texas,Mount Vernon,2752,505,1084,254,38,197,2078
Texas,Muenster,1584,342,669,94,6,121,1232
Texas,Muleshoe,5300,851,2257,275,167,261,3811
Texas,Mobeetie,156,22,67,26,0,8,123
Texas,Munday,1388,287,488,129,24,134,1062
Texas,Missouri City,70538,17525,30650,4980,1240,2628,57023
Texas,Mission,81573,17288,32898,3668,2101,2728,58683
Texas,Mertens,140,16,74,14,0,4,108
Texas,Mertzon,811,118,389,57,12,57,633
Texas,Mesquite,143584,36129,50694,12842,3125,5490,108280
Texas,Mesquite,650,185,226,37,26,71,545
Texas,Mexia,7453,2325,2304,682,180,395,5886
Texas,Miami,613,107,279,42,10,31,469
Texas,Midland,123820,28756,49159,10551,1802,4938,95206
Texas,Midlothian,20679,3179,9691,1475,438,734,15517
Texas,Midway,343,44,134,43,4,17,242
Texas,Midway North,5050,1337,1852,134,198,36,3557
Texas,Midway South,2732,735,707,113,178,81,1814
Texas,Miguel Barrera,260,25,41,0,0,71,137
Texas,Mikes,879,72,225,0,166,12,475
Texas,Mila Doce,6225,1351,1770,153,342,329,3945
Texas,Milam,1374,140,652,248,30,69,1139
Texas,Milano,447,103,156,52,5,20,336
Texas,Mildred,511,95,253,50,14,37,449
Texas,Miles,1086,316,483,54,0,46,899
Texas,Milford,673,171,249,82,21,32,555
Texas,Miller's Cove,190,11,84,2,5,0,102
Texas,Millican,265,54,136,16,6,15,227
Texas,Millsap,454,136,185,28,13,11,373
Texas,Mineola,4540,927,1452,656,59,368,3462
Texas,Mineral Wells,16159,4135,5149,1847,737,921,12789
Texas,Mingus,304,76,84,60,14,32,266
Texas,Mi Ranchito Estate,106,0,106,0,0,0,106
Texas,Mirando City,382,108,107,6,0,10,231
Texas,Mission Bend,36723,10038,14185,2310,747,1384,28664
Texas,Bishop,3169,869,1250,186,68,209,2582
Texas,Farmers Branch,31052,7795,12438,2681,697,1278,24889
Texas,Farwell,1748,276,803,137,23,89,1328
Texas,Wellman,301,99,110,42,2,4,257
Texas,Wellington,2306,424,983,90,52,193,1742
Texas,Welch,214,59,88,11,0,13,171
Texas,Weir,472,83,223,38,1,13,358
Texas,Weinert,216,56,95,25,4,17,197
Texas,Weimar,2282,536,845,146,17,244,1788
Texas,Webster,10993,3973,2884,1245,394,578,9074
Texas,Webberville village,661,168,256,57,8,21,510
Texas,Weatherford,27234,5364,10882,3104,485,1512,21347
Texas,Waxahachie,31756,7423,12052,2663,592,1407,24137
Texas,Watauga,24179,5183,9349,3020,264,826,18642
Texas,Waskom,1992,524,889,188,50,89,1740
Texas,Wells,881,179,259,107,54,52,651
Texas,Warren City,356,70,155,27,12,21,285
Texas,Walnut Springs,823,209,271,53,25,38,596
Texas,Wallis,1173,232,483,162,34,80,991
Texas,Waller,2237,403,955,183,50,88,1679
Texas,Wake Village,5479,1345,1770,678,54,240,4087
Texas,Waelder,1175,289,457,72,59,68,945
Texas,Waco,129193,42106,38721,11909,2957,6300,101993
Texas,Von Ormy,1169,284,385,110,15,65,859
Texas,Volente village,677,91,325,90,0,11,517
Texas,Vinton village,1460,412,407,123,44,48,1034
Texas,Villa Verde,561,113,222,24,83,41,483
Texas,Villarreal,440,99,189,23,0,0,311
Texas,Villa Pancho,698,148,205,53,15,90,511
Texas,Warren,640,83,330,40,20,63,536
Texas,Wells Branch,12014,3845,4106,1450,263,394,10058
Texas,Weslaco,38666,7828,12940,3345,1469,2242,27824
Texas,West,2802,673,985,320,53,303,2334
Texas,Plainview,21666,4958,8011,1836,524,945,16274
Texas,Plano,275645,59319,126927,22316,2767,9007,220336
Texas,Pleak village,1498,247,590,94,4,112,1047
Texas,Pleasant Hill,528,178,216,45,0,10,449
Texas,Pleasanton,9473,1882,3724,695,302,746,7349
Texas,Pleasant Valley,369,58,197,42,7,23,327
Texas,Plum Grove,471,78,229,50,3,18,378
Texas,Point,769,143,257,129,48,14,591
Texas,Point Blank,869,152,308,104,0,104,668
Texas,Point Comfort,689,137,264,54,16,66,537
Texas,Point Venture village,809,108,440,119,12,30,709
Texas,Ponder,1534,247,640,171,32,51,1141
Texas,Port Aransas,3772,549,1733,630,137,261,3310
Texas,Westover Hills,636,80,386,35,5,20,526
Texas,West Orange,3452,778,1168,594,82,215,2837
Texas,Weston Lakes,2548,230,1819,79,0,70,2198
Texas,Weston,321,78,142,27,11,8,266
Texas,West Odessa,23742,4990,8988,2019,240,1087,17324
Texas,Westminster,719,96,287,178,0,31,592
Texas,West Livingston,8168,2789,2828,1022,381,267,7287
Texas,West Lake Hills,3262,423,1774,252,17,171,2637
Texas,Westlake,1091,134,571,88,0,26,819
Texas,Western Lake,1230,240,511,144,14,22,931
Texas,Westdale,409,13,125,89,33,68,328
Texas,West Columbia,3919,898,1558,387,81,216,3140
Texas,Westbrook,212,31,111,6,0,11,159
Texas,West Alto Bonito,1108,278,399,12,54,0,743
Texas,Villa del Sol,106,15,28,46,0,0,89
Texas,Vidor,10887,1713,4693,1420,163,611,8600
Texas,Victoria Vera,108,45,17,0,0,23,85
Texas,Victoria,65303,15129,23536,7797,1277,2972,50711
Texas,Gordon,450,87,193,42,7,44,373
Texas,Goodrich,260,61,127,11,9,7,215
Texas,Goodlow,209,63,67,40,1,14,185
Texas,Gonzales,7370,1594,2494,588,257,508,5441
Texas,Golinda,500,96,149,71,33,30,379
Texas,Goliad,2111,483,814,184,12,136,1629
Texas,Goldthwaite,2142,251,994,151,7,204,1607
Texas,Goldsmith,208,43,105,25,0,10,183
Texas,Godley,1237,184,506,115,17,52,874
Texas,Glidden,443,52,194,5,0,14,265
Texas,Glen Rose,2523,383,1134,227,35,286,2065
Texas,Glenn Heights,11795,2946,4425,969,309,189,8838
Texas,Gladewater,6451,1481,2395,670,116,515,5177
Texas,Girard,31,0,19,0,0,6,25
Texas,Gilmer,5088,1252,1851,446,127,392,4068
Texas,Giddings,4957,1427,1720,391,40,265,3843
Texas,Gholson,851,119,428,126,11,58,742
Texas,Geronimo,1432,453,544,145,0,33,1175
Texas,George West,2538,599,862,164,54,217,1896
Texas,Georgetown,56102,9312,28001,5304,539,3269,46425
Texas,Gatesville,15826,5197,4525,2762,888,603,13975
Texas,Garza-Salinas II,753,172,260,31,0,47,510
Texas,Gary City,305,55,112,45,0,20,232
Texas,Garrison,897,160,297,88,18,112,675
Texas,Garrett,845,160,307,50,12,36,565
Texas,Garland,234213,57208,89249,19317,4454,8386,178614
Texas,Port Arthur,54864,14633,17830,5046,1398,3115,42022
Texas,Goree,258,51,103,22,6,20,202
Texas,Plains,1629,311,673,43,41,100,1168
Texas,Gorman,901,73,275,198,4,104,654
Texas,Graham,8837,1813,3533,742,94,638,6820
Texas,Vernon,10887,2548,3869,1302,221,669,8609
Texas,Venus,3126,870,1083,469,87,108,2617
Texas,Vega,797,110,444,58,5,31,648
Texas,Van Vleck,2039,463,871,129,35,134,1632
Texas,Van Horn,2175,606,861,166,35,111,1779
Texas,Vanderbilt,480,90,265,18,0,0,373
Texas,Van Alstyne,3165,495,1409,271,7,208,2390
Texas,Van,2654,422,1062,204,64,240,1992
Texas,Val Verde Park,2736,569,1143,163,18,201,2094
Texas,Valley View,978,219,357,113,2,49,740
Texas,Valley Mills,1466,383,588,104,20,61,1156
Texas,Valle Vista,354,36,113,0,22,0,171
Texas,Valle Verde,0,0,0,0,0,0,0
Texas,Valle Hermoso,0,0,0,0,0,0,0
Texas,Valentine,100,22,38,13,0,8,81
Texas,Uvalde Estates,2150,463,945,335,0,58,1801
Texas,Uvalde,16220,4295,5119,948,473,1085,11920
Texas,Utopia,227,62,72,30,0,4,168
Texas,University Park,24101,6488,10222,1078,94,402,18284
Texas,Universal City,19466,4736,7532,1986,583,659,15496
Texas,Union Valley,343,29,216,11,8,18,282
Texas,Granger,1583,423,619,140,33,86,1301
Texas,Grandview,1444,206,487,205,37,136,1071
Texas,Grand Saline,3108,571,1104,273,146,206,2300
Texas,Grand Prairie,183500,47667,69840,13712,3499,4696,139414
Texas,Grandfalls,331,43,120,24,18,23,228
Texas,Granbury,8750,1704,3238,1202,155,1031,7330
Texas,Graford,711,151,286,62,9,17,525
Texas,Porter Heights,1619,131,938,147,0,58,1274
Texas,Placedo,851,171,363,43,25,5,607
Texas,Piney Point Village,3270,562,2041,69,5,121,2798
Texas,Brazoria,3049,647,1188,344,44,119,2342
Texas,Brazos Bend,335,14,259,12,0,6,291
Texas,Brazos Country,771,117,493,15,2,22,649
Texas,Breckenridge,5596,893,2291,487,159,403,4233
Texas,Bremond,956,266,338,133,7,75,819
Texas,La Vernia,1387,311,576,172,3,44,1106
Texas,La Victoria,91,39,34,18,0,0,91
Texas,La Villa,2509,653,712,134,71,140,1710
Texas,Lavon,2507,345,1206,134,3,49,1737
Texas,La Ward,190,60,74,9,0,15,158
Texas,Lawn,326,55,136,49,3,15,258
Texas,League City,91665,18040,41543,8063,757,2314,70717
Texas,Brady,5509,980,2239,767,20,261,4267
Texas,Leakey,637,117,258,67,2,38,482
Texas,Leary,690,127,311,85,10,27,560
Texas,Lefors,374,52,162,82,2,2,300
Texas,Leming,680,89,274,98,30,15,506
Texas,Leona,167,45,60,14,9,10,138
Texas,Leonard,2171,418,755,217,46,163,1599
Texas,Leon Valley,10846,2638,4274,1198,138,614,8862
Texas,Leroy,381,46,208,22,1,15,292
Texas,Levelland,13823,3334,5279,980,226,857,10676
Texas,Lewisville,101151,25814,37278,10081,1999,2992,78164
Texas,Lexington,1301,246,477,169,20,83,995
Texas,Liberty,8817,1988,3727,684,201,403,7003
Texas,Liberty City,2177,350,938,278,53,116,1735
Texas,Leander,32051,5920,13748,2202,451,665,22986
Texas,Brackettville,2060,431,833,232,29,118,1643
Texas,Boys Ranch,374,199,53,0,0,7,259
Texas,Boyd,1295,208,611,169,24,58,1070
Texas,Bixby,624,179,261,17,0,36,493
Texas,Blackwell,383,90,147,48,7,20,312
Texas,Blanco,2309,422,882,204,61,202,1771
Texas,Blanket,384,62,132,66,12,17,289
Texas,Blessing,994,241,350,23,0,21,635
Texas,Bloomburg,390,71,141,54,7,35,308
Texas,Blooming Grove,963,181,395,96,10,48,730
Texas,Bloomington,1984,310,923,88,48,170,1539
Texas,Blossom,1253,224,514,208,17,94,1057
Texas,Blue Berry Hill,581,108,279,82,6,23,498
Texas,Blue Mound,3348,965,1141,204,111,130,2551
Texas,Blue Ridge,1138,192,443,118,16,44,813
Texas,Bluetown,287,44,76,20,25,14,179
Texas,Blum,462,77,191,48,4,22,342
Texas,Boerne,12272,2496,4951,1037,231,771,9486
Texas,Bogata,1191,128,495,203,16,144,986
Texas,Boling,959,265,393,60,0,104,822
Texas,Bolivar Peninsula,2196,327,1119,251,25,91,1813
Texas,Bonanza Hills,121,15,31,22,0,0,68
Texas,Bonham,10044,2465,3245,1641,371,669,8391
Texas,Bonney village,303,66,94,28,23,0,211
Texas,Booker,1483,404,622,87,26,44,1183
Texas,Borger,13041,2917,4700,1596,194,653,10060
Texas,Botines,15,0,0,8,0,7,15
Texas,Bovina,1825,519,579,110,66,64,1338
Texas,Bowie,5172,852,2099,580,66,482,4079
Texas,Box Canyon,25,0,20,5,0,0,25
Texas,Liberty Hill,1242,185,513,85,51,61,895
Texas,Lincoln Park,278,62,109,45,7,16,239
Texas,Lindale,5332,998,2134,610,85,402,4229
Texas,Linden,2256,447,661,414,55,238,1815
Texas,Lorena,1896,393,738,152,24,82,1389
Texas,Lorenzo,1160,245,477,52,33,63,870
Texas,Los Altos,109,21,0,0,10,0,31
Texas,Los Alvarez,374,116,203,0,0,0,319
Texas,Los Angeles,157,0,55,0,0,0,55
Texas,Los Arcos,60,10,16,8,0,0,34
Texas,Los Arrieros,40,0,36,0,0,2,38
Texas,Los Barreras,184,48,38,68,0,0,154
Texas,Los Centenarios,0,0,0,0,0,0,0
Texas,Los Corralitos,64,0,64,0,0,0,64
Texas,Los Ebanos CDP (Hidalgo County),197,0,52,52,16,62,182
Texas,Los Ebanos CDP (Starr County),356,134,138,19,0,0,291
Texas,Brenham,16257,5151,5023,1462,357,1373,13366
Texas,Briar,4221,802,2080,590,121,298,3891
Texas,Petrolia,686,105,318,76,11,55,565
Texas,Petronila,172,28,48,13,13,9,111
Texas,Pettus,557,134,207,28,4,21,394
Texas,Pflugerville,53847,11122,23378,4701,927,1298,41426
Texas,Pharr,74273,16937,26633,3307,2491,2656,52024
Texas,Pilot Point,4011,854,1832,266,40,268,3260
Texas,Pine Forest,605,77,308,41,0,27,453
Texas,Pine Harbor,690,113,330,122,37,32,634
Texas,Pinehurst,5011,954,2109,342,130,150,3685
Texas,Pinehurst,1933,500,734,267,3,187,1691
Texas,Pine Island,1416,236,695,74,30,38,1073
Texas,Pineland,942,233,251,64,10,64,622
Texas,Pinewood Estates,1787,343,972,44,0,44,1403
Texas,Loraine,561,85,180,108,13,57,443
Texas,Pittsburg,4545,1044,1579,321,69,309,3322
Texas,Lopezville,4217,752,1824,83,55,229,2943
Texas,Loop,332,38,168,13,4,9,232
Texas,Lindsay,1103,143,540,76,0,61,820
Texas,Lindsay,351,6,200,18,0,0,224
Texas,Linn,562,80,238,35,19,32,404
Texas,Lipan,509,80,194,42,12,31,359
Texas,Lipscomb,29,4,19,2,4,0,29
Texas,Little Elm,32581,6380,13588,2037,322,513,22840
Texas,Littlefield,6263,1090,2387,700,93,330,4600
Texas,Little River-Academy,1919,361,853,195,16,89,1514
Texas,Live Oak,14649,3993,5867,1653,261,429,12203
Texas,Liverpool,375,68,155,59,5,27,314
Texas,Livingston,5219,1154,1754,801,189,352,4250
Texas,Llano,3313,546,1245,493,26,452,2762
Texas,Llano Grande,3019,887,1168,56,96,213,2420
Texas,Lockhart,13091,3360,4671,1485,362,615,10493
Texas,Lockney,1835,302,793,143,71,121,1430
Texas,Log Cabin,572,96,262,87,15,55,515
Texas,Loma Grande,20,0,0,9,11,0,20
Texas,Loma Linda,60,0,38,0,0,0,38
Texas,Loma Linda East CDP (Jim Wells County),302,107,136,0,0,17,260
Texas,Loma Linda East CDP (Starr County),0,0,0,0,0,0,0
Texas,Loma Linda West,163,27,39,33,0,0,99
Texas,Loma Vista,252,120,95,0,0,25,240
Texas,Lometa,1010,182,311,61,91,48,693
Texas,Lone Oak,579,125,203,58,17,30,433
Texas,Lone Star,1557,205,670,165,53,108,1201
Texas,Longoria,0,0,0,0,0,0,0
Texas,Longview,82112,19596,28718,9001,2363,4654,64332
Texas,Lope?o,0,0,0,0,0,0,0
Texas,Farmersville,3424,682,1481,438,58,221,2880
Texas,Port Isabel,5033,1171,1891,439,78,364,3943
Texas,Port Lavaca,12315,2815,4845,1123,201,537,9521
Texas,Fulshear,3228,377,1684,108,54,72,2295
Texas,Fruitvale,582,113,205,59,22,17,416
Texas,Frost,639,156,244,53,29,46,528
Texas,Fronton Ranchettes,155,68,0,6,16,0,90
Texas,Fronton,154,36,56,14,5,20,131
Texas,Fritch,2982,549,1331,287,18,136,2321
Texas,Frisco,137797,21553,65431,8475,1179,2837,99475
Texas,Friona,4018,1007,1467,160,183,187,3004
Texas,Friendswood,37602,6624,18284,2778,346,1614,29646
Texas,Fresno,21877,5768,7437,1387,148,631,15371
Texas,Freer,2775,803,911,208,45,195,2162
Texas,Freeport,12118,3097,3901,871,507,491,8867
Texas,Fulton,1319,214,641,217,47,75,1194
Texas,Fredericksburg,10826,1833,4646,1194,84,1277,9034
Texas,Franklin,1882,404,539,204,79,156,1382
Texas,Fowlerton,165,56,53,0,0,0,109
Texas,Four Points,0,0,0,0,0,0,0
Texas,Four Corners,13626,3075,5917,509,363,311,10175
Texas,Fort Worth,796614,206345,277902,73660,16383,27590,601880
Texas,Fort Stockton,8441,1909,3224,651,351,487,6622
Texas,Fort Hood,30739,9238,10974,1137,218,99,21666
Texas,Tolar,996,155,443,82,15,39,734
Texas,Todd Mission,49,12,26,10,0,0,48
Texas,Toco,94,32,14,18,4,18,86
Texas,Tivoli,603,97,281,33,13,13,437
Texas,Tira,263,49,122,36,3,17,227
Texas,Frankston,1017,273,385,111,8,70,847
Texas,Gail,326,24,157,19,0,29,229
Texas,Gainesville,16119,3633,5601,1952,344,1027,12557
Texas,Galena Park,11126,3131,3495,736,408,470,8240
Texas,Marquez,278,104,93,18,4,17,236
Texas,Marshall,23743,6059,8490,2242,460,1398,18649
Texas,Mart,2050,400,716,207,66,162,1551
Texas,Martindale,1341,337,453,170,20,56,1036
Texas,Martinez,0,0,0,0,0,0,0
Texas,Mason,1873,452,676,317,19,137,1601
Texas,Matador,541,106,243,58,8,40,455
Texas,Matagorda,335,69,128,83,0,39,319
Texas,Mathis,4989,1404,1571,325,221,258,3779
Texas,Maud,1027,164,348,123,38,43,716
Texas,Mauriceville,3132,478,1424,262,57,124,2345
Texas,Maypearl,703,155,261,78,36,20,550
Texas,Meadow,801,127,310,41,33,42,553
Texas,Meadowlakes,2051,152,1249,87,0,164,1652
Texas,Meadows Place,4730,784,2382,359,64,301,3890
Texas,Medina,4921,1104,1619,370,128,142,3363
Texas,Megargel,224,37,138,10,9,14,208
Texas,Melissa,6214,1189,2864,245,43,144,4485
Texas,Garfield,1535,401,592,146,0,23,1162
Texas,Garden Ridge,3637,343,2313,90,0,91,2837
Texas,Gardendale,1399,208,358,269,43,71,949
Texas,Garden City,292,47,152,12,0,6,217
Texas,Garciasville,55,22,0,0,0,0,22
Texas,Garceno,592,106,155,10,109,0,380
Texas,Ganado,1796,354,681,150,29,138,1352
Texas,Galveston,48971,16764,15091,5531,1451,2685,41522
Texas,Gallatin,349,79,162,15,7,21,284
Texas,Tioga,1035,181,424,143,20,39,807
Texas,Marlin,5804,1827,1567,597,94,593,4678
Texas,Timpson,1385,302,428,211,16,86,1043
Texas,Timbercreek Canyon village,408,37,266,30,0,13,346
Texas,Taylor,16276,3779,6161,1720,409,685,12754
Texas,Tatum,960,198,314,127,54,43,736
Texas,Tanquecitos South Acres II,0,0,0,0,0,0,0
Texas,Tanquecitos South Acres,471,143,70,31,0,0,244
Texas,Talty,1652,219,863,115,9,37,1243
Texas,Fort Hancock,1623,323,651,50,38,92,1154
Texas,Fort Davis,1112,151,490,127,51,82,901
Texas,Fort Clark Springs,1012,113,618,48,0,77,856
Texas,Fort Bliss,9321,3527,2911,228,40,6,6712
Texas,Forsan,216,25,98,24,1,8,156
Texas,Forney,16793,3177,6867,1413,290,352,12099
Texas,Forest Hill,12709,3215,4165,1232,281,618,9511
Texas,Taylor Lake Village,3638,638,1912,315,8,141,3014
Texas,Follett,577,112,266,24,6,36,444
Texas,Flower Mound,68654,12266,34241,4232,513,1432,52684
Texas,Flowella,69,36,15,0,0,0,51
Texas,Floresville,6985,1800,2429,867,157,551,5804
Texas,Florence,870,235,362,102,0,41,740
Texas,Flor del Rio,139,31,56,0,0,0,87
Texas,Flatonia,1565,410,609,143,22,87,1271
Texas,Fifth Street,1943,624,333,89,96,151,1293
Texas,Ferris,2489,581,861,172,61,64,1739
Texas,Fernando Salinas,11,0,11,0,0,0,11
Texas,Faysville,608,114,198,31,12,42,397
Texas,Fayetteville,251,38,133,25,9,25,230
Texas,Fate,8414,1140,4164,571,0,193,6068
Texas,Floydada,2916,676,1152,150,91,116,2185
Texas,Taylor Landing,227,38,147,14,3,12,214
Texas,Teague,3546,570,1461,309,29,353,2722
Texas,Tehuacana,256,68,77,41,6,25,217
Texas,Tilden,365,62,145,17,13,23,260
Texas,Tiki Island village,873,68,656,75,6,36,841
Texas,Tierra Verde,296,94,138,7,0,4,243
Texas,Tierra Grande,165,70,35,18,0,10,133
Texas,Tierra Dorada,8,0,0,0,8,0,8
Texas,Tierra Bonita,112,26,11,0,12,0,49
Texas,Thunderbird Bay,634,59,367,67,5,71,569
Texas,Throckmorton,738,105,356,72,27,81,641
Texas,Three Rivers,1596,386,647,108,12,113,1266
Texas,Thrall,656,134,317,35,0,47,533
Texas,Thorntonville,495,84,209,59,2,26,380
Texas,Thornton,404,65,180,40,11,52,348
Texas,Thorndale,1414,269,625,153,10,88,1145
Texas,Thompsonville,0,0,0,0,0,0,0
Texas,Thompsons,163,35,66,20,3,8,132
Texas,The Woodlands,105713,18713,51554,6839,1056,3310,81472
Texas,The Hills village,2550,379,1480,101,5,93,2058
Texas,The Colony,39736,10456,15439,4077,597,1318,31887
Texas,Texline,490,99,243,32,9,17,400
Texas,Texhoma,275,36,125,77,5,16,259
Texas,Texas City,46266,11380,15084,5279,1424,3002,36169
Texas,Texarkana,37088,10064,12010,3917,803,2274,29068
Texas,Terrell Hills,5123,841,2573,339,0,246,3999
Texas,Terrell,16355,4063,5452,1687,587,937,12726
Texas,Terlingua,145,21,73,21,0,19,134
Texas,Tenaha,1454,484,367,146,63,63,1123
Texas,Temple,69938,14771,27569,6598,1385,4001,54324
Texas,Timberwood Park,26219,4600,12945,1431,76,625,19677
Texas,Portland,15638,2911,6692,1216,248,542,11609
Texas,Howe,2635,597,959,315,49,76,1996
Texas,Los Fresnos,6280,1607,2073,540,119,263,4602
Texas,Turkey,367,49,155,38,2,22,266
Texas,Tulsita,45,0,13,24,8,0,45
Texas,Tulia,4872,1092,1886,408,107,283,3776
Texas,Tuleta,274,30,142,44,3,12,231
Texas,Troy,1755,355,715,184,37,66,1357
Texas,Troup,1661,314,581,232,41,103,1271
Texas,Trophy Club,10187,1494,5413,634,70,156,7767
Texas,Trinity,2748,552,795,417,254,292,2310
Texas,Trinidad,838,196,250,145,37,76,704
Texas,Trenton,775,151,356,52,10,52,621
Texas,Trent,291,71,136,24,2,21,254
Texas,Travis Ranch,3021,224,1394,282,46,54,2000
Texas,Tradewinds,131,37,43,51,0,0,131
Texas,Toyah,164,34,41,7,10,16,108
Texas,Tornillo,1367,383,464,46,37,45,975
Texas,Tool,2438,358,1119,309,76,230,2092
Texas,Tom Bean,1004,146,403,132,20,45,746
Texas,Tomball,11186,2237,3866,1225,155,1008,8491
Texas,Powell,79,15,15,12,6,12,60
Texas,Los Fresnos,61,7,30,0,7,0,44
Texas,Los Huisaches,27,9,18,0,0,0,27
Texas,Los Indios,1222,267,437,81,49,68,902
Texas,Los Lobos,0,0,0,0,0,0,0
Texas,Tuscola,769,133,368,35,12,38,586
Texas,Tye,1153,263,365,171,41,39,879
Texas,Tyler,100806,28657,33403,10458,2335,5782,80635
Texas,Tynan,269,57,118,11,0,32,218
Texas,Prairie View,6064,5458,280,85,29,56,5908
Texas,Premont,2686,783,985,248,0,199,2215
Texas,Presidio,4139,982,1636,83,36,420,3157
Texas,Preston,1713,122,745,508,0,188,1563
Texas,Primera,4247,790,1783,307,56,136,3072
Texas,Princeton,7942,1493,3244,674,171,387,5969
Texas,Progreso,5789,1503,2259,192,265,113,4332
Texas,Progreso Lakes,352,44,216,23,2,23,308
Texas,Prosper,13939,2153,6525,746,78,223,9725
Texas,Providence Village,5160,970,2093,535,20,87,3705
Texas,Pueblo East,0,0,0,0,0,0,0
Texas,Los Minerales,33,4,29,0,0,0,33
Texas,Pueblo Nuevo,795,219,147,0,56,0,422
Texas,Pyote,130,29,31,20,0,20,100
Texas,Quail,18,2,6,2,2,6,18
Texas,Quail Creek,1653,191,814,256,16,36,1313
Texas,Quanah,2568,354,1031,316,91,202,1994
Texas,Queen City,1863,473,569,195,35,198,1470
Texas,Quemado,169,13,111,0,0,31,155
Texas,Quesada,0,0,0,0,0,0,0
Texas,Quinlan,1631,344,565,173,29,193,1304
Texas,Union Grove,348,51,188,24,5,26,294
Texas,Uncertain,94,15,54,18,0,7,94
Texas,Uhland,1214,257,429,93,45,13,837
Texas,Putnam,65,29,8,22,0,6,65
Texas,Los Nopalitos,94,9,30,0,0,0,39
Texas,Lost Creek,4570,635,2575,159,40,89,3498
Texas,Los Veteranos I,0,0,0,0,0,0,0
Texas,Malakoff,2982,666,804,385,36,206,2097
Texas,Malone,290,42,122,24,8,16,212
Texas,Manchaca,1427,133,822,52,0,193,1200
Texas,Manor,6435,1347,2473,395,113,73,4401
Texas,Mansfield,61559,11400,28921,4405,380,1807,46913
Texas,Manuel Garcia,310,70,106,0,0,0,176
Texas,Manuel Garcia II,232,0,131,32,0,0,163
Texas,Manvel,6690,1877,2352,625,73,457,5384
Texas,Marathon,546,110,306,64,0,16,496
Texas,Marble Falls,6170,1759,2130,659,100,719,5367
Texas,Marfa,1921,344,821,120,59,142,1486
Texas,Magnolia,1566,463,527,164,58,66,1278
Texas,Marietta,109,21,36,28,0,20,105
Texas,Markham,1280,342,503,88,0,42,975
Texas,Powderly,835,70,540,28,0,73,711
Texas,Pottsboro,2411,360,1036,235,47,81,1759
Texas,Potosi,3113,459,1586,134,70,72,2321
Texas,Poth,2114,467,906,112,36,81,1602
Texas,Poteet,3359,954,971,374,85,209,2593
Texas,Post Oak Bend City,992,94,624,49,0,31,798
Texas,Post,5218,1441,1976,634,283,171,4505
Texas,Port O'Connor,923,121,459,29,26,27,662
Texas,Port Neches,12826,2545,6128,1144,119,622,10558
Texas,Port Mansfield,70,0,49,12,0,9,70
Texas,Marion,1051,285,360,92,28,81,846
Texas,Prado Verde,262,97,124,15,0,5,241
Texas,Madisonville,4518,712,1865,595,140,383,3695
Texas,McLendon-Chisholm,1655,232,903,100,23,91,1349
Texas,Los Veteranos II,65,21,0,16,22,6,65
Texas,Los Ybanez,11,6,2,2,0,1,11
Texas,Lott,851,249,277,92,7,40,665
Texas,Louise,599,68,332,90,21,19,530
Texas,Lovelady,579,132,185,60,7,28,412
Texas,Lowry Crossing,1747,333,938,159,18,23,1471
Texas,Lozano,593,133,205,21,0,0,359
Texas,Lubbock,240719,77427,78839,21438,4541,10436,192681
Texas,Lucas,6241,775,3350,225,16,155,4521
Texas,Lueders,141,15,62,30,0,15,122
Texas,Lufkin,36015,8793,12764,3503,994,2140,28194
Texas,McQueeney,2480,402,1047,316,89,175,2029
Texas,Luling,5624,1198,2167,686,170,509,4730
Texas,Lyford,2601,605,931,191,109,118,1954
Texas,Lytle,2934,645,1343,253,28,185,2454
Texas,Mabank,3327,623,1114,399,105,228,2469
Texas,McAllen,136993,31758,52713,9470,4055,5991,103987
Texas,McCamey,1870,323,708,88,63,80,1262
Texas,McDade,913,290,322,92,13,18,735
Texas,Macdona,285,103,113,42,0,13,271
Texas,McGregor,5042,1406,1732,426,23,277,3864
Texas,McKinney,150064,28848,65997,11549,1746,3934,112074
Texas,McKinney Acres,1086,247,444,62,20,20,793
Texas,McLean,942,139,331,102,29,81,682
Texas,Lumberton,12216,1754,6278,798,93,566,9489
Texas,Poynor,208,49,106,20,1,11,187
Utah,Apple Valley,996,143,465,95,9,27,739
Utah,Alpine,9986,1959,4840,156,79,189,7223
Utah,Alta,391,282,65,18,0,3,368
Utah,Altamont,211,40,96,23,1,7,167
Utah,Alton,128,20,45,1,0,9,75
Utah,Amalga,568,106,272,16,0,8,402
Utah,American Fork,27799,5120,11679,1596,195,718,19308
Utah,Aneth,446,200,102,21,0,8,331
Utah,Annabella,862,84,429,10,2,16,541
Utah,Antimony,118,2,71,20,0,10,103
Utah,Ballard,812,169,327,56,10,28,590
Utah,Aurora,938,99,517,38,0,30,684
Utah,Avon,293,40,179,13,0,12,244
Utah,Elk Ridge,2856,479,1350,74,5,36,1944
Utah,Beaver,3051,496,1322,140,23,170,2151
Utah,Tremonton,7999,1397,3306,504,31,250,5488
Utah,Trenton,473,83,215,24,2,21,345
Utah,Tropic,655,125,277,40,12,26,480
Utah,Tselakai Dezza,155,37,88,0,0,2,127
Utah,Uintah,1427,228,649,105,18,28,1028
Utah,Vernal,10321,2197,3860,1076,146,387,7666
Utah,Vernon,266,48,122,7,6,4,187
Utah,Veyo,492,57,246,53,14,0,370
Utah,Vineyard,901,128,500,57,0,6,691
Utah,Virgin,503,120,222,46,2,18,408
Utah,Torrey,222,30,135,13,0,6,184
Utah,Wales,273,56,133,5,0,6,200
Utah,Wanship,497,102,279,0,0,17,398
Utah,Washington,22080,3587,10435,1095,357,914,16388
Utah,Washington Terrace,9119,2172,3499,1192,152,394,7409
Utah,Wellington,1694,245,727,195,21,94,1282
Utah,Wellsville,3593,659,1639,151,53,46,2548
Utah,Wendover,1273,346,443,69,12,38,908
Utah,West Bountiful,5394,1187,2641,242,13,89,4172
Utah,West Haven,11323,2412,4495,868,210,167,8152
Utah,West Jordan,109549,23428,43972,7902,1579,2343,79224
Utah,West Mountain,950,196,454,42,7,5,704
Utah,Wallsburg,368,40,237,20,0,10,307
Utah,Toquerville,1838,247,940,95,20,64,1366
Utah,Tooele,32454,6304,13276,2520,319,1139,23558
Utah,Timber Lakes,410,0,261,125,0,0,386
Utah,South Salt Lake,24501,7817,7411,2404,521,859,19012
Utah,South Weber,6568,1141,3075,306,29,119,4670
Utah,South Willard,1992,364,767,110,12,26,1279
Utah,Spanish Fork,36916,6523,14776,1960,313,604,24176
Utah,Spanish Valley,276,45,60,49,0,74,228
Utah,Spring City,916,123,486,34,11,38,692
Utah,Springdale,444,89,245,63,7,29,433
Utah,Spring Glen,1217,173,632,113,30,48,996
Utah,Spring Lake,383,69,155,7,0,12,243
Utah,Springville,31178,5217,13269,1748,265,634,21133
Utah,Stansbury Park,8752,1371,3667,370,42,110,5560
Utah,Sterling,226,33,110,21,1,7,172
Utah,Stockton,721,164,339,41,10,33,587
Utah,Summit,142,45,66,7,0,15,133
Utah,Summit Park,8025,1459,3926,487,106,171,6149
Utah,Sunset,5163,1067,1902,494,159,197,3819
Utah,Sutherland,296,71,113,0,0,59,243
Utah,Syracuse,25977,4087,11367,1150,147,295,17046
Utah,Tabiona,128,16,62,8,0,10,96
Utah,Taylorsville,60383,13743,23726,5413,963,2262,46107
Utah,Teasdale,132,11,83,0,0,8,102
Utah,Thatcher,665,51,380,20,0,0,451
Utah,Thompson Springs,85,9,41,0,0,0,50
Utah,West Point,9932,1668,4358,515,113,305,6959
Utah,West Valley City,133660,31699,48727,10148,3310,2999,96883
Utah,West Wood,738,115,406,33,0,0,554
Utah,White City,5497,982,2525,475,50,251,4283
Utah,Independence,185,52,63,23,0,0,138
Utah,Hyrum,7820,1413,3187,356,67,138,5161
Utah,Hyde Park,4170,780,1896,138,13,99,2926
Utah,Hurricane,14694,2509,6719,1271,173,587,11259
Utah,Huntsville,804,141,388,57,8,26,620
Utah,Huntington,2044,404,880,223,37,45,1589
Utah,Hoytsville,761,79,419,48,0,14,560
Utah,Howell,237,32,141,14,0,8,195
Utah,Hooper,7873,1207,3994,352,14,137,5704
Utah,Honeyville,1350,216,652,41,0,72,981
Utah,Holladay,30748,5398,14506,2350,300,1700,24254
Utah,Holden,375,51,173,19,0,17,260
Utah,Hinckley,638,122,285,96,0,21,524
Utah,Hildale,2926,847,505,64,41,47,1504
Utah,Highland,17030,3525,7515,206,45,139,11430
Utah,Hideout,691,137,269,50,20,16,492
Utah,Herriman,26721,4569,10864,960,334,231,16958
Utah,Henrieville,244,34,103,30,0,23,190
Utah,Henefer,667,90,311,44,4,36,485
Utah,Helper,2169,280,892,218,36,131,1557
Utah,Heber,13001,3081,4759,725,117,292,8974
Utah,Hatch,175,18,88,10,0,30,146
Utah,Harrisville,5942,1007,2621,507,14,75,4224
Utah,Ivins,7406,921,3673,766,126,265,5751
Utah,South Ogden,16805,2999,6756,2166,262,642,12825
Utah,Jensen,197,57,58,0,0,18,133
Utah,Junction,262,41,100,46,0,17,204
Utah,White Mesa,276,89,14,7,35,27,172
Utah,Whiterocks,108,35,11,9,0,6,61
Utah,Willard,1737,202,881,110,5,91,1289
Utah,Wolf Creek,800,17,368,271,0,50,706
Utah,Woodland,163,19,89,16,0,39,163
Utah,Woodland Hills,1389,210,742,26,14,14,1006
Utah,Woodruff,294,27,120,31,21,6,205
Utah,Leeds,890,158,454,23,27,37,699
Utah,Leamington,254,23,139,19,0,10,191
Utah,Layton,71007,13352,30974,4659,760,1614,51359
Utah,La Verkin,4156,678,1690,427,52,231,3078
Utah,La Sal,267,31,78,101,23,0,233
Utah,Laketown,242,23,118,24,0,3,168
Utah,Lake Shore,723,203,355,53,0,35,646
Utah,Koosharem,284,86,109,18,0,17,230
Utah,Kingston,270,100,101,6,0,13,220
Utah,Kenilworth,123,0,27,70,0,26,123
Utah,Kearns,36530,7978,13965,2630,483,927,25983
Utah,Kaysville,29213,4995,12748,1321,185,510,19759
Utah,Kanosh,410,55,230,19,0,22,326
Utah,Kanarraville,290,52,162,11,1,20,246
Utah,Kanab,4410,912,1806,461,50,303,3532
Utah,Kamas,2148,501,881,122,17,70,1591
Utah,Joseph,350,55,194,17,7,2,275
Utah,South Jordan,59662,10226,27720,3309,401,1066,42722
Utah,Snyderville,6252,1049,3201,585,18,40,4893
Utah,Snowville,117,31,71,1,0,2,105
Utah,Orem,91697,22866,37380,4498,929,2277,67950
Utah,Palmyra,387,51,219,9,0,18,297
Utah,Panguitch,1789,275,847,151,0,105,1378
Utah,Paradise,1134,226,483,38,17,28,792
Utah,Paragonah,543,83,265,49,11,26,434
Utah,Park City,7963,2419,3457,543,49,203,6671
Utah,Parowan,2858,604,1267,272,32,136,2311
Utah,Payson,19313,3444,7952,1059,197,451,13103
Utah,Peoa,130,18,82,0,22,8,130
Utah,Perry,4566,584,2271,135,0,102,3092
Utah,Peter,431,34,269,9,0,7,319
Utah,Pine Valley,150,39,102,9,0,0,150
Utah,Plain City,6028,861,3057,248,14,32,4212
Utah,Pleasant Grove,35771,6563,15183,1654,319,762,24481
Utah,Pleasant View,8647,1486,4177,344,55,233,6295
Utah,Plymouth,362,25,190,37,6,14,272
Utah,Portage,287,53,127,26,0,21,227
Utah,Price,8505,1910,3096,824,141,445,6416
Utah,Providence,7043,992,3283,347,36,183,4841
Utah,Provo,115345,42219,43038,4745,856,1924,92782
Utah,Randlett,184,85,45,15,0,7,152
Utah,Randolph,535,90,223,26,0,41,380
Utah,Redmond,710,150,397,40,0,18,605
Utah,Orderville,782,167,380,34,5,23,609
Utah,Richfield,7570,1411,3042,608,55,323,5439
Utah,Orangeville,1597,214,756,54,20,43,1087
Utah,Oljato-Monument Valley,1151,446,357,15,2,14,834
Utah,Montezuma Creek,350,138,89,14,3,6,250
Utah,Monticello,2517,420,935,237,27,175,1794
Utah,Morgan,3855,563,1907,210,8,83,2771
Utah,Moroni,1543,219,723,57,21,54,1074
Utah,Mountain Green,2981,385,1396,101,27,12,1921
Utah,Mount Pleasant,3251,797,1388,126,14,147,2472
Utah,Murray,48460,12439,18528,5558,760,2076,39361
Utah,Myton,512,112,225,51,9,8,405
Utah,Naples,2352,344,988,183,8,72,1595
Utah,Navajo Mountain,521,157,80,11,22,32,302
Utah,Neola,419,71,158,10,5,18,262
Utah,Nephi,5463,1063,2307,364,39,219,3992
Utah,Newcastle,299,68,149,8,0,14,239
Utah,New Harmony,192,11,118,11,1,12,153
Utah,Newton,831,122,403,33,0,42,600
Utah,Nibley,6060,863,2509,221,4,28,3625
Utah,North Logan,9380,2101,4003,381,7,263,6755
Utah,North Ogden,18006,2905,8684,983,115,505,13192
Utah,North Salt Lake,18046,2951,7919,1278,413,342,12903
Utah,Oak City,662,97,337,27,0,12,473
Utah,Oakley,1412,216,775,58,0,30,1079
Utah,Oasis,0,0,0,0,0,0,0
Utah,Ogden,84273,21288,28835,9233,2393,2744,64493
Utah,Ophir,18,0,16,2,0,0,18
Utah,Hanksville,118,32,53,13,0,2,100
Utah,Richmond,2526,413,1111,138,56,93,1811
Utah,River Heights,1973,382,1008,74,0,51,1515
Utah,Mexican Hat,0,0,0,0,0,0,0
Utah,Mendon,1121,180,511,50,10,42,793
Utah,Meadow,298,62,160,18,0,3,243
Utah,Mayfield,416,34,251,35,0,27,347
Utah,Marysvale,468,107,240,32,5,50,434
Utah,Marriott-Slaterville,1819,372,764,129,9,63,1337
Utah,Marion,711,77,365,22,0,7,471
Utah,Mapleton,8788,1661,3955,248,6,126,5996
Utah,Mantua,674,113,333,61,10,26,543
Utah,Manti,3301,630,1586,195,5,99,2515
Utah,Manila,128,3,71,8,0,8,90
Utah,Magna,27451,6011,10512,2393,524,663,20103
Utah,Maeser,4260,772,1790,292,0,118,2972
Utah,Lynndyl,104,20,58,6,0,5,89
Utah,Lyman,358,27,184,21,4,5,241
Utah,Logan,49400,16906,17866,2745,387,1052,38956
Utah,Loa,472,52,205,53,5,22,337
Utah,Lindon,10552,2196,4576,471,69,145,7457
Utah,Liberty,1881,303,919,82,66,0,1370
Utah,Lewiston,2048,326,1006,69,26,57,1484
Utah,Levan,738,83,367,53,9,41,553
Utah,Lehi,54079,7543,22818,1905,282,602,33150
Utah,Smithfield,10413,1715,4724,345,100,270,7154
Utah,Midvale,30844,7770,11196,3188,646,1067,23867
Utah,Riverdale,8610,1968,3567,843,150,272,6800
Utah,Midway,4261,684,1992,280,46,120,3122
Utah,Millcreek,60119,15419,23295,6245,765,3135,48859
Utah,Riverside,829,79,435,15,0,0,529
Utah,Riverton,40912,6378,18943,2279,323,749,28672
Utah,Rockville,395,95,187,62,6,19,369
Utah,Rocky Ridge,1168,322,247,14,3,7,593
Utah,Roosevelt,6555,1112,2661,360,49,148,4330
Utah,Roy,37670,6821,15787,3346,495,943,27392
Utah,Rush Valley,564,84,312,66,0,39,501
Utah,St. George,76915,14836,33870,6125,951,3464,59246
Utah,Salem,7015,1227,3286,228,77,137,4955
Utah,Salina,2503,426,1066,349,24,117,1982
Utah,Salt Lake City,190679,64854,63329,17541,2981,6530,155235
Utah,Samak,146,36,59,42,0,0,137
Utah,Sandy,91533,18451,41047,6836,1026,2510,69870
Utah,Santa Clara,6550,1017,3201,376,60,116,4770
Utah,Santaquin,10054,1623,4031,287,87,123,6151
Utah,Saratoga Springs,22532,2977,9013,669,140,116,12915
Utah,Scipio,408,31,223,36,4,22,316
Utah,Scofield,34,6,23,4,0,1,34
Utah,Sigurd,561,83,241,43,8,29,404
Utah,Silver Summit,3768,702,1931,189,41,64,2927
Utah,Moab,5175,1247,1612,886,135,208,4088
Utah,Minersville,863,140,438,43,15,34,670
Utah,Millville,2080,514,887,78,0,49,1528
Utah,Milford,1516,216,657,123,11,61,1068
Utah,Monroe,2603,347,1189,243,18,144,1941
Utah,Halls Crossing,0,0,0,0,0,0,0
Utah,Gunnison,3256,1363,868,601,104,28,2964
Utah,Coalville,1502,236,711,101,30,45,1123
Utah,Copperton,648,122,266,23,0,83,494
Utah,Corinne,865,203,325,99,0,29,656
Utah,Cornish,359,81,169,13,0,14,277
Utah,Cottonwood Heights,34234,7484,16357,2609,250,1007,27707
Utah,Cove,406,55,181,70,0,11,317
Utah,Dammeron Valley,484,18,371,65,0,30,484
Utah,Daniel,1072,213,530,88,27,30,888
Utah,Delta,3466,598,1529,148,82,180,2537
Utah,Deseret,309,47,152,26,0,24,249
Utah,Deweyville,353,52,192,37,0,5,286
Utah,Draper,45469,8131,20079,3197,559,700,32666
Utah,Duchesne,2051,294,965,121,24,86,1490
Utah,Dugway,597,139,295,48,0,5,487
Utah,Dutch John,143,20,70,3,0,14,107
Utah,Eagle Mountain,25037,2618,10764,692,207,183,14464
Utah,East Carbon-Sunnyside,1480,194,547,265,23,130,1159
Utah,Escalante,797,107,458,48,17,43,673
Utah,Erda,2181,481,1094,113,49,26,1763
Utah,Ephraim,6598,2380,2091,276,43,146,4936
Utah,Enterprise,1691,206,744,78,9,16,1053
Utah,Enterprise,683,116,322,0,0,13,451
Utah,Enoch,6075,1096,2478,359,14,76,4023
Utah,Clinton,21036,3597,9487,1414,108,340,14946
Utah,Emigration Canyon,1838,428,954,57,11,37,1487
Utah,Elwood,1209,159,622,38,3,27,849
Utah,Elsinore,799,80,435,77,5,33,630
Utah,Elmo,368,45,174,28,2,34,283
Utah,Elberta,223,25,113,16,0,0,154
Utah,Eden,627,148,291,43,0,16,498
Utah,Echo,99,38,51,0,0,10,99
Utah,Emery,335,60,180,15,3,16,274
Utah,Eureka,658,128,335,58,10,25,556
Utah,Cleveland,557,81,266,32,0,20,399
Utah,Clear Creek,0,0,0,0,0,0,0
Utah,Benjamin,1545,259,744,6,0,47,1056
Utah,Benson,1190,298,692,0,0,74,1064
Utah,Beryl Junction,0,0,0,0,0,0,0
Utah,Bicknell,352,69,216,7,4,7,303
Utah,Big Water,555,176,167,57,25,57,482
Utah,Blanding,3564,798,1174,216,77,104,2369
Utah,Bluebell,149,24,95,17,0,0,136
Utah,Bluff,358,84,236,38,0,0,358
Utah,Bluffdale,9008,1793,3819,415,38,160,6225
Utah,Bonanza,0,0,0,0,0,0,0
Utah,Boulder,130,37,56,28,0,7,128
Utah,Bountiful,43221,8287,19417,2914,296,2009,32923
Utah,Brian Head,60,17,18,7,0,9,51
Utah,Brigham City,18397,3424,8061,1502,157,706,13850
Utah,Bryce Canyon City,158,71,41,12,0,0,124
Utah,Cache,0,0,0,0,0,0,0
Utah,Cannonville,231,57,103,17,0,11,188
Utah,Clawson,171,11,94,8,0,2,115
Utah,Clarkston,633,98,315,30,0,13,456
Utah,Circleville,635,154,265,47,13,50,529
Utah,Charleston,614,135,313,50,2,7,507
Utah,Central Valley,627,114,317,30,0,28,489
Utah,Central,742,106,436,44,0,71,657
Utah,Clearfield,30299,5820,11612,2690,422,677,21221
Utah,Centerville,16387,2997,7516,1063,189,558,12323
Utah,Cedar Hills,10165,1776,4131,286,41,262,6496
Utah,Cedar Fort,423,67,230,26,10,14,347
Utah,Cedar City,29429,8024,11429,1732,194,993,22372
Utah,Castle Valley,310,71,151,43,0,32,297
Utah,Castle Dale,1758,262,729,129,13,95,1228
Utah,Carbonville,1558,240,652,227,59,53,1231
Utah,Centerfield,1134,179,526,77,0,56,838
Utah,Halchita,521,206,71,3,7,23,310
Utah,Mona,1464,212,690,22,20,52,996
Utah,Fairview,1819,262,870,88,2,56,1278
Utah,Bear River City,843,103,421,52,8,35,619
Utah,Woods Cross,10686,1956,4766,578,79,177,7556
Utah,Fairfield,135,34,79,4,0,0,117
Utah,Farmington,21223,3545,9887,1032,145,216,14825
Utah,Farr West,6270,1234,3029,306,23,200,4792
Utah,Fayette,328,32,138,3,5,11,189
Utah,Ferron,1634,224,803,83,0,91,1201
Utah,Fielding,417,37,220,21,6,15,299
Utah,Flaming Gorge,90,7,39,12,0,0,58
Utah,Fort Duchesne,784,321,118,89,0,21,549
Utah,Fountain Green,989,188,442,62,7,70,769
Utah,Francis,1217,228,581,59,11,34,913
Utah,Fillmore,2849,562,1126,216,40,104,2048
Utah,Fruit Heights,5625,1066,2789,221,16,115,4207
Utah,Green River,1106,229,424,56,51,31,791
Utah,Grantsville,9609,1589,3848,777,85,254,6553
Utah,Fremont,127,36,57,0,0,6,99
Utah,Goshen,916,168,405,36,0,31,640
Utah,Glenwood,555,103,239,44,0,13,399
Utah,Granite,1414,326,846,46,25,47,1290
Utah,Genola,1467,349,619,76,4,29,1077
Utah,Garland,2491,358,1134,129,14,53,1688
Utah,Garden City,683,81,233,43,59,47,463
Utah,Garden,161,16,104,15,0,0,135
Utah,Glendale,284,23,167,7,2,6,205
Vermont,Concord,277,46,84,75,2,27,234
Vermont,East Burke,111,19,46,6,0,0,71
Vermont,Coventry,98,31,34,13,5,5,88
Vermont,Danville,326,55,177,20,6,16,274
Vermont,Derby Center village,555,127,201,53,10,48,439
Vermont,Derby Line village,814,280,313,72,3,43,711
Vermont,Dorset,311,85,159,33,14,20,311
Vermont,Perkinsville village,191,28,86,16,0,6,136
Vermont,East Barre,996,244,455,120,27,29,875
Vermont,East Middlebury,279,29,165,45,0,0,239
Vermont,Windsor,2194,613,770,246,36,122,1787
Vermont,Enosburg Falls village,1341,341,509,187,26,107,1170
Vermont,Essex Junction village,9709,2780,4000,733,60,333,7906
Vermont,Fairfax,703,114,337,138,0,66,655
Vermont,Fair Haven,2238,587,877,274,21,152,1911
Vermont,Fairlee,294,61,92,48,0,12,213
Vermont,Glover,292,55,92,55,7,50,259
Vermont,Worcester,94,13,26,22,0,4,65
Vermont,Orleans village,835,229,249,75,2,73,628
Vermont,Chester,775,149,242,182,9,93,675
Vermont,East Montpelier,63,0,17,46,0,0,63
Vermont,Chelsea,319,115,55,52,0,66,288
Vermont,Bennington,8865,2495,2801,1351,143,664,7454
Vermont,Castleton,1203,969,188,21,0,6,1184
Vermont,Albany village,195,24,94,9,0,3,130
Vermont,Alburgh village,489,103,179,59,18,20,379
Vermont,Arlington,1287,282,581,71,34,94,1062
Vermont,Ascutney,393,54,239,61,0,31,385
Vermont,Barnet,187,41,77,12,0,13,143
Vermont,Barre,8885,2420,2717,1451,137,601,7326
Vermont,Barton village,567,63,231,102,14,56,466
Vermont,Beecher Falls,160,20,88,20,4,10,142
Vermont,Bellows Falls village,2985,749,959,449,47,188,2392
Vermont,Cavendish,240,90,108,14,0,11,223
Vermont,Old Bennington village,155,16,93,10,3,1,123
Vermont,Bethel,649,207,242,34,14,14,511
Vermont,Bradford,895,229,340,76,33,31,709
Vermont,Brandon,1617,245,694,207,0,80,1226
Vermont,Brattleboro,7259,2231,2257,1210,197,354,6249
Vermont,Bristol,1831,365,764,251,0,95,1475
Vermont,Burlington,42570,22874,10199,3249,282,1633,38237
Vermont,Cabot,202,57,66,18,0,13,154
Vermont,Cambridge village,188,41,82,39,2,2,166
Vermont,Canaan,322,75,138,40,2,27,282
Vermont,Benson,309,104,90,39,0,41,274
Vermont,Norwich,1058,310,418,78,0,20,826
Vermont,North Westminster,243,73,129,13,0,13,228
Vermont,North Troy village,635,155,208,47,8,41,459
Vermont,South Shaftsbury,540,135,167,69,16,30,417
Vermont,South Royalton,727,465,136,54,0,30,685
Vermont,South Burlington,18536,4816,7766,1853,175,1071,15681
Vermont,South Barre,1457,334,540,204,11,116,1205
Vermont,Shelburne,690,113,353,72,0,55,593
Vermont,Saxtons River village,562,178,179,66,0,18,441
Vermont,Springfield,3700,807,1113,466,52,254,2692
Vermont,St. Johnsbury,6122,1423,2333,818,141,498,5213
Vermont,Rutland,16091,4255,5621,2394,282,955,13507
Vermont,Rochester,304,89,128,16,0,17,250
Vermont,Richmond,630,223,134,71,34,10,472
Vermont,Richford,1338,305,517,219,16,92,1149
Vermont,Readsboro,272,52,136,23,3,21,235
Vermont,Randolph,2214,605,870,296,52,128,1951
Vermont,St. Albans,6864,1826,2276,945,61,343,5451
Vermont,Stowe,434,208,78,55,7,86,434
Vermont,Swanton village,2558,587,983,325,20,250,2165
Vermont,Troy,134,7,112,4,0,9,132
Vermont,Wilmington,442,64,181,52,0,17,314
Vermont,Williamstown,1161,319,442,165,0,70,996
Vermont,Wilder,1562,355,706,163,8,0,1232
Vermont,White River Junction,2267,679,682,341,18,243,1963
Vermont,West Rutland,2075,541,793,216,26,126,1702
Vermont,Westminster village,279,44,141,23,4,29,241
Vermont,West Burke village,332,77,109,41,9,16,252
Vermont,West Brattleboro,2559,631,949,305,0,187,2072
Vermont,Wells River village,386,89,126,63,4,30,312
Vermont,Wells,354,42,223,8,0,7,280
Vermont,Websterville,432,119,129,97,6,18,369
Vermont,Waterbury village,1815,541,670,207,33,96,1547
Vermont,Wallingford,717,214,256,97,18,32,617
Vermont,Waitsfield,192,40,96,30,0,6,172
Vermont,Vergennes,2629,722,935,400,36,184,2277
Vermont,Quechee,645,250,224,40,0,0,514
Vermont,Winooski,7223,3238,2010,599,50,282,6179
Vermont,Putney,395,122,133,74,13,29,371
Vermont,Woodstock village,1064,213,382,188,5,88,876
Vermont,Marshfield village,293,46,114,23,0,14,197
Vermont,Middlebury,6885,3610,1573,599,37,453,6272
Vermont,Milton,1926,379,833,151,44,149,1556
Vermont,Montpelier,7712,1988,2890,985,78,421,6362
Vermont,Morrisville village,2401,633,980,383,6,165,2167
Vermont,Newbury village,313,49,138,61,3,20,271
Vermont,Manchester Center,2238,295,967,301,15,67,1645
Vermont,Newfane village,65,8,30,10,0,5,53
Vermont,Newport Center,288,96,94,33,0,23,246
Vermont,North Bennington village,1795,931,495,110,11,81,1628
Vermont,Northfield,2181,748,631,267,51,144,1841
Vermont,North Hartland,172,53,82,25,0,12,172
Vermont,North Springfield,549,124,188,34,101,83,530
Vermont,Pittsford,539,146,195,96,7,27,471
Vermont,Newport,4493,1403,1338,649,38,211,3639
Vermont,Manchester village,777,143,317,107,0,122,689
Vermont,Lyndonville village,1178,472,307,173,27,40,1019
Vermont,Ludlow village,944,320,341,121,14,61,857
Vermont,Graniteville,595,95,230,137,8,49,519
Vermont,Greensboro,103,14,65,14,0,8,101
Vermont,Greensboro Bend,232,32,91,25,0,24,172
Vermont,Groton,432,83,164,63,13,24,347
Vermont,Hardwick,1478,418,481,125,57,61,1142
Vermont,Hartland,395,123,174,0,0,10,307
Vermont,Hinesburg,963,220,394,101,17,12,744
Vermont,Hyde Park village,506,106,228,49,2,21,406
Vermont,Irasburg,171,17,89,16,3,27,152
Vermont,Island Pond,701,185,235,64,6,53,543
Vermont,Jacksonville village,238,58,90,38,0,12,198
Vermont,Jeffersonville village,936,330,242,116,9,45,742
Vermont,Jericho village,1352,241,704,74,14,44,1077
Vermont,Johnson village,1418,725,287,114,3,63,1192
Vermont,Lowell,116,31,39,8,8,12,98
Vermont,Proctorsville,510,160,184,80,10,35,469
Vermont,Poultney village,1518,784,402,112,3,60,1361
Vermont,Plainfield,278,68,80,65,0,23,236
Village of Islands village; Florida,Islamorada,6386,1186,3266,776,17,416,5661
Virginia,Yogaville,179,66,79,17,0,17,179
Virginia,Heathsville,53,11,42,0,0,0,53
Virginia,Haysi,452,157,134,69,33,23,416
Virginia,Haymarket,1915,358,915,102,27,23,1425
Virginia,Hayfield,4610,819,2213,197,60,122,3411
Virginia,Harriston,1050,188,452,144,32,37,853
Virginia,Harrisonburg,51388,26206,12746,2831,1043,1563,44389
Virginia,Harborton,131,25,68,0,0,38,131
Virginia,Hanover,237,56,140,16,9,16,237
Virginia,Hampton,137081,40946,45827,14391,3417,7271,111852
Virginia,Hampden-Sydney,1704,1457,194,29,10,0,1690
Virginia,Hamilton,463,87,242,22,10,34,395
Virginia,Bon Air,17128,4564,6401,1964,442,979,14350
Virginia,Bobtown,444,46,332,10,0,0,388
Virginia,Blue Ridge Shores,791,182,239,82,22,66,591
Virginia,Henry Fork,1374,408,491,74,26,31,1030
Virginia,Herndon,24384,6196,10099,1699,528,567,19089
Virginia,Highland Springs,16955,6021,4507,1443,567,1052,13590
Virginia,Chatmoss,1475,320,671,83,92,76,1242
Virginia,Castlewood,1875,207,650,201,38,256,1352
Virginia,Catlett,297,87,198,0,0,0,285
Virginia,Cats Bridge,262,50,65,20,17,43,195
Virginia,Cave Spring,25554,5371,11854,2524,489,1313,21551
Virginia,Cedar Bluff,1148,180,486,135,43,114,958
Virginia,Central Garage,1156,72,659,123,39,37,930
Virginia,Centreville,73660,17598,33101,4869,881,1643,58092
Virginia,Chamberlayne,6190,1389,2632,794,0,380,5195
Virginia,Chantilly,23864,5830,10271,1336,439,658,18534
Virginia,Charles City,213,57,63,21,0,39,180
Virginia,Charlotte Court House,736,166,230,75,28,30,529
Virginia,Charlottesville,45084,21654,11802,3726,657,1329,39168
Virginia,Chase City,2312,680,600,237,135,216,1868
Virginia,Chase Crossing,539,88,260,0,0,0,348
Virginia,Chatham,1059,242,420,142,12,125,941
Virginia,Blue Ridge,2640,512,1428,261,37,63,2301
Virginia,Bluefield,5350,1107,2425,369,126,373,4400
Virginia,Bloxom,414,59,172,36,13,30,310
Virginia,Bland,588,94,233,93,60,9,489
Virginia,Riverview,504,73,254,92,6,40,465
Virginia,Riverdale,1483,209,734,137,11,73,1164
Virginia,Rivanna,1795,208,1168,96,0,71,1543
Virginia,Riner,713,41,389,45,0,42,517
Virginia,Ridgeway,850,131,388,81,19,52,671
Virginia,Richmond,213735,93553,47125,21649,6901,10615,179843
Virginia,Cheriton,462,126,202,36,8,64,436
Virginia,Richlands,5630,1006,2164,676,152,586,4584
Virginia,Reston,60112,15208,25529,5941,773,1880,49331
Virginia,Remington,619,162,191,72,33,36,494
Virginia,Ravensworth,2563,477,1133,280,30,162,2082
Virginia,Raven,2018,408,701,217,82,312,1720
Virginia,Radford,17057,9497,3863,1121,245,515,15241
Virginia,Quinby,206,33,113,8,0,36,190
Virginia,Rich Creek,797,155,244,105,10,138,652
Virginia,Bealeton,4666,1194,1947,280,42,146,3609
Virginia,Bedford,6522,1955,1996,807,117,703,5578
Virginia,Belle Haven,441,86,149,83,10,23,351
Virginia,Blairs,834,173,424,59,15,25,696
Virginia,Blackstone,3553,842,1534,245,103,293,3017
Virginia,Blacksburg,43530,29303,8403,1245,293,741,39985
Virginia,Big Stone Gap,5508,1887,1788,503,191,413,4782
Virginia,Big Island,261,39,138,18,0,43,238
Virginia,Bethel Manor,3996,402,1826,46,0,11,2285
Virginia,Berryville,4267,934,1523,380,164,525,3526
Virginia,Bensley,6228,2088,1679,506,243,218,4734
Virginia,Benns Church,585,73,351,32,12,41,509
Virginia,Belview,1236,138,519,153,0,13,823
Virginia,Belspring,201,35,85,0,0,57,177
Virginia,Belmont Estates,1388,157,814,29,0,120,1120
Virginia,Belmont,6360,812,3316,195,36,84,4443
Virginia,Bellwood,5772,1523,1678,788,133,399,4521
Virginia,Belle Haven,6721,1676,2706,609,92,281,5364
Virginia,Cascades,12194,2452,5806,774,203,386,9621
Virginia,Carrsville,269,46,109,44,0,70,269
Virginia,Carrollton,5383,1054,2673,475,88,224,4514
Virginia,Captains Cove,1082,103,693,45,0,31,872
Virginia,Fairlawn,2402,312,1199,221,52,186,1970
Virginia,Fair Oaks,33268,9461,13800,2926,321,606,27114
Virginia,Courtland,2065,564,536,193,70,152,1515
Virginia,County Center,2513,494,984,236,124,95,1933
Virginia,Countryside,10301,2317,4823,679,118,156,8093
Virginia,Concord,1543,219,899,31,24,103,1276
Virginia,Fair Lakes,7721,1860,3623,589,173,181,6426
Virginia,Columbia,62,9,26,0,2,0,37
Virginia,Colonial Beach,3556,940,1235,643,43,325,3186
Virginia,Collinsville,7507,1819,2809,991,287,522,6428
Virginia,Coeburn,2377,446,677,364,129,163,1779
Virginia,Cluster Springs,903,173,386,107,31,63,760
Virginia,Cloverdale,3415,668,1635,292,24,122,2741
Virginia,Clover,450,139,124,74,0,48,385
Virginia,Colonial Heights,17515,3873,6739,1752,425,1430,14219
Virginia,Fairfax Station,11290,2479,6232,404,175,270,9560
Virginia,Fairfax,23402,6300,10255,1512,294,1006,19367
Virginia,Exmore,1510,331,421,275,37,143,1207
Virginia,Staunton,24193,6386,8914,2905,530,1720,20455
Virginia,Stephens City,1905,550,678,217,73,88,1606
Virginia,Sterling,28883,8285,10635,2355,517,1006,22798
Virginia,Stone Ridge,9578,1129,4811,332,127,128,6527
Virginia,Stony Creek,160,28,70,19,3,6,126
Virginia,Strasburg,6506,1447,2535,881,22,443,5328
Virginia,Stuart,1613,355,457,256,53,271,1392
Virginia,Stuarts Draft,9005,1520,4174,785,229,585,7293
Virginia,Sudley,17009,4409,6111,1223,413,570,12726
Virginia,Suffolk,86184,20227,34253,7095,2323,4054,67952
Virginia,Crimora,1913,461,825,169,126,77,1658
Virginia,Crewe,2746,544,890,277,107,124,1942
Virginia,Craigsville,1164,179,480,152,45,91,947
Virginia,Covington,5736,1307,2044,711,160,515,4737
Virginia,Ewing,280,46,98,18,5,32,199
Virginia,Clintwood,1423,301,573,151,61,162,1248
Virginia,Quantico Base,6560,1997,2572,29,90,10,4698
Virginia,Clinchport,74,28,16,6,2,8,60
Virginia,Clifton Forge,3839,785,1429,436,19,365,3034
Virginia,Buckhall,17066,3366,8175,733,275,489,13038
Virginia,Buckingham Courthouse,209,61,115,10,0,8,194
Virginia,Buena Vista,6666,1908,2659,458,136,363,5524
Virginia,Bull Run,14781,4715,4478,1454,390,410,11447
Virginia,Bull Run Mountain Estates,1380,288,739,102,0,33,1162
Virginia,Burke,42205,8498,21438,2005,352,1317,33610
Virginia,Buchanan,1098,195,429,132,40,107,903
Virginia,Burke Centre,17982,4216,8132,1314,290,561,14513
Virginia,Callaghan,183,48,64,38,0,33,183
Virginia,Calverton,196,38,102,36,20,0,196
Virginia,Camptown,609,119,188,56,21,103,487
Virginia,Cana,1310,257,594,102,14,92,1059
Virginia,Cape Charles,912,189,362,92,43,110,796
Virginia,Yorkshire,9244,2316,3419,652,313,221,6921
Virginia,Burkeville,400,97,138,28,14,57,334
Virginia,Brookneal,1184,297,396,134,41,154,1022
Virginia,Brodnax,278,63,102,19,11,30,225
Virginia,Broadway,3765,878,1466,378,25,220,2967
Virginia,Boones Mill,158,27,88,17,1,10,143
Virginia,Boston,336,140,43,62,0,57,302
Virginia,Boswell's Corner,1399,271,513,99,71,42,996
Virginia,Bowling Green,1266,232,486,166,15,145,1044
Virginia,Boyce,775,113,385,50,9,28,585
Virginia,Boydton,350,94,142,32,14,25,307
Virginia,Boykins,762,228,253,53,27,54,615
Virginia,Bracey,1357,213,595,168,43,173,1192
Virginia,Brambleton,15537,2110,7391,699,226,103,10529
Virginia,Branchville,145,38,49,11,4,5,107
Virginia,Brandermill,13721,3066,6310,1230,203,601,11410
Virginia,Bridgewater,5844,1961,2334,342,0,505,5142
Virginia,Brightwood,1703,420,785,33,55,152,1445
Virginia,Bristol,17524,3798,6679,2018,523,1447,14465
Virginia,Broadlands,13436,1780,6415,416,122,182,8915
Virginia,Clinchco,336,89,108,46,17,15,275
Virginia,Quantico,469,158,121,71,38,19,407
Virginia,Purcellville,8658,1791,3583,477,124,242,6217
Virginia,Pungoteague,251,83,66,12,38,6,205
Virginia,Allisonia,140,22,20,28,21,0,91
Virginia,Alexandria,149315,49918,55568,13048,3111,4289,125934
Virginia,Alberta,296,77,107,43,9,24,260
Virginia,Adwolf,1418,228,750,165,0,133,1276
Virginia,Accomac,468,141,166,36,30,32,405
Virginia,Abingdon,8143,2033,2818,1030,352,778,7011
Virginia,Altavista,3464,1100,1014,445,78,306,2943
Virginia,Cherry Hill,18089,3979,7156,1255,499,415,13304
Virginia,Chester,21927,5727,8190,2037,445,1123,17522
Virginia,Chester Gap,800,167,389,105,17,28,706
Virginia,Chilhowie,1839,330,793,207,47,181,1558
Virginia,Chincoteague,2930,429,1643,247,16,176,2511
Virginia,Christiansburg,21623,4199,9181,2395,373,1255,17403
Virginia,Churchville,68,16,36,16,0,0,68
Virginia,Chesapeake,230601,54237,96671,18994,5081,9155,184138
Virginia,Amelia Court House,483,110,132,49,0,176,467
Virginia,Amherst,2323,683,841,225,33,234,2016
Virginia,Annandale,42893,11915,16920,2969,1202,1876,34882
Virginia,Bassett,1113,195,405,140,35,141,916
Virginia,Baskerville,47,4,25,0,0,6,35
Virginia,Bailey's Crossroads,26075,8023,9068,1559,681,1131,20462
Virginia,Augusta Springs,339,29,223,19,0,6,277
Virginia,Atlantic,1111,183,628,62,57,70,1000
Virginia,Atkins,1009,196,402,192,38,108,936
Virginia,Ashland,7298,2835,2015,786,87,502,6225
Virginia,Ashburn,48954,9719,21984,3170,537,1428,36838
Virginia,Arrington,767,188,229,98,46,12,573
Virginia,Arlington,223945,86227,82052,14552,2741,5720,191292
Virginia,Arcola,229,57,131,10,0,0,198
Virginia,Aquia Harbour,6975,1357,3393,724,98,214,5786
Virginia,Appomattox,2124,737,566,169,122,203,1797
Virginia,Apple Mountain Lake,1459,248,607,156,0,44,1055
Virginia,Appalachia,1871,499,634,172,67,108,1480
Virginia,Claremont,281,78,129,22,12,18,259
Virginia,Basye,685,116,355,106,25,58,660
Virginia,Clarksville,1213,371,420,109,35,104,1039
Virginia,Cleveland,198,20,57,27,13,36,153
Virginia,Forest,10292,2232,5184,752,178,302,8648
Virginia,Floyd,558,158,222,43,4,51,478
Virginia,Floris,8357,1503,4734,191,43,98,6569
Virginia,Flint Hill,171,20,120,6,0,6,152
Virginia,Fishersville,7911,1546,3660,565,44,770,6585
Virginia,Fincastle,374,96,118,56,21,33,324
Virginia,Fort Belvoir,8209,1133,3587,200,38,53,5011
Virginia,Fieldale,770,156,286,92,0,66,600
Virginia,Farmville,8355,4606,1522,345,272,452,7197
Virginia,Fancy Gap,190,12,144,0,0,0,156
Virginia,Falmouth,4630,921,1928,316,136,75,3376
Virginia,Falls Church,13308,3267,5828,903,271,278,10547
Virginia,Fairview Beach,413,191,161,34,0,0,386
Virginia,Fairview,141,27,40,8,3,63,141
Virginia,Ferrum,1996,1397,359,50,0,0,1806
Virginia,Fort Chiswell,1024,101,505,114,57,92,869
Virginia,Fort Hunt,17273,2354,9256,700,84,744,13138
Virginia,Fort Lee,4747,899,1793,190,35,39,2956
Virginia,Clifton,257,25,161,15,0,3,204
Virginia,Glade Spring,1575,236,655,195,48,135,1269
Virginia,George Mason,10065,5797,2639,230,37,146,8849
Virginia,Gate City,2370,460,1003,198,46,220,1927
Virginia,Gasburg,504,41,257,123,0,44,465
Virginia,Gargatha,519,28,309,29,27,12,405
Virginia,Galax,6876,1622,2324,926,190,626,5688
Virginia,Gainesville,12950,2349,5954,778,127,359,9567
Virginia,Front Royal,14846,3541,4949,1799,606,1037,11932
Virginia,Fries,513,84,224,81,19,55,463
Virginia,Free Union,358,104,120,58,37,0,319
Virginia,Fredericksburg,27395,10326,7580,2666,761,1165,22498
Virginia,Franklin Farm,19776,3619,9843,849,176,493,14980
Virginia,Franklin,8457,2438,2329,988,247,680,6682
Virginia,Franconia,19698,5416,8439,1685,238,406,16184
Virginia,Claypool Hill,1625,192,933,132,0,60,1317
Virginia,Stanleytown,1280,274,548,273,0,79,1174
Virginia,Bayside,85,0,0,13,17,55,85
Virginia,New Kent,283,83,155,26,19,0,283
Virginia,Grundy,891,265,316,64,21,56,722
Virginia,Groveton,16373,3857,6959,852,310,509,12487
Virginia,Grottoes,2714,523,1142,246,56,127,2094
Virginia,Gretna,1283,231,486,125,57,163,1062
Virginia,Greenville,1287,327,519,109,10,35,1000
Virginia,Greenbush,151,45,50,6,0,30,131
Virginia,Gwynn,695,188,371,13,0,7,579
Virginia,Greenbriar,8060,1554,3779,447,127,317,6224
Virginia,Great Falls,15764,2810,9033,453,17,396,12709
Virginia,Gratton,920,144,429,68,45,65,751
Virginia,Goshen,381,81,114,61,20,48,324
Virginia,Gordonsville,1564,471,575,148,25,102,1321
Virginia,Goochland,777,42,544,20,0,19,625
Virginia,Gloucester Point,9199,1884,4285,922,131,403,7625
Virginia,Greenbackville,139,0,125,14,0,0,139
Virginia,Halifax,1335,398,513,183,67,55,1216
Virginia,Hallwood,320,50,128,27,14,15,234
Virginia,Pennington Gap,1804,288,524,319,80,291,1502
Virginia,Pulaski,8958,2190,3211,1127,254,834,7616
Virginia,Prince George,1944,509,680,141,34,132,1496
Virginia,Prices Fork,1407,304,460,186,75,29,1054
Virginia,Powhatan,185,13,151,0,0,21,185
Virginia,Pound,948,137,449,106,15,31,738
Virginia,Potomac Mills,5768,1419,2486,376,103,186,4570
Virginia,Portsmouth,96135,28674,29035,10376,3121,5538,76744
Virginia,Port Royal,99,40,21,12,0,2,75
Virginia,Poquoson,12077,2351,5973,881,48,657,9910
Virginia,Pocahontas,365,66,122,53,13,45,299
Virginia,Plum Creek,1646,568,466,113,14,229,1390
Virginia,Piney Mountain,1564,350,513,107,42,123,1135
Virginia,Pimmit Hills,6646,1876,3036,367,102,117,5498
Virginia,Phenix,285,49,94,29,2,27,201
Virginia,Petersburg,32123,12471,7811,2963,1197,2078,26520
Virginia,Gloucester Courthouse,2732,653,1048,271,74,272,2318
Virginia,Newington Forest,12280,2706,5856,815,123,161,9661
Virginia,Glenvar,978,85,373,92,7,301,858
Virginia,Glen Allen,15007,3179,6334,1616,192,543,11864
Virginia,Oak Level,745,128,277,90,11,121,627
Virginia,Oak Hall,370,92,183,0,0,0,275
Virginia,Oak Grove,1727,561,540,208,15,35,1359
Virginia,Nottoway Court House,97,22,14,12,23,0,71
Virginia,Norton,4007,865,1448,603,193,250,3359
Virginia,North Springfield,6825,1763,2831,489,292,239,5614
Virginia,Oakton,36739,8896,16698,2227,546,995,29362
Virginia,North Shore,2951,135,2232,234,0,118,2719
Virginia,Nokesville,1901,470,886,78,30,102,1566
Virginia,Nickelsville,430,70,180,53,9,33,345
Virginia,Newsoms,350,87,144,39,2,37,309
Virginia,New River,497,63,183,179,0,37,462
Virginia,Newport News,181323,54324,59667,17866,5285,7920,145062
Virginia,New Market,2336,492,915,245,105,218,1975
Virginia,Norfolk,245452,93003,68937,23040,7179,10146,202305
Virginia,Occoquan,932,160,460,123,16,21,780
Virginia,Onancock,1214,326,450,126,37,141,1080
Virginia,Onley,501,92,209,48,16,44,409
Virginia,Glasgow,1362,338,523,133,17,129,1140
Virginia,Penhook,784,101,580,24,0,12,717
Virginia,Pembroke,1328,268,486,187,28,87,1056
Virginia,Pearisburg,2727,465,1029,265,216,242,2217
Virginia,Patrick Springs,1695,287,808,223,58,205,1581
Virginia,Pastoria,1028,196,371,87,31,98,783
Virginia,Passapatanzy,1204,240,516,114,0,14,884
Virginia,Parrott,528,48,234,32,0,63,377
Virginia,Parksley,756,191,265,80,25,48,609
Virginia,Pantops,3647,714,1594,426,22,357,3113
Virginia,Pamplin City,175,29,63,26,2,8,128
Virginia,Palmyra,143,35,74,18,0,0,127
Virginia,Painter,251,66,85,25,8,10,194
Virginia,Orange,4854,1373,1622,450,122,334,3901
Virginia,Opal,649,116,325,63,0,16,520
Virginia,Glen Lyn,152,30,44,17,6,12,109
Virginia,Stanley,1697,349,691,183,74,133,1430
Virginia,Capron,89,13,43,16,1,9,82
Virginia,Stafford Courthouse,4295,1536,1557,221,95,23,3432
Virginia,Round Hill,541,101,273,31,3,13,421
Virginia,Rose Hill CDP (Lee County),878,177,391,82,29,34,713
Virginia,Rose Hill CDP (Fairfax County),20142,4864,9249,1162,323,673,16271
Virginia,Rocky Mount,4794,1123,1614,664,95,524,4020
Virginia,Rockwood,8634,1595,3810,813,159,504,6881
Virginia,Roanoke,98736,28486,31020,12241,2353,6083,80183
Virginia,Crosspointe,6197,1391,3338,165,42,152,5088
Virginia,Crozet,6601,804,2956,625,102,402,4889
Virginia,Culpeper,17167,4099,5993,1361,464,658,12575
Virginia,Cumberland,216,42,140,22,0,0,204
Virginia,Dahlgren,3049,717,1293,233,52,153,2448
Virginia,Dahlgren Center,573,69,253,12,5,18,357
Virginia,Dale City,72130,18508,29016,4267,1465,2079,55335
Virginia,Daleville,2872,542,1458,155,0,205,2360
Virginia,Damascus,759,88,253,113,30,95,579
Virginia,Dante,632,220,104,50,34,37,445
Virginia,Danville,42450,11358,13413,4513,1998,3383,34665
Virginia,Dayton,1654,390,699,213,12,65,1379
Virginia,Stanardsville,363,76,131,31,12,11,261
Virginia,Deerfield,101,21,13,50,0,17,101
Virginia,Deltaville,1032,194,476,70,33,106,879
Virginia,Ruckersville,984,67,596,72,18,37,790
Virginia,Rural Retreat,1559,216,799,146,19,81,1261
Virginia,Rushmere,786,170,305,111,10,109,705
Virginia,Rustburg,1039,328,349,181,58,46,962
Virginia,Mineral,636,158,159,63,40,31,451
Virginia,Midland,210,14,107,20,0,9,150
Virginia,Middletown,1537,455,553,149,37,57,1251
Virginia,Middleburg,689,180,214,119,20,43,576
Virginia,Middlebrook,256,84,59,9,0,0,152
Virginia,Metompkin,498,95,119,54,87,57,412
Virginia,Merrimac,1890,467,526,319,32,302,1646
Virginia,Merrifield,16412,5144,6407,1607,264,243,13665
Virginia,Scottsburg,120,27,56,13,4,5,105
Virginia,Scotland,135,26,74,16,8,0,124
Virginia,Dendron,328,96,126,45,15,16,298
Virginia,Schuyler,101,0,19,9,0,59,87
Virginia,Savageville,63,10,53,0,0,0,63
Virginia,Savage Town,90,72,0,0,0,0,72
Virginia,Sanford,169,0,102,14,0,8,124
Virginia,Sandy Level,406,137,167,57,10,10,381
Virginia,Sandston,7317,1642,2385,870,183,425,5505
Virginia,Saluda,629,232,232,68,16,48,596
Virginia,Saltville,2343,435,831,307,83,211,1867
Virginia,Salem,25165,6628,10037,2579,451,1536,21231
Virginia,St. Paul,1080,235,528,117,8,65,953
Virginia,St. Charles,113,20,32,15,0,18,85
Virginia,Saxis,198,34,81,32,9,34,190
Virginia,Modest Town,118,0,67,0,0,51,118
Virginia,Dillwyn,486,100,123,36,23,75,357
Virginia,Drakes Branch,698,182,197,64,29,62,534
Virginia,Max Meadows,221,0,141,16,0,64,221
Virginia,Maurertown,881,184,391,40,53,40,708
Virginia,Matoaca,2132,423,670,460,100,136,1789
Virginia,Mathews,589,143,182,84,34,54,497
Virginia,Massanutten,2213,456,1208,154,31,41,1890
Virginia,Massanetta Springs,5015,878,2514,234,58,242,3926
Virginia,Mason Neck,1983,340,1017,195,6,79,1637
Virginia,Marumsco,38847,11127,13476,3013,1329,872,29817
Virginia,Martinsville,13624,3534,4228,1862,387,1053,11064
Virginia,Marshall,1864,427,690,164,73,14,1368
Virginia,Marion,5919,1191,2034,824,306,672,5027
Virginia,Mappsville,501,72,188,0,68,0,328
Virginia,Mappsburg,46,24,15,7,0,0,46
Virginia,Mantua,7531,1313,3820,412,26,500,6071
Virginia,Manchester,10378,2739,3607,1122,183,773,8424
Virginia,Manassas Park,15625,3877,6252,1048,322,504,12003
Virginia,Manassas,40743,9955,16725,2350,992,1373,31395
Virginia,Makemie Park,264,66,14,54,48,24,206
Virginia,Madison Heights,10355,2543,3935,927,259,845,8509
Virginia,Madison,182,70,54,11,6,18,159
Virginia,McNair,20022,5067,8217,1323,261,371,15239
Virginia,Meadowbrook,19027,5628,7090,1614,354,876,15562
Virginia,Meadow View,1090,256,369,160,16,80,881
Virginia,Mechanicsville,37210,6992,17165,3341,391,2037,29926
Virginia,Melfa,439,109,200,32,15,32,388
Virginia,Dranesville,11895,2297,6352,436,9,291,9385
Virginia,Draper,291,48,177,31,0,35,291
Virginia,Dryden,1268,218,551,122,39,111,1041
Virginia,Dublin,2665,709,893,392,129,103,2226
Virginia,Duffield,115,10,65,1,3,6,85
Virginia,Dulles Town Center,4971,1364,2085,330,70,45,3894
Virginia,Dumbarton,8701,3026,2110,1243,221,422,7022
Virginia,Dumfries,5158,1373,1689,489,154,91,3796
Virginia,Dungannon,443,92,161,46,4,36,339
Virginia,Dunn Loring,9393,1838,4834,404,115,283,7474
Virginia,Dooms,1247,89,573,78,75,90,905
Virginia,East Highland Park,14733,4465,3979,1950,708,838,11940
Virginia,Eastville,175,36,81,9,3,16,145
Virginia,Ebony,109,35,34,0,0,22,91
Virginia,Edinburg,1279,276,479,159,7,57,978
Virginia,Elkton,2779,544,1116,272,103,268,2303
Virginia,Elliston,1210,395,503,15,80,17,1010
Virginia,Emory,1189,803,280,14,0,15,1112
Virginia,Emporia,5672,1456,2003,467,145,519,4590
Virginia,Enon,3973,834,1633,390,142,187,3186
Virginia,Esmont,521,169,129,71,23,10,402
Virginia,Ettrick,5696,3351,1236,298,33,209,5127
Virginia,East Lexington,1171,371,494,116,0,81,1062
Virginia,Montclair,19896,3240,10075,1454,316,502,15587
Virginia,Monterey,156,27,74,12,2,11,126
Virginia,Hillsboro,84,21,48,8,0,1,78
Virginia,Mount Crawford,431,91,196,59,10,10,366
Virginia,Mountain Road,1430,298,602,62,12,94,1068
Virginia,Motley,992,163,536,62,0,72,833
Virginia,Moorefield Station,1096,258,448,58,8,24,796
Virginia,Montvale,556,147,285,32,25,39,528
Virginia,Montross,440,92,180,56,8,39,375
Virginia,Montrose,7880,2685,1695,987,139,455,5961
Virginia,Lovingston,380,153,76,86,4,48,367
Virginia,Lovettsville,2022,325,832,131,31,72,1391
Virginia,Louisa,2204,528,697,252,61,144,1682
Virginia,Loudoun Valley Estates,5659,429,2942,188,11,112,3682
Virginia,Lorton,19722,5034,8057,1067,597,617,15372
Virginia,Long Branch,7560,1625,3723,562,71,379,6360
Virginia,Loch Lomond,4149,1406,1402,267,145,242,3462
Virginia,Linton Hall,40567,6960,18327,1657,592,569,28105
Virginia,Lincolnia,23802,7301,9125,1548,495,674,19143
Virginia,Lexington,7071,4690,1231,269,28,300,6518
Virginia,Leesburg,47872,11158,20751,2774,856,1262,36801
Virginia,Lee Mont,265,53,131,12,15,31,242
Virginia,Lebanon,3388,745,1517,266,129,263,2920
Virginia,Laymantown,2510,257,1384,215,0,98,1954
Virginia,Mount Hermon,3981,652,2094,283,119,171,3319
Virginia,Mount Jackson,2253,606,812,211,60,101,1790
Virginia,Mount Sidney,412,66,220,0,17,13,316
Virginia,Mount Vernon,12639,2324,5930,885,221,589,9949
Virginia,Wytheville,8154,1775,3081,1006,279,867,7008
Virginia,Yorktown,130,42,68,20,0,0,130
Virginia,Scottsville,546,145,198,69,12,39,463
Virginia,Sedley,537,174,129,5,25,85,418
Virginia,Selma,339,105,69,47,21,97,339
Virginia,Seven Corners,8801,3160,2919,591,131,380,7181
Virginia,Seven Mile Ford,696,249,226,76,0,55,606
Virginia,Shawneeland,1345,193,774,71,43,63,1144
Virginia,Shawsville,1274,342,440,145,0,71,998
Virginia,Shenandoah,2412,475,1008,378,57,125,2043
Virginia,Lawrenceville,1419,751,215,100,47,62,1175
Virginia,Shenandoah Farms,3930,402,1970,359,43,172,2946
Virginia,New Hope,972,81,485,36,16,66,684
Virginia,New Church,211,24,95,32,0,21,172
Virginia,New Castle,166,28,42,31,9,12,122
Virginia,New Baltimore,9192,1596,4504,471,133,314,7018
Virginia,Nelsonia,367,107,213,12,0,35,367
Virginia,Nellysford,1139,108,617,173,69,75,1042
Virginia,Neabsco,16073,3795,7206,777,301,326,12405
Virginia,Nathalie,146,62,30,0,0,0,92
Virginia,Nassawadox,631,114,223,80,22,134,573
Virginia,Narrows,2166,389,785,365,109,105,1753
Virginia,Newington,13470,2997,6109,789,171,207,10273
Virginia,Laurel Park,883,146,369,68,0,63,646
Virginia,Laurel Hill,7569,1426,3466,650,13,310,5865
Virginia,Laurel,16618,5538,5314,1939,574,707,14072
Virginia,Jarratt,628,71,285,55,7,47,465
Virginia,Ivy,927,38,501,66,31,23,659
Virginia,Ivor,407,55,156,55,19,48,333
Virginia,Ivanhoe,379,136,188,21,0,34,379
Virginia,Irvington,490,57,291,79,0,34,461
Virginia,Iron Gate,354,57,130,77,9,31,304
Virginia,Innsbrook,7699,1807,3214,527,145,304,5997
Virginia,Independent Hill,8583,1737,4174,313,98,247,6569
Virginia,Independence,1211,249,324,234,55,141,1003
Virginia,Idylwood,18514,5990,6860,1320,199,549,14918
Virginia,Jolivue,1255,298,490,46,0,140,974
Virginia,Hybla Valley,16106,4686,5587,1142,336,645,12396
Virginia,Huntington,12718,4513,4952,1189,241,350,11245
Virginia,Hot Springs,526,68,183,31,49,75,406
Virginia,Horse Pasture,1857,276,731,270,65,194,1536
Virginia,Horntown,431,78,80,0,23,78,259
Virginia,Hopewell,22279,6422,6168,2549,585,1765,17489
Virginia,Honaker,1576,230,582,199,61,191,1263
Virginia,Hollymead,8352,1228,4056,685,49,296,6314
Virginia,Hollins,14654,3117,5922,1652,335,1496,12522
Virginia,Hiwassee,188,58,75,23,0,13,169
Virginia,Hillsville,2701,660,954,404,99,180,2297
Virginia,Hurt,1412,253,654,123,26,89,1145
Virginia,McMullin,329,66,87,83,0,70,306
Virginia,Jonesville,1263,319,469,118,26,117,1049
Virginia,Kenbridge,1233,277,410,117,37,87,928
Virginia,Lansdowne,11707,2225,5280,865,151,448,8969
Virginia,Lancaster,167,50,46,26,6,0,128
Virginia,Lake Wilderness,2570,546,1141,266,19,45,2017
Virginia,Lakeside,13039,3751,4625,1307,219,580,10482
Virginia,Lake Ridge,43963,9878,18517,3320,678,1241,33634
Virginia,Lake of the Woods,7926,1464,3801,751,79,551,6646
Virginia,Lake Monticello,9629,1316,5154,572,236,455,7733
Virginia,Lake Land'Or,3865,602,1562,376,31,125,2696
Virginia,Lake Holiday,2302,267,1305,73,9,64,1718
Virginia,Lake Caroline,2154,263,1046,238,0,175,1722
Virginia,Keller,170,32,80,14,1,8,135
Virginia,Lake Barcroft,9833,2099,4756,768,90,329,8042
Virginia,La Crosse,741,155,203,37,69,92,556
Virginia,King William,119,28,55,21,0,15,119
Virginia,Kingstowne,15935,3741,6970,1329,139,537,12716
Virginia,Kings Park West,13702,3719,6168,730,123,405,11145
Virginia,Kings Park,4564,948,2115,321,12,178,3574
Virginia,King George,5299,1316,2086,361,136,180,4079
Virginia,King and Queen Court House,132,0,78,12,0,0,90
Virginia,Kilmarnock,1443,308,509,240,15,219,1291
Virginia,Keysville,1067,363,243,115,45,88,854
Virginia,Keokee,286,34,167,14,23,37,275
Virginia,Lafayette,450,147,81,66,17,51,362
Virginia,McLean,47784,8515,24907,2209,396,2028,38055
Virginia,Deep Creek,55,0,31,9,0,0,40
Virginia,Woodlawn CDP (Carroll County),2266,427,1090,206,62,132,1917
Virginia,Warm Springs,58,35,0,7,0,0,42
Virginia,Warrenton,9843,2236,3816,1124,153,658,7987
Virginia,Warsaw,1287,277,375,192,39,156,1039
Virginia,Washington,136,35,64,17,2,13,131
Virginia,Wattsville,1195,164,537,110,82,90,983
Virginia,Waverly,1570,307,500,124,61,102,1094
Virginia,Waynesboro,21150,4736,8080,2011,605,1454,16886
Virginia,Weber City,1389,306,484,168,45,158,1161
Virginia,West Falls Church,29489,8226,12157,2060,513,775,23731
Virginia,Westlake Corner,1058,71,779,60,0,29,939
Virginia,West Point,3336,558,1535,268,80,235,2676
Virginia,West Springfield,22897,5619,10219,1781,387,639,18645
Virginia,Weyers Cave,2754,452,1169,215,134,34,2004
Virginia,White Stone,479,153,136,46,9,51,395
Virginia,Whitesville,346,72,189,0,8,36,305
Virginia,Williamsburg,14754,7945,3513,1020,380,568,13426
Virginia,Winchester,27168,7749,9114,3110,717,1401,22091
Virginia,Lynchburg,78158,30435,23274,6221,1391,3991,65312
Virginia,Luray,4843,1132,1877,552,152,505,4218
Virginia,Lunenburg,180,29,103,0,0,12,144
Virginia,Wyndham,10040,1419,4953,553,121,283,7329
Virginia,Woodstock,5181,885,2057,397,103,486,3928
Virginia,Woodlawn CDP (Fairfax County),22466,6990,7963,1781,456,435,17625
Virginia,Warfield,87,0,28,15,9,30,82
Virginia,Low Moor,122,0,42,38,0,32,112
Virginia,Woodburn,8883,2499,4076,527,105,252,7459
Virginia,Woodbridge,4448,1176,1601,610,111,77,3575
Virginia,Wolf Trap,16631,2955,9432,350,110,312,13159
Virginia,Wise,3185,929,1289,269,53,166,2706
Virginia,Wintergreen,377,58,235,0,38,46,377
Virginia,Windsor,2642,568,1039,301,99,194,2201
Virginia,Woodlake,6945,1443,3318,588,131,166,5646
Virginia,Lyndhurst,1681,341,832,99,37,41,1350
Virginia,Wakefield,13082,2679,6675,553,93,520,10520
Virginia,Virginia Beach,448290,112291,181371,40955,9904,17591,362112
Virginia,Surry,235,68,93,15,0,14,190
Virginia,Sussex,145,31,40,28,2,21,122
Virginia,Tangier,491,90,271,38,0,69,468
Virginia,Tappahannock,2223,641,700,262,57,201,1861
Virginia,Tasley,237,85,40,20,10,17,172
Virginia,Tazewell,4522,691,1858,605,63,344,3561
Virginia,Temperanceville,449,189,196,43,21,0,449
Virginia,Templeton,488,159,94,147,0,59,459
Virginia,The Plains,187,41,63,27,12,7,150
Virginia,Thynedale,72,35,0,10,0,27,72
Virginia,Timberlake,12440,2629,5448,980,369,648,10074
Virginia,Timberville,2576,586,792,355,81,178,1992
Virginia,Toms Brook,337,57,136,22,8,16,239
Virginia,Triangle,8901,2430,3253,603,285,270,6841
Virginia,Troutdale,149,29,66,15,8,13,131
Virginia,Troutville,551,115,261,60,16,43,495
Virginia,Tuckahoe,47316,10813,20557,3969,606,2691,38636
Virginia,Virgilina,135,27,64,9,0,16,116
Virginia,Vinton,8162,1790,3114,1061,219,521,6705
Virginia,Villa Heights,458,84,195,83,0,65,427
Virginia,Vienna,16341,3152,8010,780,118,624,12684
Virginia,Victoria,1809,400,695,192,76,179,1542
Virginia,Verona,3434,1085,1205,451,72,148,2961
Virginia,Wachapreague,201,12,126,11,0,30,179
Virginia,Vansant,389,63,132,44,0,107,346
Virginia,University of Virginia,8902,7402,1032,77,12,65,8588
Virginia,University Center,4341,1682,1453,456,36,39,3666
Virginia,Union Level,101,18,36,26,0,21,101
Virginia,Union Hall,1365,134,814,73,7,128,1156
Virginia,Tysons Corner,22437,5985,9721,1721,339,718,18484
Virginia,Twin Lakes,1744,226,848,118,31,42,1265
Virginia,Urbanna,556,142,208,73,8,86,517
Virginia,McKenney,401,81,153,43,5,48,330
Virginia,Wakefield,850,260,250,82,25,65,682
Virginia,South Riding,27441,3812,13252,1245,220,456,18985
Virginia,Springfield,30444,8440,12604,1385,637,2033,25099
Virginia,Spotsylvania Courthouse,4382,890,1639,404,42,198,3173
Virginia,Sperryville,259,56,150,0,0,15,221
Virginia,Southside Chesconessex,159,0,65,0,0,15,80
Virginia,South Run,6500,1193,3497,252,9,321,5272
Virginia,South Hill,4566,1122,1607,388,231,413,3761
Virginia,Southern Gateway,2900,771,1208,222,20,55,2276
Virginia,South Boston,8037,2215,2260,894,287,823,6479
Virginia,Southampton Meadows,398,0,135,0,110,45,290
Virginia,Snowville,185,41,97,0,11,6,155
Virginia,Smithfield,8233,1384,3853,693,186,425,6541
Virginia,Skyland Estates,713,177,376,40,0,0,593
Virginia,Shipman,412,141,115,79,0,43,378
Virginia,Sherando,746,311,279,48,14,38,690
Virginia,Short Pump,26902,5207,12275,1896,425,781,20584
Virginia,Shenandoah Retreat,578,139,213,136,0,15,503
Virginia,Lowes Island,11396,1815,5741,462,187,416,8621
Virginia,Sugar Grove,549,99,220,98,5,57,479
Virginia,Sugarland Run,12527,3331,5333,636,194,285,9779
Virginia,Springville,1647,541,780,46,0,40,1407
Virginia,Shenandoah Shores,906,192,363,46,0,27,628
Washington,Bryant,1815,357,1003,211,0,45,1616
Washington,Bryn Mawr-Skyway,16473,4669,5521,1477,364,1065,13096
Washington,Camano,15500,2364,8402,1630,101,785,13282
Washington,Burlington,8509,1893,2881,1123,220,553,6670
Washington,Burley,1735,497,627,216,0,58,1398
Washington,Buckley,4475,1348,1596,424,84,85,3537
Washington,Burbank,3114,609,1492,199,39,149,2488
Washington,Bunk Foss,3522,621,1726,293,32,146,2818
Washington,Buena,1691,219,500,10,60,10,799
Washington,Bucoda,622,156,250,63,12,29,510
Washington,Brush Prairie,2708,544,1290,236,7,125,2202
Washington,Burien,49785,13343,18393,5016,862,1834,39448
Washington,Browns Point,1260,265,605,133,19,40,1062
Washington,Krupp,45,20,13,7,0,3,43
Washington,Forks,3693,992,1243,497,20,248,3000
Washington,Fort Lewis,13163,2270,5645,327,45,23,8310
Washington,Four Lakes,221,47,73,88,0,13,221
Washington,Camas,20890,3964,9313,1981,239,641,16138
Washington,Fox Island,3731,551,2239,318,5,41,3154
Washington,Frederickson,19949,4159,8427,1677,251,581,15095
Washington,Freeland,1803,346,896,164,17,175,1598
Washington,Friday Harbor,2162,487,783,326,62,162,1820
Washington,Garfield,496,77,222,73,17,46,435
Washington,Garrett,1508,201,740,196,0,102,1239
Washington,Geneva,2544,482,1303,219,14,74,2092
Washington,George,648,199,223,21,0,19,462
Washington,Gig Harbor,7918,1819,3411,695,133,687,6745
Washington,Fords Prairie,1815,372,627,231,69,114,1413
Washington,Canterwood,3408,522,2159,89,0,145,2915
Washington,Cathlamet,612,154,203,86,6,53,502
Washington,Carbonado,547,159,201,54,0,18,432
Washington,Clear Lake CDP (Pierce County),1114,177,502,235,0,65,979
Washington,Clayton,346,73,114,52,16,13,268
Washington,Clarkston Heights-Vineland,6590,923,3546,510,81,443,5503
Washington,Clarkston,7330,1466,2457,1399,186,390,5898
Washington,Clallam Bay,378,117,131,40,26,0,314
Washington,Chinook,341,36,244,0,0,7,287
Washington,Chico,2157,426,1176,183,47,82,1914
Washington,Chewelah,2592,487,974,391,75,173,2100
Washington,Cherry Grove,647,173,274,11,14,6,478
Washington,Cheney,11171,6336,2462,828,74,230,9930
Washington,Chelan Falls,186,93,71,22,0,0,186
Washington,Chelan,3974,542,1750,721,105,156,3274
Washington,Canyon Creek,3045,665,1199,394,20,90,2368
Washington,Chehalis,7314,2149,2281,928,150,397,5905
Washington,Central Park,2652,359,1357,225,35,209,2185
Washington,Centralia,16683,3921,5764,2167,285,1294,13431
Washington,Centerville,167,30,71,32,0,8,141
Washington,Cavalero,4950,1042,2253,448,0,53,3796
Washington,Glacier,73,18,27,14,0,14,73
Washington,Cathcart,2553,533,1463,136,0,88,2220
Washington,Castle Rock,2334,593,702,309,152,158,1914
Washington,Cashmere,3146,633,1400,270,17,199,2519
Washington,Cascade Valley,2280,326,1061,386,19,0,1792
Washington,Carson,2361,586,989,201,7,125,1908
Washington,Carnation,1733,353,665,234,41,50,1343
Washington,Carlsborg,675,64,255,282,11,63,675
Washington,Chain Lake,4660,813,2232,339,26,88,3498
Washington,Gleed,2948,625,1465,150,9,141,2390
Washington,Grapeview,1156,181,523,230,4,63,1001
Washington,Gold Bar,2193,567,807,241,27,71,1713
Washington,Hockinson,4985,818,2325,317,65,215,3740
Washington,Hobart,6362,1056,3285,593,0,248,5182
Washington,High Bridge,3152,622,1796,137,21,76,2652
Washington,Herron Island,81,0,74,7,0,0,81
Washington,Hazel Dell,20155,4785,7917,2655,291,739,16387
Washington,Hatton,74,13,27,14,5,3,62
Washington,Hat Island,0,0,0,0,0,0,0
Washington,Hartline,119,18,58,11,2,6,95
Washington,Harrington,327,56,166,40,3,21,286
Washington,Harrah,680,213,239,21,3,21,497
Washington,Hansville,3617,307,1920,522,37,143,2929
Washington,Hamilton,230,50,81,57,7,10,205
Washington,Hogans Corner,161,76,23,62,0,0,161
Washington,Clear Lake CDP (Skagit County),1061,198,557,108,0,10,873
Washington,Green Bluff,992,286,502,39,16,23,866
Washington,Grays River,474,97,245,27,0,34,403
Washington,Grayland,489,48,318,39,41,43,489
Washington,Kent,124292,34737,47177,10422,1932,3953,98221
Washington,Ketron Island,0,0,0,0,0,0,0
Washington,Kettle Falls,1437,226,643,154,30,119,1172
Washington,Key Center,3811,805,1838,293,55,208,3199
Washington,Keyport,488,5,378,7,0,8,398
Washington,Kingston,1963,407,762,326,18,98,1611
Washington,Kirkland,84721,19383,39086,8098,742,2517,69826
Washington,Kittitas,1387,209,627,186,25,45,1092
Washington,Klahanie,11586,1728,6121,690,57,184,8780
Washington,Greenwater,109,49,32,9,0,19,109
Washington,Glenwood,186,28,69,26,7,13,143
Washington,Home,1702,308,636,216,17,61,1238
Washington,Hoquiam,8479,1989,2637,1271,168,666,6731
Washington,Goldendale,3437,834,1278,289,54,290,2745
Washington,Gorst,484,104,174,69,59,78,484
Washington,Graham,24976,4476,11383,2061,171,769,18860
Washington,Grand Coulee,897,172,326,198,22,65,783
Washington,Grand Mound,3329,496,1576,173,38,30,2313
Washington,Grandview,11083,2788,3476,789,212,435,7700
Washington,Granger,3404,978,1044,178,51,31,2282
Washington,Granite Falls,3451,776,1227,472,116,120,2711
Washington,Klickitat,448,92,206,42,4,30,374
Washington,Kendall,126,34,51,0,0,15,100
Washington,Kelso,11837,3173,3480,1649,327,632,9261
Washington,Keller,228,64,45,21,14,30,174
Washington,Hoodsport,880,175,165,254,0,100,694
Washington,Kayak Point,2068,452,1015,140,51,57,1715
Washington,Kalama,2498,454,1058,336,32,136,2016
Washington,Kahlotus,224,35,96,33,0,2,166
Washington,Junction City,9,0,0,9,0,0,9
Washington,Jamestown,427,59,184,70,22,0,335
Washington,Issaquah,33682,6226,15479,3170,336,1245,26456
Washington,Ione,342,65,155,48,1,29,298
Washington,Indianola,3486,770,1485,429,67,118,2869
Washington,Index,178,58,77,20,2,2,159
Washington,Inchelium,494,159,106,72,12,24,373
Washington,Ilwaco,1021,235,406,68,15,96,820
Washington,Hunts Point,508,77,277,40,0,20,414
Washington,Humptulips,251,83,130,38,0,0,251
Washington,Kapowsin,285,39,177,8,0,16,240
Washington,Clearview,3682,716,1916,278,50,67,3027
Washington,Des Moines,30715,8539,12116,2586,621,1564,25426
Washington,Cliffdell,138,4,81,19,0,7,111
Washington,Everson,2553,600,978,214,50,124,1966
Washington,Everett,105685,30049,35538,13746,2075,4740,86148
Washington,Esperance,3811,827,1713,340,42,198,3120
Washington,Eschbach,260,52,145,0,0,0,197
Washington,Erlands Point-Kitsap Lake,3065,628,1061,465,86,95,2335
Washington,Ephrata,7948,1592,3167,796,56,428,6039
Washington,Fairchild AFB,2947,613,1381,5,0,12,2011
Washington,Enumclaw,11494,2776,3732,1676,182,572,8938
Washington,Enetai,1919,319,940,274,9,82,1624
Washington,Endicott,239,35,117,28,5,10,195
Washington,Elmer City,307,70,101,51,6,24,252
Washington,Elma,3035,967,610,542,37,91,2247
Washington,Ellensburg,18637,9808,4282,1656,111,444,16301
Washington,Elk Plain,14252,3335,6103,1090,172,511,11211
Washington,Entiat,1190,228,582,144,27,35,1016
Washington,Electric City,1094,165,539,122,0,73,899
Washington,Fairfield,464,53,224,66,6,30,379
Washington,Fairwood CDP (Spokane County),8262,1564,3584,776,48,268,6240
Washington,McKenna,970,29,484,31,30,33,607
Washington,McMillin,1399,132,829,173,6,59,1199
Washington,Malden,168,25,69,18,2,24,138
Washington,Malo,0,0,0,0,0,0,0
Washington,Fircrest,6612,1294,2603,777,58,455,5187
Washington,Finley,5958,1138,2782,485,32,195,4632
Washington,Fairwood CDP (King County),20032,4726,8908,1804,164,636,16238
Washington,Fife Heights,2009,493,805,230,15,72,1615
Washington,Fern Prairie,2108,473,974,209,33,73,1762
Washington,Ferndale,12355,2821,5031,1305,158,514,9829
Washington,Felida,7744,1473,3874,491,58,316,6212
Washington,Federal Way,92859,25429,34862,9138,1676,3597,74702
Washington,Farmington,104,16,56,6,0,2,80
Washington,Fall City,1729,358,840,195,19,111,1523
Washington,Fife,9477,2640,3253,1102,177,258,7430
Washington,Machias,1168,313,493,93,16,25,940
Washington,Elbe,0,0,0,0,0,0,0
Washington,Edison,162,21,68,0,0,13,102
Washington,Dixie,268,56,109,37,0,9,211
Washington,Curlew Lake,560,74,318,31,23,9,455
Washington,Cusick,106,34,46,3,0,14,97
Washington,Custer,423,117,208,0,0,21,346
Washington,Dallesport,1365,182,539,230,31,132,1114
Washington,Danville,32,7,7,18,0,0,32
Washington,Dollars Corner,1101,279,527,84,0,142,1032
Washington,Darrington,1497,324,493,209,49,79,1154
Washington,Davenport,1610,327,655,199,30,105,1316
Washington,Dayton,2852,665,1124,346,41,167,2343
Washington,Deep River,182,27,112,4,13,14,170
Washington,Deer Park,3784,713,1441,532,28,142,2856
Washington,Deming,420,127,212,21,2,0,362
Washington,Desert Aire,2131,231,789,113,23,61,1217
Washington,Dash Point,830,135,439,116,4,45,739
Washington,Edmonds,40689,9525,18293,4476,560,2304,35158
Washington,Donald,0,0,0,0,0,0,0
Washington,DuPont,9054,1210,4546,592,36,128,6512
Washington,Covington,18689,3844,8132,1927,179,375,14457
Washington,Cowiche,1007,113,441,27,0,0,581
Washington,Creston,273,40,140,21,10,21,232
Washington,Crocker,1385,386,700,58,9,33,1186
Washington,Curlew,117,24,44,21,0,7,96
Washington,Edgewood,9600,2031,5022,753,56,194,8056
Washington,Duluth,1550,233,807,139,0,82,1261
Washington,Eatonville,2830,512,1227,255,10,136,2140
Washington,East Renton Highlands,11092,2235,5284,917,192,344,8972
Washington,East Port Orchard,5109,1377,1874,514,50,208,4023
Washington,Easton,374,43,144,122,0,14,323
Washington,Eastmont,21274,4704,9753,2008,251,611,17327
Washington,East Cathlamet,490,139,275,44,0,32,490
Washington,Duvall,7373,1703,3027,514,14,116,5374
Washington,East Wenatchee,13473,3096,5609,1156,147,513,10521
Washington,Cle Elum,2544,613,838,424,47,121,2043
Washington,McCleary,1965,346,791,189,14,104,1444
Washington,Mabton,2329,620,697,141,75,50,1583
Washington,Coupeville,2141,387,932,283,20,177,1799
Washington,Fobes Hill,2824,657,1297,271,37,101,2363
Washington,Five Corners,19662,4689,7259,1895,293,587,14723
Washington,La Center,3066,392,1553,284,27,83,2339
Washington,Lacey,44825,10189,18663,4293,653,2229,36027
Washington,La Conner,748,105,260,173,15,102,655
Washington,Country Homes,5573,2724,1457,500,92,188,4961
Washington,LaCrosse,265,48,155,30,0,21,254
Washington,Lake Bosworth,554,121,278,7,8,41,455
Washington,Lake Cassidy,3666,583,1727,415,45,137,2907
Washington,Lake Cavanaugh,125,0,68,49,0,0,117
Washington,Lake Forest Park,13059,2577,6720,1182,64,523,11066
Washington,Lake Goodwin,3577,755,1976,319,17,52,3119
Washington,Lake Holm,3416,828,1803,149,0,232,3012
Washington,La Grande,102,9,93,0,0,0,102
Washington,Disautel,27,0,21,0,0,6,27
Washington,Coulee Dam,1290,291,547,141,18,65,1062
Washington,Cottage Lake,23703,4925,12766,1036,32,434,19193
Washington,Clinton,766,22,511,69,0,34,636
Washington,Clover Creek,6792,1453,2728,976,88,266,5511
Washington,Clyde Hill,3150,497,1727,128,12,112,2476
Washington,Cohassett Beach,641,115,265,9,16,89,494
Washington,Colfax,2842,522,1112,414,10,227,2285
Washington,College Place,8957,2647,3222,1109,133,413,7524
Washington,Coulee City,634,124,278,65,17,30,514
Washington,Colton,435,47,258,50,0,14,369
Washington,Conconully,172,27,92,28,2,10,159
Washington,Concrete,739,157,275,128,9,31,600
Washington,Connell,5359,1869,1303,650,197,114,4133
Washington,Conway,10,0,10,0,0,0,10
Washington,Copalis Beach,370,145,57,147,0,21,370
Washington,Cosmopolis,1547,293,754,153,8,105,1313
Washington,Colville,4692,1162,1658,636,60,340,3856
Washington,McChord AFB,3288,572,1412,27,0,0,2011
Washington,Lakeland North,12380,3329,5027,1208,93,446,10103
Washington,Lake McMurray,132,30,55,24,0,14,123
Washington,Lind,488,66,223,44,0,20,353
Washington,Lochsloy,2593,558,1326,173,16,37,2110
Washington,Lofall,2081,362,995,299,29,90,1775
Washington,Long Beach,1434,278,549,319,29,64,1239
Washington,Longbranch,3023,387,1490,436,0,70,2383
Washington,Longview,36619,8130,13486,4767,943,2555,29881
Washington,Liberty Lake,8269,1154,3648,765,58,342,5967
Washington,Longview Heights,3403,752,1614,452,26,102,2946
Washington,Loon Lake,766,111,429,73,4,13,630
Washington,Lower Elochoman,130,6,116,8,0,0,130
Washington,Lyle,578,97,251,24,0,77,449
Washington,Lyman,591,93,222,103,0,41,459
Washington,Lynden,12886,2063,6492,793,24,677,10049
Washington,Lynnwood,36491,10838,13085,3968,517,1825,30233
Washington,Loomis,85,38,16,15,0,16,85
Washington,Lakeland South,13460,2772,6141,1235,106,349,10603
Washington,Lewisville,1732,206,910,101,42,42,1301
Washington,Leavenworth,2227,546,871,284,20,208,1929
Washington,Lake Marcel-Stillwater,1269,253,714,48,40,20,1075
Washington,Lake Morton-Berrydale,9921,1764,5164,611,189,546,8274
Washington,Lake Roesiger,772,53,297,242,0,24,616
Washington,Lake Shore,6957,1323,3342,636,72,254,5627
Washington,Lake Stevens,29774,6275,12513,2979,287,703,22757
Washington,Lake Stickney,8930,2293,3366,866,137,237,6899
Washington,Lebam,133,38,85,0,0,5,128
Washington,Lake Tapps,12710,2992,5796,1017,95,339,10239
Washington,Lakewood,59122,14015,22030,7754,1379,2728,47906
Washington,Lamont,84,14,41,12,0,2,69
Washington,Langley,1287,153,603,173,11,112,1052
Washington,Larch Way,3834,765,1808,247,0,94,2914
Washington,Latah,160,22,79,5,0,4,110
Washington,Laurier,0,0,0,0,0,0,0
Washington,Lakeview,892,173,346,128,0,129,776
Washington,Lake Ketchum,948,71,557,154,0,41,823
Washington,Kenmore,21575,4261,10278,1744,154,608,17045
Washington,Tukwila,19757,6005,6485,1970,333,809,15602
Washington,Winlock,1513,328,520,168,44,87,1147
Washington,Winthrop,364,65,122,80,16,15,298
Washington,Wishram,364,81,144,41,5,33,304
Washington,Wollochet,5930,970,2931,473,62,341,4777
Washington,Woodinville,11373,2540,4947,1007,90,513,9097
Washington,Woodland,5589,1413,2034,316,154,158,4075
Washington,Woods Creek,5652,1156,2747,436,58,115,4512
Washington,Woodway,1337,245,721,63,10,22,1061
Washington,Yacolt,1819,348,779,109,0,44,1280
Washington,Yakima,93261,24549,31695,8789,1885,4650,71568
Washington,Yarrow Point,1172,175,703,41,0,33,952
Washington,Yelm,7701,1694,2889,539,115,216,5453
Washington,Zillah,3100,752,1287,255,55,50,2399
Washington,Alderton,3314,628,1383,472,18,108,2609
Washington,Alder,64,0,27,12,0,0,39
Washington,Albion,585,172,213,84,0,27,496
Washington,Airway Heights,6449,2234,1656,1300,247,170,5607
Washington,Ahtanum,3359,464,1613,213,69,140,2499
Washington,Addy,139,38,29,13,0,29,109
Washington,Wilson Creek,185,33,42,34,13,33,155
Washington,Willapa,233,15,146,20,4,10,195
Washington,Wilkeson,406,73,179,62,5,20,339
Washington,Wilderness Rim,1476,134,1070,79,0,12,1295
Washington,Nooksack,1807,239,764,89,29,34,1155
Washington,Normandy Park,6568,1357,3104,518,52,399,5430
Washington,North Bend,6305,976,2899,565,115,140,4695
Washington,Warm Beach,2397,406,1261,248,4,118,2037
Washington,Washougal,14777,3222,6360,1233,206,534,11555
Washington,Washtucna,279,29,122,35,6,31,223
Washington,Waterville,1869,356,711,197,9,96,1369
Washington,Wauna,4451,878,2086,586,37,136,3723
Washington,Waverly,80,24,23,13,4,0,64
Washington,Acme,156,68,0,0,44,0,112
Washington,Wenatchee,32950,8036,11792,2941,569,1831,25169
Washington,West Pasco,2223,233,1207,316,17,113,1886
Washington,Westport,1965,392,672,447,51,64,1626
Washington,West Richland,13048,2476,6010,1096,184,257,10023
Washington,West Side Highway,5812,1107,2303,497,31,380,4318
Washington,Whidbey Island Station,1938,1545,245,48,21,0,1859
Washington,White Center,14728,4856,4806,1332,326,520,11840
Washington,White Salmon,2212,699,745,236,38,160,1878
Washington,White Swan,652,269,98,40,9,22,438
Washington,Wilbur,682,78,305,87,4,92,566
Washington,West Clarkston-Highland,5470,1233,2208,682,68,449,4640
Washington,Nisqually Indian Community,644,204,155,63,6,49,477
Washington,Aberdeen Gardens,261,28,143,28,0,24,223
Washington,North Fort Lewis,3682,1618,1013,130,63,9,2833
Washington,Othello,7624,1641,2756,267,170,256,5090
Washington,Otis Orchards-East Farms,6792,1297,2961,793,35,434,5520
Washington,Outlook,305,218,11,0,0,0,229
Washington,Oyehut,13,0,0,0,0,13,13
Washington,Pacific,6954,1889,2747,524,137,223,5520
Washington,Pacific Beach,216,72,74,0,0,56,202
Washington,Packwood,212,30,171,0,0,11,212
Washington,Palouse,1071,184,519,103,0,28,834
Washington,Parker,125,30,32,11,0,18,91
Washington,Parkland,36318,11578,11689,4158,449,1245,29119
Washington,Parkwood,7294,1759,3145,648,104,303,5959
Washington,Pasco,67391,16532,22911,5028,1366,1553,47390
Washington,Pateros,678,181,230,59,8,27,505
Washington,Peaceful Valley,3654,953,1437,331,54,151,2926
Washington,Pe Ell,553,117,217,102,2,21,459
Washington,Picnic Point,9094,2031,4292,759,66,327,7475
Washington,Pine Grove,136,14,94,6,7,0,121
Washington,Point Roberts,1270,278,596,149,37,96,1156
Washington,Pomeroy,1279,126,612,171,24,114,1047
Washington,Oso,231,72,104,10,8,17,211
Washington,Orting,7078,1231,2761,714,93,320,5119
Washington,Oroville,1863,546,643,205,35,155,1584
Washington,Orient,73,7,40,11,0,12,70
Washington,North Lynnwood,18829,5789,6694,2251,195,330,15259
Washington,North Marysville,137,12,105,7,0,13,137
Washington,North Omak,773,164,300,19,30,56,569
Washington,Northport,334,84,128,43,18,16,289
Washington,North Puyallup,1758,377,810,300,28,112,1627
Washington,North Sultan,201,28,109,20,0,9,166
Washington,Northwest Stanwood,82,25,19,18,0,0,62
Washington,North Yelm,2700,436,919,406,60,185,2006
Washington,Oakesdale,543,98,243,63,11,38,453
Washington,Aberdeen,16429,4098,5721,1954,236,885,12894
Washington,Oak Harbor,22331,4568,9225,2304,232,886,17215
Washington,Ocean City,156,38,84,0,0,0,122
Washington,Ocean Park,1315,52,624,357,41,102,1176
Washington,Ocean Shores,5637,897,3012,664,172,382,5127
Washington,Odessa,744,122,360,83,12,87,664
Washington,Okanogan,2594,666,793,323,95,207,2084
Washington,Olympia,48941,14740,17163,6442,659,2149,41153
Washington,Omak,4812,1107,1740,452,70,339,3708
Washington,Onalaska,977,132,402,51,59,18,662
Washington,Orchards,21299,4511,8239,1627,280,861,15518
Washington,Oakville,725,100,300,91,0,55,546
Washington,Nile,89,0,82,7,0,0,89
Washington,Newport,2263,498,738,355,21,201,1813
Washington,Newcastle,10994,2158,5376,884,92,340,8850
Washington,Benton City,3156,700,1334,331,53,106,2524
Washington,Bethel,3906,972,1893,239,0,137,3241
Washington,Bickleton,61,12,27,3,0,5,47
Washington,Big Lake,1934,325,1086,152,36,97,1696
Washington,Bingen,914,231,307,104,10,43,695
Washington,Birch Bay,8404,1303,4171,937,163,383,6957
Washington,Tumwater,18478,4563,7624,2051,214,877,15329
Washington,Ames Lake,1358,226,742,72,38,12,1090
Washington,Amboy,1878,207,853,82,0,29,1171
Washington,Amanda Park,154,46,43,17,0,15,121
Washington,Altoona,66,3,63,0,0,0,66
Washington,Almira,263,29,121,25,4,22,201
Washington,Allyn,2144,494,1234,97,0,66,1891
Washington,Algona,3107,794,1129,289,78,48,2338
Washington,Alger,141,25,60,10,0,31,126
Washington,Alderwood Manor,9337,2226,4242,558,142,264,7432
Washington,Mercer Island,24120,3616,12507,1489,193,1262,19067
Washington,Mesa,352,84,146,30,1,7,268
Washington,Metaline,206,34,82,35,0,12,163
Washington,Bellingham,82944,34027,24593,8835,1050,3520,72025
Washington,Bell Hill,954,72,789,60,0,11,932
Washington,Bellevue,134630,31419,63557,10945,1202,4905,112028
Washington,Belfair,3298,561,1429,362,66,182,2600
Washington,Anacortes,16048,2894,7689,1833,209,991,13616
Washington,Anderson Island,1053,195,690,99,13,56,1053
Washington,Arlington,18578,3839,7776,1647,137,982,14381
Washington,Arlington Heights,2725,647,1060,252,82,128,2169
Washington,Artondale,13376,2272,7226,906,20,385,10809
Washington,Ashford,296,132,52,51,0,61,296
Washington,Asotin,1360,273,612,155,4,50,1094
Washington,Auburn,74527,19178,28015,7271,1219,2813,58496
Washington,Bainbridge Island,23343,3615,11938,2400,165,928,19046
Washington,Metaline Falls,136,40,46,25,0,15,126
Washington,Bangor Base,6392,2045,2603,57,25,0,4730
Washington,Barberton,6201,963,3168,334,41,287,4793
Washington,Baring,164,35,74,36,3,0,148
Washington,Barney's Junction,179,0,105,15,0,39,159
Washington,Barstow,69,0,48,0,0,7,55
Washington,Basin City,1373,439,383,0,43,33,898
Washington,Battle Ground,18576,3757,7317,1687,183,729,13673
Washington,Bay Center,202,41,121,11,0,16,189
Washington,Bay View,826,24,535,91,0,17,667
Washington,Beaux Arts Village,333,40,170,25,3,7,245
Washington,Banks Lake South,200,32,92,10,0,9,143
Washington,Methow,49,30,10,9,0,0,49
Washington,Midland,8349,2293,2826,936,111,340,6506
Washington,Mill Creek,19028,3606,9611,1390,169,810,15586
Washington,Blaine,4905,725,2181,580,23,250,3759
Washington,Blyn,30,0,6,23,0,0,29
Washington,Bonney Lake,18516,3736,8020,1601,140,496,13993
Washington,Bothell,41207,9306,18090,3759,643,1710,33508
Washington,Bothell East,9307,1561,4454,602,88,284,6989
Washington,Bothell West,19088,3344,9003,1721,47,490,14605
Washington,Boulevard Park,3815,1292,1269,296,99,186,3142
Washington,Boyds,91,0,60,0,0,0,60
Washington,Brady,604,120,333,16,0,31,500
Washington,Black Diamond,4291,811,2205,309,0,110,3435
Washington,Bremerton,39017,13212,11841,5333,766,2013,33165
Washington,Bridgeport,2285,462,900,138,56,55,1611
Washington,Brier,6443,1249,3449,446,31,137,5312
Washington,Brinnon,705,106,298,151,16,76,647
Washington,Medina,3120,472,1700,134,7,87,2400
Washington,Medical Lake,4924,1472,1395,703,185,238,3993
Washington,Neah Bay,945,329,234,88,21,25,697
Washington,Neilton,361,97,177,17,9,3,303
Washington,Nespelem,173,66,35,25,0,13,139
Washington,Nespelem Community,230,101,42,29,3,11,186
Washington,Brewster,2624,601,967,117,49,138,1872
Washington,Port Angeles,19200,5129,6795,2582,324,1195,16025
Washington,Navy Yard City,2622,867,655,497,38,99,2156
Washington,Napavine,1748,289,794,216,41,75,1415
Washington,Mill Creek East,17967,3389,8419,1308,158,459,13733
Washington,Millwood,1686,395,668,233,15,97,1408
Washington,Milton,7219,1749,2909,790,68,470,5986
Washington,Mineral,188,31,47,63,0,47,188
Washington,Minnehaha,9548,1866,4129,1335,78,238,7646
Washington,Mirrormont,3763,690,2042,255,44,131,3162
Washington,Moclips,0,0,0,0,0,0,0
Washington,Monroe,17734,4896,6013,2165,434,540,14048
Washington,Monroe North,1584,112,873,49,0,52,1086
Washington,Naselle,342,70,170,4,0,59,303
Washington,Montesano,3894,843,1513,432,53,319,3160
Washington,Moses Lake,21579,4391,7824,2318,272,859,15664
Washington,Moses Lake North,4057,1440,962,415,93,100,3010
Washington,Mossyrock,789,157,346,85,25,32,645
Washington,Mountlake Terrace,20521,5438,7831,2383,424,814,16890
Washington,Mount Vernon,32957,7552,12940,3332,504,1204,25532
Washington,Mount Vista,7995,1448,3910,827,139,316,6640
Washington,Moxee,3702,796,1313,345,57,59,2570
Washington,Mukilteo,20818,4771,9617,2153,130,575,17246
Washington,Naches,881,173,370,89,14,45,691
Washington,Morton,1296,257,358,203,21,151,990
Washington,Port Angeles East,3406,788,1401,450,60,200,2899
Washington,North Bonneville,1317,231,589,196,0,80,1096
Washington,Port Gamble Tribal Community,898,206,287,184,3,25,705
Washington,Sumas,1563,346,636,128,4,61,1175
Washington,Summit,7467,1321,3744,773,151,401,6390
Washington,Summit View,7014,2033,2421,941,50,235,5680
Washington,Summitview,1501,460,618,0,13,14,1105
Washington,Sumner,9584,2304,3193,1320,219,501,7537
Washington,Sunday Lake,838,108,347,114,0,26,595
Washington,Sunnyside,16204,3914,5193,1123,219,558,11007
Washington,Sunnyslope,3452,563,1936,109,31,175,2814
Washington,Suquamish,4220,979,1639,637,56,198,3509
Washington,Porter,233,42,142,0,9,10,203
Washington,Sultan,4744,1364,1832,414,37,162,3809
Washington,Tacoma,203481,58615,69507,25288,3690,8882,165982
Washington,Tampico,427,138,132,93,0,0,363
Washington,Tanglewilde,6110,1388,2278,858,84,198,4806
Washington,Tanner,1048,210,496,93,0,20,819
Washington,Tekoa,824,145,321,119,11,71,667
Washington,Tenino,1915,451,624,273,39,119,1506
Washington,Terrace Heights,6952,1626,3106,769,43,223,5767
Washington,Thorp,351,101,134,45,9,7,296
Washington,Three Lakes,2902,453,1720,318,39,62,2592
Washington,Tieton,1391,276,545,123,19,50,1013
Washington,Tokeland,240,34,139,14,1,17,205
Washington,Taholah,844,309,183,85,17,44,638
Washington,Toledo,605,157,228,61,23,59,528
Washington,Sudden Valley,6815,1607,3114,667,101,283,5772
Washington,Steptoe,184,24,92,28,8,12,164
Washington,Snohomish,9437,2075,3503,1482,115,562,7737
Washington,Snoqualmie,12115,1443,6097,860,0,65,8465
Washington,Snoqualmie Pass,249,69,113,52,1,6,241
Washington,Soap Lake,1766,361,631,264,56,110,1422
Washington,South Bend,1703,419,524,298,34,147,1422
Washington,South Cle Elum,552,145,203,67,0,54,469
Washington,South Creek,2140,426,1067,360,62,113,2028
Washington,South Hill,55592,11115,24588,4330,568,1590,42191
Washington,South Prairie,292,60,116,34,10,23,243
Washington,South Wenatchee,1728,614,532,238,45,0,1429
Washington,Stevenson,1402,271,551,223,18,105,1168
Washington,Southworth,2393,415,1291,225,0,64,1995
Washington,Spangle,186,39,64,42,2,22,169
Washington,Spokane,210695,58519,74249,26450,2419,10366,172003
Washington,Spokane Valley,92286,20305,38246,10834,970,4245,74600
Washington,Sprague,589,98,226,99,0,45,468
Washington,Springdale,304,44,93,35,0,23,195
Washington,Stansberry Lake,2312,458,975,307,50,38,1828
Washington,Stanwood,6560,1079,2233,902,104,346,4664
Washington,Starbuck,90,19,44,17,2,8,90
Washington,Startup,696,188,294,62,0,47,591
Washington,Steilacoom,6118,1364,2899,626,62,202,5153
Washington,Spanaway,29214,6937,11279,2872,589,1026,22703
Washington,Skykomish,130,39,44,31,0,8,122
Washington,Tonasket,1053,223,272,174,18,178,865
Washington,Torboy,126,8,78,5,0,0,91
Washington,Twisp,976,194,347,238,10,38,827
Washington,Twin Lakes,103,18,45,21,0,7,91
Washington,Mattawa,4516,1220,1386,88,68,13,2775
Washington,Marysville,63760,14214,26326,6121,564,2731,49956
Washington,Maryhill,0,0,0,0,0,0,0
Washington,Martha Lake,17163,4828,7033,1643,117,321,13942
Washington,Marrowstone,1242,199,600,114,0,52,965
Washington,Markham,126,0,96,0,0,19,115
Washington,Marietta-Alderwood,4704,1289,1745,422,179,170,3805
Washington,Marcus,163,17,74,43,0,5,139
Washington,Union,345,0,255,66,0,24,345
Washington,Marblemount,63,19,16,20,0,0,55
Washington,Maple Valley,24682,3907,11407,1878,178,727,18097
Washington,Maple Heights-Lake Desire,3416,676,1783,335,58,102,2954
Washington,Maple Falls,14,14,0,0,0,0,14
Washington,Manson,1284,199,603,158,8,61,1029
Washington,Mansfield,291,29,180,35,2,13,259
Washington,Manchester,5094,1088,2166,617,3,287,4161
Washington,Maltby,11220,2341,5525,926,64,319,9175
Washington,Malott,649,161,264,50,5,0,480
Washington,Malone,551,50,221,51,16,29,367
Washington,Kennewick,76918,17823,28638,7334,1500,3578,58873
Washington,Maplewood,4961,766,2505,435,72,271,4049
Washington,Toppenish,9006,2603,2914,285,160,216,6178
Washington,Union Gap,6042,1587,1684,708,155,252,4386
Washington,Uniontown,418,36,214,49,5,14,318
Washington,Touchet,436,75,207,28,10,16,336
Washington,Town and Country,5481,1204,2213,342,105,319,4183
Washington,Tracyton,6205,1588,2345,702,86,314,5035
Washington,Trout Lake,640,61,351,70,11,16,509
Washington,Warden,2735,556,936,195,51,97,1835
Washington,Wapato,5075,1489,1415,254,177,164,3499
Washington,Walnut Grove,9732,1669,4447,1002,188,493,7799
Washington,Wallula,302,63,55,17,0,0,135
Washington,Waller,7998,1802,3615,886,101,465,6869
Washington,Walla Walla East,1767,207,1027,77,0,37,1348
Washington,Union Hill-Novelty Hill,21510,3072,11833,1282,101,735,17023
Washington,Walla Walla,31957,10366,10063,3354,651,1839,26273
Washington,Verlot,115,0,64,10,0,13,87
Washington,Venersborg,3823,514,2211,114,39,75,2953
Washington,Vaughn,527,138,303,7,1,47,496
Washington,Vashon,10189,2098,4966,1089,82,763,8998
Washington,Vantage,27,0,18,0,0,9,27
Washington,Vancouver,168050,41983,61459,20990,3579,7389,135400
Washington,Valley,163,59,85,14,2,0,160
Washington,Vader,674,105,256,55,26,73,515
Washington,Upper Elochoman,51,11,18,22,0,0,51
Washington,University Place,31991,7935,12476,3307,384,1510,25612
Washington,Waitsburg,1128,248,479,141,0,71,939
Washington,Skokomish,691,272,131,76,22,25,526
Washington,Swede Heaven,829,162,442,56,19,20,699
Washington,Sisco Heights,2829,540,1579,180,22,90,2411
Washington,Rockford,367,52,172,55,7,9,295
Washington,Rock Island,856,149,332,116,13,34,644
Washington,Rockport,78,14,34,0,0,30,78
Washington,Rocky Point,1592,337,671,167,56,101,1332
Washington,Ronald,200,81,91,28,0,0,200
Washington,Roosevelt,148,3,79,8,0,5,95
Washington,Rosalia,635,118,266,93,0,35,512
Washington,Rosburg,429,87,144,74,0,30,335
Washington,Puget Island,798,139,352,168,14,0,673
Washington,Rosedale,4620,1068,1890,650,36,167,3811
Washington,Rochester,2249,523,880,220,0,225,1848
Washington,Roslyn,911,171,371,98,25,29,694
Washington,Royal City,1695,479,544,55,26,31,1135
Washington,Ruston,915,248,354,141,15,36,794
Washington,Ryderwood,281,14,130,96,0,41,281
Washington,St. John,597,67,242,86,0,95,490
Washington,Salmon Creek,21301,4838,9366,1943,280,681,17108
Washington,Sammamish,50163,6919,27105,1937,102,653,36716
Washington,Prosser,5819,1032,2239,496,93,226,4086
Washington,Prescott,377,79,111,76,15,12,293
Washington,Prairie Ridge,12495,2920,5189,1090,115,429,9743
Washington,Prairie Heights,4306,789,2006,392,29,87,3303
Washington,Roy,634,141,280,57,9,43,530
Washington,May Creek,661,151,290,71,25,0,537
Washington,Mead,7363,1278,3549,833,30,354,6044
Washington,Meadowdale,2806,738,1297,222,0,118,2375
Washington,River Road,383,135,188,37,0,0,360
Washington,Riverbend,2121,340,942,333,34,12,1661
Washington,Ritzville,1603,233,685,183,48,131,1280
Washington,Ridgefield,5693,1092,2593,484,18,64,4251
Washington,Richland,52291,10925,22737,4766,528,2291,41247
Washington,Republic,1154,240,343,167,31,156,937
Washington,Renton,97234,26521,37056,9559,1690,3554,78380
Washington,Riverside,402,95,142,40,15,18,310
Washington,Redmond,57959,12408,27611,4336,461,1473,46289
Washington,Reardan,675,142,267,53,0,44,506
Washington,Raymond,2800,689,861,440,23,308,2321
Washington,Ravensdale,1162,319,557,81,0,12,969
Washington,Rainier,2219,447,934,215,25,109,1730
Washington,Raft Island,305,65,192,24,0,8,289
Washington,Quincy,7163,1904,2480,293,194,279,5150
Washington,Qui-nai-elt Village,69,8,27,8,0,0,43
Washington,Skamokawa Valley,377,127,149,57,35,0,368
Washington,Quilcene,437,97,152,67,54,23,393
Washington,Queets,175,57,25,32,0,14,128
Washington,Puyallup,38720,9789,14223,4933,643,2309,31897
Washington,Purdy,1074,202,588,77,0,55,922
Washington,Pullman,31502,19181,7393,1172,216,390,28352
Washington,Meadow Glade,2649,376,1387,135,18,122,2038
Washington,Poulsbo,9588,1776,4019,938,145,658,7536
Washington,Port Townsend,9208,1771,3833,1762,134,661,8161
Washington,Port Orchard,13004,2933,5226,1232,177,634,10202
Washington,SeaTac,27859,8213,9790,2734,615,1010,22362
Washington,Santiago,19,5,2,8,0,0,15
Washington,Satsop,621,100,293,89,2,57,541
Washington,Seabeck,1306,184,693,190,15,82,1164
Washington,Seattle,653017,248810,228209,58869,7224,22369,565481
Washington,Sedro-Woolley,10673,2488,3566,1567,116,459,8196
Washington,Sekiu,53,0,35,0,0,0,35
Washington,Selah,7531,1439,2889,682,179,403,5592
Washington,Port Ludlow,2382,213,1648,208,27,131,2227
Washington,Shadow Lake,2714,767,1434,102,0,71,2374
Washington,Shelton,9810,2829,2680,1314,286,595,7704
Washington,Shoreline,54774,14779,22822,5557,925,2623,46706
Washington,Silvana,80,0,80,0,0,0,80
Washington,Silverdale,20053,4601,8664,1852,400,1192,16709
Washington,Silver Firs,22153,4304,10600,1524,278,186,16892
Washington,Port Hadlock-Irondale,3552,819,1396,747,33,150,3145
Washington,Sequim,6695,1402,2548,881,69,903,5803
West Virginia,Glen Ferris,123,19,67,23,0,14,123
West Virginia,Glen Fork,586,70,246,89,0,76,481
West Virginia,Glen Jean,340,175,18,0,10,40,243
West Virginia,Glenville,1812,896,422,175,11,83,1587
West Virginia,Grant Town,587,150,254,49,4,43,500
West Virginia,Grafton,5173,1375,1721,747,45,546,4434
West Virginia,Grantsville,581,149,190,56,9,54,458
West Virginia,Glen Dale,1537,275,695,182,19,130,1301
West Virginia,Glen White,474,107,303,0,15,0,425
West Virginia,Enterprise,840,177,439,127,0,43,786
West Virginia,Gilbert Creek,1170,86,652,89,30,101,958
West Virginia,Gilbert,373,66,156,50,4,23,299
West Virginia,Fairlea,1817,282,613,360,12,175,1442
West Virginia,Fairmont,18773,5222,6626,2025,218,1262,15353
West Virginia,Fairview,354,100,139,32,0,32,303
West Virginia,Falling Spring,169,36,94,5,0,10,145
West Virginia,Falling Waters,1109,252,499,22,21,106,900
West Virginia,Falls View,152,0,45,34,0,21,100
West Virginia,Farmington,399,127,164,37,0,11,339
West Virginia,Fayetteville,2914,692,1259,367,8,173,2499
West Virginia,Fenwick,130,19,83,3,0,5,110
West Virginia,Flatwoods,312,48,103,53,1,18,223
West Virginia,Flemington,366,98,141,33,3,24,299
West Virginia,Follansbee,2934,666,1154,369,36,319,2544
West Virginia,Fort Ashby,1454,447,656,104,55,60,1322
West Virginia,Fort Gay,808,170,200,151,25,80,626
West Virginia,Frank,81,22,9,18,7,4,60
West Virginia,Franklin,726,143,315,63,8,105,634
West Virginia,Friendly,77,13,25,25,0,9,72
West Virginia,Gallipolis Ferry,996,293,421,146,20,36,916
West Virginia,Galloway,122,10,76,24,0,12,122
West Virginia,Gary,722,166,243,41,18,140,608
West Virginia,Gassaway,913,235,311,110,15,88,759
West Virginia,Gauley Bridge,723,182,266,84,7,36,575
West Virginia,Ghent,555,136,338,24,0,0,498
West Virginia,Glasgow,740,146,338,53,0,111,648
West Virginia,Ellenboro,454,69,190,38,15,37,349
West Virginia,Culloden,3549,687,1486,372,96,156,2797
West Virginia,Elkins,7244,2011,2524,1018,102,438,6093
West Virginia,Williamson,3077,439,1049,590,44,386,2508
West Virginia,Wiley Ford,790,278,214,83,0,129,704
West Virginia,Whitmer,55,30,0,9,0,0,39
West Virginia,Whitesville,548,80,185,119,7,35,426
West Virginia,White Sulphur Springs,2538,719,892,323,10,181,2125
West Virginia,White Hall,640,198,252,74,11,26,561
West Virginia,Wheeling,27894,7356,9823,3696,501,2159,23535
West Virginia,Beckley,17375,4415,5755,2104,301,1572,14147
West Virginia,Beaver,1086,109,603,208,0,73,993
West Virginia,Beards Fork,115,9,76,21,0,9,115
West Virginia,Bayard,403,96,176,40,4,19,335
West Virginia,Bath (Berkeley Springs),580,153,151,87,8,91,490
West Virginia,Bartow,47,0,36,0,0,11,47
West Virginia,Bartley,250,46,101,61,0,23,231
West Virginia,Barrackville,1324,258,637,79,24,85,1083
West Virginia,Barboursville village,4078,1318,1378,582,37,307,3622
West Virginia,Bancroft,914,282,442,59,17,27,827
West Virginia,Accoville,749,146,369,57,0,0,572
West Virginia,Addison (Webster Springs),1015,195,388,170,20,66,839
West Virginia,Albright,327,79,130,31,5,8,253
West Virginia,Alderson,1221,153,483,180,44,82,942
West Virginia,Alum Creek,1902,520,681,194,0,251,1646
West Virginia,Amherstdale,205,29,77,28,8,24,166
West Virginia,Williamstown,2931,482,1342,267,36,329,2456
West Virginia,Anawalt,191,55,69,24,0,13,161
West Virginia,Ansted,1583,284,720,188,4,102,1298
West Virginia,Apple Grove,175,5,126,0,0,0,131
West Virginia,Arbovale,197,3,111,5,0,37,156
West Virginia,Athens,1086,669,276,64,0,28,1037
West Virginia,Auburn,128,34,46,13,3,12,108
West Virginia,Aurora,296,44,148,20,10,0,222
West Virginia,Anmoore,608,114,196,103,8,26,447
West Virginia,Elkview,1377,166,608,194,0,163,1131
West Virginia,Windsor Heights village,437,126,160,50,12,30,378
West Virginia,Wolf Summit,124,23,80,7,0,14,124
West Virginia,Elk Garden,120,24,48,9,7,16,104
West Virginia,Elizabeth,839,158,267,147,12,56,640
West Virginia,Eleanor,1807,300,922,133,48,124,1527
West Virginia,Eccles,118,0,0,72,28,18,118
West Virginia,East Dailey,434,126,182,49,0,11,368
West Virginia,East Bank,729,159,361,54,0,56,630
West Virginia,Durbin,224,67,92,17,0,7,183
West Virginia,Dunbar,7798,1890,2720,1249,104,776,6739
West Virginia,Despard,1560,182,588,158,55,145,1128
West Virginia,Delbarton,547,79,215,79,6,26,405
West Virginia,Deep Water,271,21,132,10,0,24,187
West Virginia,Davy,249,47,105,22,12,26,212
West Virginia,Davis,683,132,330,67,21,42,592
West Virginia,Danville,688,130,245,87,0,129,591
West Virginia,Daniels,2301,308,1044,203,2,301,1858
West Virginia,Dailey,101,52,37,12,0,0,101
West Virginia,Cucumber,57,14,29,0,0,14,57
West Virginia,Womelsdorf (Coalton),298,63,151,28,0,22,264
West Virginia,Worthington,140,7,77,17,2,14,117
West Virginia,Beech Bottom village,618,95,257,100,4,35,491
West Virginia,Belington,2080,411,797,252,35,159,1654
West Virginia,Belle,1247,279,550,176,5,48,1058
West Virginia,Belmont,1031,204,416,119,3,88,830
West Virginia,Winfield,2256,405,1036,313,10,104,1868
West Virginia,Belva,95,0,71,10,0,14,95
West Virginia,Bergoo,64,0,41,23,0,0,64
West Virginia,Granville,1966,776,532,241,11,114,1674
West Virginia,Craigsville,1779,229,881,132,20,225,1487
West Virginia,Cross Lanes,10567,2463,4198,1228,223,383,8495
West Virginia,Crum,175,56,71,0,0,48,175
West Virginia,Crumpler,155,7,105,8,6,9,135
West Virginia,Benwood,1363,301,498,171,24,75,1069
West Virginia,Great Cacapon,284,121,77,47,0,6,251
West Virginia,New Richmond,289,103,113,38,0,35,289
West Virginia,Dixie,135,19,88,5,0,5,117
West Virginia,Thurmond,7,0,5,0,0,2,7
West Virginia,Thomas,638,98,261,65,5,115,544
West Virginia,Terra Alta,1591,378,623,155,17,105,1278
West Virginia,Teays Valley,13848,2310,6607,996,171,933,11017
West Virginia,Sylvester,133,22,60,7,0,18,107
West Virginia,Switzer,864,327,278,128,8,49,790
West Virginia,Tioga,10,0,0,0,0,10,10
West Virginia,Crab Orchard,2475,247,1232,256,0,197,1932
West Virginia,Covel,174,0,106,0,0,0,106
West Virginia,Corinne,200,29,110,14,0,16,169
West Virginia,Comfort,328,15,154,0,0,10,179
West Virginia,Coal Fork,1061,226,369,206,12,119,932
West Virginia,Coal City,1596,196,839,247,0,57,1339
West Virginia,Clendenin,1033,217,406,144,15,94,876
West Virginia,Cowen,527,85,195,82,7,35,404
West Virginia,Tornado,1280,173,716,82,0,16,987
West Virginia,Triadelphia,640,136,254,96,15,25,526
West Virginia,Tunnelton,290,85,105,35,1,20,246
West Virginia,Wayne,1884,346,511,391,67,137,1452
West Virginia,Waverly,215,22,144,40,0,0,206
West Virginia,Washington,1296,149,711,108,0,72,1040
West Virginia,Wardensville,221,39,83,35,2,22,181
West Virginia,War,811,115,384,73,24,38,634
West Virginia,Wallace,479,109,161,11,40,5,326
West Virginia,Vivian,75,0,52,0,0,0,52
West Virginia,Vienna,10623,2076,5057,965,93,648,8839
West Virginia,Verdunville,763,106,391,143,31,59,730
West Virginia,Van,98,4,77,0,0,6,87
West Virginia,Valley Head,295,86,157,28,0,24,295
West Virginia,Valley Grove village,312,50,138,39,3,19,249
West Virginia,Valley Bend,519,51,261,10,0,23,345
West Virginia,Union,548,118,172,66,8,46,410
West Virginia,Twilight,165,0,66,20,0,12,98
West Virginia,Clearview village,516,74,284,25,1,32,416
West Virginia,Weirton,19432,4130,7820,2618,432,1607,16607
West Virginia,Clay,607,160,215,97,0,42,514
West Virginia,Chester,2526,360,976,384,5,249,1974
West Virginia,Smithfield,139,34,35,9,4,16,98
West Virginia,Smithers,981,239,296,123,7,105,770
West Virginia,Sistersville,1366,345,412,206,40,136,1139
West Virginia,Sissonville,4655,711,1929,808,9,262,3719
West Virginia,Shrewsbury,752,106,246,140,18,113,623
West Virginia,Shinnston,2565,751,1014,210,20,128,2123
West Virginia,Sophia,1356,273,578,170,20,94,1135
West Virginia,Shepherdstown,1587,1236,165,101,21,27,1550
West Virginia,Shady Spring,3060,320,1638,199,0,152,2309
West Virginia,Scarbro,648,115,225,90,23,29,482
West Virginia,Sarah Ann,276,76,54,31,0,23,184
West Virginia,Sand Fork,182,38,52,22,4,7,123
West Virginia,Salt Rock,713,97,354,55,26,74,606
West Virginia,Salem,1671,538,502,171,15,112,1338
West Virginia,Shannondale,3305,615,1419,230,79,148,2491
West Virginia,South Charleston,13276,3237,4930,2095,104,786,11152
West Virginia,Spelter,470,28,171,52,18,47,316
West Virginia,Spencer,2014,382,816,254,11,216,1679
West Virginia,Chesapeake,1544,373,550,236,13,146,1318
West Virginia,Chelyan,889,201,267,152,23,96,739
West Virginia,Cheat Lake,9219,2151,3980,728,40,317,7216
West Virginia,Chauncey,331,72,213,0,0,0,285
West Virginia,Chattaroy,598,75,347,20,26,49,517
West Virginia,Charlton Heights,382,26,242,0,0,19,287
West Virginia,Charles Town,5587,938,2324,639,6,312,4219
West Virginia,Charleston,50566,14010,16938,7303,678,3336,42265
West Virginia,Sutton,1231,177,548,109,27,114,975
West Virginia,Summersville,3531,862,1529,456,29,291,3167
West Virginia,Stonewood,1909,368,874,193,5,131,1571
West Virginia,Stollings,442,21,144,62,9,89,325
West Virginia,Star City,2050,912,510,252,29,109,1812
West Virginia,Stanaford,1726,392,581,246,17,197,1433
West Virginia,Springfield,389,116,168,25,0,37,346
West Virginia,Clarksburg,16347,4075,5628,2128,334,1209,13374
West Virginia,Welch,3021,1135,823,349,169,284,2760
West Virginia,Wellsburg,2746,516,1121,343,61,267,2308
West Virginia,West Hamlin,875,185,258,144,12,67,666
West Virginia,Monaville,166,18,77,0,0,31,126
West Virginia,Monongah,1020,226,420,80,15,113,854
West Virginia,Montcalm,559,100,329,33,0,44,506
West Virginia,Montgomery,1801,673,497,232,11,108,1521
West Virginia,Montrose,165,22,103,13,0,4,142
West Virginia,Moorefield,2814,761,923,383,37,274,2378
West Virginia,Mitchell Heights,381,70,198,26,0,35,329
West Virginia,Morgantown,30164,18345,6530,2032,175,938,28020
West Virginia,Moundsville,8888,1741,3856,1150,80,764,7591
West Virginia,Mount Carbon,346,39,175,57,0,22,293
West Virginia,Mount Gay-Shamrock,1349,194,629,194,0,183,1200
West Virginia,Mount Hope,1271,312,444,99,26,91,972
West Virginia,Mullens,1993,454,783,200,22,179,1638
West Virginia,Neibert,128,15,75,38,0,0,128
West Virginia,Green Bank,223,30,111,4,0,6,151
West Virginia,Mineralwells,1582,318,807,141,16,40,1322
West Virginia,Minden,413,185,130,0,0,55,370
West Virginia,Milton,2557,547,1052,313,38,276,2226
West Virginia,Man,991,137,508,92,5,63,805
West Virginia,Mannington,2036,373,832,164,33,166,1568
West Virginia,Marlinton,1002,187,366,197,27,95,872
West Virginia,Marmet,1570,365,645,208,41,136,1395
West Virginia,Martinsburg,17564,5180,5133,1997,680,898,13888
West Virginia,Mason,966,226,276,135,0,169,806
West Virginia,Masontown,602,147,257,55,10,23,492
West Virginia,Matewan,516,110,138,67,37,68,420
West Virginia,Matheny,379,58,234,46,0,27,365
West Virginia,Matoaka,212,38,84,28,0,17,167
West Virginia,Maybeury,149,93,29,8,0,0,130
West Virginia,Meadow Bridge,384,63,130,50,5,11,259
West Virginia,Middlebourne,875,162,335,105,5,91,698
West Virginia,Middleway,519,104,303,12,17,0,436
West Virginia,Mill Creek,745,190,323,83,4,32,632
West Virginia,Nettie,757,82,391,112,15,93,693
West Virginia,Newburg,401,64,216,34,5,16,335
West Virginia,New Cumberland,1165,291,328,255,30,68,972
West Virginia,Newell,1317,292,575,174,15,80,1136
West Virginia,Pea Ridge,6323,919,2914,772,112,559,5276
West Virginia,Pennsboro,1184,344,398,141,34,85,1002
West Virginia,Pentress,197,30,67,27,0,0,124
West Virginia,Petersburg,2450,478,906,232,142,279,2037
West Virginia,Peterstown,473,68,204,53,6,61,392
West Virginia,Philippi,3192,1117,824,490,37,282,2750
West Virginia,Pickens,33,18,15,0,0,0,33
West Virginia,Piedmont,839,289,245,91,34,49,708
West Virginia,Pinch,2876,396,1540,173,0,168,2277
West Virginia,Pine Grove,658,183,192,96,0,33,504
West Virginia,Westover,4145,1440,1523,308,61,213,3545
West Virginia,Weston,4096,930,1408,642,20,350,3350
West Virginia,West Milford,772,166,318,66,5,49,604
West Virginia,West Logan,573,91,231,55,4,63,444
West Virginia,West Liberty,1781,1370,206,81,7,36,1700
West Virginia,Pax,151,35,60,12,0,7,114
West Virginia,St. Marys,1725,296,869,201,9,93,1468
West Virginia,Paw Paw,504,123,155,23,13,40,354
West Virginia,Parkersburg,31133,7328,10734,4544,692,2269,25567
West Virginia,New Haven,1456,226,628,191,49,130,1224
West Virginia,New Martinsville,5295,1281,2001,548,21,496,4347
West Virginia,West Union,1163,275,326,242,11,53,907
West Virginia,Nitro,6711,1126,2832,1158,30,421,5567
West Virginia,Northfork,320,48,137,25,7,44,261
West Virginia,North Hills,867,139,437,76,10,28,690
West Virginia,Nutter Fort,1625,346,560,210,28,168,1312
West Virginia,Oak Hill,8249,1422,3198,1249,135,605,6609
West Virginia,Oakvale,174,42,39,61,2,8,152
West Virginia,Oceana,1172,181,521,142,12,136,992
West Virginia,Omar,447,102,123,26,0,155,406
West Virginia,Paden City,2773,507,1182,355,56,161,2261
West Virginia,Page,161,15,77,13,0,12,117
West Virginia,Pageton,88,46,0,34,0,8,88
West Virginia,Parcoal,43,5,20,12,0,6,43
West Virginia,Parsons,1526,216,715,178,7,118,1234
West Virginia,St. George,63,8,45,0,0,10,63
West Virginia,Shenandoah Junction,516,107,266,20,19,23,435
West Virginia,Rupert,902,178,349,115,4,70,716
West Virginia,Hilltop,686,142,206,98,22,140,608
West Virginia,Hillsboro,262,36,100,42,0,20,198
West Virginia,Hico,174,41,123,10,0,0,174
West Virginia,Hepzibah,703,118,405,22,0,58,603
West Virginia,Henlawson,244,30,151,0,0,18,199
West Virginia,Hendricks,243,39,146,15,0,33,233
West Virginia,Henderson,170,13,85,13,2,18,131
West Virginia,Hinton,2589,692,1018,334,47,228,2319
West Virginia,Helvetia,31,0,16,8,0,7,31
West Virginia,Hedgesville,283,59,108,44,8,5,224
West Virginia,Harts,627,78,290,49,77,40,534
West Virginia,Hartford City,612,87,269,93,6,47,502
West Virginia,Harrisville,2423,515,868,388,27,177,1975
West Virginia,Harpers Ferry,200,71,72,21,3,12,179
West Virginia,Harman,106,13,42,16,0,10,81
West Virginia,Handley,301,70,106,20,2,19,217
West Virginia,Helen,114,0,0,114,0,0,114
West Virginia,Hamlin,1643,417,620,164,27,119,1347
West Virginia,Holden,644,89,281,80,0,47,497
West Virginia,Hooverson Heights,2834,690,1339,227,50,169,2475
West Virginia,Point Pleasant,4307,897,1456,640,48,468,3509
West Virginia,St. Albans,10882,2003,4400,1425,156,1132,9116
West Virginia,Pleasant Valley,3180,759,1256,504,24,221,2764
West Virginia,Piney View,911,178,487,70,11,60,806
West Virginia,Pineville,685,135,348,42,3,63,591
West Virginia,Chapmanville,1297,165,529,182,6,139,1021
West Virginia,Ceredo,1471,356,585,248,26,101,1316
West Virginia,Hometown,530,182,247,0,20,28,477
West Virginia,Century,185,9,97,23,0,18,147
West Virginia,Cassville,1150,222,679,66,0,39,1006
West Virginia,Cass,47,34,8,5,0,0,47
West Virginia,Carpendale,789,231,350,79,0,42,702
West Virginia,Carolina,355,144,158,44,0,0,346
West Virginia,Capon Bridge,373,92,119,35,10,16,272
West Virginia,Huntersville,146,17,72,28,0,11,128
West Virginia,Hundred,262,68,122,17,5,26,238
West Virginia,Cedar Grove,838,184,317,80,17,78,676
West Virginia,Hambleton,254,45,126,22,0,27,220
West Virginia,Gypsy,317,78,98,59,0,43,278
West Virginia,Greenview,486,137,156,35,0,36,364
West Virginia,Boomer,923,206,450,66,0,28,750
West Virginia,Bolt,598,99,288,44,0,31,462
West Virginia,Bolivar,1236,293,456,148,23,114,1034
West Virginia,Boaz,1306,245,613,175,8,76,1117
West Virginia,Bluewell,2535,824,999,125,24,203,2175
West Virginia,Bluefield,10431,2501,3882,1282,93,919,8677
West Virginia,Blennerhassett,2769,559,1324,295,0,225,2403
West Virginia,Bowden,0,0,0,0,0,0,0
West Virginia,Blacksville,163,20,67,21,0,2,110
West Virginia,Big Sandy,185,12,146,0,0,27,185
West Virginia,Big Creek,367,33,209,30,0,12,284
West Virginia,Big Chimney,301,0,212,36,0,53,301
West Virginia,Beverly,656,157,173,83,28,48,489
West Virginia,Bethlehem village,2589,572,1163,189,47,166,2137
West Virginia,Bethany,1137,864,174,33,3,20,1094
West Virginia,Berwind,578,86,139,50,22,59,356
West Virginia,Birch River,62,0,0,0,19,0,19
West Virginia,Bradley,1810,630,647,254,0,80,1611
West Virginia,Bradshaw,293,53,162,6,4,14,239
West Virginia,Bramwell,293,63,138,23,4,25,253
West Virginia,Green Spring,252,137,69,7,0,39,252
West Virginia,Cameron,969,177,401,83,18,83,762
West Virginia,Camden-on-Gauley,196,29,66,39,0,11,145
West Virginia,Cairo,405,95,114,33,14,42,298
West Virginia,Burnsville,511,115,168,56,11,48,398
West Virginia,Burlington,243,32,88,0,0,24,144
West Virginia,Buffalo,1331,316,516,114,3,116,1065
West Virginia,Bud,440,121,146,42,0,99,408
West Virginia,Buckhannon,5650,2118,1734,477,113,287,4729
West Virginia,Brush Fork,1137,375,357,145,17,64,958
West Virginia,Bruno,1102,227,507,67,0,42,843
West Virginia,Bruceton Mills,54,15,29,4,2,0,50
West Virginia,Brookhaven,5384,1552,2111,256,58,290,4267
West Virginia,Bridgeport,8338,1496,4140,990,12,397,7035
West Virginia,Brenton,207,47,66,45,0,22,180
West Virginia,Brandywine,119,25,32,41,2,15,115
West Virginia,Brandonville,140,23,54,11,0,7,95
West Virginia,Powellton,610,208,163,46,0,23,440
West Virginia,Pratt,527,103,246,38,21,37,445
West Virginia,Poca,1071,209,528,108,13,68,926
West Virginia,Prince,100,29,21,0,12,0,62
West Virginia,Lumberport,1022,202,417,85,37,55,796
West Virginia,Lubeck,1308,176,663,196,0,101,1136
West Virginia,Lost Creek,481,102,228,24,3,31,388
West Virginia,Logan,1818,379,649,365,28,123,1544
West Virginia,Littleton,123,32,0,7,13,0,52
West Virginia,Lewisburg,3948,880,1742,479,36,306,3443
West Virginia,Lester,334,55,141,38,9,23,266
West Virginia,Mabscott,1387,166,732,126,11,53,1088
West Virginia,Lesage,1358,179,697,169,0,126,1171
West Virginia,Lavalette,1159,137,532,65,0,107,841
West Virginia,Lashmeet,436,85,212,21,0,26,344
West Virginia,Kopperston,495,90,210,98,0,19,417
West Virginia,Kistler,507,73,171,60,0,104,408
West Virginia,Kingwood,2955,581,1276,251,41,205,2354
West Virginia,Kincaid,392,36,109,10,15,25,195
West Virginia,Prichard,267,0,225,22,0,20,267
West Virginia,Leon,128,21,63,10,0,10,104
West Virginia,MacArthur,1559,381,562,190,53,187,1373
West Virginia,McConnell,615,51,269,58,0,28,406
West Virginia,McMechen,1702,424,658,218,18,141,1459
West Virginia,Rowlesburg,749,188,279,61,9,80,617
West Virginia,Rossmore,596,188,257,65,0,6,516
West Virginia,Ronceverte,1582,333,585,291,26,135,1370
West Virginia,Romney,2221,783,566,283,35,225,1892
West Virginia,Roderfield,51,0,27,0,0,13,40
West Virginia,Robinette,703,100,324,91,17,13,545
West Virginia,Rivesville,1025,221,320,110,4,83,738
West Virginia,Ripley,3258,798,1058,396,28,529,2809
West Virginia,Ridgeley,612,176,194,101,18,56,545
West Virginia,Richwood,2180,357,863,271,25,188,1704
West Virginia,Rhodell,212,56,88,8,1,16,169
West Virginia,Reedy,149,26,77,13,0,3,119
West Virginia,Reedsville,508,123,196,48,18,44,429
West Virginia,Red Jacket,685,119,230,95,15,69,528
West Virginia,Reader,359,32,205,33,0,45,315
West Virginia,Mallory,1306,326,580,154,19,95,1174
West Virginia,Madison,2993,636,1283,328,31,162,2440
West Virginia,Kimball,105,20,46,14,4,10,94
West Virginia,Keystone,176,37,58,22,2,12,131
West Virginia,Kimberly,261,0,193,31,0,0,224
West Virginia,Kermit,294,40,151,48,8,20,267
West Virginia,Idamay,204,50,107,0,0,14,171
West Virginia,Iaeger,241,57,86,27,2,25,197
West Virginia,Keyser,5320,2167,1283,393,52,502,4397
West Virginia,Hurricane,6388,1170,2494,685,103,559,5011
West Virginia,Huntington,48944,16592,13881,7128,919,2921,41441
West Virginia,Raysal,498,162,138,69,0,34,403
West Virginia,Ravenswood,3853,871,1255,516,86,364,3092
West Virginia,Inwood,2351,528,960,220,66,125,1899
West Virginia,Ranson corpora,4713,1423,1497,449,72,137,3578
West Virginia,Rainelle,1452,319,547,199,34,150,1249
West Virginia,Racine,235,20,113,52,0,24,209
West Virginia,Rachel,234,14,155,0,0,28,197
West Virginia,Quinwood,209,47,97,31,0,11,186
West Virginia,Pullman,190,40,81,15,26,13,175
West Virginia,Prosperity,1624,293,728,198,16,180,1415
West Virginia,Princeton,6082,1472,1843,974,67,654,5010
West Virginia,Rand,1315,381,334,182,28,85,1010
West Virginia,Itmann,302,71,84,21,0,36,212
West Virginia,Huttonsville,260,43,113,15,3,6,180
West Virginia,Kenova,3127,788,889,523,108,316,2624
West Virginia,Justice,427,94,200,20,0,41,355
West Virginia,Junior,471,127,142,71,0,49,389
West Virginia,Jefferson,800,121,245,143,3,103,615
West Virginia,Jane Lew,365,70,143,38,0,34,285
West Virginia,Jacksonburg,106,13,67,15,0,11,106
Wisconsin,Arpin village,319,76,137,33,1,23,270
Wisconsin,Avoca village,595,119,274,64,7,39,503
Wisconsin,Augusta,1468,298,588,152,7,86,1131
Wisconsin,Auburndale village,626,90,309,56,0,21,476
Wisconsin,Athens village,1016,184,491,66,7,68,816
Wisconsin,Ashwaubenon village,17082,4319,7382,1503,116,876,14196
Wisconsin,Angelica,87,12,38,9,0,12,71
Wisconsin,Aniwa village,243,64,107,23,0,7,201
Wisconsin,Babcock,72,24,18,11,0,12,65
Wisconsin,Appleton,73118,19395,28376,6887,715,2931,58304
Wisconsin,Arcadia,2947,919,864,206,13,141,2143
Wisconsin,Arena village,820,179,346,59,5,41,630
Wisconsin,Argonne,176,64,63,14,0,6,147
Wisconsin,Ashippun,216,16,120,23,0,8,167
Wisconsin,Ashland,8116,2501,2581,1131,42,590,6845
Wisconsin,Argyle village,785,131,353,87,12,45,628
Wisconsin,Arkansaw,179,49,82,9,0,7,147
Wisconsin,Arkdale,145,37,59,22,0,15,133
Wisconsin,Arlington village,860,163,401,59,9,27,659
Wisconsin,Antigo,8001,2058,2724,1062,87,671,6602
Wisconsin,Bagley village,478,96,207,49,0,57,409
Wisconsin,Cataract,139,10,60,37,0,9,116
Wisconsin,Baldwin village,3964,731,1665,267,60,291,3014
Wisconsin,Dalton,222,42,61,43,4,8,158
Wisconsin,Dallas village,368,64,162,33,4,54,317
Wisconsin,Dale,473,96,238,35,0,10,379
Wisconsin,Curtiss village,319,68,106,13,8,10,205
Wisconsin,Cumberland,2434,631,933,233,52,176,2025
Wisconsin,Cudahy,18347,4716,6906,1981,141,997,14741
Wisconsin,Cuba City,1917,401,832,143,20,161,1557
Wisconsin,Cross Plains village,3834,752,1751,340,35,90,2968
Wisconsin,Crivitz village,1035,199,350,149,14,141,853
Wisconsin,Crandon,1914,458,680,274,19,136,1567
Wisconsin,Couderay village,75,11,49,2,0,7,69
Wisconsin,Cottage Grove village,6639,1368,2931,388,29,136,4852
Wisconsin,Cornucopia,93,12,58,13,0,10,93
Wisconsin,Cornell,1481,328,614,134,39,101,1216
Wisconsin,Coon Valley village,689,110,323,58,6,60,557
Wisconsin,Conrath village,133,41,37,19,1,14,112
Wisconsin,Como,2416,414,1058,210,20,147,1849
Wisconsin,Combined Locks village,3444,488,1978,213,18,133,2830
Wisconsin,Columbus,4999,1045,2269,527,19,194,4054
Wisconsin,Boaz village,113,19,52,16,3,5,95
Wisconsin,Bohners Lake,2110,417,1020,180,0,113,1730
Wisconsin,Bonduel village,1409,247,542,145,12,74,1020
Wisconsin,Boscobel,3194,945,1256,343,0,246,2790
Wisconsin,Boulder Junction,123,25,55,28,6,4,118
Wisconsin,Bowler village,416,103,119,59,6,18,305
Wisconsin,Coloma village,392,85,163,45,3,32,328
Wisconsin,Collins,180,23,114,7,0,5,149
Wisconsin,Danbury,219,35,69,33,4,5,146
Wisconsin,Dane village,1171,288,482,79,12,12,873
Wisconsin,Darien village,1708,425,747,145,12,48,1377
Wisconsin,Darlington,2338,597,945,136,24,237,1939
Wisconsin,Eagle River,1644,554,434,256,16,93,1353
Wisconsin,Eagle Lake,1229,396,575,72,0,46,1089
Wisconsin,Eagle village,1777,304,892,134,0,45,1375
Wisconsin,Dyckesville,484,55,293,27,0,32,407
Wisconsin,Durand,1742,394,719,176,22,143,1454
Wisconsin,Dunbar,121,34,28,11,0,3,76
Wisconsin,Drummond,163,30,64,42,0,12,148
Wisconsin,Dresser village,859,189,297,122,8,60,676
Wisconsin,Doylestown village,265,79,99,39,3,11,231
Wisconsin,Downsville,130,31,51,22,0,0,104
Wisconsin,Downing village,326,83,147,25,6,8,269
Wisconsin,Dousman village,2412,403,1044,259,33,244,1983
Wisconsin,Dorchester village,977,235,349,91,9,33,717
Wisconsin,Colfax village,1154,231,381,146,18,99,875
Wisconsin,Dodgeville,4678,1186,1888,248,70,368,3760
Wisconsin,Dickeyville village,1176,228,574,100,3,38,943
Wisconsin,Diaperville,40,9,24,1,0,0,34
Wisconsin,Diamond Bluff,160,18,86,17,6,15,142
Wisconsin,De Soto village,275,71,111,46,4,11,243
Wisconsin,De Pere,24366,6275,10169,1979,168,957,19548
Wisconsin,Denmark village,2080,337,972,149,5,135,1598
Wisconsin,Dellwood,598,138,247,76,0,59,520
Wisconsin,Delavan Lake,2352,552,1122,232,0,109,2015
Wisconsin,Delavan,8439,1720,3355,836,112,444,6467
Wisconsin,Delafield,7168,1679,3231,604,38,391,5943
Wisconsin,DeForest village,9347,1821,4188,749,115,210,7083
Wisconsin,Deer Park village,235,45,97,37,2,15,196
Wisconsin,Deerfield village,2631,604,1253,136,5,49,2047
Wisconsin,Dodge,124,48,49,5,0,2,104
Wisconsin,Eastman village,413,97,175,27,0,19,318
Wisconsin,Coleman village,729,170,335,45,7,38,595
Wisconsin,Cochrane village,442,97,209,32,0,33,371
Wisconsin,Brooklyn village,1428,261,680,89,9,26,1065
Wisconsin,Brown Deer village,12101,2647,5472,940,179,768,10006
Wisconsin,Browns Lake,2318,330,1091,298,0,46,1765
Wisconsin,Brownsville village,615,186,315,35,0,13,549
Wisconsin,Browntown village,292,38,148,30,6,9,231
Wisconsin,Bruce village,797,176,244,101,2,91,614
Wisconsin,Brule,239,45,124,16,0,11,196
Wisconsin,Buffalo City,1035,182,531,90,10,64,877
Wisconsin,Burlington,10548,2871,3716,1160,18,682,8447
Wisconsin,Burnett,240,43,107,23,4,23,200
Wisconsin,Butler village,1763,472,660,238,15,136,1521
Wisconsin,Butte des Morts,832,95,475,53,5,28,656
Wisconsin,Butternut village,385,87,126,63,2,29,307
Wisconsin,Cable,215,48,58,33,9,10,158
Wisconsin,Cadott village,1407,353,510,144,20,99,1126
Wisconsin,Caledonia village,24659,4957,12615,1909,150,1027,20658
Wisconsin,Cambria village,716,192,286,68,2,19,567
Wisconsin,Cambridge village,1298,206,610,149,22,79,1066
Wisconsin,Cameron village,1974,392,793,213,30,82,1510
Wisconsin,Campbellsport village,2007,489,829,128,13,112,1571
Wisconsin,Camp Douglas village,580,133,203,84,6,44,470
Wisconsin,Camp Lake,4003,1122,1676,233,65,112,3208
Wisconsin,Caroline,227,80,94,0,3,5,182
Wisconsin,Cascade village,675,135,321,56,17,27,556
Wisconsin,Casco village,559,134,234,34,5,43,450
Wisconsin,Cashton village,992,266,436,108,13,48,871
Wisconsin,Cassville village,854,205,388,63,2,69,727
Wisconsin,Brookfield,38000,6940,19923,1805,177,2350,31195
Wisconsin,Brokaw village,229,72,87,33,2,11,205
Wisconsin,Brodhead,3323,774,1278,380,54,215,2701
Wisconsin,Bristol village,4928,993,2518,378,20,133,4042
Wisconsin,Cobb village,532,98,270,38,1,15,422
Wisconsin,Clyman village,473,145,193,61,1,16,416
Wisconsin,Clintonville,4504,1121,1714,585,35,277,3732
Wisconsin,Clinton village,2123,541,808,271,9,131,1760
Wisconsin,Cleveland village,1626,232,800,107,8,25,1172
Wisconsin,Clear Lake village,803,125,313,169,6,70,683
Wisconsin,Clayton village,615,124,195,77,6,13,415
Wisconsin,Clam Lake,32,2,27,3,0,0,32
Wisconsin,Chippewa Falls,13868,3157,5025,1958,106,1038,11284
Wisconsin,Chilton,3944,865,1649,312,13,376,3215
Wisconsin,Chili,278,65,83,17,9,9,183
Wisconsin,Chief Lake,601,171,186,62,0,56,475
Wisconsin,Chetek,2345,446,1045,220,20,194,1925
Wisconsin,Colby,1851,380,750,148,17,169,1464
Wisconsin,Chenequa village,527,93,319,24,0,27,463
Wisconsin,Chaseburg village,275,51,133,46,6,9,245
Wisconsin,Chain O' Lakes,1070,175,604,122,0,85,986
Wisconsin,Centuria village,1035,211,241,146,6,54,658
Wisconsin,Cedar Grove village,2165,460,958,111,17,144,1690
Wisconsin,Cedarburg,11508,2270,5213,972,60,712,9227
Wisconsin,Cecil village,611,92,344,82,3,15,536
Wisconsin,Cazenovia village,407,96,170,44,1,19,330
Wisconsin,Catawba village,102,21,44,17,2,8,92
Wisconsin,Boyceville village,996,263,314,147,5,71,800
Wisconsin,Boyd village,565,105,293,44,9,19,470
Wisconsin,Brandon village,960,237,413,58,3,38,749
Wisconsin,Brice Prairie,1924,385,938,190,0,16,1529
Wisconsin,Brillion,3175,615,1419,165,44,137,2380
Wisconsin,Chelsea,109,17,62,7,0,7,93
Wisconsin,Baileys Harbor,276,44,194,16,0,16,270
Wisconsin,East Troy village,4304,1080,1216,503,98,223,3120
Wisconsin,Eden village,761,121,345,81,4,47,598
Wisconsin,Galesville,1495,360,556,176,14,121,1227
Wisconsin,Friesland village,357,49,199,11,1,12,272
Wisconsin,Friendship village,696,173,251,137,11,73,645
Wisconsin,French Island,4397,1018,2195,361,42,150,3766
Wisconsin,Fremont village,675,123,286,65,12,43,529
Wisconsin,Fredonia village,2115,398,962,186,48,92,1686
Wisconsin,Frederic village,985,183,389,123,16,97,808
Wisconsin,Franks Field,141,61,16,27,2,4,110
Wisconsin,Franklin,36103,8544,16773,2599,199,1741,29856
Wisconsin,Francis Creek village,519,103,281,39,0,29,452
Wisconsin,Fox Point village,6709,1133,3535,385,9,288,5350
Wisconsin,Fox Lake,1545,382,599,183,27,79,1270
Wisconsin,Fountain City,853,234,371,93,7,40,745
Wisconsin,Fort Atkinson,12447,3085,4897,1138,81,801,10002
Wisconsin,Forestville village,505,137,205,45,2,20,409
Wisconsin,Forest Junction,665,118,302,55,0,24,499
Wisconsin,Footville village,646,148,264,64,6,70,552
Wisconsin,Fontana-on-Geneva Lake village,1406,195,784,151,5,91,1226
Wisconsin,Fond du Lac,43060,11394,16078,4389,342,2775,34978
Wisconsin,Florence,502,125,154,43,0,88,410
Wisconsin,Fitchburg,26616,7488,10175,2112,470,747,20992
Wisconsin,Ferryville village,158,22,98,18,0,12,150
Wisconsin,Fenwood village,149,28,75,9,0,9,121
Wisconsin,Fennimore,2465,495,976,276,7,168,1922
Wisconsin,Fall River village,1601,359,613,194,22,34,1222
Wisconsin,Fall Creek village,1321,228,571,107,14,111,1031
Wisconsin,Fairwater village,366,89,164,34,0,9,296
Wisconsin,Gays Mills village,501,129,162,74,5,19,389
Wisconsin,Genoa City village,3035,701,1215,269,17,90,2292
Wisconsin,Germantown village,19830,3783,9628,1565,54,824,15854
Wisconsin,Gibbsville,507,63,301,19,0,15,398
Wisconsin,Hager City,261,45,141,16,0,11,213
Wisconsin,Gresham village,446,144,135,64,5,15,363
Wisconsin,Greenwood,1093,323,399,101,4,80,907
Wisconsin,Green Valley,160,28,80,0,0,0,108
Wisconsin,Greenleaf,821,202,212,65,0,20,499
Wisconsin,Green Lake,955,201,437,117,6,80,841
Wisconsin,Greenfield,37113,9407,14505,3930,526,3102,31470
Wisconsin,Greendale village,14294,2805,6727,1004,153,871,11560
Wisconsin,Greenbush,153,16,70,10,0,8,104
Wisconsin,Green Bay,104847,31767,35665,9720,1478,4185,82815
Wisconsin,Gratiot village,189,40,78,31,0,8,157
Wisconsin,Grantsburg village,1251,215,516,141,27,110,1009
Wisconsin,Granton village,377,83,116,50,2,19,270
Wisconsin,Fairchild village,524,198,130,58,12,34,432
Wisconsin,Grand View,161,34,61,18,2,5,120
Wisconsin,Grafton village,11535,2630,5256,835,138,687,9546
Wisconsin,Gotham,221,24,130,2,0,24,180
Wisconsin,Gordon,180,27,114,14,0,6,161
Wisconsin,Goodman,277,27,134,36,8,22,227
Wisconsin,Glidden,416,111,127,86,0,27,351
Wisconsin,Glenwood City,1267,208,517,153,17,119,1014
Wisconsin,Glen Haven,78,14,39,5,0,6,64
Wisconsin,Glen Flora village,79,13,24,18,0,4,59
Wisconsin,Glendale,12914,3509,5461,1182,87,885,11124
Wisconsin,Glenbeulah village,455,77,234,37,3,18,369
Wisconsin,Gilmanton,145,31,78,5,0,7,121
Wisconsin,Gilman village,388,64,134,59,13,58,328
Wisconsin,Gillett,1340,301,564,149,0,112,1126
Wisconsin,Grand Marsh,88,27,31,11,0,2,71
Wisconsin,Eau Claire,67385,25031,22237,6044,501,2770,56583
Wisconsin,Exeland village,219,39,85,16,5,5,150
Wisconsin,Eureka,402,68,223,22,0,21,334
Wisconsin,Big Falls village,71,34,18,8,0,11,71
Wisconsin,Birch Hill,266,70,51,26,1,6,154
Wisconsin,Birchwood village,466,97,166,83,8,33,387
Wisconsin,Birnamwood village,874,202,306,81,20,100,709
Wisconsin,Biron village,895,138,457,65,8,70,738
Wisconsin,Black Creek village,1349,236,555,135,2,52,980
Wisconsin,Black Earth village,1396,271,568,180,19,94,1132
Wisconsin,Black River Falls,3574,809,1292,541,53,340,3035
Wisconsin,Blair,1310,242,470,144,28,119,1003
Wisconsin,Blanchardville village,809,172,307,110,11,42,642
Wisconsin,Bloomer,3536,541,1553,412,0,186,2692
Wisconsin,Bloomfield village,4666,1175,2181,339,2,143,3840
Wisconsin,Bloomington village,809,125,372,57,9,45,608
Wisconsin,Blue Mounds village,829,144,392,86,8,26,656
Wisconsin,Blue River village,442,107,175,56,2,42,382
Wisconsin,Bluffview,595,87,186,55,12,26,366
Wisconsin,Elk Mound village,1062,242,380,121,15,30,788
Wisconsin,Elkhorn,9998,2350,3868,1016,80,600,7914
Wisconsin,Elkhart Lake village,1051,227,491,123,3,52,896
Wisconsin,Eleva village,761,148,273,78,16,63,578
Wisconsin,Elderon village,161,21,69,23,0,13,126
Wisconsin,Elcho,284,57,120,64,0,24,265
Wisconsin,Eland village,237,57,117,6,0,8,188
Wisconsin,Egg Harbor village,283,79,152,17,0,20,268
Wisconsin,Edmund,175,42,44,55,2,2,145
Wisconsin,Edgerton,5484,1212,2035,803,52,272,4374
Wisconsin,Edgar village,1605,354,716,95,4,60,1229
Wisconsin,Big Bend village,1285,280,699,61,12,38,1090
Wisconsin,Berlin,5454,1092,2370,499,77,406,4444
Wisconsin,Benton village,1030,173,469,93,5,54,794
Wisconsin,Beloit,36858,10472,11428,4236,561,1999,28696
Wisconsin,Ettrick village,647,162,239,63,4,46,514
Wisconsin,Ephraim village,269,34,163,29,1,20,247
Wisconsin,Endeavor village,459,106,188,60,0,12,366
Wisconsin,Emerald,155,19,56,16,9,5,105
Wisconsin,Embarrass village,601,151,215,32,2,80,480
Wisconsin,Elroy,1414,338,483,159,38,151,1169
Wisconsin,Elmwood Park village,448,74,223,36,5,32,370
Wisconsin,Elmwood village,865,158,363,78,12,76,687
Wisconsin,Elm Grove village,6037,1002,3156,214,19,393,4784
Wisconsin,Ellsworth village,3227,727,1246,291,39,146,2449
Wisconsin,Ellison Bay,213,45,140,13,0,0,198
Wisconsin,Balsam Lake village,781,156,340,136,13,32,677
Wisconsin,Bancroft,565,112,236,42,17,14,421
Wisconsin,Evansville,5143,942,2159,458,37,236,3832
Wisconsin,Bangor village,1435,314,617,169,8,82,1190
Wisconsin,Barneveld village,1276,182,582,82,19,37,902
Wisconsin,Barron,3366,1092,1136,419,16,198,2861
Wisconsin,Barronett,102,8,50,28,0,0,86
Wisconsin,Bay City village,471,124,197,55,2,16,394
Wisconsin,Bayfield,544,122,216,89,2,47,476
Wisconsin,Bayside village,4490,567,2404,316,0,214,3501
Wisconsin,Bear Creek village,424,113,189,23,8,16,349
Wisconsin,Beaver Dam,16400,4172,5844,1788,250,1137,13191
Wisconsin,Belgium village,2067,466,861,162,37,53,1579
Wisconsin,Bell Center village,127,24,65,11,1,7,108
Wisconsin,Belleville village,2643,425,1163,174,28,118,1908
Wisconsin,Bellevue village,15048,3401,6333,1458,60,751,12003
Wisconsin,Belmont village,1007,278,394,92,5,58,827
Wisconsin,Baraboo,12071,3162,4217,1423,200,761,9763
Wisconsin,Genoa village,241,47,123,16,0,16,202
Wisconsin,Livingston village,656,145,289,30,2,32,498
Wisconsin,Amherst village,1220,191,429,185,8,56,869
Wisconsin,Sauk City village,3461,725,1327,370,67,281,2770
Wisconsin,Sandy Hook,465,34,211,68,7,14,334
Wisconsin,St. Peter,1401,169,856,13,0,127,1165
Wisconsin,St. Nazianz village,638,120,284,82,3,48,537
Wisconsin,St. Joseph,431,151,152,29,5,25,362
Wisconsin,St. Francis,9549,2777,3390,1444,59,731,8401
Wisconsin,St. Croix Falls,2082,410,881,297,6,197,1791
Wisconsin,St. Cloud village,494,104,265,30,0,41,440
Wisconsin,Rudolph village,471,119,243,32,0,16,410
Wisconsin,Rothschild village,5287,1176,2263,581,64,262,4346
Wisconsin,Rosholt village,426,82,162,36,12,27,319
Wisconsin,Rosendale village,934,170,473,64,4,49,760
Wisconsin,Rome,750,137,353,59,0,39,588
Wisconsin,Rock Springs village,386,81,159,37,3,12,292
Wisconsin,Rockland village,661,125,282,81,4,12,504
Wisconsin,Rockdale village,202,38,92,19,0,10,159
Wisconsin,Rochester village,3706,542,1872,500,0,133,3047
Wisconsin,Roberts village,1645,286,738,147,15,48,1234
Wisconsin,River Hills village,1472,255,864,64,0,41,1224
Wisconsin,River Falls,15103,6802,4597,942,91,425,12857
Wisconsin,Ripon,7690,2275,2790,722,21,604,6412
Wisconsin,Rio village,1102,178,423,178,14,54,847
Wisconsin,Ridgeway village,591,140,228,64,9,28,469
Wisconsin,Ridgeland village,230,47,108,16,0,12,183
Wisconsin,Richland Center,5094,1178,2118,497,48,379,4220
Wisconsin,Richfield village,11410,1747,6536,534,94,480,9391
Wisconsin,Rice Lake,8355,2071,3056,1063,138,675,7003
Wisconsin,Saukville village,4484,1044,2159,245,58,95,3601
Wisconsin,Saxon,64,19,21,17,0,6,63
Wisconsin,Sayner,131,37,63,2,10,5,117
Wisconsin,Scandinavia village,358,74,171,35,2,14,296
Wisconsin,Spooner,2625,525,817,437,44,274,2097
Wisconsin,Spencer village,2030,432,825,216,32,120,1625
Wisconsin,Sparta,9638,2433,3304,1344,161,526,7768
Wisconsin,South Wayne village,447,100,168,45,0,42,355
Wisconsin,South Milwaukee,21229,5629,8084,2184,243,1164,17304
Wisconsin,Somerset village,2671,610,876,220,31,90,1827
Wisconsin,Solon Springs village,575,89,312,83,8,19,511
Wisconsin,Soldiers Grove village,592,100,182,111,10,70,473
Wisconsin,Sobieski,499,85,247,43,0,0,375
Wisconsin,Slinger village,5148,1180,2330,438,11,186,4145
Wisconsin,Sister Bay village,734,94,355,92,9,132,682
Wisconsin,Siren village,806,232,242,120,22,67,683
Wisconsin,Silver Lake village,2270,439,885,300,16,49,1689
Wisconsin,Rib Mountain,5714,1272,2940,293,74,147,4726
Wisconsin,Shullsburg,1115,211,514,90,3,100,918
Wisconsin,Shorewood village,13284,4070,5287,1232,98,466,11153
Wisconsin,Shiocton village,892,241,319,97,5,38,700
Wisconsin,Sherwood village,2810,374,1525,166,4,63,2132
Wisconsin,Shell Lake,1375,246,577,133,41,150,1147
Wisconsin,Sheldon village,215,43,95,13,5,16,172
Wisconsin,Sheboygan Falls,7803,1368,3648,891,45,363,6315
Wisconsin,Sheboygan,48853,12273,18415,5017,462,2571,38738
Wisconsin,Amherst Junction village,403,86,186,17,0,4,293
Wisconsin,Sharon village,1632,438,604,163,23,87,1315
Wisconsin,Seymour,3450,776,1405,205,1,206,2593
Wisconsin,Seymour,1579,246,711,247,18,55,1277
Wisconsin,Sextonville,366,39,165,50,0,9,263
Wisconsin,Schofield,2104,457,794,319,26,119,1715
Wisconsin,Shorewood Hills village,1839,308,982,89,0,98,1477
Wisconsin,Springbrook,91,11,24,34,0,7,76
Wisconsin,Rib Lake village,1061,192,381,76,17,130,796
Wisconsin,Rewey village,308,71,123,40,0,13,247
Wisconsin,Plymouth,8427,1693,3967,671,98,499,6928
Wisconsin,Plum City village,586,122,221,57,18,62,480
Wisconsin,Plover village,12255,2853,5272,1060,12,628,9825
Wisconsin,Pleasant Prairie village,20217,4219,9456,1635,257,979,16546
Wisconsin,Platteville,11740,7144,2603,462,54,348,10611
Wisconsin,Plainfield village,1057,271,356,64,5,76,772
Wisconsin,Plain village,830,184,412,39,2,40,677
Wisconsin,Pittsville,883,173,379,91,6,49,698
Wisconsin,Pine River,103,38,45,8,0,0,91
Wisconsin,Pigeon Falls village,357,76,161,24,3,47,311
Wisconsin,Phillips,1446,337,578,160,55,134,1264
Wisconsin,Pewaukee village,8252,2143,3241,974,170,456,6984
Wisconsin,Pewaukee,13784,2397,7551,707,39,559,11253
Wisconsin,Peshtigo,3458,862,1175,420,29,441,2927
Wisconsin,Pepin village,818,140,361,127,5,72,705
Wisconsin,Pence,126,17,79,4,0,12,112
Wisconsin,Pembine,185,28,66,23,0,6,123
Wisconsin,Pella,182,35,108,14,0,12,169
Wisconsin,Patch Grove village,129,34,69,11,0,2,116
Wisconsin,Park Ridge village,595,108,278,54,2,55,497
Wisconsin,Park Falls,2216,474,925,272,25,203,1899
Wisconsin,Pardeeville village,2196,470,872,285,9,118,1754
Wisconsin,Palmyra village,1640,390,749,148,32,84,1403
Wisconsin,Paddock Lake village,3005,698,1352,285,18,107,2460
Wisconsin,Packwaukee,268,63,76,48,6,19,212
Wisconsin,Oxford village,577,109,212,103,1,36,461
Wisconsin,Owen,917,180,371,94,14,62,721
Wisconsin,Polonia,568,142,258,46,0,7,453
Wisconsin,Poplar village,590,81,326,43,6,22,478
Wisconsin,Portage,10232,2961,3304,1368,128,608,8369
Wisconsin,Port Edwards village,1660,302,779,155,14,140,1390
Wisconsin,Reserve,448,145,96,56,4,24,325
Wisconsin,Reeseville village,663,131,250,77,5,38,501
Wisconsin,Reedsville village,1088,165,551,57,6,41,820
Wisconsin,Reedsburg,9468,1830,4017,820,32,529,7228
Wisconsin,Redgranite village,2110,780,495,477,28,164,1944
Wisconsin,Readstown village,442,118,129,71,0,47,365
Wisconsin,Random Lake village,1550,389,629,177,3,65,1263
Wisconsin,Randolph village,1711,302,633,210,25,141,1311
Wisconsin,Radisson village,134,14,67,18,0,8,107
Wisconsin,Racine,78127,24179,23661,7956,915,3023,59734
Wisconsin,Pulcifer,156,40,82,9,0,4,135
Wisconsin,Pulaski village,3531,724,1467,370,0,295,2856
Wisconsin,Princeton,1191,199,486,146,0,100,931
Wisconsin,Rhinelander,7583,2124,2442,980,10,651,6207
Wisconsin,Prescott,4212,870,1826,350,79,151,3276
Wisconsin,Prairie Farm village,485,74,174,73,2,70,393
Wisconsin,Prairie du Sac village,4168,598,2146,296,72,188,3300
Wisconsin,Prairie du Chien,5809,1594,2100,649,108,515,4966
Wisconsin,Poy Sippi,282,49,81,86,3,17,236
Wisconsin,Poynette village,2636,586,992,365,1,99,2043
Wisconsin,Powers Lake,1150,217,630,129,0,44,1020
Wisconsin,Pound village,504,112,219,40,6,17,394
Wisconsin,Potter Lake,1092,259,580,78,0,72,989
Wisconsin,Potter village,303,94,141,14,0,10,259
Wisconsin,Potosi village,709,127,355,64,3,39,588
Wisconsin,Post Lake,359,50,216,19,3,44,332
Wisconsin,Port Wing,137,21,84,18,0,7,130
Wisconsin,Port Washington,11481,2482,5012,1235,46,607,9382
Wisconsin,Prentice village,640,98,223,147,12,39,519
Wisconsin,Springfield,236,77,113,0,0,0,190
Wisconsin,Spring Green village,1709,433,757,105,4,118,1417
Wisconsin,Spring Valley village,1414,209,600,145,23,91,1068
Wisconsin,Whitefish Bay village,14122,2340,6921,729,17,555,10562
Wisconsin,Wheeler village,337,82,131,31,7,23,274
Wisconsin,Weyerhaeuser village,252,71,95,29,4,16,215
Wisconsin,Weyauwega,1696,407,607,228,24,109,1375
Wisconsin,West Salem village,4936,863,2031,429,53,446,3822
Wisconsin,Weston village,14956,3263,6619,1299,105,604,11890
Wisconsin,West Milwaukee village,4222,1783,997,407,85,130,3402
Wisconsin,Westfield village,1328,294,411,170,28,64,967
Wisconsin,Westby,2147,373,879,234,10,161,1657
Wisconsin,Westboro,210,48,110,16,0,7,181
Wisconsin,West Bend,31611,6391,13802,3125,173,1693,25184
Wisconsin,West Baraboo village,1747,403,537,241,20,70,1271
Wisconsin,West Allis,60677,18537,20755,6682,586,3389,49949
Wisconsin,Webster village,623,212,144,74,11,53,494
Wisconsin,Wauzeka village,777,131,291,74,3,18,517
Wisconsin,Wauwatosa,47126,11479,20049,3689,356,2736,38309
Wisconsin,Wautoma,1960,465,518,323,26,179,1511
Wisconsin,Wausaukee village,479,101,147,72,15,72,407
Wisconsin,Wausau,39210,9961,13949,4894,485,2345,31634
Wisconsin,Waupun,11355,3102,4402,1031,194,647,9376
Wisconsin,Waupaca,6006,1299,2187,773,35,569,4863
Wisconsin,Waunakee village,12846,2234,6137,840,62,456,9729
Wisconsin,Waumandee,55,23,20,3,0,5,51
Wisconsin,Waukesha,71324,19705,27794,6631,402,2972,57504
Wisconsin,Waukau,312,66,156,37,0,8,267
Wisconsin,Waubeka,813,153,408,54,9,16,640
Wisconsin,Watertown,23878,5644,9664,2143,168,1306,18925
Wisconsin,Whitehall,1676,403,658,151,37,117,1366
Wisconsin,White Lake village,333,74,128,50,1,20,273
Wisconsin,Whitelaw village,692,163,350,57,4,28,602
Wisconsin,Whitewater,14866,9249,2922,590,86,490,13337
Wisconsin,Zoar,161,68,36,9,0,10,123
Wisconsin,Yuba village,63,11,35,9,0,4,59
Wisconsin,Wyocena village,694,163,251,92,7,74,587
Wisconsin,Wyeville village,149,12,58,27,1,11,109
Wisconsin,Wrightstown village,3205,605,1472,182,5,64,2328
Wisconsin,Woodville village,1195,277,470,114,3,91,955
Wisconsin,Woodruff,709,73,305,98,6,137,619
Wisconsin,Woodman village,109,26,52,8,0,11,97
Wisconsin,Woodford,75,2,26,27,0,2,57
Wisconsin,Wonewoc village,850,191,352,77,12,55,687
Wisconsin,Wittenberg village,1029,290,370,82,17,85,844
Wisconsin,Withee village,512,119,229,34,1,27,410
Wisconsin,Wisconsin Rapids,18104,3630,6806,2664,141,1363,14604
Wisconsin,Waterloo,3345,741,1603,251,68,83,2746
Wisconsin,Wisconsin Dells,2255,558,734,235,112,174,1813
Wisconsin,Winter village,288,53,113,47,7,26,246
Wisconsin,Winneconne village,2487,381,1170,250,22,119,1942
Wisconsin,Windsor,3876,612,1905,414,35,194,3160
Wisconsin,Wind Point village,1749,260,1056,97,6,96,1515
Wisconsin,Wind Lake,5384,937,2714,466,15,190,4322
Wisconsin,Winchester,619,66,402,60,0,11,539
Wisconsin,Wilton village,578,129,162,79,0,37,407
Wisconsin,Wilson village,266,41,163,12,0,3,219
Wisconsin,Wilmot,225,19,93,0,0,81,193
Wisconsin,Williams Bay village,2593,516,1133,273,20,223,2165
Wisconsin,Wild Rose village,800,146,335,90,9,85,665
Wisconsin,Whittlesey,131,2,71,21,0,6,100
Wisconsin,Whiting village,1664,317,756,209,2,183,1467
Wisconsin,Wiota,111,23,68,8,0,4,103
Wisconsin,Waterford village,5348,927,2500,424,19,274,4144
Wisconsin,Washburn,2094,520,777,272,50,162,1781
Wisconsin,Warrens village,435,96,157,62,0,21,336
Wisconsin,Theresa village,1175,261,564,88,0,73,986
Wisconsin,Tennyson village,347,86,148,21,3,30,288
Wisconsin,Taylor village,487,171,132,52,0,28,383
Wisconsin,Taycheedah,844,151,484,85,0,30,750
Wisconsin,Tainter Lake,2764,419,1414,357,13,91,2294
Wisconsin,Sussex village,10680,2171,4865,726,14,366,8142
Wisconsin,Suring village,344,56,131,46,11,68,312
Wisconsin,Superior village,700,121,305,87,11,62,586
Wisconsin,Superior,26817,8619,8647,3119,196,1635,22216
Wisconsin,Sun Prairie,31174,7038,12467,2697,479,1219,23900
Wisconsin,Summit Lake,148,26,61,13,4,2,106
Wisconsin,Summit village,4738,1043,2310,315,8,207,3883
Wisconsin,Sullivan village,693,168,305,86,13,27,599
Wisconsin,Thiensville village,3203,727,1384,259,57,269,2696
Wisconsin,Suamico village,11787,1842,6296,824,65,224,9251
Wisconsin,Sturgeon Bay,9043,1582,4214,1130,34,590,7550
Wisconsin,Strum village,999,165,473,71,15,84,808
Wisconsin,Stratford village,1726,342,681,177,2,77,1279
Wisconsin,Stoughton,12976,2710,5588,1166,111,769,10344
Wisconsin,Stone Lake,176,42,110,9,0,6,167
Wisconsin,Stoddard village,824,166,361,88,8,49,672
Wisconsin,Stockholm village,78,17,37,18,0,3,75
Wisconsin,Stockbridge village,765,154,419,65,0,37,675
Wisconsin,Stevens Point,26769,12364,7943,1934,187,902,23330
Wisconsin,Steuben village,109,27,43,14,1,2,87
Wisconsin,Stetsonville village,605,132,211,89,8,30,470
Wisconsin,Star Prairie village,617,169,246,66,0,16,497
Wisconsin,Stanley,3608,1326,885,614,73,197,3095
Wisconsin,Sturtevant village,6983,2326,2230,977,86,255,5874
Wisconsin,Osseo,1581,316,689,143,9,137,1294
Wisconsin,Thornton,100,19,45,9,0,11,84
Wisconsin,Three Lakes,437,31,294,53,0,32,410
Wisconsin,Walworth village,2824,528,857,561,75,143,2164
Wisconsin,Wales village,2573,470,1372,198,10,38,2088
Wisconsin,Waldo village,542,138,242,34,6,21,441
Wisconsin,Wabeno,456,111,178,63,0,36,388
Wisconsin,Viroqua,4363,838,1939,401,56,409,3643
Wisconsin,Viola village,770,183,272,109,3,37,604
Wisconsin,Vesper village,636,118,284,36,3,32,473
Wisconsin,Verona,11723,2427,5192,738,196,400,8953
Wisconsin,Van Dyne,258,21,160,11,0,6,198
Wisconsin,Valders village,1041,301,363,93,6,88,851
Wisconsin,Unity village,337,48,168,35,5,15,271
Wisconsin,Union Grove village,4891,1373,1896,527,34,223,4053
Wisconsin,Union Center village,172,25,92,15,0,16,148
Wisconsin,Thorp,1631,389,558,168,37,155,1307
Wisconsin,Two Rivers,11500,2663,4906,1020,129,804,9522
Wisconsin,Tustin,114,17,71,10,0,8,106
Wisconsin,Turtle Lake,350,42,158,61,4,17,282
Wisconsin,Turtle Lake village,1115,255,364,159,18,60,856
Wisconsin,Tunnel City,186,47,86,15,0,9,157
Wisconsin,Trempealeau village,1717,315,736,194,6,94,1345
Wisconsin,Trego,141,18,69,21,2,14,124
Wisconsin,Townsend,81,26,19,24,0,6,75
Wisconsin,Tony village,89,11,39,13,1,21,85
Wisconsin,Tomahawk,3309,690,1272,493,24,282,2761
Wisconsin,Tomah,9326,2074,3243,1236,106,598,7257
Wisconsin,Tilleda,72,18,6,16,0,11,51
Wisconsin,Tigerton village,923,226,326,72,11,79,714
Wisconsin,Tichigan,5524,990,2831,560,38,147,4566
Wisconsin,Twin Lakes village,6031,1242,2397,716,101,302,4758
Wisconsin,Oshkosh,66582,25057,20037,7487,562,3325,56468
Wisconsin,Shawano,9181,2129,3321,1028,147,793,7418
Wisconsin,Orfordville village,1422,364,548,151,33,43,1139
Wisconsin,La Crosse,51993,23954,14299,4436,393,2332,45414
Wisconsin,Lac La Belle village,301,43,172,14,0,10,239
Wisconsin,Lac du Flambeau,1739,655,430,220,14,49,1368
Wisconsin,Kronenwetter village,7406,1452,3459,611,27,245,5794
Wisconsin,Krakow,346,41,183,39,0,14,277
Wisconsin,Kohler village,2389,414,1178,177,17,88,1874
Wisconsin,Knowlton,138,7,78,11,0,0,96
Wisconsin,Knapp village,427,81,158,77,8,45,369
Wisconsin,Kingston village,303,45,145,15,0,17,222
Wisconsin,King,1587,194,618,284,7,421,1524
Wisconsin,Kimberly village,6646,1213,2841,621,118,361,5154
Wisconsin,Kieler,484,86,265,27,0,26,404
Wisconsin,Kiel,3739,777,1575,353,8,255,2968
Wisconsin,Kewaunee,2912,621,1249,373,12,200,2455
Wisconsin,Kewaskum village,4043,827,1863,270,60,124,3144
Wisconsin,Keshena,1364,525,241,73,14,22,875
Wisconsin,Kenosha,99897,29407,32684,10224,1408,4518,78241
Wisconsin,Kennan village,128,22,50,19,0,14,105
Wisconsin,Kendall village,515,72,253,53,0,45,423
Wisconsin,Kellnersville village,413,99,162,49,4,31,345
Wisconsin,Kekoskee village,170,23,97,12,0,15,147
Wisconsin,Kaukauna,15720,3891,6678,1383,147,466,12565
Wisconsin,Juneau,2741,735,895,319,39,234,2222
Wisconsin,Junction City village,384,79,176,35,5,15,310
Wisconsin,Jump River,44,7,14,2,0,12,35
Wisconsin,Juda,361,88,167,19,4,16,294
Wisconsin,Johnson Creek village,2855,516,1337,281,0,57,2191
Wisconsin,Ladysmith,3278,685,1102,404,52,408,2651
Wisconsin,La Farge village,640,140,292,91,0,53,576
Wisconsin,Lake Arrowhead,810,58,542,92,16,80,788
Wisconsin,Lake Camelot,897,100,597,46,0,53,796
Wisconsin,Linden village,509,103,210,60,6,18,397
Wisconsin,Lime Ridge village,203,15,122,23,0,4,164
Wisconsin,Lily Lake,518,104,224,1,0,39,368
Wisconsin,Lewis,97,17,40,24,0,8,89
Wisconsin,Leopolis,67,15,20,13,0,7,55
Wisconsin,Lena village,534,144,193,64,5,13,419
Wisconsin,Legend Lake,1272,352,504,124,17,70,1067
Wisconsin,Lebanon,389,134,165,10,3,7,319
Wisconsin,La Valle village,409,106,151,46,2,31,336
Wisconsin,Lauderdale Lakes,1061,199,615,46,0,66,926
Wisconsin,Laona,415,99,179,28,0,28,334
Wisconsin,Lannon village,1108,267,438,176,18,44,943
Wisconsin,Lancaster,3811,842,1615,351,32,265,3105
Wisconsin,Jim Falls,232,54,93,24,0,23,194
Wisconsin,Lakewood,308,45,177,37,0,12,271
Wisconsin,Lake Wisconsin,4443,565,2443,372,20,198,3598
Wisconsin,Lake Wazeecha,2622,350,1343,245,17,167,2122
Wisconsin,Lake Tomahawk,197,70,83,27,0,14,194
Wisconsin,Lake Sherwood,348,65,172,76,0,8,321
Wisconsin,Lake Ripley,1670,303,946,205,0,95,1549
Wisconsin,Lake Nebagamon village,1173,183,645,82,0,41,951
Wisconsin,Lake Mills,5776,1151,2408,639,51,324,4573
Wisconsin,Lake Lorraine,282,48,121,49,6,22,246
Wisconsin,Lake Koshkonong,1201,259,629,83,2,54,1027
Wisconsin,Lake Ivanhoe,626,149,256,22,1,17,445
Wisconsin,Lake Hallie village,6562,1415,2911,440,44,312,5122
Wisconsin,Lake Geneva,7714,1982,2962,797,76,480,6297
Wisconsin,Lake Delton village,2952,955,1061,282,34,220,2552
Wisconsin,Lake Wissota,3131,357,1594,412,20,163,2546
Wisconsin,Little Chute village,10641,2242,5111,831,117,281,8582
Wisconsin,Jefferson,7965,1945,3112,782,81,456,6376
Wisconsin,Jackson village,6808,1118,2980,760,97,336,5291
Wisconsin,Hayward,2101,574,637,288,4,174,1677
Wisconsin,Hawkins village,345,49,155,39,3,34,280
Wisconsin,Haugen village,361,69,150,40,5,16,280
Wisconsin,Osceola village,2524,548,968,276,19,141,1952
Wisconsin,Hatfield,191,42,90,27,0,6,165
Wisconsin,Hartland village,9187,1736,4113,843,116,376,7184
Wisconsin,Hartford,14271,2889,6369,1183,160,715,11316
Wisconsin,Harrison village,7386,1110,3804,288,20,101,5323
Wisconsin,Hanover,183,46,75,14,0,0,135
Wisconsin,Hancock village,344,70,122,57,3,29,281
Wisconsin,Hammond village,2015,464,699,223,22,74,1482
Wisconsin,Hales Corners village,7756,1929,3310,739,46,582,6606
Wisconsin,Abbotsford,2179,459,888,200,10,132,1689
Wisconsin,Abrams,401,67,207,38,0,19,331
Wisconsin,Adams,1660,442,434,162,79,194,1311
Wisconsin,Adell village,459,116,224,34,0,15,389
Wisconsin,Albany village,1268,458,387,121,9,63,1038
Wisconsin,Algoma,3131,640,1407,228,33,245,2553
Wisconsin,Allenton,950,76,381,198,0,27,682
Wisconsin,Allouez village,13947,3400,6558,958,66,660,11642
Wisconsin,Alma,678,144,325,100,0,36,605
Wisconsin,Alma Center village,514,87,223,26,15,32,383
Wisconsin,Almena village,684,184,241,82,0,42,549
Wisconsin,Almond village,510,106,189,28,7,38,368
Wisconsin,Altoona,7053,1493,2882,776,62,395,5608
Wisconsin,Amberg,164,15,51,29,0,36,131
Wisconsin,Amery,2865,300,1424,285,19,335,2363
Wisconsin,Hazel Green village,1105,246,492,89,12,72,911
Wisconsin,Hebron,162,33,65,44,0,7,149
Wisconsin,Helenville,190,17,106,27,0,4,154
Wisconsin,Herbster,97,12,68,11,0,4,95
Wisconsin,Ixonia,1710,269,709,262,8,38,1286
Wisconsin,Ironton village,269,69,80,43,1,5,198
Wisconsin,Iron River,719,195,290,96,9,57,647
Wisconsin,Iron Ridge village,986,232,405,157,2,23,819
Wisconsin,Iron Belt,211,43,88,26,10,8,175
Wisconsin,Iola village,1344,241,513,209,11,137,1111
Wisconsin,Ingram village,81,18,34,5,0,7,64
Wisconsin,Independence,1624,396,593,148,10,132,1279
Wisconsin,Hustler village,177,29,55,33,0,22,139
Wisconsin,Hustisford village,1212,258,477,147,9,27,918
Wisconsin,Hurley,1560,326,569,236,24,186,1341
Wisconsin,Humbird,201,39,80,35,4,4,162
Wisconsin,Hudson,13194,2865,5506,1222,155,698,10446
Wisconsin,Janesville,63799,15396,25235,6876,631,3044,51182
Wisconsin,Howards Grove village,3238,657,1615,206,0,130,2608
Wisconsin,Houlton,352,108,215,14,0,15,352
Wisconsin,Hortonville village,2708,572,1125,246,17,120,2080
Wisconsin,Horicon,3644,842,1487,325,78,158,2890
Wisconsin,Holmen village,9432,1444,4132,953,94,405,7028
Wisconsin,Hollandale village,291,58,133,28,1,10,230
Wisconsin,Holcombe,149,14,81,19,0,6,120
Wisconsin,Hobart village,7356,1567,3176,484,151,243,5621
Wisconsin,Hixton village,423,79,217,36,4,22,358
Wisconsin,Hingham,1004,155,583,38,0,16,792
Wisconsin,Hillsboro,1396,367,525,139,15,119,1165
Wisconsin,Hilbert village,1108,196,515,98,4,78,891
Wisconsin,Highland village,919,243,377,38,7,52,717
Wisconsin,Hewitt village,840,149,459,33,3,32,676
Wisconsin,Howard village,18668,4090,8417,1531,97,522,14657
Wisconsin,Little Round Lake,1287,475,181,158,10,58,882
Wisconsin,Hatley village,518,124,266,36,3,20,449
Wisconsin,Oconto,4492,1194,1553,718,59,318,3842
Wisconsin,New Glarus village,2128,401,920,238,12,157,1728
Wisconsin,Newburg village,1190,224,590,103,0,78,995
Wisconsin,New Berlin,39774,7664,20705,2658,188,2447,33662
Wisconsin,New Auburn village,543,82,256,44,17,25,424
Wisconsin,Newald,128,8,85,5,0,13,111
Wisconsin,Neosho village,610,142,286,28,2,19,477
Wisconsin,Neopit,851,318,182,41,7,18,566
Wisconsin,Nelsonville village,118,19,67,1,3,3,93
Wisconsin,Nelson village,324,67,161,34,3,15,280
Wisconsin,Nekoosa,2450,613,823,261,51,199,1947
Wisconsin,Neillsville,2270,439,1026,182,21,277,1945
Wisconsin,Neenah,25781,6140,10494,2594,239,1167,20634
Wisconsin,Necedah village,958,226,396,86,8,36,752
Wisconsin,Navarino,157,48,69,7,1,6,131
Wisconsin,Nashotah village,1452,285,762,69,0,57,1173
Wisconsin,Muskego,24529,4739,12579,1581,45,944,19888
Wisconsin,Muscoda village,1452,317,532,151,47,115,1162
Wisconsin,Mukwonago village,7485,1405,3480,690,43,384,6002
Wisconsin,Mount Sterling village,202,36,92,7,7,13,155
Wisconsin,Mount Pleasant village,26196,5491,12100,2271,158,1686,21706
Wisconsin,Mount Horeb village,7349,1144,3084,859,46,378,5511
Wisconsin,Mount Hope village,164,32,53,26,1,9,121
Wisconsin,Mount Calvary village,532,111,247,37,2,17,414
Wisconsin,Mountain,330,50,137,38,12,25,262
Wisconsin,Mosinee,4021,1082,1836,239,0,221,3378
Wisconsin,Montreal,739,112,321,103,11,30,577
Wisconsin,Monticello village,1182,277,466,147,28,63,981
Wisconsin,New Holstein,3219,592,1625,194,11,239,2661
Wisconsin,New Lisbon,2316,1052,507,303,27,153,2042
Wisconsin,New London,7129,1560,2812,809,92,353,5626
Wisconsin,New Odanah,502,156,125,75,3,15,374
Wisconsin,Little Sturgeon,156,23,117,5,5,6,156
Wisconsin,Oregon village,9769,2047,3761,1035,53,434,7330
Wisconsin,Oostburg village,2927,386,1544,136,5,175,2246
Wisconsin,Ontario village,503,119,196,26,0,14,355
Wisconsin,Onalaska,18255,3749,8303,1405,165,977,14599
Wisconsin,Omro,3543,735,1437,303,0,160,2635
Wisconsin,Oliver village,359,68,162,29,1,20,280
Wisconsin,Okauchee Lake,4516,805,2329,409,0,136,3679
Wisconsin,Ogema,221,26,98,22,1,8,155
Wisconsin,Ogdensburg village,219,51,71,41,4,8,175
Wisconsin,Odanah,7,6,0,0,0,1,7
Wisconsin,Oconto Falls,2859,637,1245,239,0,244,2365
Wisconsin,Oconomowoc Lake village,619,123,325,35,5,44,532
Wisconsin,Montfort village,691,152,337,48,10,26,573
Wisconsin,Oconomowoc,16111,2956,7264,1414,141,657,12432
Wisconsin,Oakdale village,272,64,116,32,1,23,236
Wisconsin,Oak Creek,34974,7740,15865,2674,261,1466,28006
Wisconsin,Norwalk village,656,98,220,40,5,33,396
Wisconsin,North Prairie village,2281,488,1100,156,8,80,1832
Wisconsin,Northport,518,100,293,54,0,11,458
Wisconsin,North Hudson village,3807,734,1687,306,16,104,2847
Wisconsin,North Freedom village,616,180,238,76,6,18,518
Wisconsin,North Fond du Lac village,5003,996,2179,539,30,208,3952
Wisconsin,North Bay village,263,49,148,13,0,6,216
Wisconsin,Nichols village,226,50,88,27,5,8,178
Wisconsin,Niagara,1584,338,581,200,41,89,1249
Wisconsin,New Richmond,8599,1920,3342,1015,155,224,6656
Wisconsin,New Post,262,54,115,42,2,18,231
Wisconsin,Oakfield village,1060,220,529,104,5,33,891
Wisconsin,Montello,1436,363,496,214,26,174,1273
Wisconsin,Neshkoro village,385,55,185,41,8,28,317
Wisconsin,Monona,7835,2061,3031,1060,50,492,6694
Wisconsin,Marshfield,18410,4408,7715,1753,201,1066,15143
Wisconsin,Marshall village,3920,792,1373,535,9,157,2866
Wisconsin,Marquette village,133,31,51,11,0,20,113
Wisconsin,Markesan,1585,306,590,133,26,179,1234
Wisconsin,Marion,1155,209,453,154,6,93,915
Wisconsin,Marinette,10863,2682,3698,1576,114,837,8907
Wisconsin,Maribel village,396,86,184,24,5,16,315
Wisconsin,Marengo,110,22,56,0,0,4,82
Wisconsin,Marathon City village,1412,251,735,93,1,95,1175
Wisconsin,Maple Bluff village,1478,250,866,50,8,37,1211
Wisconsin,Manitowoc,33301,7592,13536,3582,173,2410,27293
Wisconsin,Manawa,1332,271,551,144,14,73,1053
Wisconsin,Maiden Rock village,104,35,29,14,2,0,80
Wisconsin,Mason village,76,13,32,9,0,1,55
Wisconsin,Madison,243122,100250,78913,18422,2251,7028,206864
Wisconsin,Lynxville village,147,25,61,20,2,11,119
Wisconsin,Lyndon Station village,651,221,102,124,3,54,504
Wisconsin,Luxemburg village,2559,469,1002,163,32,141,1807
Wisconsin,Luck village,1067,197,428,127,4,158,914
Wisconsin,Lublin village,100,30,42,9,0,12,93
Wisconsin,Monroe,10807,2525,4217,1119,89,872,8822
Wisconsin,Lowell village,313,77,122,45,3,21,268
Wisconsin,Long Lake,26,4,21,0,0,1,26
Wisconsin,Lone Rock village,881,203,364,116,5,28,716
Wisconsin,Lomira village,2246,625,852,219,30,136,1862
Wisconsin,Lohrville village,390,59,172,29,1,40,301
Wisconsin,Loganville village,269,46,118,33,3,13,213
Wisconsin,Lodi,3047,590,1236,351,0,260,2437
Wisconsin,McFarland village,8092,2073,3839,651,26,194,6783
Wisconsin,Mattoon village,509,129,172,39,6,28,374
Wisconsin,Loyal,1206,212,548,98,18,63,939
Wisconsin,Mayville,5060,1081,1985,617,49,432,4164
Wisconsin,Mauston,4435,1128,1458,628,126,347,3687
Wisconsin,Mondovi,2693,542,922,391,0,204,2059
Wisconsin,Mole Lake,541,207,98,89,14,14,422
Wisconsin,Mishicot village,1466,267,713,105,8,102,1195
Wisconsin,Minong village,400,73,161,45,0,43,322
Wisconsin,Mineral Point,2547,559,1059,225,24,179,2046
Wisconsin,Milwaukee,599498,240688,141664,50090,11093,22241,465776
Wisconsin,Milton,5572,1140,2297,713,17,259,4426
Wisconsin,Milltown village,1103,313,404,143,0,41,901
Wisconsin,Millston,129,24,50,26,5,7,112
Wisconsin,Milladore village,269,49,122,27,5,12,215
Wisconsin,Middle Village,237,80,53,20,10,15,178
Wisconsin,Middleton,18478,4896,7900,1883,257,664,15600
Wisconsin,Merton village,3492,473,1764,126,26,67,2456
Wisconsin,Minocqua,288,68,68,94,0,40,270
Wisconsin,Merrillan village,648,162,228,86,14,52,542
Wisconsin,Medford,4338,971,1655,490,23,451,3590
Wisconsin,Merrimac village,506,110,216,65,19,25,435
Wisconsin,Mellen,699,133,286,73,12,68,572
Wisconsin,Melvina village,57,8,33,5,0,2,48
Wisconsin,Menasha,17546,3877,6947,1789,196,939,13748
Wisconsin,Melrose village,620,120,263,49,2,32,466
Wisconsin,Menomonie,16210,8204,4041,1322,69,739,14375
Wisconsin,Mequon,23494,3671,13144,1214,44,1354,19427
Wisconsin,Mercer,620,163,256,52,0,79,550
Wisconsin,Merrill,9419,2206,3711,993,50,650,7610
Wisconsin,Menomonee Falls village,35884,6884,17434,2780,103,2482,29683
Wisconsin,Mazomanie village,1716,336,751,217,20,42,1366
Wyoming,South Greeley,4478,772,1802,722,133,94,3523
Wyoming,Smoot,278,0,101,0,0,0,101
Wyoming,Saratoga,1851,362,846,192,28,72,1500
Wyoming,Sleepy Hollow,1245,199,709,63,8,0,979
Wyoming,Slater,83,0,37,46,0,0,83
Wyoming,Sinclair,371,60,188,51,0,14,313
Wyoming,Shoshoni,530,110,251,53,0,36,450
Wyoming,South Park,1681,180,830,195,0,0,1205
Wyoming,Sheridan,17775,3648,7403,1932,288,1156,14427
Wyoming,Shell,69,0,64,0,0,5,69
Wyoming,Robertson,139,13,93,18,0,0,124
Wyoming,Rolling Hills,487,79,217,26,2,10,334
Wyoming,Rock Springs,23869,4689,9630,2690,280,875,18164
Wyoming,Rock River,219,28,148,16,0,11,203
Wyoming,Riverton,10915,2683,3737,1486,177,694,8777
Wyoming,Riverside,57,9,44,4,0,0,57
Wyoming,Reliance,587,33,304,94,0,38,469
Wyoming,Red Butte,574,128,304,83,0,22,537
Wyoming,Star Valley Ranch,1342,161,704,119,4,73,1061
Wyoming,Ranchettes,6138,959,3580,410,34,216,5199
Wyoming,Rawlins,9155,2202,3246,1233,176,429,7286
Wyoming,Ryan Park,0,0,0,0,0,0,0
Wyoming,Story,954,101,565,28,0,87,781
Wyoming,Veteran,35,11,14,0,0,0,25
Wyoming,Superior,265,78,107,6,0,5,196
Wyoming,Ranchester,911,138,444,75,0,11,668
Wyoming,Worland,5416,823,2120,884,68,362,4257
Wyoming,Woods Landing-Jelm,43,11,8,16,0,8,43
Wyoming,Wilson,1645,321,854,177,0,47,1399
Wyoming,Whiting,135,0,109,26,0,0,135
Wyoming,Wheatland,3639,614,1654,347,56,339,3010
Wyoming,Westview Circle,45,0,0,0,0,45,45
Wyoming,Washam,38,18,20,0,0,0,38
Wyoming,Warren AFB,2634,626,1138,59,0,0,1823
Wyoming,Wamsutter,360,30,210,29,3,4,276
Wyoming,Sundance,1401,153,756,97,4,111,1121
Wyoming,Vista West,929,159,492,139,0,0,790
Wyoming,Urie,462,84,222,104,0,7,417
Wyoming,Upton,1030,302,476,85,13,48,924
Wyoming,Turnerville,134,11,67,22,0,34,134
Wyoming,Torrington,6736,1765,2603,899,47,395,5709
Wyoming,Thermopolis,2832,554,1142,378,33,244,2351
Wyoming,Thayne,457,106,152,52,4,29,343
Wyoming,Teton Village,161,37,81,0,0,0,118
Wyoming,Ten Sleep,237,42,100,51,0,25,218
Wyoming,Taylor,61,0,61,0,0,0,61
Wyoming,Table Rock,0,0,0,0,0,0,0
Wyoming,Van Tassell,7,0,4,1,0,0,5
Wyoming,Ralston,339,85,179,0,0,5,269
Wyoming,Kaycee,234,53,87,23,0,8,171
Wyoming,Purple Sage,853,390,225,0,0,0,615
Wyoming,Marbleton,1385,201,680,73,2,65,1021
Wyoming,Manville,46,0,24,3,0,19,46
Wyoming,Manderson,110,16,50,19,0,6,91
Wyoming,Mammoth,108,14,67,4,0,23,108
Wyoming,McKinnon,0,0,0,0,0,0,0
Wyoming,Lyman,2249,418,891,223,4,43,1579
Wyoming,Lusk,1755,313,712,213,71,149,1458
Wyoming,Lucerne,680,44,381,104,0,9,538
Wyoming,Lovell,2361,420,885,304,43,191,1843
Wyoming,Lost Springs,5,0,0,5,0,0,5
Wyoming,Meadow Acres,153,37,74,42,0,0,153
Wyoming,Lonetree,0,0,0,0,0,0,0
Wyoming,Lingle,649,115,265,86,5,24,495
Wyoming,Laramie,31879,14565,9752,2132,300,673,27422
Wyoming,Lander,7758,1693,3130,854,20,486,6183
Wyoming,Lance Creek,27,0,19,0,0,0,19
Wyoming,Lakeview North,48,0,48,0,0,0,48
Wyoming,La Grange,425,143,179,8,6,10,346
Wyoming,La Barge,467,69,211,48,6,17,351
Wyoming,Kirby,67,4,51,5,0,4,64
Wyoming,Kemmerer,2692,507,1191,216,22,122,2058
Wyoming,Wright,2255,477,907,198,59,18,1659
Wyoming,Little America,74,74,0,0,0,0,74
Wyoming,Rafter J Ranch,1535,476,742,190,0,9,1417
Wyoming,Medicine Bow,252,51,123,8,0,20,202
Wyoming,Midwest,362,44,154,39,27,18,282
Wyoming,Powell,6408,1828,1842,772,35,586,5063
Wyoming,Powder River,0,0,0,0,0,0,0
Wyoming,Point of Rocks,81,16,14,19,0,0,49
Wyoming,Pine Haven,468,29,273,58,0,18,378
Wyoming,Pinedale,1865,336,756,154,13,56,1315
Wyoming,Pine Bluffs,1131,158,522,139,0,66,885
Wyoming,Pavillion,244,53,104,31,8,10,206
Wyoming,Parkman,194,13,167,0,0,0,180
Wyoming,Owl Creek,0,0,0,0,0,0,0
Wyoming,Osmond,295,59,137,14,0,0,210
Wyoming,Meeteetse,314,39,169,25,0,10,243
Wyoming,Osage,332,77,191,40,0,8,316
Wyoming,Opal,79,18,50,7,0,1,76
Wyoming,Oakley,0,0,0,0,0,0,0
Wyoming,North Rock Springs,2107,356,873,218,98,41,1586
Wyoming,Nordic,664,27,374,156,0,0,557
Wyoming,Newcastle,3502,662,1414,361,23,331,2791
Wyoming,Mountain View,1293,185,556,63,10,79,893
Wyoming,Mountain View,103,14,28,0,0,28,70
Wyoming,Moose Wilson Road,1836,601,831,147,0,25,1604
Wyoming,Moorcroft,1094,208,403,99,8,46,764
Wyoming,Mills,3597,646,1168,688,46,236,2784
Wyoming,Orin,44,0,34,0,0,0,34
Wyoming,Yoder,74,8,43,7,0,12,70
Wyoming,Cheyenne,62195,13992,24567,7152,1056,3055,49822
Wyoming,Johnstown,306,102,79,55,7,7,250
Wyoming,Bondurant,0,0,0,0,0,0,0
Wyoming,Boulder,0,0,0,0,0,0,0
Wyoming,Boulder Flats,407,103,123,48,4,26,304
Wyoming,Brookhurst,195,12,169,0,0,5,186
Wyoming,Buffalo,4614,972,1769,636,24,413,3814
Wyoming,Burlington,257,54,91,30,0,12,187
Wyoming,Burns,266,70,71,28,0,34,203
Wyoming,Byron,620,135,276,45,10,18,484
Wyoming,Carpenter,271,53,181,0,0,0,234
Wyoming,Carter,0,0,0,0,0,0,0
Wyoming,Casper,58817,13532,23028,6835,708,2687,46790
Wyoming,Casper Mountain,373,41,240,19,0,28,328
Wyoming,Centennial,180,37,76,43,0,0,156
Wyoming,Chugcreek,356,64,79,0,0,45,188
Wyoming,Chugwater,269,99,87,54,2,22,264
Wyoming,Clearmont,138,23,58,9,0,5,95
Wyoming,Clearview Acres,1038,258,548,0,23,62,891
Wyoming,Cody,9741,2224,4513,785,81,435,8038
Wyoming,Cokeville,508,51,239,36,7,6,339
Wyoming,Cora,0,0,0,0,0,0,0
Wyoming,Cowley,831,213,317,49,6,32,617
Wyoming,Big Piney,530,157,198,31,0,10,396
Wyoming,Big Horn,427,0,340,0,0,0,340
Wyoming,Beulah,77,0,77,0,0,0,77
Wyoming,Bessemer Bend,166,22,84,27,9,0,142
Wyoming,Afton,1959,382,873,121,29,78,1483
Wyoming,Albany,41,7,28,6,0,0,41
Wyoming,Albin,152,21,59,16,5,2,103
Wyoming,Alcova,0,0,0,0,0,0,0
Wyoming,Alpine,771,144,411,57,10,0,622
Wyoming,Alpine Northeast,11,0,11,0,0,0,11
Wyoming,Alpine Northwest,220,0,158,18,0,44,220
Wyoming,Alta,511,149,195,23,0,15,382
Wyoming,Antelope Hills,0,0,0,0,0,0,0
Wyoming,Antelope Valley-Crestview,1529,216,659,249,1,83,1208
Wyoming,Crowheart,102,16,44,31,0,11,102
Wyoming,Arapahoe,1572,541,287,172,16,58,1074
Wyoming,Arrowhead Springs,49,0,27,22,0,0,49
Wyoming,Arvada,36,10,7,13,0,0,30
Wyoming,Atlantic City,15,0,15,0,0,0,15
Wyoming,Auburn,128,21,61,13,0,18,113
Wyoming,Baggs,393,67,186,45,0,10,308
Wyoming,Bairoil,111,34,55,10,0,1,100
Wyoming,Bar Nunn,2573,393,1350,186,0,50,1979
Wyoming,Basin,1392,270,556,182,19,81,1108
Wyoming,Bear River,674,136,359,46,11,8,560
Wyoming,Bedford,38,7,31,0,0,0,38
Wyoming,Arlington,33,6,11,0,0,4,21
Wyoming,Daniel,308,65,185,28,0,0,278
Wyoming,Dayton,903,159,427,121,3,31,741
Wyoming,Deaver,172,53,52,15,6,15,141
Wyoming,Glendo,308,19,162,37,0,24,242
Wyoming,Glenrock,2593,464,1089,435,0,92,2080
Wyoming,Granger,138,6,62,30,2,7,107
Wyoming,Green River,12604,2436,5700,1268,198,342,9944
Wyoming,Greybull,2089,482,836,218,28,87,1651
Wyoming,Grover,273,11,142,0,0,0,153
Wyoming,Guernsey,1124,245,448,153,9,79,934
Wyoming,Hanna,782,142,382,108,3,30,665
Wyoming,Hartrandt,764,23,251,183,46,33,536
Wyoming,Hartville,83,5,54,19,0,4,82
Wyoming,Gillette,31634,7081,12167,2802,632,886,23568
Wyoming,Hawk Springs,26,5,15,6,0,0,26
Wyoming,Hill View Heights,84,7,77,0,0,0,84
Wyoming,Hoback,1274,208,646,182,0,20,1056
Wyoming,Homa Hills,281,0,164,13,14,19,210
Wyoming,Hudson,517,116,172,63,16,28,395
Wyoming,Hulett,396,134,143,41,4,12,334
Wyoming,Huntley,0,0,0,0,0,0,0
Wyoming,Hyattville,44,0,17,17,0,10,44
Wyoming,Jackson,10152,4072,3135,676,356,197,8436
Wyoming,James Town,576,103,355,44,0,0,502
Wyoming,Jeffrey City,0,0,0,0,0,0,0
Wyoming,Hillsdale,116,57,0,0,0,0,57
Wyoming,Y-O Ranch,124,54,70,0,0,0,124
Wyoming,Garland,106,59,47,0,0,0,106
Wyoming,Frannie,134,24,63,9,0,4,100
Wyoming,Diamondville,644,103,375,38,3,41,560
Wyoming,Dixon,75,13,31,14,1,5,64
Wyoming,Douglas,6371,937,2722,936,86,386,5067
Wyoming,Dubois,780,164,320,136,0,86,706
Wyoming,East Thermopolis,307,46,80,67,4,63,260
Wyoming,Eden,232,32,140,0,0,20,192
Wyoming,Edgerton,327,61,127,17,5,14,224
Wyoming,Elk Mountain,156,29,107,7,0,3,146
Wyoming,Encampment,455,69,245,49,4,15,382
Wyoming,Esterbrook,54,0,33,21,0,0,54
Wyoming,Freedom,416,116,150,0,33,0,299
Wyoming,Ethete,1678,571,315,219,21,57,1183
Wyoming,Evanston,12213,1961,4941,1257,190,654,9003
Wyoming,Evansville,2836,570,1027,403,30,101,2131
Wyoming,Fairview,387,82,156,6,12,0,256
Wyoming,Farson,425,73,229,22,0,0,324
Wyoming,Fontenelle,0,0,0,0,0,0,0
Wyoming,Fort Bridger,249,63,77,76,0,33,249
Wyoming,Fort Laramie,210,41,108,36,2,15,202
Wyoming,Fort Washakie,1861,507,439,193,26,105,1270
Wyoming,Fox Farm-College,4390,1402,1072,712,140,131,3457
Wyoming,Fox Park,0,0,0,0,0,0,0
Wyoming,Etna,259,69,56,72,0,62,259
Wyoming,Kelly,36,36,0,0,0,0,36
