State,City,Population,Nursery-Pre-School,Kindergarten,1st-4th,5th-8th,9th-12th,Total
Alabama,Movico,170,26,0,0,0,0,26
Alabama,Pell City,13312,381,124,754,736,541,2536
Alabama,Pelham,22346,326,117,1515,1244,1295,4497
Alabama,Parrish,1086,24,8,39,82,63,216
Alabama,Panola,32,0,0,0,0,11,11
Alabama,Paint Rock,208,6,4,9,11,10,40
Alabama,Ozark,14786,234,183,698,706,772,2593
Alabama,Oxford,21243,248,283,1227,1427,1163,4348
Alabama,Owens Cross Roads,1667,32,13,90,77,88,300
Alabama,Our Town,490,0,0,0,0,0,0
Alabama,Orrville,110,0,0,0,5,8,13
Alabama,Orange Beach,5682,0,0,232,202,218,652
Alabama,Pennington,218,0,1,9,6,9,25
Alabama,Opp,6665,116,116,285,307,353,1177
Alabama,Onycha,197,7,5,19,8,24,63
Alabama,Oneonta,6633,72,66,415,251,389,1193
Alabama,Ohatchee,962,11,18,62,30,45,166
Alabama,Odenville,3663,79,103,123,135,90,530
Alabama,Oakman,659,8,7,23,25,33,96
Alabama,Oak Hill,11,0,0,0,0,0,0
Alabama,Oak Grove,564,2,5,39,16,27,89
Alabama,Notasulga,974,9,5,33,40,62,149
Alabama,Northport,24339,451,398,1201,1357,968,4375
Alabama,North Johns,179,5,0,21,4,6,36
Alabama,North Courtland,710,0,10,14,38,64,126
Alabama,Opelika,28544,360,176,1478,1433,1699,5146
Alabama,Newville,509,3,0,28,6,33,70
Alabama,Penton,236,0,0,0,14,9,23
Alabama,Boykin,67,0,0,0,0,0,0
Alabama,Phil Campbell,1149,3,15,119,79,38,254
Alabama,Phenix City,36639,405,541,2211,2206,2171,7534
Alabama,Petrey,42,0,0,5,0,0,5
Alabama,Peterman,120,0,0,0,0,0,0
Alabama,Perdido Beach,599,0,2,11,13,21,47
Alabama,Perdido,554,0,10,62,32,0,104
Alabama,Camden,2721,0,37,164,336,191,728
Alabama,Calvert,394,0,0,0,94,38,132
Alabama,Calera,12593,366,258,755,760,579,2718
Alabama,Butler,2360,50,27,134,86,118,415
Alabama,Bucks,50,0,0,0,0,0,0
Alabama,Bon Secour,648,0,0,0,0,38,38
Alabama,Brundidge,2189,6,17,127,85,163,398
Alabama,Brookwood,1932,17,34,61,127,118,357
Alabama,Brookside,1258,12,10,76,85,44,227
Alabama,Brook Highland,7032,99,78,264,281,346,1068
Alabama,Bristow Cove,531,0,0,54,54,35,143
Alabama,Brilliant,908,8,15,30,48,56,157
Alabama,Brighton,2904,0,59,173,114,42,388
Alabama,Bridgeport,2300,14,10,78,175,191,468
Alabama,Brewton,5424,190,47,325,223,247,1032
Alabama,Brent,4898,95,89,176,245,194,799
Alabama,Brantleyville,1111,31,0,136,92,74,333
Alabama,Brantley,971,2,5,49,96,77,229
Alabama,Broomtown,160,0,0,0,9,0,9
Alabama,New Union,1088,35,16,61,63,103,278
Alabama,Newton,1709,34,16,43,62,54,209
Alabama,New Site,767,2,2,25,48,47,124
Alabama,Bessemer,27043,198,316,1625,1331,1664,5134
Alabama,Berry,1392,42,20,60,41,87,250
Alabama,Benton,49,0,0,6,7,1,14
Alabama,Belle Fontaine,539,9,10,32,39,19,109
Alabama,Bellamy,816,0,75,0,64,0,139
Alabama,Belk,289,7,0,24,19,24,74
Alabama,Belgreen,66,0,0,3,2,0,5
Alabama,Beaverton,273,0,0,4,11,21,36
Alabama,Beatrice,294,0,0,27,26,28,81
Alabama,Bear Creek,1296,27,10,71,44,66,218
Alabama,Bayou La Batre,2634,62,56,169,182,146,615
Alabama,Billingsley,176,3,0,7,24,24,58
Alabama,Bay Minette,8843,171,98,513,558,326,1666
Alabama,Ballplay,1535,29,54,119,58,51,311
Alabama,Bakerhill,209,8,0,9,13,7,37
Alabama,Baileyton,909,14,13,38,58,41,164
Alabama,Babbie,687,8,0,19,41,43,111
Alabama,Axis,911,0,7,56,17,86,166
Alabama,Avon,594,13,0,19,56,48,136
Alabama,Autaugaville,1119,28,23,54,43,68,216
Alabama,Auburn,58693,915,717,2146,2388,2588,8754
Alabama,Attalla,5965,20,45,280,296,227,868
Alabama,Atmore,10072,44,95,235,392,725,1491
Alabama,Athens,23938,167,379,1233,1411,1238,4428
Alabama,Banks,136,0,0,13,9,3,25
Alabama,Birmingham,212211,3056,2948,9402,8837,8909,33152
Alabama,Black,157,1,7,3,3,7,21
Alabama,Blountsville,1967,11,17,111,118,108,365
Alabama,New Market,1410,18,33,106,147,73,377
Alabama,New Hope,2803,33,15,194,184,179,605
Alabama,New Brockton,1346,21,43,102,87,59,312
Alabama,Newbern,160,0,1,8,14,6,29
Alabama,Needham,108,0,1,2,2,5,10
Alabama,Nectar,281,0,5,12,17,9,43
Alabama,Nauvoo,171,0,1,7,11,9,28
Alabama,Natural Bridge,43,0,0,2,2,0,4
Alabama,Napier Field,414,2,4,15,32,13,66
Alabama,Nances Creek,292,0,0,44,0,24,68
Alabama,Nanafalia,64,0,0,10,0,4,14
Alabama,Myrtlewood,157,0,0,6,6,4,16
Alabama,Muscle Shoals,13492,125,131,669,968,652,2545
Alabama,Munford,1443,32,0,86,51,115,284
Alabama,Mulga,922,18,21,51,40,25,155
Alabama,Eufaula,12809,182,299,645,827,696,2649
Alabama,Mount Vernon,1482,0,49,116,34,56,255
Alabama,Mount Olive CDP (Jefferson County),4100,91,37,255,199,202,784
Alabama,Mount Olive CDP (Coosa County),300,23,0,0,0,36,59
Alabama,Mountain Brook,20518,682,288,1655,1369,1422,5416
Alabama,Bon Air,103,0,2,13,9,0,24
Alabama,Boligee,640,30,15,63,29,18,155
Alabama,Boaz,9673,75,109,801,666,579,2230
Alabama,Blue Springs,99,0,0,1,2,6,9
Alabama,Blue Ridge,1461,5,0,70,135,155,365
Alabama,Pickensville,661,9,7,41,25,28,110
Alabama,Piedmont,4767,132,82,417,213,204,1048
Alabama,Pike Road,7178,111,111,661,325,409,1617
Alabama,Pinckard,460,0,6,23,9,27,65
Alabama,St. Stephens,580,0,0,30,31,32,93
Alabama,St. Florian,418,2,0,6,20,13,41
Alabama,Rutledge,342,4,2,13,19,6,44
Alabama,Russellville,9824,75,291,682,381,570,1999
Alabama,Rosa,385,1,2,11,12,30,56
Alabama,Rogersville,1099,22,25,40,95,34,216
Alabama,Rockville,34,0,0,0,0,7,7
Alabama,Rock Mills,648,0,0,0,93,69,162
Alabama,Rockford,620,0,4,9,27,3,43
Alabama,Rock Creek,1336,0,0,65,90,59,214
Alabama,Robertsdale,5656,50,99,232,438,221,1040
Alabama,Saks,10826,135,55,462,846,492,1990
Alabama,Roanoke,6013,55,99,313,273,265,1005
Alabama,Riverside,2296,15,26,90,117,113,361
Alabama,River Falls,721,3,1,38,49,38,129
Alabama,Ridgeville,117,0,4,0,0,10,14
Alabama,Repton,130,0,2,8,4,6,20
Alabama,Rehobeth,1602,25,9,96,107,44,281
Alabama,Reform,2012,89,50,88,71,135,433
Alabama,Reeltown,425,0,0,0,14,0,14
Alabama,Reece City,793,8,0,33,67,44,152
Alabama,Redstone Arsenal,1657,21,17,51,101,72,262
Alabama,Red Level,364,0,2,17,24,12,55
Alabama,Redland,4331,76,78,297,184,218,853
Alabama,Riverview,138,0,4,0,6,10,20
Alabama,Samson,2103,21,23,136,86,158,424
Alabama,Sand Rock,590,2,6,15,27,36,86
Alabama,Sanford,212,8,1,9,7,10,35
Alabama,South Vinemont,545,3,4,24,13,19,63
Alabama,Southside,8514,157,11,430,458,455,1511
Alabama,Somerville,691,7,19,44,24,30,124
Alabama,Snead,765,13,4,41,21,25,104
Alabama,Smoke Rise,2443,13,18,230,149,222,632
Alabama,Smiths Station,5165,156,94,354,296,137,1037
Alabama,Slocomb,1880,5,28,120,50,142,345
Alabama,Skyline,1048,3,4,55,66,84,212
Alabama,Sipsey,473,0,10,9,37,14,70
Alabama,Sims Chapel,163,0,0,24,28,6,58
Alabama,Silverhill,654,7,17,8,25,28,85
Alabama,Silas,680,12,3,75,42,21,153
Alabama,Shorter,436,20,4,27,9,19,79
Alabama,Shoal Creek,1481,33,42,129,56,111,371
Alabama,Shiloh,350,12,4,8,20,10,54
Alabama,Shelby,1364,5,30,72,67,94,268
Alabama,Sheffield,9074,157,90,287,435,437,1406
Alabama,Semmes,3583,27,45,233,304,129,738
Alabama,Selmont-West Selmont,2574,30,57,243,142,302,774
Alabama,Selma,19987,241,448,1198,934,1090,3911
Alabama,Section,811,6,6,31,43,22,108
Alabama,Scottsboro,14775,153,134,754,580,781,2402
Alabama,Satsuma,6152,104,155,451,490,228,1428
Alabama,Sardis City,1654,7,26,71,82,121,307
Alabama,Saraland,13715,120,9,616,725,822,2292
Alabama,Red Bay,3143,40,81,161,136,133,551
Alabama,Ashville,2342,24,32,152,231,101,540
Alabama,Ray,480,0,0,0,0,30,30
Alabama,Rainsville,4992,38,72,217,260,287,874
Alabama,Dothan,67708,1049,961,3720,3600,3673,13003
Alabama,Double Springs,1180,27,31,46,28,69,201
Alabama,Douglas,1024,6,17,67,64,79,233
Alabama,Dozier,307,7,2,5,15,26,55
Alabama,Dunnavant,984,0,33,23,76,95,227
Alabama,Dutton,331,1,8,18,24,19,70
Alabama,East Brewton,2508,12,12,91,104,210,429
Alabama,East Point,151,0,0,0,0,0,0
Alabama,Eclectic,912,9,22,59,76,69,235
Alabama,Edgewater,905,15,56,61,47,37,216
Alabama,Edwardsville,137,7,3,15,3,1,29
Alabama,Dora,2295,38,16,113,180,195,542
Alabama,Egypt,1254,54,37,18,10,78,197
Alabama,Elberta,1506,8,21,66,67,56,218
Alabama,Eldridge,204,7,3,14,1,11,36
Alabama,Elkmont,430,3,2,23,18,15,61
Alabama,Pleasant Groves,560,8,8,46,34,13,109
Alabama,Pleasant Grove,10270,98,117,421,845,431,1912
Alabama,Pisgah,717,16,12,25,26,62,141
Alabama,Pinson,7448,133,64,306,285,357,1145
Alabama,Pine Ridge,235,5,7,24,17,5,58
Alabama,Pine Level,4552,35,44,199,180,326,784
Alabama,Pine Hill,929,0,25,110,47,65,247
Alabama,Pine Apple,138,1,1,7,6,11,26
Alabama,Elba,3919,23,30,94,222,223,592
Alabama,Dodge City,714,0,9,22,42,43,116
Alabama,Detroit,215,0,3,1,6,21,31
Alabama,Demopolis,7249,184,114,405,613,432,1748
Alabama,Rainbow City,9608,57,81,522,665,582,1907
Alabama,Ragland,1802,32,6,150,125,72,385
Alabama,Putnam,100,0,0,0,0,19,19
Alabama,Providence,268,8,0,9,13,9,39
Alabama,Prichard,22439,615,483,1389,1030,1322,4839
Alabama,Priceville,2943,76,75,216,124,172,663
Alabama,Prattville,34706,396,603,1970,2328,2105,7402
Alabama,Powell,1037,29,3,71,23,49,175
Alabama,Pollard,236,11,7,52,9,12,91
Alabama,Point Clear,2495,0,62,294,213,22,591
Alabama,Crossville,2312,40,17,123,106,162,448
Alabama,Cuba,509,3,20,12,13,28,76
Alabama,Cullman,15014,244,113,765,762,708,2592
Alabama,Cullomburg,117,0,0,4,12,18,34
Alabama,Cusseta,151,0,0,8,2,6,16
Alabama,Dadeville,3181,23,0,124,41,173,361
Alabama,Daleville,5188,56,64,170,291,272,853
Alabama,Daphne,23559,350,305,1305,1262,1296,4518
Alabama,Dauphin Island,1319,0,14,63,21,19,117
Alabama,Daviston,271,0,1,18,9,7,35
Alabama,Dayton,25,0,0,4,6,1,11
Alabama,Deatsville,1218,61,25,71,93,87,337
Alabama,Decatur,55598,726,782,3348,2651,2616,10123
Alabama,Deer Park,203,0,0,9,8,9,26
Alabama,Delta,259,0,0,0,0,0,0
Alabama,Ranburne,441,7,3,8,38,10,66
Alabama,Ashland,2667,67,50,128,139,181,565
Alabama,Ashford,2316,21,21,141,113,146,442
Alabama,Arley,476,0,0,15,23,28,66
Alabama,Hanceville,3195,10,38,239,133,76,496
Alabama,Hammondville,587,3,10,39,27,32,111
Alabama,Hamilton,6814,27,196,283,288,290,1084
Alabama,Haleyville,4068,61,78,250,188,239,816
Alabama,Haleburg,96,0,0,5,3,5,13
Alabama,Hackneyville,381,0,0,0,0,0,0
Alabama,Hackleburg,1444,6,15,49,26,56,152
Alabama,Gu-Win,126,0,5,3,4,11,23
Alabama,Gurley,691,5,8,45,30,33,121
Alabama,Guntersville,8326,90,102,290,349,373,1204
Alabama,Gulf Shores,10703,77,204,396,259,437,1373
Alabama,Harpersville,1711,28,23,102,100,103,356
Alabama,Gulfcrest,207,0,26,0,18,0,44
Alabama,Grove Hill,1716,38,8,82,110,93,331
Alabama,Elmore,1671,36,23,121,69,63,312
Alabama,Emelle,38,0,0,0,0,0,0
Alabama,Emerald Mountain,2895,153,42,162,203,114,674
Alabama,Enterprise,27785,363,432,1187,1604,1694,5280
Alabama,Epes,137,0,0,16,0,7,23
Alabama,Grimes,570,4,14,31,18,37,104
Alabama,Greenville,7912,164,140,456,327,275,1362
Alabama,Greensboro,2485,49,43,100,140,84,416
Alabama,Graysville,2149,29,22,63,160,119,393
Alabama,Grayson Valley,5160,45,90,137,284,305,861
Alabama,Guin,2351,6,65,72,111,138,392
Alabama,Hartford,2645,7,28,107,173,171,486
Alabama,Hartselle,14455,291,173,765,860,785,2874
Alabama,Harvest,5226,64,132,148,226,240,810
Alabama,Hoover,83547,2084,1299,5057,4341,4483,17264
Alabama,Homewood,25535,502,445,1302,1105,1160,4514
Alabama,Holtville,4263,13,0,403,287,258,961
Alabama,Holt,3652,111,20,224,173,211,739
Alabama,Hollywood,971,0,6,21,34,49,110
Alabama,Holly Pond,1084,17,23,37,68,56,201
Alabama,Hollis Crossroads,714,0,8,62,70,12,152
Alabama,Hollins,930,0,0,50,163,46,259
Alabama,Hokes Bluff,4314,57,28,134,222,204,645
Alabama,Hodges,308,0,1,7,10,14,32
Alabama,Hobson City,998,0,36,74,62,45,217
Alabama,Hobson,77,0,0,0,0,0,0
Alabama,Hissop,772,0,0,24,51,23,98
Alabama,Hillsboro,562,3,7,39,23,28,100
Alabama,Highland Lakes,4864,142,137,305,126,337,1047
Alabama,Highland Lake,393,3,2,13,14,13,45
Alabama,Henagar,2253,18,6,118,137,215,494
Alabama,Helena,17589,668,218,1231,1358,970,4445
Alabama,Heflin,3504,54,13,137,103,280,587
Alabama,Heath,338,9,1,26,23,21,80
Alabama,Headland,4685,47,62,183,339,348,979
Alabama,Hazel Green,3266,47,39,143,153,190,572
Alabama,Hayneville,984,24,4,9,58,37,132
Alabama,Hayden,1186,1,11,48,55,62,177
Alabama,Hatton,144,0,0,0,0,0,0
Alabama,Grant,956,3,18,60,72,58,211
Alabama,Horn Hill,254,0,3,32,6,11,52
Alabama,Grand Bay,3501,63,54,215,224,247,803
Alabama,Goshen,356,0,7,27,16,18,68
Alabama,Fort Rucker,4895,104,146,465,404,191,1310
Alabama,Fort Payne,14112,67,347,814,653,508,2389
Alabama,Fort Deposit,1482,32,35,75,174,54,370
Alabama,Forkland,767,3,6,39,119,62,229
Alabama,Forestdale,9716,121,134,303,644,659,1861
Alabama,Foley,16345,316,72,1158,494,830,2870
Alabama,Florence,39855,451,303,1737,1684,1500,5675
Alabama,Florala,1863,12,18,89,74,102,295
Alabama,Flomaton,1670,21,35,85,98,72,311
Alabama,Five Points,181,3,0,2,2,11,18
Alabama,Fitzpatrick,84,0,0,0,0,0,0
Alabama,Franklin,243,0,0,6,16,22,44
Alabama,Fayetteville,1257,0,38,75,154,47,314
Alabama,Faunsdale,53,0,0,0,0,11,11
Alabama,Falkville,1226,15,4,52,51,49,171
Alabama,Fairview,483,5,8,26,15,44,98
Alabama,Fairhope,17309,487,102,1060,838,1051,3538
Alabama,Fairford,85,0,0,0,0,0,0
Alabama,Fairfield,10987,332,62,588,396,452,1830
Alabama,Excel,1019,2,30,27,85,70,214
Alabama,Evergreen,3842,89,157,195,177,117,735
Alabama,Eva,552,6,0,27,42,29,104
Alabama,Eutaw,2834,15,28,87,101,163,394
Alabama,Eunola,421,0,0,14,0,31,45
Alabama,Fayette,4523,61,39,357,252,198,907
Alabama,Fredonia,385,24,17,10,10,13,74
Alabama,Frisco City,1272,18,14,75,72,110,289
Alabama,Fruitdale,209,0,0,31,38,40,109
Alabama,Gordonville,278,9,0,20,9,17,55
Alabama,Gordon,275,0,0,7,13,18,38
Alabama,Gordo,1680,34,55,113,52,60,314
Alabama,Goodwater,1537,24,11,76,71,127,309
Alabama,Good Hope,2232,22,51,223,139,82,517
Alabama,Goldville,43,0,0,0,4,0,4
Alabama,Glenwood,228,0,2,15,15,16,48
Alabama,Glencoe,5139,15,43,154,299,118,629
Alabama,Glen Allen,513,1,1,16,23,43,84
Alabama,Gilbertown,191,3,0,13,12,2,30
Alabama,Geraldine,883,14,14,80,32,58,198
Alabama,Georgiana,1710,0,8,71,114,92,285
Alabama,Geneva,4469,26,106,426,145,0,703
Alabama,Geiger,262,0,9,12,16,1,38
Alabama,Gaylesville,187,5,0,8,4,8,25
Alabama,Gardendale,13763,135,101,672,664,806,2378
Alabama,Garden City,374,5,0,19,23,0,47
Alabama,Gantt,180,6,0,3,4,4,17
Alabama,Gallant,742,0,6,18,0,95,119
Alabama,Gainesville,171,0,0,5,31,3,39
Alabama,Gadsden,36455,408,460,1860,1723,1812,6263
Alabama,Fyffe,1358,5,9,56,77,94,241
Alabama,Fultondale,8733,104,40,340,525,414,1423
Alabama,Fulton,211,0,0,15,30,7,52
Alabama,Fruithurst,266,6,3,14,5,15,43
Alabama,Graham,332,0,0,0,83,72,155
Alabama,Spanish Fort,7578,105,75,257,566,325,1328
Alabama,Hueytown,15894,314,310,871,875,978,3348
Alabama,Huntsville,185594,2616,2125,8236,8265,8456,29698
Alabama,Margaret,4487,96,92,399,473,425,1485
Alabama,Marbury,1419,8,31,142,41,116,338
Alabama,Maplesville,815,14,5,34,58,66,177
Alabama,Malvern,1816,5,15,61,80,143,304
Alabama,Malcolm,168,0,0,36,0,0,36
Alabama,Magnolia Springs,752,16,0,22,34,33,105
Alabama,Madrid,355,6,10,28,8,3,55
Alabama,Madison,45590,725,549,2818,2894,2981,9967
Alabama,McMullen,5,0,0,0,0,0,0
Alabama,McKenzie,551,12,8,45,19,19,103
Alabama,McIntosh,422,0,1,25,39,41,106
Alabama,Marion,3551,32,51,148,36,262,529
Alabama,Macedonia,165,0,0,21,10,5,36
Alabama,Lynn,563,8,2,25,20,25,80
Alabama,Luverne,2825,24,22,187,113,106,452
Alabama,Loxley,1886,53,35,152,72,88,400
Alabama,Lowndesboro,118,0,0,7,14,0,21
Alabama,Louisville,440,4,5,11,8,0,28
Alabama,Lookout Mountain,1152,0,25,16,22,101,164
Alabama,Locust Fork,1441,0,27,100,69,87,283
Alabama,Lockhart,443,6,0,43,17,10,76
Alabama,Loachapoka,217,0,0,9,13,9,31
Alabama,Livingston,3466,78,64,8,139,216,505
Alabama,Littleville,1029,0,7,43,25,91,166
Alabama,McDonald Chapel,530,0,24,12,54,16,106
Alabama,Maytown,359,2,0,18,16,15,51
Alabama,Meadowbrook,8752,94,73,433,667,623,1890
Alabama,Megargel,64,0,0,0,0,0,0
Alabama,Ariton,702,4,8,43,17,78,150
Alabama,Moundville,2183,103,0,124,94,129,450
Alabama,Moulton,3386,0,28,269,195,130,622
Alabama,Mosses,1036,39,0,37,74,54,204
Alabama,Morrison Crossroads,190,0,0,0,0,0,0
Alabama,Morris,1737,12,18,110,72,100,312
Alabama,Mooresville,78,0,5,4,4,0,13
Alabama,Moores Mill,6591,125,122,273,461,627,1608
Alabama,Moody,12292,160,217,557,688,755,2377
Alabama,Montgomery,202967,3683,2739,11496,10965,11096,39979
Alabama,Montevallo,6549,61,67,320,157,192,797
Alabama,Monroeville,6265,130,108,182,421,426,1267
Alabama,Mobile,194669,3236,2699,8905,9642,10403,34885
Alabama,Minor,1334,0,20,57,63,21,161
Alabama,Millry,565,2,4,16,23,70,115
Alabama,Millport,1070,11,10,60,43,33,157
Alabama,Millerville,216,11,41,7,0,0,59
Alabama,Millbrook,14983,302,266,660,1000,733,2961
Alabama,Mignon,1088,4,48,78,69,56,255
Alabama,Midway,583,0,9,57,17,13,96
Alabama,Midland City,2151,31,44,171,114,126,486
Alabama,Midfield,5284,22,82,273,322,362,1061
Alabama,Meridianville,6270,52,51,376,377,463,1319
Alabama,Mentone,390,3,2,9,13,18,45
Alabama,Memphis,38,0,0,0,0,2,2
Alabama,Lisman,613,11,17,62,41,58,189
Alabama,Huguley,2373,22,16,56,97,144,335
Alabama,Lipscomb,2275,25,27,109,134,129,424
Alabama,Linden,2123,8,0,125,141,72,346
Alabama,Ardmore,1419,15,6,43,128,50,242
Alabama,Argo,4146,39,79,70,294,119,601
Alabama,Lakeview,133,2,4,3,12,20,41
Alabama,La Fayette,2989,66,5,92,177,211,551
Alabama,Ladonia,2840,262,0,189,79,57,587
Alabama,Kinston,563,2,2,52,59,11,126
Alabama,Kinsey,2275,33,18,172,199,154,576
Alabama,Kimberly,2799,44,36,171,147,174,572
Alabama,Killen,1177,7,8,74,90,51,230
Alabama,Kennedy,412,2,0,15,7,2,26
Alabama,Kellyton,248,0,7,26,19,0,52
Alabama,Arab,8282,69,85,394,491,467,1506
Alabama,Kansas,186,0,0,0,8,7,15
Alabama,Jemison,2627,0,74,160,175,115,524
Alabama,Jasper,14186,178,218,710,637,702,2445
Alabama,Jacksonville,12372,197,110,477,473,446,1703
Alabama,Jacksons' Gap,932,8,5,53,47,40,153
Alabama,Jackson,5055,54,27,245,271,338,935
Alabama,Ivalee,690,0,0,49,28,40,117
Alabama,Irondale,12398,90,120,513,697,756,2176
Alabama,Indian Springs Village,2505,33,23,64,150,219,489
Alabama,Ider,887,4,5,36,68,75,188
Alabama,Hytop,422,12,3,29,18,21,83
Alabama,Hurtsboro,487,4,3,25,32,13,77
Alabama,Joppa,263,0,0,0,0,0,0
Alabama,Anniston,22626,512,455,931,911,918,3727
Alabama,Anderson,253,0,4,9,8,9,30
Alabama,Andalusia,9058,166,180,333,617,367,1663
Alabama,Lincoln,6391,194,8,285,266,276,1029
Alabama,Lillian,1256,0,0,145,70,66,281
Alabama,Libertyville,146,0,0,10,9,0,19
Alabama,Lexington,667,10,7,35,29,50,131
Alabama,Level Plains,2181,10,11,80,184,130,415
Alabama,Lester,143,0,0,4,10,20,34
Alabama,Leroy,779,0,0,46,43,54,143
Alabama,Leighton,859,2,23,51,31,71,178
Alabama,Leesburg,1055,18,0,48,78,64,208
Alabama,Leeds,11881,196,246,638,563,644,2287
Alabama,Langston,211,0,0,2,13,22,37
Alabama,Lanett,6457,83,96,363,395,276,1213
Alabama,Lake View,2417,11,14,119,96,111,351
Alabama,Abanda,52,0,0,0,0,0,0
Alabama,Abbeville,2646,47,13,119,148,114,441
Alabama,Adamsville,4454,33,0,235,215,288,771
Alabama,Addison,682,6,2,26,52,42,128
Alabama,Akron,293,5,0,2,7,26,40
Alabama,Alabaster,31905,436,640,2085,1987,2036,7184
Alabama,Albertville,21406,397,273,1759,1569,935,4933
Alabama,Alexander City,14787,288,82,935,949,727,2981
Alabama,Alexandria,3912,32,118,247,275,141,813
Alabama,Aliceville,3727,131,100,215,157,258,861
Alabama,Allgood,803,21,12,45,33,71,182
Alabama,Altoona,808,2,25,13,51,52,143
Alabama,Lineville,2549,26,35,175,178,145,559
Alabama,Spring Garden,179,0,0,12,13,0,25
Alabama,Ethelsville,99,4,7,0,4,4,19
Alabama,Castleberry,543,0,6,23,8,18,55
Alabama,Chatom,1006,0,7,14,60,40,121
Alabama,Chelsea,11386,367,221,812,414,553,2367
Alabama,Cherokee,850,27,8,47,54,51,187
Alabama,Chickasaw,6005,116,156,326,433,368,1399
Alabama,Childersburg,5105,62,132,204,337,213,948
Alabama,Choccolocco,2279,36,15,174,164,136,525
Alabama,Chunchula,136,0,0,0,0,0,0
Alabama,Citronelle,3886,0,47,129,185,228,589
Alabama,Clanton,8715,83,169,372,319,440,1383
Alabama,Clay,9682,16,149,369,491,615,1640
Alabama,Clayhatchee,441,5,0,6,23,23,57
Alabama,Clayton,2947,0,16,47,100,115,278
Alabama,Cleveland,1206,24,13,30,39,55,161
Alabama,Clio,856,19,13,32,30,53,147
Alabama,Coaling,1808,20,22,144,82,98,366
Alabama,Coats Bend,1842,0,22,124,95,232,473
Alabama,Coffeeville,383,6,0,30,26,52,114
Alabama,Coker,819,16,5,49,44,44,158
Alabama,Collinsville,2104,26,57,73,98,161,415
Alabama,Colony,345,0,6,1,24,14,45
Alabama,Columbia,680,5,2,18,45,23,93
Alabama,Columbiana,4176,32,79,167,124,154,556
Alabama,Concord,2044,29,0,70,71,169,339
Alabama,Coosada,1374,22,22,61,67,113,285
Alabama,Cordova,2074,7,21,45,79,96,248
Alabama,Cottondale,3702,12,54,197,157,92,512
Alabama,Cottonwood,1438,27,33,90,78,44,272
Alabama,County Line,187,1,0,3,1,4,9
Alabama,Courtland,592,13,11,52,45,22,143
Alabama,Centreville,2719,25,36,69,111,119,360
Alabama,Centre,3570,17,53,165,136,128,499
Alabama,Camp Hill,1051,37,13,48,56,39,193
Alabama,Carbon Hill,1739,3,21,112,88,78,302
Alabama,West End-Cobb Town,3790,6,36,182,202,227,653
Alabama,West Jefferson,442,2,5,33,24,28,92
Alabama,Westover,1239,17,16,85,54,56,228
Alabama,West Point,626,2,5,35,24,17,83
Alabama,White Hall,832,22,17,48,46,37,170
Alabama,Whatley,0,0,0,0,0,0,0
Alabama,White Plains,908,0,59,0,47,32,138
Alabama,Wetumpka,7406,234,60,295,349,341,1279
Alabama,York,2652,25,37,142,116,130,450
Alabama,Sterrett,575,0,0,20,19,19,58
Alabama,Steele,945,2,19,34,24,29,108
Alabama,Stapleton,1360,12,14,73,83,113,295
Alabama,Standing Rock,48,0,0,0,0,0,0
Alabama,Spruce Pine,146,0,0,0,0,0,0
Alabama,Cowarts,2071,15,25,122,126,150,438
Alabama,Yellow Bluff,186,0,0,0,25,27,52
Alabama,Woodstock,1766,26,42,111,86,82,347
Alabama,Woodland,222,0,0,6,10,18,34
Alabama,Whitesboro,2139,71,84,80,163,202,600
Alabama,Wilsonville,2163,19,13,151,139,117,439
Alabama,Wilton,584,25,15,24,15,62,141
Alabama,Winfield,4345,14,41,145,222,326,748
Alabama,Center Point,16797,298,214,1051,956,1239,3758
Alabama,Cedar Bluff,2017,40,28,133,135,107,443
Alabama,Catherine,20,0,0,0,0,0,0
Alabama,Carrollton,922,2,32,50,33,54,171
Alabama,Carolina,285,0,0,19,10,8,37
Alabama,Carlton,74,0,0,0,0,0,0
Alabama,Carlisle-Rockledge,2910,14,30,113,170,238,565
Alabama,Cardiff,30,0,1,0,2,0,3
Alabama,Woodville,763,9,11,58,48,61,187
Alabama,Creola,1842,17,32,97,99,138,383
Alabama,Coffee Springs,264,0,2,6,11,14,33
Alabama,Tuscumbia,8537,64,51,645,535,414,1709
Alabama,Tuscaloosa,94865,1099,726,3521,3892,4012,13250
Alabama,Vernon,2202,24,3,83,133,208,451
Alabama,Tuskegee,9218,170,69,246,344,419,1248
Alabama,Twin,415,0,2,17,11,32,62
Alabama,Underwood-Petersville,3425,19,42,133,169,219,582
Alabama,Union,269,6,0,6,2,20,34
Alabama,Union Grove,81,0,0,0,1,5,6
Alabama,Union Springs,3915,95,109,215,171,91,681
Alabama,Uniontown,2841,33,42,170,297,321,863
Alabama,Uriah,278,8,0,0,5,0,13
Alabama,West Blocton,1359,14,0,92,78,75,259
Alabama,Weogufka,292,0,8,0,45,8,61
Alabama,Wedowee,714,12,0,34,26,18,90
Alabama,Webb,1287,7,9,58,57,92,223
Alabama,Trussville,20351,523,233,1334,1060,1366,4516
Alabama,Weaver,3072,40,27,82,167,172,488
Alabama,Waterloo,143,0,0,9,10,8,27
Alabama,Warrior,3191,0,0,224,142,232,598
Alabama,Valley,9444,183,92,472,446,420,1613
Alabama,Valley Grande,3912,74,38,232,313,225,882
Alabama,Valley Head,587,3,0,21,6,29,59
Alabama,Walnut Grove,910,2,19,41,82,30,174
Alabama,Vance,1302,25,37,78,46,64,250
Alabama,Waldo,246,1,3,15,19,10,48
Alabama,Wadley,809,7,12,63,12,15,109
Alabama,Vredenburgh,154,0,2,0,0,4,6
Alabama,Vinegar Bend,214,0,33,6,28,0,67
Alabama,Vincent,2032,9,49,85,67,213,423
Alabama,Vina,335,0,8,3,31,8,50
Alabama,Vandiver,1020,8,0,16,55,40,119
Alabama,Waverly,266,1,4,9,4,3,21
Alabama,Troy,18696,207,114,843,510,717,2391
Alabama,Vestavia Hills,34116,949,490,1996,2054,1835,7324
Alabama,Triana,578,8,1,3,34,9,55
Alabama,Springville,4174,32,100,199,344,287,962
Alabama,Stevenson,2194,32,41,113,160,170,516
Alabama,Stewartville,1956,0,27,113,49,130,319
Alabama,Stockton,748,38,0,12,0,27,77
Alabama,Sulligent,1956,31,56,109,69,125,390
Alabama,Sumiton,2689,39,42,192,154,149,576
Alabama,Summerdale,986,9,11,42,86,66,214
Alabama,Susan Moore,731,0,13,33,30,44,120
Alabama,Sweet Water,304,0,20,9,52,20,101
Alabama,Sylacauga,12749,126,117,655,864,862,2624
Alabama,Trinity,2239,29,49,177,90,129,474
Alabama,Sylvan Springs,1729,20,26,135,56,59,296
Alabama,Talladega,15931,236,119,655,757,840,2607
Alabama,Talladega Springs,224,0,5,22,13,19,59
Alabama,Sylvania,2119,17,47,112,122,205,503
Alabama,Tarrant,6278,57,164,285,291,214,1011
Alabama,Taylor,2880,28,69,228,233,186,744
Alabama,Theodore,5942,58,199,315,238,328,1138
Alabama,Trafford,601,6,14,28,12,38,98
Alabama,Thomaston,268,6,0,9,20,12,47
Alabama,Thomasville,4099,94,57,157,189,203,700
Alabama,Toxey,182,2,1,1,31,2,37
Alabama,Town Creek,998,16,0,71,69,42,198
Alabama,Tallassee,5380,152,16,334,259,243,1004
Alabama,Tillmans Corner,19065,180,298,1071,1203,1000,3752
Alabama,Thorsby,2140,31,38,105,136,82,392
Alabama,Tibbie,24,0,0,0,0,0,0
Alabama,Tidmore Bend,1170,0,48,35,46,68,197
Alaska,Toksook Bay,549,17,10,51,51,53,182
Alaska,Tonsina,30,0,0,0,0,0,0
Alaska,Tolsona,0,0,0,0,0,0,0
Alaska,Teller,165,3,3,11,13,10,40
Alaska,Tenakee Springs,150,0,6,5,5,6,22
Alaska,Tetlin,121,2,3,21,17,7,50
Alaska,Tok,1331,22,34,36,65,106,263
Alaska,Thorne Bay,566,8,0,19,28,28,83
Alaska,Togiak,787,28,11,70,56,57,222
Alaska,Tazlina,358,3,6,12,9,18,48
Alaska,Mekoryuk,174,4,2,13,9,4,32
Alaska,South Naknek,63,0,0,1,0,5,6
Alaska,Tanana,277,3,1,12,21,17,54
Alaska,Mentasta Lake,157,4,3,6,6,0,19
Alaska,Mertarvik,0,0,0,0,0,0,0
Alaska,Trapper Creek,432,4,7,29,45,41,126
Alaska,Meadow Lakes,7424,184,69,436,427,430,1546
Alaska,Marshall,350,10,9,26,35,26,106
Alaska,Manokotak,691,27,10,36,41,59,173
Alaska,Manley Hot Springs,84,1,0,10,4,0,15
Alaska,Soldotna,4409,110,60,156,138,278,742
Alaska,Mendeltna,22,0,0,0,0,0,0
Alaska,South Van Horn,581,13,0,42,85,0,140
Alaska,Stebbins,547,6,8,44,51,50,159
Alaska,Steele Creek,6272,110,115,337,227,283,1072
Alaska,Sterling,6054,0,26,208,275,390,899
Alaska,Stevens Village,25,0,0,0,1,0,1
Alaska,Stony River,40,3,0,2,1,0,6
Alaska,Sunrise,15,0,0,0,0,0,0
Alaska,Susitna,0,0,0,0,0,0,0
Alaska,Susitna North,1404,7,9,51,76,36,179
Alaska,Sutton-Alpine,1602,16,10,48,30,69,173
Alaska,Takotna,49,1,3,9,5,2,20
Alaska,Talkeetna,616,8,0,8,28,41,85
Alaska,Tanacross,127,2,2,8,9,8,29
Alaska,Tanaina,9640,131,150,664,802,780,2527
Alaska,Tatitlek,86,2,0,2,2,0,6
Alaska,Haines,1955,26,3,50,162,111,352
Alaska,Salcha,984,0,46,40,78,80,244
Alaska,Gulkana,115,1,4,5,2,1,13
Alaska,Evansville,16,0,0,2,0,0,2
Alaska,Eureka Roadhouse,0,0,0,0,0,0,0
Alaska,Ester,3008,32,69,0,18,277,396
Alaska,Emmonak,835,36,17,51,62,68,234
Alaska,Elim,328,16,8,24,28,17,93
Alaska,Elfin Cove,24,2,0,0,3,0,5
Alaska,Ekwok,78,2,3,6,0,8,19
Alaska,Eielson AFB,2630,39,118,239,191,84,671
Alaska,Egegik,68,2,2,3,1,3,11
Alaska,Eek,455,15,9,47,37,33,141
Alaska,Excursion Inlet,40,0,0,0,0,0,0
Alaska,Edna Bay,0,0,0,0,0,0,0
Alaska,Eagle,89,0,0,0,2,10,12
Alaska,Dry Creek,84,0,0,5,7,0,12
Alaska,Dot Lake Village,54,0,0,2,3,6,11
Alaska,Dot Lake,0,0,0,0,0,0,0
Alaska,Diomede,43,2,1,4,5,2,14
Alaska,Metlakatla,1661,32,43,80,117,87,359
Alaska,Dillingham,2307,88,68,107,84,133,480
Alaska,Diamond Ridge,1140,26,12,72,55,65,230
Alaska,Deltana,2311,12,40,152,181,181,566
Alaska,Delta Junction,1045,14,27,62,65,79,247
Alaska,Eagle Village,17,0,0,0,0,0,0
Alaska,Gustavus,496,0,0,40,4,3,47
Alaska,Fairbanks,32193,458,436,1896,1511,1325,5626
Alaska,Farmers Loop,4149,23,36,270,249,62,640
Alaska,Grayling,171,4,2,20,9,8,43
Alaska,Goodnews Bay,230,2,13,20,8,12,55
Alaska,Golovin,132,2,2,16,9,8,37
Alaska,Goldstream,3862,23,100,39,206,161,529
Alaska,Glennallen,366,0,0,15,41,34,90
Alaska,Glacier View,249,0,3,18,8,10,39
Alaska,Gateway,5610,56,83,400,365,309,1213
Alaska,Game Creek,36,0,8,7,0,0,15
Alaska,Gambell,718,19,11,49,54,53,186
Alaska,Galena,554,15,14,30,43,41,143
Alaska,False Pass,37,0,0,0,0,4,4
Alaska,Gakona,205,0,5,19,29,10,63
Alaska,Fritz Creek,1910,17,19,85,92,75,288
Alaska,Fox River,649,0,4,77,74,71,226
Alaska,Fox,558,0,0,14,0,0,14
Alaska,Four Mile Road,10,0,0,0,0,0,0
Alaska,Fort Yukon,555,18,15,42,36,34,145
Alaska,Fort Greely,391,10,0,35,46,19,110
Alaska,Flat,0,0,0,0,0,0,0
Alaska,Fishhook,5323,102,42,222,413,475,1254
Alaska,Ferry,6,0,0,0,0,0,0
Alaska,Farm Loop,1081,4,0,45,50,89,188
Alaska,Funny River,776,0,21,14,35,43,113
Alaska,Minto,257,4,2,17,14,18,55
Alaska,Old Harbor,249,2,1,3,11,21,38
Alaska,Moose Pass,428,0,5,0,40,6,51
Alaska,Anchorage municipal,299107,3743,3985,15579,15876,16925,56108
Alaska,Anchor Point,1951,20,12,98,94,90,314
Alaska,Anderson,201,0,4,8,6,7,25
Alaska,Angoon,382,6,12,10,8,27,63
Alaska,Aniak,525,24,11,34,38,31,138
Alaska,Anvik,87,2,0,4,9,11,26
Alaska,Arctic Village,138,7,2,10,7,13,39
Alaska,Atka,66,2,0,0,1,5,8
Alaska,Atmautluak,258,3,12,21,28,12,76
Alaska,Atqasuk,159,5,3,9,7,10,34
Alaska,Attu Station,16,0,0,0,0,0,0
Alaska,Badger,21197,235,297,1594,1210,1143,4479
Alaska,Barrow,4293,54,125,381,305,265,1130
Alaska,Bear Creek,1824,12,66,107,75,36,296
Alaska,Beaver,60,0,1,0,0,0,1
Alaska,Beluga,6,0,0,0,0,0,0
Alaska,Bethel,6370,84,93,413,472,504,1566
Alaska,Bettles,22,0,0,0,0,0,0
Alaska,Big Delta,539,9,0,19,31,16,75
Alaska,Big Lake,3815,44,60,255,316,264,939
Alaska,Birch Creek,1,0,0,0,0,0,0
Alaska,Akiak,399,9,15,36,27,17,104
Alaska,Akiachak,562,11,17,42,60,44,174
Alaska,Anaktuvuk Pass,247,2,5,13,25,42,87
Alaska,Akhiok,84,0,2,4,3,1,10
Alaska,Ambler,280,10,9,27,27,14,87
Alaska,Aleneva,59,0,0,22,0,0,22
Alaska,Port Alexander,31,0,0,0,3,8,11
Alaska,Northway Village,92,4,0,5,0,0,9
Alaska,Northway Junction,64,1,3,5,8,14,31
Alaska,Northway,131,0,0,6,11,7,24
Alaska,Port Alsworth,147,1,5,8,23,15,52
Alaska,Port Clarence,40,0,0,0,0,0,0
Alaska,Port Graham,206,11,2,10,9,11,43
Alaska,Port Heiden,81,0,2,4,3,7,16
Alaska,Port Lions,231,3,3,10,3,11,30
Alaska,Port Protection,82,0,0,0,0,0,0
Alaska,Primrose,73,0,0,0,0,0,0
Alaska,Prudhoe Bay,2724,0,0,0,0,0,0
Alaska,Quinhagak,661,20,4,64,58,43,189
Alaska,Rampart,7,0,0,0,0,0,0
Alaska,Red Devil,22,0,0,0,2,0,2
Alaska,Red Dog Mine,81,0,0,0,0,0,0
Alaska,Ridgeway,2195,70,32,147,97,128,474
Alaska,Ruby,202,8,1,20,13,4,46
Alaska,Russian Mission,410,15,4,24,29,39,111
Alaska,St. George,53,0,0,2,4,2,8
Alaska,Alatna,1,0,0,0,0,0,0
Alaska,Alcan Border,51,0,9,11,11,6,37
Alaska,Aleknagik,199,0,2,8,19,23,52
Alaska,Allakaket,77,1,2,2,2,4,11
Alaska,Nuiqsut,345,12,11,27,20,20,90
Alaska,Nulato,285,15,4,6,17,22,64
Alaska,Nunam Iqua,129,4,3,6,10,7,30
Alaska,Noatak,443,16,8,37,27,39,127
Alaska,Ninilchik,728,6,4,15,31,27,83
Alaska,Nikolski,37,0,0,0,0,1,1
Alaska,Nikolai,113,2,1,1,2,3,9
Alaska,Nikolaevsk,234,0,3,9,23,11,46
Alaska,Nikiski,4549,52,100,149,260,301,862
Alaska,Nightmute,259,7,9,18,17,22,73
Alaska,Newtok,388,8,5,52,48,31,144
Alaska,New Stuyahok,609,20,17,53,49,45,184
Alaska,Newhalen,159,10,1,17,11,16,55
Alaska,New Allakaket,67,2,0,6,8,5,21
Alaska,Nenana,406,7,0,12,27,44,90
Alaska,Nelson Lagoon,42,0,0,0,0,0,0
Alaska,Nelchina,170,0,0,0,39,0,39
Alaska,Naukati Bay,32,0,0,0,0,0,0
Alaska,Napaskiak,408,11,10,47,47,27,142
Alaska,Napakiak,352,9,13,41,39,14,116
Alaska,Nanwalek,238,14,9,35,24,19,101
Alaska,Naknek,567,8,7,28,34,53,130
Alaska,Nabesna,0,0,0,0,0,0,0
Alaska,Mud Bay,167,0,0,0,0,0,0
Alaska,Mountain Village,749,21,22,81,67,75,266
Alaska,Mosquito Lake,126,0,0,0,0,0,0
Alaska,Nome,3773,87,75,181,234,271,848
Alaska,Nondalton,182,7,6,11,20,13,57
Alaska,Noorvik,608,11,13,52,41,52,169
Alaska,North Pole,2265,36,23,184,117,121,481
Alaska,Nunapitchuk,554,14,16,66,45,49,190
Alaska,Deering,144,2,4,9,5,5,25
Alaska,Oscarville,22,0,0,5,3,1,9
Alaska,Ouzinkie,230,0,3,11,13,17,44
Alaska,Palmer,6449,100,120,361,385,438,1404
Alaska,Paxson,38,0,0,0,0,5,5
Alaska,Pedro Bay,12,0,0,0,0,1,1
Alaska,Pelican,79,0,0,4,4,5,13
Alaska,Perryville,98,3,2,7,9,8,29
Alaska,Petersburg,3024,83,19,139,152,185,578
Alaska,Petersville,0,0,0,0,0,0,0
Alaska,Moose Creek,728,11,0,28,50,155,244
Alaska,Pilot Point,53,2,1,5,3,2,13
Alaska,Pitkas Point,136,2,2,10,13,8,35
Alaska,Platinum,42,0,0,5,10,2,17
Alaska,Pleasant Valley,168,0,0,0,44,0,44
Alaska,Point Baker,41,0,0,0,0,0,0
Alaska,Point Hope,562,20,26,55,39,37,177
Alaska,Point Lay,285,4,17,33,23,18,95
Alaska,Point MacKenzie,466,0,0,11,0,23,34
Alaska,Point Possession,0,0,0,0,0,0,0
Alaska,Pope-Vannoy Landing,0,0,0,0,0,0,0
Alaska,Portage Creek,0,0,0,0,0,0,0
Alaska,Adak,122,0,1,28,2,7,38
Alaska,Pilot Station,582,14,19,57,49,39,178
Alaska,Crown Point,132,0,0,6,16,12,34
Alaska,Central,58,0,0,0,5,5,10
Alaska,Craig,1231,13,15,74,59,81,242
Alaska,Halibut Cove,23,0,0,0,0,0,0
Alaska,Happy Valley,607,3,7,19,7,33,69
Alaska,Harding-Birch Lakes,142,0,0,13,6,0,19
Alaska,Healy,1120,22,12,81,46,74,235
Alaska,Healy Lake,0,0,0,0,0,0,0
Alaska,Hobart Bay,0,0,0,0,0,0,0
Alaska,Hollis,124,0,0,0,19,0,19
Alaska,Holy Cross,214,6,0,15,16,16,53
Alaska,Homer,5324,77,103,244,225,333,982
Alaska,Yakutat,597,8,8,26,35,38,115
Alaska,Hoonah,821,16,9,28,33,43,129
Alaska,Hope,50,4,0,0,0,0,4
Alaska,Houston,1977,31,16,100,153,115,415
Alaska,Hughes,62,0,2,5,2,10,19
Alaska,Huslia,420,24,17,33,32,52,158
Alaska,Hydaburg,277,1,2,10,22,30,65
Alaska,Hyder,13,0,0,0,0,0,0
Alaska,Igiugig,49,2,1,5,2,0,10
Alaska,Iliamna,78,3,1,2,6,4,16
Alaska,Ivanof Bay,0,0,0,0,0,0,0
Alaska,Hooper Bay,1140,39,43,140,121,93,436
Alaska,Wrangell city and borough,2387,28,20,72,96,131,347
Alaska,Womens Bay,852,0,18,32,43,34,127
Alaska,Wiseman,11,0,0,0,0,0,0
Alaska,Tuntutuliak,466,20,14,42,55,41,172
Alaska,Tununak,294,3,8,31,24,26,92
Alaska,Twin Hills,95,0,2,11,10,2,25
Alaska,Two Rivers,238,0,32,0,0,0,32
Alaska,Tyonek,214,0,0,5,23,15,43
Alaska,Ugashik,19,0,0,0,0,0,0
Alaska,Unalakleet,710,22,15,47,42,24,150
Alaska,Unalaska,4619,61,91,231,205,330,918
Alaska,Upper Kalskag,284,18,3,24,30,23,98
Alaska,Valdez,3979,108,72,273,114,224,791
Alaska,Venetie,177,2,6,14,7,12,41
Alaska,Wainwright,458,6,13,38,40,33,130
Alaska,Wales,155,2,3,11,7,3,26
Alaska,Wasilla,8676,90,168,674,587,528,2047
Alaska,Whale Pass,16,0,0,0,0,0,0
Alaska,White Mountain,179,7,3,8,20,6,44
Alaska,Whitestone,195,0,3,4,3,4,14
Alaska,Whitestone Logging Camp,0,0,0,0,0,0,0
Alaska,Whittier,295,15,3,21,19,13,71
Alaska,Willow,2085,23,43,90,105,131,392
Alaska,Willow Creek,8,0,0,0,0,0,0
Alaska,Juneau city and borough,32531,522,477,1539,1648,1990,6176
Alaska,Kachemak,551,0,5,12,14,15,46
Alaska,Kake,628,16,10,43,31,31,131
Alaska,Kaktovik,155,2,1,14,9,14,40
Alaska,Kotzebue,3283,31,66,238,196,197,728
Alaska,Koyuk,272,6,7,38,31,20,102
Alaska,Koyukuk,80,2,0,11,4,1,18
Alaska,Kupreanof,40,0,0,2,2,0,4
Alaska,Kwethluk,824,22,25,73,81,95,296
Alaska,Kwigillingok,331,4,7,32,22,18,83
Alaska,Lake Louise,45,0,0,0,0,0,0
Alaska,Lake Minchumina,21,0,0,0,0,4,4
Alaska,Lakes,9028,93,92,445,781,705,2116
Alaska,Larsen Bay,61,1,0,1,0,2,4
Alaska,Lazy Mountain,1637,29,23,106,108,160,426
Alaska,Levelock,114,4,5,14,12,13,48
Alaska,Lime Village,7,0,0,0,0,0,0
Alaska,Livengood,10,0,0,0,0,0,0
Alaska,Loring,0,0,0,0,0,0,0
Alaska,Lowell Point,141,0,0,0,0,0,0
Alaska,Lower Kalskag,317,9,10,19,24,24,86
Alaska,Lutak,13,0,0,0,0,0,0
Alaska,McCarthy,107,0,0,0,12,26,38
Alaska,McGrath,346,24,6,21,19,4,74
Alaska,McKinley Park,514,10,0,0,0,0,10
Alaska,Kotlik,643,24,12,42,52,57,187
Alaska,Tuluksak,436,10,28,57,34,27,156
Alaska,Kongiganak,408,8,7,39,12,33,99
Alaska,Kokhanok,145,10,5,6,4,12,37
Alaska,Kalifornsky,7965,223,83,496,511,524,1837
Alaska,Kaltag,192,0,2,7,14,8,31
Alaska,Karluk,44,0,0,0,5,9,14
Alaska,Kasaan,71,0,0,0,7,6,13
Alaska,Kasigluk,599,1,18,45,61,30,155
Alaska,Kasilof,388,6,0,48,42,10,106
Alaska,Kenai,7463,95,124,389,396,394,1398
Alaska,Kenny Lake,128,0,0,12,12,0,24
Alaska,Ketchikan,8197,161,117,361,364,463,1466
Alaska,Kiana,380,7,9,28,29,26,99
Alaska,King Cove,1074,18,9,28,35,42,132
Alaska,King Salmon,340,8,8,20,25,22,83
Alaska,Kipnuk,686,0,9,69,43,54,175
Alaska,Kivalina,576,12,18,52,47,34,163
Alaska,Klawock,792,20,11,29,27,42,129
Alaska,Klukwan,66,0,0,0,0,8,8
Alaska,Knik-Fairview,16017,201,373,1113,974,914,3575
Alaska,Knik River,765,4,8,39,44,57,152
Alaska,Kobuk,159,5,2,20,24,18,69
Alaska,Kodiak,6293,79,65,215,380,309,1048
Alaska,Kodiak Station,1398,50,28,116,102,58,354
Alaska,Koliganek,129,6,3,18,9,8,44
Alaska,Crooked Creek,98,6,0,4,8,9,27
Alaska,Akutan,899,2,1,1,2,7,13
Alaska,Cantwell,209,2,2,12,14,2,32
Alaska,Shaktoolik,223,10,8,22,9,11,60
Alaska,Shishmaref,573,26,14,56,62,29,187
Alaska,Shungnak,342,10,9,42,21,27,109
Alaska,Silver Springs,168,5,11,0,5,7,28
Alaska,Sitka city and borough,8943,180,73,453,468,510,1684
Alaska,Skagway,957,29,14,19,13,26,101
Alaska,Skwentna,42,0,0,4,5,0,9
Alaska,Slana,84,0,0,0,0,0,0
Alaska,Sleetmute,96,8,1,9,8,4,30
Alaska,Chiniak,23,0,0,0,0,0,0
Alaska,Chignik Lake,70,3,1,3,1,9,17
Alaska,Shageluk,43,0,1,1,2,2,6
Alaska,Chignik Lagoon,73,2,0,2,4,8,16
Alaska,Chicken,0,0,0,0,0,0,0
Alaska,Chickaloon,284,0,0,0,3,8,11
Alaska,Chevak,1082,41,22,93,79,100,335
Alaska,Chenega,66,0,0,7,3,0,10
Alaska,Chena Ridge,5473,37,162,289,338,313,1139
Alaska,Chefornak,516,10,15,51,48,53,177
Alaska,Brevig Mission,442,21,6,37,40,29,133
Alaska,Buckland,596,9,13,50,64,63,199
Alaska,Buffalo Soapstone,827,3,22,47,75,99,246
Alaska,Butte,3854,68,40,174,189,271,742
Alaska,Chase,23,0,0,0,0,0,0
Alaska,Chignik,70,3,0,7,5,4,19
Alaska,Seward,2710,0,19,19,153,65,256
Alaska,Seldovia Village,174,5,0,0,8,4,17
Alaska,Seldovia,243,0,0,6,14,20,40
Alaska,Covenant Life,105,0,0,0,0,0,0
Alaska,Cordova,2621,22,0,80,200,133,435
Alaska,Copper Center,405,7,8,25,25,29,94
Alaska,Cooper Landing,457,0,0,51,14,11,76
Alaska,College,14675,117,142,436,467,844,2006
Alaska,Coldfoot,10,0,0,0,0,0,0
Alaska,Cold Bay,46,0,0,0,2,0,2
Alaska,Cohoe,1577,20,13,59,90,131,313
Alaska,Coffman Cove,150,0,0,7,3,5,15
Alaska,Clark's Point,56,0,0,3,8,7,18
Alaska,Clam Gulch,182,0,0,3,28,16,47
Alaska,Circle,118,15,0,2,1,2,20
Alaska,Chuathbaluk,116,5,4,15,8,7,39
Alaska,Chitina,80,2,3,8,9,10,32
Alaska,Chistochina,59,0,0,0,3,0,3
Alaska,Chisana,0,0,0,0,0,0,0
Alaska,St. Mary's,583,7,11,44,63,40,165
Alaska,St. Michael,396,14,11,46,41,37,149
Alaska,St. Paul,576,13,12,23,20,19,87
Alaska,Salamatof,1110,13,9,33,55,66,176
Alaska,Sand Point,1188,18,15,63,51,47,194
Alaska,Savoonga,883,30,24,87,68,63,272
Alaska,Saxman,401,9,1,21,20,20,71
Alaska,Scammon Bay,488,11,11,51,51,74,198
Alaska,Selawik,794,12,17,96,71,59,255
Alaska,Alakanuk,777,22,24,73,62,73,254
Alaska,Chalkyitsik,101,3,3,11,11,2,30
Arizona,Houck,1152,0,22,51,58,72,203
Arizona,Central Heights-Midland City,3030,48,34,59,143,217,501
Arizona,Cornville,2708,0,0,92,43,99,234
Arizona,Corona de Tucson,7023,91,97,258,589,636,1671
Arizona,Cottonwood,178,0,0,7,19,34,60
Arizona,Cottonwood,11493,118,114,564,371,573,1740
Arizona,Cowlic,90,0,0,0,11,23,34
Arizona,Crozier,24,0,0,0,0,0,0
Arizona,Crystal Beach,160,0,0,0,0,7,7
Arizona,Cutter,64,0,0,0,0,0,0
Arizona,Dateland,249,5,7,6,15,16,49
Arizona,Deer Creek,204,0,0,19,3,13,35
Arizona,Jakes Corner,41,0,0,0,0,0,0
Arizona,Indian Wells,212,0,9,8,14,20,51
Arizona,Icehouse Canyon,736,0,0,13,0,11,24
Arizona,Haigler Creek,27,0,0,0,0,0,0
Arizona,Haivana Nakya,203,0,0,36,28,12,76
Arizona,Hard Rock,80,0,0,2,2,6,10
Arizona,Hayden,600,0,0,30,24,58,112
Arizona,Heber-Overgaard,2594,17,62,143,54,175,451
Arizona,Hunter Creek,0,0,0,0,0,0,0
Arizona,Hondah,1118,8,18,101,110,58,295
Arizona,Hotevilla-Bacavi,1091,22,9,91,23,102,247
Arizona,Cornfields,300,8,3,23,17,17,68
Arizona,Cordes Lakes,2642,0,87,73,90,109,359
Arizona,Copper Hill,18,0,0,0,0,0,0
Arizona,Coolidge,11973,112,107,867,837,513,2436
Arizona,Chandler,250202,4747,3222,15529,15335,14751,53584
Arizona,Charco,16,0,0,0,0,0,0
Arizona,Chiawuli Tak,42,0,0,0,0,12,12
Arizona,Chilchinbito,839,7,10,64,54,66,201
Arizona,Chinle,4947,67,113,498,438,538,1654
Arizona,Chino Valley,10961,182,274,538,455,366,1815
Arizona,Chloride,182,0,0,0,0,6,6
Arizona,Christopher Creek,37,0,0,0,0,0,0
Arizona,Chuichu,221,0,0,18,0,0,18
Arizona,Cibecue,1848,25,29,182,163,113,512
Arizona,Huachuca City,2160,51,38,108,154,70,421
Arizona,Cibola,393,0,0,53,10,0,63
Arizona,Citrus Park,4451,101,11,223,315,254,904
Arizona,Clacks Canyon,113,0,0,0,0,0,0
Arizona,Clarkdale,4132,73,4,99,104,320,600
Arizona,Claypool,1843,53,26,129,82,52,342
Arizona,Clay Springs,503,13,19,40,59,85,216
Arizona,Clifton,3500,72,81,308,314,179,954
Arizona,Colorado City,4808,167,115,913,760,257,2212
Arizona,Comobabi,49,0,11,0,20,0,31
Arizona,Concho,238,20,0,40,0,0,60
Arizona,Congress,1255,0,18,14,25,39,96
Arizona,Cienega Springs,1798,29,10,91,37,95,262
Arizona,Holbrook,4993,102,47,434,360,175,1118
Arizona,Bylas,1834,97,50,127,102,138,514
Arizona,Yucca,69,0,0,0,0,0,0
Arizona,Mammoth,1532,34,23,126,89,106,378
Arizona,Maish Vaya,133,0,6,5,9,9,29
Arizona,McNeal,274,8,0,16,19,25,68
Arizona,McNary,634,8,12,53,39,63,175
Arizona,McConnico,0,0,0,0,0,0,0
Arizona,Lupton,3,0,0,0,0,0,0
Arizona,Many Farms,1667,18,68,145,114,130,475
Arizona,Lukachukai,1803,12,23,124,125,166,450
Arizona,Lower Santan Village,688,16,8,95,32,82,233
Arizona,Littletown,436,0,0,48,40,0,88
Arizona,Littlefield,228,0,0,0,28,25,53
Arizona,Litchfield Park,5253,57,64,308,254,296,979
Arizona,Linden,2536,55,40,171,150,186,602
Arizona,Leupp,1059,20,28,74,58,86,266
Arizona,Low Mountain,750,6,31,61,71,62,231
Arizona,Marana,38280,890,388,2251,2031,1744,7304
Arizona,Maricopa,45748,764,1090,2748,2823,2491,9916
Arizona,Maricopa Colony,746,27,29,65,68,31,220
Arizona,Morenci,1649,67,14,139,141,123,484
Arizona,Mojave Ranch Estates,41,0,0,0,5,1,6
Arizona,Mohave Valley,2983,56,34,204,123,113,530
Arizona,Moenkopi,1114,20,28,66,48,37,199
Arizona,Moccasin,55,0,0,0,0,0,0
Arizona,Miracle Valley,515,18,0,37,31,41,127
Arizona,Miami,2052,31,2,95,90,223,441
Arizona,Mesquite Creek,508,0,1,9,8,9,27
Arizona,Mescal,1652,61,7,91,20,34,213
Arizona,Mesa del Caballo,705,0,25,44,30,34,133
Arizona,Mesa,458860,5624,6367,25337,24605,24658,86591
Arizona,Meadview,677,0,0,0,0,0,0
Arizona,Mead Ranch,28,0,0,4,4,0,8
Arizona,Mayer,1269,0,0,0,49,139,188
Arizona,Martinez Lake,54,0,0,0,0,0,0
Arizona,LeChee,1542,39,24,84,89,121,357
Arizona,Youngtown,6405,77,90,335,452,391,1345
Arizona,Lazy Y U,648,42,0,75,170,0,287
Arizona,Lake of the Woods,4363,140,36,240,363,187,966
Arizona,Jerome,388,2,0,12,8,0,22
Arizona,Jeddito,311,8,7,23,27,58,123
Arizona,Morristown,97,0,0,0,0,0,0
Arizona,Hackberry,94,0,0,0,0,0,0
Arizona,Mountainaire,1219,91,5,61,155,27,339
Arizona,Munds Park,660,0,0,0,0,0,0
Arizona,Joseph City,1184,3,16,103,154,98,374
Arizona,Naco,1013,9,42,88,96,80,315
Arizona,Nelson,520,0,18,26,42,29,115
Arizona,New Kingman-Butler,11859,63,99,487,427,558,1634
Arizona,New River,15289,143,133,769,728,831,2604
Arizona,Nogales,20601,201,364,1445,1509,1540,5059
Arizona,Nolic,0,0,0,0,0,0,0
Arizona,Yuma,93812,1710,1586,5684,5698,5944,20622
Arizona,Nazlini,483,3,6,34,52,45,140
Arizona,Kachina Village,2638,52,6,55,140,150,403
Arizona,Kaibab,147,3,0,7,11,19,40
Arizona,Kaibito,1611,26,54,121,151,154,506
Arizona,Lake Montezuma,5970,159,1,55,50,249,514
Arizona,Lake Havasu City,53010,274,822,2409,2062,2511,8078
Arizona,Kykotsmovi Village,843,0,0,57,36,97,190
Arizona,Ko Vaya,24,0,0,0,0,4,4
Arizona,Komatke,1458,68,19,157,189,99,532
Arizona,Kohls Ranch,103,0,0,0,0,0,0
Arizona,Kohatk,21,0,0,0,0,0,0
Arizona,Klagetoh,291,7,3,31,18,23,82
Arizona,Kino Springs,247,0,0,23,9,20,52
Arizona,Kingman,28511,292,83,1576,1505,1251,4707
Arizona,Kearny,2312,31,37,184,104,117,473
Arizona,Keams Canyon,203,0,0,10,0,11,21
Arizona,Kayenta,4702,114,169,406,324,375,1388
Arizona,Katherine,103,0,0,0,0,0,0
Arizona,Kaka,123,5,0,7,0,10,22
Arizona,La Paz Valley,469,0,0,0,0,0,0
Arizona,Gu Oidak,123,0,0,21,0,0,21
Arizona,Cameron,1199,10,21,69,73,102,275
Arizona,Greer,46,0,0,0,0,0,0
Arizona,Verde Village,12532,120,294,581,944,672,2611
Arizona,Vernon,36,0,0,0,0,0,0
Arizona,Vicksburg,1043,0,0,45,46,0,91
Arizona,Village of Oak Creek (Big Park),6336,0,25,87,89,152,353
Arizona,Wagon Wheel,1340,40,14,91,101,21,267
Arizona,Wahak Hotrontk,126,6,0,12,12,6,36
Arizona,Wall Lane,775,0,44,26,151,43,264
Arizona,Walnut Creek,465,0,18,36,0,0,54
Arizona,Ventana,96,0,0,6,14,32,52
Arizona,Washington Park,124,0,0,0,0,0,0
Arizona,Wellton Hills,229,0,22,0,0,0,22
Arizona,Wenden,470,0,0,22,6,22,50
Arizona,Wet Camp Village,333,7,8,36,32,34,117
Arizona,Wheatfields,821,0,17,22,125,90,254
Arizona,Whetstone,2926,77,22,219,263,48,629
Arizona,Whispering Pines,198,0,0,0,0,0,0
Arizona,Whitecone,930,30,23,87,47,89,276
Arizona,White Hills,379,0,0,0,0,0,0
Arizona,Wellton,2942,0,0,46,168,192,406
Arizona,Valle Vista,1988,34,0,63,119,112,328
Arizona,Valle,310,0,39,49,0,0,88
Arizona,Valentine,68,1,0,1,2,0,4
Arizona,Tonto Village,165,0,9,6,6,5,26
Arizona,Topawa,268,0,0,38,28,30,96
Arizona,Topock,14,0,0,0,0,0,0
Arizona,Top-of-the-World,217,0,0,0,13,6,19
Arizona,Toyei,0,0,0,0,0,0,0
Arizona,Truxton,191,3,0,9,14,31,57
Arizona,Tsaile,1198,23,11,79,85,85,283
Arizona,Tubac,1249,0,0,26,0,12,38
Arizona,Tuba City,9772,101,107,873,706,641,2428
Arizona,Tucson,528374,5784,6724,26035,24833,26298,89674
Arizona,Tucson Estates,12079,117,52,420,536,331,1456
Arizona,Tumacacori-Carmen,420,0,0,17,17,29,63
Arizona,Turkey Creek,405,23,13,65,40,32,173
Arizona,Tusayan,355,0,0,20,9,0,29
Arizona,Upper Santan Village,470,13,0,14,0,51,78
Arizona,Utting,120,0,10,8,0,0,18
Arizona,Vail,11143,154,238,629,674,672,2367
Arizona,Vaiva Vo,36,0,0,0,6,0,6
Arizona,Valencia West,10331,212,233,770,764,762,2741
Arizona,White Mountain Lake,2241,11,17,60,155,185,428
Arizona,Whiteriver,4766,121,110,351,340,333,1255
Arizona,Why,184,0,0,0,0,0,0
Arizona,Wickenburg,6620,14,107,280,329,244,974
Arizona,Peach Springs,1010,42,18,92,82,58,292
Arizona,Peeples Valley,523,0,0,35,31,23,89
Arizona,Peoria,163664,2505,2098,9776,10066,9011,33456
Arizona,Peridot,1687,54,11,66,114,176,421
Arizona,Phoenix,1514208,17624,21690,92909,89135,91117,312475
Arizona,Picacho,296,0,0,7,10,0,17
Arizona,Guadalupe,6012,24,49,520,407,447,1447
Arizona,Pima,2440,44,55,194,198,115,606
Arizona,Pimaco Two,435,0,0,0,0,0,0
Arizona,Pinal,486,0,0,26,57,0,83
Arizona,Pine,1147,0,0,0,27,23,50
Arizona,Pinedale,588,0,0,59,24,22,105
Arizona,Pine Lake,73,0,0,0,0,16,16
Arizona,Pinetop Country Club,1635,0,18,14,29,40,101
Arizona,Six Shooter Canyon,985,30,0,48,31,80,189
Arizona,Snowflake,5604,95,158,498,451,465,1667
Arizona,So-Hi,197,0,0,0,0,0,0
Arizona,Solomon,260,0,19,17,23,4,63
Arizona,Somerton,14845,255,209,1511,1128,1080,4183
Arizona,Payson,15248,112,51,470,525,462,1620
Arizona,Sierra Vista Southeast,15128,275,192,585,739,645,2436
Arizona,Paulden,4277,23,26,252,288,19,608
Arizona,Parks,1462,0,0,82,19,48,149
Arizona,Wide Ruins,125,0,0,0,0,0,0
Arizona,Wikieup,150,0,0,0,8,14,22
Arizona,Wilhoit,912,3,7,32,39,28,109
Arizona,Willcox,3639,19,57,114,202,268,660
Arizona,Williams,3065,69,69,158,183,132,611
Arizona,Williamson,5531,21,0,100,108,345,574
Arizona,Willow Canyon,0,0,0,0,0,0,0
Arizona,Willow Valley,872,0,1,28,50,17,96
Arizona,Window Rock,3255,77,10,144,184,109,524
Arizona,Winkelman,327,0,0,13,2,26,41
Arizona,Winslow,9530,145,66,574,635,604,2024
Arizona,Winslow West,518,20,69,26,37,99,251
Arizona,Wintersburg,97,0,0,0,0,0,0
Arizona,Wittmann,456,0,0,0,68,89,157
Arizona,Woodruff,132,0,0,0,0,0,0
Arizona,Yarnell,543,0,0,22,0,0,22
Arizona,York,881,2,9,67,42,111,231
Arizona,Young,456,5,0,5,6,15,31
Arizona,Cactus Flats,1356,0,11,145,48,69,273
Arizona,Patagonia,708,0,18,32,24,11,85
Arizona,Sierra Vista,44892,709,716,2323,2781,2317,8846
Arizona,Show Low,10768,111,134,584,560,446,1835
Arizona,Shonto,546,8,18,33,53,16,128
Arizona,Salome,1421,0,10,155,103,102,370
Arizona,San Carlos,4314,73,41,317,238,248,917
Arizona,Sanders,606,25,4,92,58,95,274
Arizona,San Jose,728,11,12,95,85,69,272
Arizona,Burnside,543,0,17,23,34,98,172
Arizona,Bullhead City,39424,365,736,1182,1367,1886,5536
Arizona,Buckshot,14,0,0,0,0,0,0
Arizona,Buckeye,57165,435,799,3768,3656,4298,12956
Arizona,Bryce,72,0,0,4,5,0,9
Arizona,Brenda,429,0,0,0,0,0,0
Arizona,Bowie,366,0,0,12,0,14,26
Arizona,Bouse,711,0,0,12,33,29,74
Arizona,Bluewater,710,10,10,10,48,0,78
Arizona,Blackwater,1247,18,0,121,133,95,367
Arizona,Black Canyon City,2325,0,0,16,65,59,140
Arizona,Bitter Springs,443,10,0,26,8,35,79
Arizona,Bisbee,5415,81,12,306,286,225,910
Arizona,Beyerville,286,4,9,29,29,39,110
Arizona,Benson,5013,74,54,197,275,103,703
Arizona,St. Michaels,1483,11,11,65,106,87,280
Arizona,Beaver Valley,175,0,0,0,0,0,0
Arizona,St. Johns,633,11,7,46,14,51,129
Arizona,Parker Strip,572,0,0,16,0,5,21
Arizona,Tolleson,6806,22,22,463,433,242,1182
Arizona,Tombstone,1510,13,26,35,82,66,222
Arizona,Tonalea,331,5,14,25,41,27,112
Arizona,Tonopah,19,0,0,0,0,0,0
Arizona,Tonto Basin,1394,18,11,48,17,55,149
Arizona,North Fork,1701,61,8,135,93,80,377
Arizona,Nutrioso,74,0,0,0,0,0,0
Arizona,Oak Springs,83,2,2,7,10,2,23
Arizona,Oatman,120,0,0,0,0,0,0
Arizona,Oljato-Monument Valley,250,4,0,30,4,8,46
Arizona,Oracle,3756,59,0,42,144,417,662
Arizona,Orange Grove Mobile Manor,685,0,0,32,60,54,146
Arizona,Oro Valley,41965,625,468,1635,1440,2458,6626
Arizona,Oxbow Estates,103,0,11,0,0,0,11
Arizona,Padre Ranchitos,142,12,0,10,31,8,61
Arizona,Page,7429,280,74,661,398,556,1969
Arizona,Palominas,453,0,0,55,160,99,314
Arizona,Paradise Valley,13477,361,137,592,645,717,2452
Arizona,Parker,3068,41,21,239,154,139,594
Arizona,St. Johns,3512,104,90,143,205,230,772
Arizona,Sonoita,958,0,0,20,38,83,141
Arizona,Beaver Dam,1622,0,0,0,59,167,226
Arizona,Bagdad,1913,29,53,203,106,108,499
Arizona,Aguila,1066,16,10,22,54,61,163
Arizona,San Luis,30658,560,570,1743,2280,2530,7683
Arizona,San Manuel,4028,77,127,260,397,173,1034
Arizona,San Miguel,253,0,10,9,22,33,74
Arizona,San Simon,131,0,0,13,0,0,13
Arizona,Santa Cruz,0,0,0,0,0,0,0
Arizona,San Tan Valley,87923,1396,1875,7400,7313,5691,23675
Arizona,Santa Rosa,562,5,0,48,27,67,147
Arizona,Sawmill,633,7,2,40,49,63,161
Arizona,Scenic,1699,0,48,210,176,17,451
Arizona,Scottsdale,227471,3243,2152,8352,8754,10155,32656
Arizona,Seba Dalkai,115,0,0,7,3,13,23
Arizona,Second Mesa,1296,35,36,58,115,105,349
Arizona,Sedona,10204,126,0,258,230,175,789
Arizona,Sehili,119,3,0,8,12,4,27
Arizona,Seligman,457,0,0,31,7,28,66
Arizona,Sells,2160,34,57,186,131,160,568
Arizona,Seven Mile,831,0,5,49,33,13,100
Arizona,Shongopovi,997,22,28,111,54,59,274
Arizona,Ajo,3886,7,22,402,73,89,593
Arizona,Bear Flat,9,0,0,0,0,0,0
Arizona,Ak Chin,33,0,0,0,0,15,15
Arizona,Alamo Lake,4,0,0,0,0,0,0
Arizona,Aztec,2,0,0,0,0,0,0
Arizona,Avra Valley,4736,0,53,90,229,350,722
Arizona,Avondale,78872,846,1564,5139,5159,5791,18499
Arizona,Avenue B and C,3798,8,6,265,275,450,1004
Arizona,Ash Fork,650,0,0,60,142,105,307
Arizona,Arlington,77,0,0,0,0,0,0
Arizona,Arizona Village,929,20,14,72,70,46,222
Arizona,Arizona City,8969,16,316,468,371,480,1651
Arizona,Arivaca Junction,868,10,8,71,98,79,266
Arizona,Arivaca,587,0,0,17,8,0,25
Arizona,Apache Junction,36586,592,557,1259,1454,1096,4958
Arizona,Anthem,22995,308,342,1674,1648,1992,5964
Arizona,Antares,113,0,0,3,0,0,3
Arizona,Anegam,79,0,0,0,0,9,9
Arizona,Amado,165,0,0,0,0,0,0
Arizona,Alpine,95,0,0,0,0,0,0
Arizona,Ali Molina,131,0,0,0,11,20,31
Arizona,Ali Chukson,108,0,0,0,10,11,21
Arizona,Ali Chuk,149,17,5,5,0,0,27
Arizona,Ak-Chin Village,1193,43,39,75,82,53,292
Arizona,South Komelik,73,0,0,0,0,0,0
Arizona,Picture Rocks,8666,174,42,474,400,515,1605
Arizona,Springerville,1995,45,30,122,179,192,568
Arizona,East Fork,709,26,26,46,21,45,164
Arizona,Rock House,14,0,0,0,0,0,0
Arizona,Rock Point,525,0,10,47,66,28,151
Arizona,Roosevelt,61,0,0,0,0,0,0
Arizona,Rough Rock,553,10,15,34,45,64,168
Arizona,Round Rock,882,6,16,89,79,86,276
Arizona,Round Valley,599,0,0,0,80,40,120
Arizona,Rye,88,0,0,0,0,0,0
Arizona,Sacate Village,135,7,7,7,7,15,43
Arizona,Sacaton,2667,7,37,172,86,92,394
Arizona,Sacaton Flats Village,422,11,23,10,52,0,96
Arizona,Saddlebrooke,9790,12,0,26,75,190,303
Arizona,Safford,9636,38,102,557,555,675,1927
Arizona,Sahuarita,25430,573,294,2329,1432,1166,5794
Arizona,St. David,1564,0,82,85,129,192,488
Arizona,Cactus Forest,518,0,11,19,46,33,109
Arizona,Campo Bonito,18,0,0,0,0,0,0
Arizona,Camp Verde,11008,76,97,555,559,446,1733
Arizona,Cane Beds,569,0,12,81,86,55,234
Arizona,Canyon Day,1310,35,30,78,150,48,341
Arizona,Carefree,3491,37,0,39,0,0,76
Arizona,Carrizo,208,0,6,27,22,20,75
Arizona,Casa Blanca,1623,61,31,124,66,57,339
Arizona,Casa Grande,49796,547,624,2743,3209,3399,10522
Arizona,Casas Adobes,68862,677,836,3324,3277,3817,11931
Arizona,Eagar,4930,245,129,403,456,280,1513
Arizona,Duncan,683,1,9,26,35,49,120
Arizona,Dudleyville,336,0,0,0,23,57,80
Arizona,Drysdale,223,0,15,31,21,0,67
Arizona,Tempe,169816,1646,1437,5724,5816,7251,21874
Arizona,Thatcher,4935,13,102,342,372,295,1124
Arizona,Theba,102,0,0,11,5,5,21
Arizona,Three Points,5033,37,82,174,296,319,908
Arizona,Tolani Lake,344,17,11,22,33,17,100
Arizona,Pinetop-Lakeside,4306,41,39,294,209,198,781
Arizona,Pinion Pines,248,0,0,0,0,0,0
Arizona,Pinon,836,13,25,84,57,44,223
Arizona,Pirtleville,1794,15,0,106,210,158,489
Arizona,Pisinemo,447,14,16,37,23,34,124
Arizona,South Tucson,5686,164,96,412,351,492,1515
Arizona,Prescott,40700,207,208,997,1321,1224,3957
Arizona,Catalina,7456,170,64,397,344,393,1368
Arizona,Prescott Valley,40258,339,415,1867,2328,2072,7021
Arizona,Queen Creek,30143,764,669,2832,2862,2420,9547
Arizona,Queen Valley,689,0,0,0,0,0,0
Arizona,Rainbow City,1102,55,9,96,78,18,256
Arizona,Rancho Mesa Verde,619,0,0,9,24,123,156
Arizona,Red Mesa,222,4,4,11,3,15,37
Arizona,Red Rock CDP (Apache County),223,0,7,13,14,5,39
Arizona,Red Rock CDP (Pinal County),2169,63,57,167,119,222,628
Arizona,Rillito,297,0,0,46,12,11,69
Arizona,Rincon Valley,5103,61,31,326,387,342,1147
Arizona,Rio Rico,18760,209,435,1031,1410,1564,4649
Arizona,Rio Verde,2114,0,0,0,0,0,0
Arizona,Dripping Springs,103,0,0,0,4,4,8
Arizona,Quartzsite,3665,0,0,3,0,0,3
Arizona,Catalina Foothills,50940,631,332,1918,2127,2499,7507
Arizona,Cave Creek,5122,43,21,109,225,337,735
Arizona,Cedar Creek,416,6,15,46,9,22,98
Arizona,Fort Mohave,13686,181,134,638,518,387,1858
Arizona,Fort Thomas,481,0,0,0,87,57,144
Arizona,Fortuna Foothills,27487,182,164,819,887,870,2922
Arizona,Fort Valley,1105,22,4,17,17,246,306
Arizona,Fountain Hills,23322,104,239,390,733,1071,2537
Arizona,Franklin,34,3,0,6,3,0,12
Arizona,Fredonia,1688,15,34,45,131,167,392
Arizona,Freedom Acres,57,0,0,4,0,0,4
Arizona,Gadsden,579,14,11,31,36,50,142
Arizona,Ganado,1007,17,23,107,72,40,259
Arizona,Geronimo Estates,160,0,0,0,0,0,0
Arizona,Gila Bend,1725,69,9,151,88,80,397
Arizona,Fort Defiance,4005,73,71,310,184,396,1034
Arizona,Gila Crossing,748,27,40,55,30,54,206
Arizona,Gisela,652,4,7,13,43,19,86
Arizona,Glendale,234844,2474,3269,13989,13635,14665,48032
Arizona,Globe,7430,57,49,365,403,581,1455
Arizona,Gold Canyon,9597,8,36,160,122,166,492
Arizona,Golden Shores,1460,0,0,0,49,0,49
Arizona,Golden Valley,8946,52,21,314,301,335,1023
Arizona,Goodyear,72880,1266,1086,4406,4273,4185,15216
Arizona,Goodyear Village,407,0,0,11,32,7,50
Arizona,Grand Canyon Village,1504,0,0,4,15,62,81
Arizona,Grand Canyon West,0,0,0,0,0,0,0
Arizona,Greasewood,519,5,10,49,57,62,183
Arizona,Green Valley,22419,3,0,121,96,164,384
Arizona,Gilbert,230781,4564,4122,16666,17934,15411,58697
Arizona,Tees Toh,445,9,5,30,14,41,99
Arizona,Fort Apache,135,5,6,12,6,6,35
Arizona,Flowing Springs,61,0,0,0,0,0,0
Arizona,Centennial Park,1411,72,22,151,186,201,632
Arizona,Central,406,0,26,0,0,0,26
Arizona,Drexel Heights,28233,288,402,1816,2091,2148,6745
Arizona,Dragoon,108,0,0,0,0,0,0
Arizona,Douglas,16911,156,206,743,782,1126,3013
Arizona,Donovan Estates,1313,38,17,70,66,37,228
Arizona,Doney Park,5944,48,25,436,516,482,1507
Arizona,Dolan Springs,2050,0,0,58,140,72,270
Arizona,Dilkon,1268,29,23,121,135,126,434
Arizona,Dewey-Humboldt,3928,17,13,221,182,185,618
Arizona,Desert Hills,2602,0,0,125,85,15,225
Arizona,Dennehotso,752,5,11,49,55,48,168
Arizona,Flowing Wells,16078,207,127,756,789,870,2749
Arizona,Del Muerto,411,0,0,10,52,45,107
Arizona,East Verde Estates,232,0,0,0,0,0,0
Arizona,Ehrenberg,979,0,0,60,22,54,136
Arizona,El Capitan,131,0,0,9,0,27,36
Arizona,Elephant Head,650,18,17,32,21,53,141
Arizona,Elfrida,383,0,0,22,27,23,72
Arizona,Elgin,184,0,0,12,0,19,31
Arizona,El Mirage,33010,595,426,2359,2528,2250,8158
Arizona,Eloy,16954,225,195,668,672,469,2229
Arizona,El Prado Estates,415,0,0,15,27,54,96
Arizona,First Mesa,1739,27,41,139,150,80,437
Arizona,Flagstaff,68375,1120,684,2662,2590,2629,9685
Arizona,Florence,30770,17,422,1054,859,1109,3461
Arizona,East Globe,143,0,0,10,13,12,35
Arizona,Teec Nos Pos,643,7,4,21,37,86,155
Arizona,Poston,370,0,5,15,22,18,60
Arizona,Steamboat,270,0,7,19,20,9,55
Arizona,Swift Trail Junction,3323,54,0,213,219,143,629
Arizona,Sweet Water Village,372,0,0,12,21,43,76
Arizona,Surprise,123813,1667,2327,8506,7528,6081,26109
Arizona,Superior,2868,29,31,178,200,107,545
Arizona,Supai,10,0,0,0,0,0,0
Arizona,Sunwest,3,0,0,0,0,0,0
Arizona,Sun Valley,280,0,0,0,0,0,0
Arizona,Tacna,706,10,0,43,63,93,209
Arizona,Sun Lakes,14378,0,25,52,52,36,165
Arizona,Sun City West,24338,0,0,0,0,37,37
Arizona,Sun City,39111,0,12,92,72,85,261
Arizona,Summit,5097,72,57,384,362,382,1257
Arizona,Summerhaven,151,0,16,36,18,0,70
Arizona,Spring Valley,1470,0,0,36,61,22,119
Arizona,Stanfield,232,0,0,0,0,0,0
Arizona,Star Valley,2090,11,0,76,128,24,239
Arizona,Sunizona,200,0,2,5,7,14,28
Arizona,Tanque Verde,16748,205,102,604,828,814,2553
Arizona,Tat Momoli,50,0,0,0,0,0,0
Arizona,Taylor,4118,67,17,359,268,393,1104
Arizona,Strawberry,430,0,0,0,0,8,8
Arizona,Stotonic Village,466,18,8,40,62,26,154
Arkansas,Belleville,359,3,4,23,21,20,71
Arkansas,Reader,18,0,0,0,0,0,0
Arkansas,Quitman,806,4,6,38,52,46,146
Arkansas,Sulphur Springs,1065,16,0,10,13,61,100
Arkansas,Summit,507,7,14,29,9,25,84
Arkansas,Sunset,171,7,3,12,28,15,65
Arkansas,Sweet Home,579,15,31,4,49,16,115
Arkansas,Ben Lomond,108,2,2,2,0,9,15
Arkansas,Bauxite,546,12,6,31,26,28,103
Arkansas,Benton,32725,803,651,1880,1742,1758,6834
Arkansas,Beaver,80,0,0,2,5,4,11
Arkansas,Beebe,7851,150,57,427,541,752,1927
Arkansas,Beedeville,137,2,0,28,10,2,42
Arkansas,Bella Vista,27606,148,391,1110,921,1043,3613
Arkansas,Bellefonte,513,2,6,19,23,42,92
Arkansas,Bay,1973,36,32,98,112,90,368
Arkansas,Bearden,934,40,12,66,73,57,248
Arkansas,Almyra,345,4,5,11,10,13,43
Arkansas,Warren,5852,121,77,307,297,166,968
Arkansas,Tuckerman,2257,23,24,110,146,109,412
Arkansas,Trumann,7179,54,124,499,495,341,1513
Arkansas,Traskwood,401,0,3,6,26,49,84
Arkansas,Tontitown,2625,49,35,112,202,198,596
Arkansas,Tollette,325,2,0,5,15,27,49
Arkansas,Tinsman,37,0,0,0,1,4,5
Arkansas,Tull,631,16,3,41,39,37,136
Arkansas,Tillar,248,5,0,23,17,19,64
Arkansas,Texarkana,30127,457,373,1622,1648,1528,5628
Arkansas,Taylor,610,5,4,39,46,66,160
Arkansas,Swifton,687,18,5,34,29,32,118
Arkansas,Ravenden Springs,223,0,0,6,6,9,21
Arkansas,Ravenden,444,0,5,8,18,36,67
Arkansas,Ratcliff,183,3,0,13,2,20,38
Arkansas,Thornton,592,14,10,6,16,46,92
Arkansas,Tumbling Shoals,1148,30,0,33,95,77,235
Arkansas,Tupelo,179,0,7,1,0,8,16
Arkansas,Turrell,430,10,4,10,10,28,62
Arkansas,Ward,4478,60,13,365,290,361,1089
Arkansas,Walnut Ridge,4755,37,110,273,277,191,888
Arkansas,Waldron,3505,66,108,225,219,109,727
Arkansas,Waldo,1279,8,35,59,55,76,233
Arkansas,Waldenburg,88,0,0,0,10,0,10
Arkansas,Wabbaseka,262,3,6,14,19,9,51
Arkansas,Viola,386,4,2,33,22,25,86
Arkansas,Vilonia,4214,87,43,321,305,354,1110
Arkansas,Victoria,48,0,3,0,4,4,11
Arkansas,Vandervoort,80,0,0,4,16,1,21
Arkansas,Van Buren,22992,474,236,1479,1502,1570,5261
Arkansas,Valley Springs,214,0,5,19,26,8,58
Arkansas,Ulm,213,7,0,6,16,20,49
Arkansas,Tyronza,1003,17,14,55,78,46,210
Arkansas,Twin Groves,385,0,2,15,28,13,58
Arkansas,Rector,2016,89,18,120,156,73,456
Arkansas,Redfield,1598,9,0,79,112,106,306
Arkansas,Reed,130,1,2,7,0,5,15
Arkansas,Reyno,417,4,4,13,37,21,79
Arkansas,Avoca,619,4,7,29,48,78,166
Arkansas,Bald Knob,2902,32,16,206,249,84,587
Arkansas,Banks,129,0,2,1,6,18,27
Arkansas,Barling,4738,28,134,257,135,217,771
Arkansas,Bassett,193,0,0,12,7,9,28
Arkansas,Batesville,10479,163,274,455,393,488,1773
Arkansas,Searcy,23782,475,234,745,988,764,3206
Arkansas,Sedgwick,147,6,4,2,8,5,25
Arkansas,Shannon Hills,3497,161,17,245,150,79,652
Arkansas,Sheridan,4763,52,59,329,320,256,1016
Arkansas,Sherrill,84,0,0,1,16,3,20
Arkansas,Sherwood,30210,688,324,1537,1196,1589,5334
Arkansas,Shirley,342,1,1,31,17,12,62
Arkansas,Sidney,181,0,4,11,8,17,40
Arkansas,Siloam Springs,15832,270,312,1166,912,682,3342
Arkansas,Avilla,812,0,19,0,87,24,130
Arkansas,Austin,2823,93,44,199,200,166,702
Arkansas,Augusta,2420,66,53,96,111,116,442
Arkansas,Aubrey,175,2,0,14,1,6,23
Arkansas,Alma,5537,142,181,354,299,333,1309
Arkansas,Allport,228,13,14,26,26,17,96
Arkansas,Alicia,142,2,0,2,5,17,26
Arkansas,Alexander,2809,107,44,193,166,226,736
Arkansas,Adona,132,2,4,9,4,5,24
Arkansas,Altheimer,957,6,14,67,58,62,207
Arkansas,Altus,861,20,13,43,43,41,160
Arkansas,Smackover,1764,43,15,82,115,102,357
Arkansas,Amagon,88,0,1,5,4,0,10
Arkansas,Anthonyville,237,0,0,0,0,10,10
Arkansas,Antoine,92,0,2,0,0,3,5
Arkansas,Arkadelphia,10721,77,57,488,379,352,1353
Arkansas,Arkansas City,534,7,0,8,26,63,104
Arkansas,Ashdown,4565,127,34,257,375,193,986
Arkansas,Ash Flat,1087,3,10,37,20,60,130
Arkansas,Atkins,3042,60,51,207,119,148,585
Arkansas,Amity,768,29,7,51,43,47,177
Arkansas,Smithville,98,3,0,3,6,11,23
Arkansas,South Lead Hill,117,0,0,7,9,17,33
Arkansas,Southside,2517,20,0,153,184,93,450
Arkansas,St. Joe,151,4,0,5,5,5,19
Arkansas,St. Francis,194,0,9,4,12,3,28
Arkansas,St. Charles,294,0,0,7,9,13,29
Arkansas,Rye,156,7,0,0,11,18,36
Arkansas,Russellville,28738,542,416,1625,1250,1115,4948
Arkansas,Russell,220,0,0,12,11,16,39
Arkansas,Rudy,94,1,0,6,14,12,33
Arkansas,St. Paul,106,0,3,3,8,9,23
Arkansas,Rosston,454,27,9,78,55,37,206
Arkansas,Rondo,257,4,2,2,10,33,51
Arkansas,Roland,548,0,0,14,11,28,53
Arkansas,Rogers,60384,1014,944,3885,3482,3679,13004
Arkansas,Roe,110,4,0,12,7,4,27
Arkansas,Rockwell,3763,127,22,258,284,167,858
Arkansas,Rockport,913,31,12,81,34,21,179
Arkansas,Rison,1175,25,26,49,95,95,290
Arkansas,Rose Bud,498,4,1,26,48,27,106
Arkansas,Alpena,443,19,18,35,14,14,100
Arkansas,Salem,1763,48,29,121,52,64,314
Arkansas,Salesville,409,0,0,17,16,15,48
Arkansas,Sparkman,413,12,0,35,23,0,70
Arkansas,Springdale,75088,1440,1868,5873,4321,4561,18063
Arkansas,Springtown,90,0,0,0,2,7,9
Arkansas,Stamps,1840,53,21,105,69,73,321
Arkansas,Star City,2362,106,40,137,118,66,467
Arkansas,Staves,180,0,15,0,0,8,23
Arkansas,Stephens,1012,11,31,60,18,61,181
Arkansas,Salem,2621,57,23,195,213,36,524
Arkansas,Strawberry,409,3,14,38,35,9,99
Arkansas,Stuttgart,9195,139,225,403,527,562,1856
Arkansas,Subiaco,534,3,0,16,22,80,121
Arkansas,Success,119,4,0,6,4,3,17
Arkansas,Sulphur Rock,398,4,0,38,25,28,95
Arkansas,Sulphur Springs,377,2,6,37,20,22,87
Arkansas,Scranton,198,14,2,12,11,14,53
Arkansas,Scott,29,0,0,0,0,0,0
Arkansas,Strong,426,7,4,17,18,11,57
Arkansas,Pyatt,196,2,4,22,22,5,55
Arkansas,Hensley,30,0,0,0,0,0,0
Arkansas,Prattsville,418,8,10,23,23,41,105
Arkansas,Earle,2134,10,15,115,143,185,468
Arkansas,Dyess,397,0,0,42,37,46,125
Arkansas,Dyer,725,11,0,24,29,57,121
Arkansas,Dumas,4482,111,33,292,258,389,1083
Arkansas,Dover,1413,10,4,48,116,137,315
Arkansas,Donaldson,304,3,3,19,22,34,81
Arkansas,Montrose,360,38,0,27,21,22,108
Arkansas,Moorefield,202,0,6,14,8,9,37
Arkansas,Moro,266,6,3,14,13,5,41
Arkansas,Morrilton,6746,91,132,462,455,398,1538
Arkansas,Morrison Bluff,55,1,0,7,5,4,17
Arkansas,Mountainburg,531,3,0,16,49,50,118
Arkansas,Mountain Home,12309,220,81,706,293,402,1702
Arkansas,Mountain Pine,816,6,5,49,75,82,217
Arkansas,Mountain View,2817,7,39,82,115,157,400
Arkansas,Mount Ida,1191,24,23,31,55,74,207
Arkansas,Mount Pleasant,360,4,6,4,22,6,42
Arkansas,Mount Vernon,164,1,2,6,5,23,37
Arkansas,Mulberry,1703,33,11,98,149,61,352
Arkansas,Murfreesboro,1639,10,38,83,77,95,303
Arkansas,Nashville,4558,104,88,269,277,183,921
Arkansas,East Camden,1070,27,8,82,39,83,239
Arkansas,East End,7248,85,92,441,450,283,1351
Arkansas,Edmondson,265,0,4,6,8,20,38
Arkansas,Egypt,111,4,6,11,9,10,40
Arkansas,Fordyce,4174,75,56,153,308,296,888
Arkansas,Flippin,1516,20,6,56,126,81,289
Arkansas,Fisher,342,12,2,14,26,12,66
Arkansas,Fifty-Six,204,4,2,3,11,14,34
Arkansas,Felsenthal,69,0,0,0,2,0,2
Arkansas,Fayetteville,79037,1328,655,3082,2864,2765,10694
Arkansas,Farmington,6336,111,93,562,349,412,1527
Arkansas,Fargo,120,0,1,5,10,13,29
Arkansas,Fairfield Bay,2382,38,0,168,73,46,325
Arkansas,Everton,207,15,1,17,10,35,78
Arkansas,Natural Steps,372,0,0,0,20,22,42
Arkansas,Evening Shade,465,10,15,19,25,8,77
Arkansas,Eudora,2132,65,14,107,102,101,389
Arkansas,Etowah,321,2,5,9,25,6,47
Arkansas,Enola,407,9,6,26,38,18,97
Arkansas,England,2794,68,72,232,113,131,616
Arkansas,Emmet,584,5,17,15,10,46,93
Arkansas,Emerson,319,0,2,16,25,38,81
Arkansas,Elm Springs,2136,9,56,141,103,154,463
Arkansas,Elkins,2832,44,42,137,126,201,550
Arkansas,El Dorado,18480,498,429,1211,929,981,4048
Arkansas,Elaine,722,50,0,65,33,40,188
Arkansas,Eureka Springs,2054,50,6,39,71,45,211
Arkansas,Newark,1470,25,19,98,103,94,339
Arkansas,New Blaine,179,7,0,0,14,7,28
Arkansas,New Edinburg,399,31,0,0,0,51,82
Arkansas,Parkdale,287,12,0,14,11,31,68
Arkansas,Parkin,907,0,6,41,35,47,129
Arkansas,Patmos,82,0,5,0,0,0,5
Arkansas,Patterson,459,14,8,28,8,39,97
Arkansas,Peach Orchard,98,4,0,6,2,7,19
Arkansas,Pea Ridge,5046,126,160,321,230,360,1197
Arkansas,Perla,321,19,8,31,20,18,96
Arkansas,Perry,265,0,1,12,8,29,50
Arkansas,Perrytown,342,12,4,18,10,21,65
Arkansas,Perryville,1636,44,3,133,107,79,366
Arkansas,Paris,3482,76,35,134,123,184,552
Arkansas,Piggott,3713,40,0,155,135,184,514
Arkansas,Pine Bluff,46228,994,827,2219,2617,2717,9374
Arkansas,Prescott,3221,73,167,305,57,77,679
Arkansas,Piney,4073,19,48,153,226,196,642
Arkansas,Plainview,553,12,15,41,22,30,120
Arkansas,Pleasant Plains,324,6,2,29,8,19,64
Arkansas,Plumerville,1052,7,9,67,43,47,173
Arkansas,Pocahontas,6516,140,95,312,190,336,1073
Arkansas,Pollard,208,7,4,17,11,4,43
Arkansas,Portia,591,23,3,31,16,18,91
Arkansas,Portland,427,0,1,13,20,14,48
Arkansas,Pindall,147,6,2,7,4,3,22
Arkansas,Foreman,1242,25,5,44,68,77,219
Arkansas,Paragould,27228,646,280,1563,1569,1394,5452
Arkansas,Palestine,688,5,11,37,12,54,119
Arkansas,Newport,7782,144,49,304,248,282,1027
Arkansas,Nimmons,47,0,0,0,6,0,6
Arkansas,Norfork,545,22,4,9,6,26,67
Arkansas,Norman,329,17,0,16,19,34,86
Arkansas,Norphlet,835,24,32,36,40,43,175
Arkansas,North Crossett,2898,10,56,168,264,110,608
Arkansas,North Little Rock,65538,1422,920,4154,3501,2987,12984
Arkansas,Oak Grove,425,3,3,23,17,20,66
Arkansas,Oak Grove Heights,902,17,24,35,64,71,211
Arkansas,Oakhaven,59,2,2,3,4,0,11
Arkansas,Pangburn,643,2,14,30,25,43,114
Arkansas,Oden,240,10,5,12,23,34,84
Arkansas,Oil Trough,250,7,1,15,23,21,67
Arkansas,O'Kean,194,0,0,4,19,18,41
Arkansas,Okolona,139,0,3,5,5,10,23
Arkansas,Ola,1284,7,3,32,35,50,127
Arkansas,Omaha,198,0,12,10,16,11,49
Arkansas,Oppelo,826,8,11,48,23,32,122
Arkansas,Osceola,7424,120,130,339,702,554,1845
Arkansas,Oxford,636,19,4,37,11,18,89
Arkansas,Ozan,71,6,0,0,0,0,6
Arkansas,Ozark,3623,0,22,237,312,218,789
Arkansas,Ogden,144,0,2,5,5,8,20
Arkansas,Forrest City,14999,335,126,757,813,1029,3060
Arkansas,Fort Smith,87603,1432,1397,4655,4330,4948,16762
Arkansas,Fouke,783,7,3,28,38,65,141
Arkansas,Highfill,635,5,5,40,61,22,133
Arkansas,Highland,999,2,13,39,67,57,178
Arkansas,Hindsville,36,0,0,0,0,2,2
Arkansas,Holiday Island,2596,45,18,56,60,53,232
Arkansas,Holland,651,3,14,23,23,36,99
Arkansas,Holly Grove,677,17,0,52,65,52,186
Arkansas,Hope,10001,219,269,744,813,678,2723
Arkansas,Horatio,1117,27,23,72,54,91,267
Arkansas,Horseshoe Bend,2178,22,12,70,36,85,225
Arkansas,Horseshoe Lake,248,0,0,1,8,4,13
Arkansas,Higginson,768,17,9,52,49,55,182
Arkansas,Hot Springs,35539,619,269,1636,1709,1483,5716
Arkansas,Houston,265,4,0,15,3,4,26
Arkansas,Hoxie,2719,50,23,66,125,190,454
Arkansas,Hughes,1700,61,14,85,132,99,391
Arkansas,Humnoke,225,4,0,20,17,7,48
Arkansas,Humphrey,489,9,10,8,6,28,61
Arkansas,Hunter,99,0,0,0,0,2,2
Arkansas,Huntington,609,3,9,13,33,44,102
Arkansas,Huntsville,2348,51,34,200,123,115,523
Arkansas,Huttig,561,17,10,24,23,25,99
Arkansas,Imboden,565,17,7,14,32,30,100
Arkansas,Hot Springs Village,13477,63,25,119,238,148,593
Arkansas,Jacksonport,134,0,2,9,0,11,22
Arkansas,Higden,137,3,0,4,15,10,32
Arkansas,Grubbs,465,5,0,29,35,18,87
Arkansas,Helena-West Helena,11546,432,129,730,936,819,3046
Arkansas,Hector,517,12,7,32,9,31,91
Arkansas,Heber Springs,7187,156,68,408,232,403,1267
Arkansas,Hazen,1478,35,12,49,97,113,306
Arkansas,Haynes,188,0,5,19,9,18,51
Arkansas,Havana,244,1,3,12,8,10,34
Arkansas,Hatfield,449,3,12,22,28,47,112
Arkansas,Haskell,4323,132,26,171,345,197,871
Arkansas,Hartman,594,6,2,21,53,70,152
Arkansas,Hartford,498,8,7,17,17,24,73
Arkansas,Hickory Ridge,233,1,1,3,6,19,30
Arkansas,Harrison,13131,210,241,533,838,664,2486
Arkansas,Harrell,320,3,10,14,7,17,51
Arkansas,Hardy,702,0,2,12,28,35,77
Arkansas,Hampton,1340,36,11,76,57,61,241
Arkansas,Hamburg,2819,60,32,173,189,199,653
Arkansas,Hagarville,265,0,0,24,9,0,33
Arkansas,Hackett,833,19,24,43,41,33,160
Arkansas,Guy,761,11,35,38,49,52,185
Arkansas,Gurdon,2206,15,18,118,165,176,492
Arkansas,Gum Springs,141,0,0,1,14,6,21
Arkansas,Guion,112,0,1,0,6,0,7
Arkansas,Harrisburg,2329,16,15,101,202,115,449
Arkansas,Pottsville,3030,37,62,246,161,103,609
Arkansas,Jacksonville,28726,589,560,1856,1552,1474,6031
Arkansas,Jennette,130,0,0,1,9,16,26
Arkansas,Gosnell,3401,63,83,235,267,280,928
Arkansas,Goshen,1525,38,36,111,124,92,401
Arkansas,Glenwood,2376,50,19,73,86,107,335
Arkansas,Gilmore,233,0,0,0,2,12,14
Arkansas,Gillham,265,6,6,31,27,0,70
Arkansas,Gillett,682,12,9,34,31,27,113
Arkansas,Gilbert,32,0,0,0,0,1,1
Arkansas,Gibson,4417,70,100,170,178,105,623
Arkansas,Georgetown,83,0,0,3,0,3,6
Arkansas,Gentry,3336,0,47,327,161,245,780
Arkansas,Gould,764,37,19,77,76,21,230
Arkansas,Gateway,406,0,5,24,45,42,116
Arkansas,Garner,179,2,0,7,5,5,19
Arkansas,Garland,321,4,4,14,19,12,53
Arkansas,Garfield,525,4,10,20,23,34,91
Arkansas,Fulton,184,0,8,8,10,6,32
Arkansas,Friendship,182,2,1,7,11,6,27
Arkansas,Fredonia (Biscoe),415,16,6,44,12,17,95
Arkansas,Franklin,197,0,7,0,7,3,17
Arkansas,Fourche,70,0,0,0,2,9,11
Arkansas,Fountain Lake,506,20,2,27,44,36,129
Arkansas,Fountain Hill,93,0,4,4,3,2,13
Arkansas,Gassville,2277,47,22,106,111,60,346
Arkansas,Jasper,488,3,0,13,9,34,59
Arkansas,Grady,399,7,8,6,12,44,77
Arkansas,Gravette,3216,66,31,251,185,219,752
Arkansas,Jericho,64,2,2,0,2,3,9
Arkansas,Jerome,49,0,0,1,2,8,11
Arkansas,Johnson,3552,56,56,293,346,122,873
Arkansas,Joiner,514,10,17,41,21,27,116
Arkansas,Jonesboro,71576,1615,1420,3849,3451,3228,13563
Arkansas,Judsonia,2360,43,18,145,91,141,438
Arkansas,Junction City,746,8,30,35,30,88,191
Arkansas,Keiser,600,18,25,35,27,38,143
Arkansas,Kensett,1832,7,63,92,126,112,400
Arkansas,Keo,229,1,0,5,10,29,45
Arkansas,Grannis,600,2,5,19,35,20,81
Arkansas,Kibler,1043,23,9,46,32,60,170
Arkansas,Kirby,820,32,24,53,41,23,173
Arkansas,Knobel,236,4,0,4,16,9,33
Arkansas,Knoxville,805,5,14,18,49,34,120
Arkansas,Griffithville,156,0,0,2,5,8,15
Arkansas,Greers Ferry,857,4,14,22,27,23,90
Arkansas,Greenwood,9283,192,151,536,816,641,2336
Arkansas,Greenway,208,0,0,11,21,11,43
Arkansas,Greenland,1496,55,9,95,72,73,304
Arkansas,Green Forest,2775,14,71,116,143,223,567
Arkansas,Greenbrier,5090,112,52,287,280,299,1030
Arkansas,Kingsland,439,3,5,43,20,7,78
Arkansas,Monticello,9793,201,78,493,343,315,1430
Arkansas,Pineville,420,0,3,87,38,13,141
Arkansas,Mansfield,1235,23,18,93,97,85,316
Arkansas,Lafe,448,3,4,22,24,21,74
Arkansas,LaGrange,60,0,0,0,0,0,0
Arkansas,Lake City,2315,44,25,140,131,161,501
Arkansas,Lake Hamilton,1970,15,16,95,88,78,292
Arkansas,Lakeview,867,15,0,14,19,39,87
Arkansas,Lake View,409,5,8,10,13,28,64
Arkansas,Lake Village,2398,32,41,173,129,160,535
Arkansas,Lamar,1748,13,25,93,77,57,265
Arkansas,Landmark,3171,23,87,135,58,133,436
Arkansas,Lavaca,2562,127,19,118,162,59,485
Arkansas,Leachville,1755,53,26,79,98,79,335
Arkansas,Lead Hill,277,1,3,13,22,9,48
Arkansas,Leola,534,3,12,15,33,37,100
Arkansas,Lepanto,1955,43,48,57,82,148,378
Arkansas,Leslie,529,12,13,47,31,25,128
Arkansas,Letona,286,13,1,14,18,21,67
Arkansas,Lewisville,1113,48,5,62,51,74,240
Arkansas,Lexa,389,29,10,27,13,29,108
Arkansas,Lincoln,2232,31,48,145,126,127,477
Arkansas,Little Flock,2692,16,35,166,122,135,474
Arkansas,Little Rock,196943,4088,2852,9898,8713,10520,36071
Arkansas,Zinc,69,0,0,0,2,0,2
Arkansas,Lockesburg,824,37,10,44,29,41,161
Arkansas,Yellville,1180,49,11,64,68,36,228
Arkansas,Wynne,8242,164,154,410,532,521,1781
Arkansas,Calico Rock,1464,29,9,38,67,41,184
Arkansas,Cale,104,0,0,3,1,8,12
Arkansas,Caldwell,508,6,0,7,22,37,72
Arkansas,Whelen Springs,53,0,0,3,2,3,8
Arkansas,White Hall,5319,55,27,374,452,381,1289
Arkansas,Wickes,716,11,10,55,33,56,165
Arkansas,Widener,325,11,6,19,25,15,76
Arkansas,Wiederkehr Village,39,0,0,2,1,0,3
Arkansas,Williford,49,0,1,3,6,5,15
Arkansas,Willisville,190,4,0,11,8,4,27
Arkansas,Wilmar,362,6,3,30,43,15,97
Arkansas,Wilmot,517,75,0,6,15,32,128
Arkansas,Wilson,933,13,6,60,57,30,166
Arkansas,Wilton,303,3,0,6,10,26,45
Arkansas,Winchester,211,0,3,20,15,36,74
Arkansas,Winslow,356,1,6,14,17,28,66
Arkansas,Winthrop,131,6,8,0,0,4,18
Arkansas,Woodlawn,213,9,10,13,14,14,60
Arkansas,Woodson,455,0,0,0,0,16,16
Arkansas,Wooster,959,13,3,62,84,99,261
Arkansas,Wrightsville,1204,27,11,27,13,73,151
Arkansas,Yarborough Landing,495,0,0,0,26,44,70
Arkansas,Calion,464,4,0,19,20,39,82
Arkansas,London,995,7,21,69,33,60,190
Arkansas,Lonsdale,128,3,4,2,6,0,15
Arkansas,Maysville,108,0,0,9,0,7,16
Arkansas,Maynard,329,8,0,11,18,20,57
Arkansas,Mayflower,1975,13,31,83,17,103,247
Arkansas,Maumelle,17695,237,322,1312,1063,604,3538
Arkansas,Marvell,1056,33,9,66,63,57,228
Arkansas,Marshall,1657,64,7,73,141,106,391
Arkansas,Marmaduke,1132,15,32,104,67,47,265
Arkansas,Marked Tree,2520,94,32,108,89,100,423
Arkansas,Marion,12328,196,151,925,969,747,2988
Arkansas,Marie,48,0,0,5,1,0,6
Arkansas,Marianna,3927,75,17,195,385,157,829
Arkansas,Hermitage,758,61,25,63,52,57,258
Arkansas,Manila,3275,30,0,252,203,133,618
Arkansas,Mammoth Spring,981,4,25,46,45,42,162
Arkansas,Malvern,10770,194,91,635,300,417,1637
Arkansas,Magnolia,11690,179,193,531,451,588,1942
Arkansas,Magnet Cove,298,0,0,0,0,0,0
Arkansas,Magness,215,18,11,33,18,10,90
Arkansas,Magazine,925,19,15,55,38,57,184
Arkansas,Madison,1004,58,20,87,104,22,291
Arkansas,McRae,740,0,11,29,72,32,144
Arkansas,Melbourne,1797,22,22,95,65,47,251
Arkansas,Lonoke,4250,25,133,233,242,323,956
Arkansas,Mena,5692,27,32,276,317,303,955
Arkansas,Midland,398,4,0,60,65,6,135
Arkansas,Lost Bridge Village,423,0,9,9,0,8,26
Arkansas,Louann,132,0,0,0,15,4,19
Arkansas,Lowell,8011,160,158,464,515,518,1815
Arkansas,Luxora,1007,4,0,108,81,59,252
Arkansas,Lynn,237,14,0,17,6,12,49
Arkansas,McAlmont,1504,38,15,46,69,108,276
Arkansas,McCaskill,120,0,0,1,3,0,4
Arkansas,McCrory,1928,8,63,100,63,173,407
Arkansas,Caddo Valley,641,26,11,68,35,24,164
Arkansas,McDougal,163,0,0,5,24,7,36
Arkansas,McGehee,4029,129,77,237,341,286,1070
Arkansas,Cabot,25102,369,299,1660,1635,1488,5451
Arkansas,Burdette,180,4,0,8,10,1,23
Arkansas,Bull Shoals,2107,10,0,91,126,70,297
Arkansas,Buckner,280,0,0,13,21,19,53
Arkansas,Monette,1537,11,46,68,43,56,224
Arkansas,Mitchellville,389,5,4,35,12,29,85
Arkansas,Minturn,66,2,0,0,0,0,2
Arkansas,Mineral Springs,1092,38,33,55,71,66,263
Arkansas,Midway,374,4,2,24,24,33,87
Arkansas,Midway,1319,38,0,22,101,56,217
Arkansas,Menifee,344,10,8,4,2,15,39
Arkansas,Camden,11683,298,204,725,652,522,2401
Arkansas,Cammack Village,1036,47,13,45,75,63,243
Arkansas,Campbell Station,249,8,5,13,6,23,55
Arkansas,Bradley,489,9,18,40,21,14,102
Arkansas,Branch,362,5,5,9,10,23,52
Arkansas,Briarcliff,240,0,2,6,14,14,36
Arkansas,Brinkley,3007,109,16,170,156,134,585
Arkansas,Brookland,2503,39,19,212,123,175,568
Arkansas,Bryant,19162,330,169,904,980,1102,3485
Arkansas,Washington,182,2,0,0,0,12,14
Arkansas,Watson,163,2,2,4,5,13,26
Arkansas,Weiner,762,14,14,42,31,53,154
Arkansas,Weldon,77,0,4,7,3,4,18
Arkansas,West Crossett,1123,20,16,80,52,85,253
Arkansas,Western Grove,415,10,4,11,11,30,66
Arkansas,West Fork,2454,57,44,121,130,169,521
Arkansas,West Memphis,25544,621,423,1438,1611,1432,5525
Arkansas,West Point,210,0,0,7,12,33,52
Arkansas,Wheatley,260,0,4,12,15,21,52
Arkansas,Dierks,1155,10,15,92,93,66,276
Arkansas,Diaz,1414,15,26,106,56,59,262
Arkansas,Diamond City,911,2,12,33,31,46,124
Arkansas,DeWitt,3234,85,54,184,120,192,635
Arkansas,De Valls Bluff,622,11,10,31,43,47,142
Arkansas,Bradford,812,13,11,22,38,61,145
Arkansas,Des Arc,1862,24,17,30,86,104,261
Arkansas,Booneville,3936,60,149,153,166,210,738
Arkansas,Bonanza,637,3,5,27,22,21,78
Arkansas,Prairie Grove,4859,53,128,375,244,265,1065
Arkansas,Prairie Creek,2116,31,24,47,134,102,338
Arkansas,Poyen,318,0,5,21,21,34,81
Arkansas,Powhatan,76,0,0,7,3,7,17
Arkansas,Bentonville,40368,636,578,3038,2476,1977,8705
Arkansas,Bergman,455,5,5,10,16,28,64
Arkansas,Berryville,5339,96,187,267,403,169,1122
Arkansas,Bethel Heights,2776,58,123,269,165,181,796
Arkansas,Bigelow,325,0,0,13,14,23,50
Arkansas,Big Flat,59,0,1,2,11,0,14
Arkansas,Biggers,278,11,4,12,21,9,57
Arkansas,Birdsong,41,0,5,0,0,0,5
Arkansas,Black Oak,267,5,0,22,18,8,53
Arkansas,Black Rock,642,8,2,20,27,43,100
Arkansas,Black Springs,35,0,0,0,0,6,6
Arkansas,Blevins,251,5,8,17,11,21,62
Arkansas,Blue Eye,39,0,0,0,0,0,0
Arkansas,Blue Mountain,94,7,0,3,2,5,17
Arkansas,Bluff City,101,0,0,0,9,0,9
Arkansas,Blytheville,15090,366,164,848,796,1012,3186
Arkansas,Bodcaw,172,0,0,0,2,0,2
Arkansas,Bono,2488,79,56,182,179,164,660
Arkansas,Dermott,2787,71,57,122,124,167,541
Arkansas,De Queen,6678,155,197,643,418,311,1724
Arkansas,Denning,161,1,0,1,8,2,12
Arkansas,Clarksville,9338,88,140,373,564,373,1538
Arkansas,Clarkedale,445,20,9,37,52,45,163
Arkansas,Clarendon,1577,46,25,38,58,93,260
Arkansas,Chidester,266,5,5,5,2,2,19
Arkansas,Chester,119,0,0,11,9,19,39
Arkansas,Cherry Valley,891,3,29,50,61,50,193
Arkansas,Cherokee Village,4581,12,95,172,340,188,807
Arkansas,Cherokee City,83,0,0,8,24,0,32
Arkansas,Charleston,2638,37,20,104,144,196,501
Arkansas,Central City,522,7,2,35,40,23,107
Arkansas,Centerton,10764,390,179,968,636,702,2875
Arkansas,Center Ridge,514,8,0,15,60,22,105
Arkansas,Cedarville,1723,0,11,91,117,71,290
Arkansas,Cave Springs,2475,30,26,194,189,117,556
Arkansas,Cave City,2278,46,52,191,160,101,550
Arkansas,Caulksville,203,0,6,4,2,4,16
Arkansas,Cash,348,10,4,9,8,16,47
Arkansas,Casa,208,1,12,7,9,16,45
Arkansas,Carthage,536,9,3,47,28,33,120
Arkansas,Carlisle,2084,55,11,79,168,78,391
Arkansas,Caraway,1037,20,25,68,59,50,222
Arkansas,Clinton,2564,21,8,135,171,157,492
Arkansas,Coal Hill,989,7,7,43,24,55,136
Arkansas,College City,427,3,2,3,4,2,14
Arkansas,College Station,617,0,0,0,102,23,125
Arkansas,Dennard,389,0,0,9,0,0,9
Arkansas,Dell,220,3,0,18,11,3,35
Arkansas,Delight,321,1,3,16,23,12,55
Arkansas,Delaplaine,62,0,0,0,0,3,3
Arkansas,Decatur,2306,41,77,227,153,180,678
Arkansas,Datto,72,0,0,1,13,4,18
Arkansas,Dardanelle,4676,64,48,336,135,277,860
Arkansas,Danville,2242,154,23,139,197,149,662
Arkansas,Damascus,497,10,6,37,23,15,91
Arkansas,Daisy,120,3,2,2,3,6,16
Arkansas,McNeil,514,30,7,35,13,8,93
Arkansas,Cushman,547,10,3,62,19,39,133
Arkansas,Crawfordsville,519,14,4,16,34,32,100
Arkansas,Coy,164,0,9,28,29,0,66
Arkansas,Cove,433,0,17,25,27,40,109
Arkansas,Cotton Plant,587,3,4,3,13,10,33
Arkansas,Cotter,954,13,16,37,33,55,154
Arkansas,Corning,3223,66,7,196,156,145,570
Arkansas,Corinth,57,0,0,2,0,1,3
Arkansas,Conway,63555,1215,631,3215,3447,2748,11256
Arkansas,Concord,242,8,3,8,4,14,37
Arkansas,Colt,433,2,2,17,22,6,49
Arkansas,Crossett,5333,164,13,433,320,161,1091
Arkansas,McNab,49,6,0,0,0,9,15
California,Tipton,2787,23,108,212,271,291,905
California,Atherton,7081,186,37,245,375,470,1313
California,Delleker,656,26,8,74,11,19,138
California,Delhi,10026,241,241,670,704,933,2789
California,Delft Colony,132,13,0,20,12,0,45
California,Delano,52807,729,792,3311,2953,3841,11626
California,Del Aire,10692,90,192,614,727,524,2147
California,Deer Park,1104,15,0,27,107,6,155
California,Day Valley,3836,0,0,175,311,122,608
California,Davis,66510,986,852,2351,2247,2893,9329
California,Davenport,297,0,0,16,15,23,54
California,Darwin,24,0,0,0,0,0,0
California,Daphnedale Park,90,0,0,13,0,31,44
California,Three Rocks,212,0,0,0,0,35,35
California,Three Rivers,2185,22,17,38,60,54,191
California,Thousand Palms,8222,14,107,373,499,381,1374
California,Thousand Oaks,128565,2391,1530,6762,7226,8231,26140
California,Thornton,916,9,17,72,44,86,228
California,Agoura Hills,20697,303,81,1073,1275,1581,4313
California,Agua Dulce,3567,78,10,143,153,229,613
California,Aguanga,766,0,0,58,19,36,113
California,Ahwahnee,1709,0,0,88,94,99,281
California,Airport,1565,0,77,124,58,20,279
California,Del Mar,4269,107,16,107,189,121,540
California,Alameda,76733,1683,1197,3106,3101,3148,12235
California,Del Monte Forest,5122,2,2,207,205,93,509
California,Del Rey Oaks,1673,32,2,57,68,78,237
California,Tobin,10,0,0,0,0,0,0
California,Tomales,208,0,0,0,0,0,0
California,Tonyville,572,0,0,18,53,6,77
California,Tooleville,391,0,0,0,0,27,27
California,Topanga,8419,351,240,592,349,370,1902
California,Topaz,202,0,19,0,86,19,124
California,Toro Canyon,1580,23,17,154,83,36,313
California,Torrance,147589,2572,1857,6773,6770,7856,25828
California,Tracy,85284,1420,1326,5550,6476,6392,21164
California,Tranquillity,691,9,19,61,41,28,158
California,Tiburon,9158,206,71,500,565,483,1825
California,Desert View Highlands,2489,69,69,264,142,188,732
California,Desert Shores,1383,0,35,77,103,65,280
California,Desert Palms,6826,0,0,0,0,23,23
California,Desert Hot Springs,27912,420,743,1898,2343,1700,7104
California,Desert Edge,4431,12,62,114,144,130,462
California,Desert Center,207,0,0,15,12,5,32
California,Descanso,1355,5,21,56,66,20,168
California,Derby Acres,320,3,8,14,16,19,60
California,Denair,5176,130,113,212,384,435,1274
California,Del Rio,1925,52,21,73,62,133,341
California,Del Rey,1457,6,53,147,142,89,437
California,Atwater,28858,370,481,1843,2201,2153,7048
California,Alamo,16301,371,166,839,1109,1411,3896
California,Albion,303,0,0,0,0,0,0
California,Angwin,3522,70,41,72,69,106,358
California,Antelope,47763,815,679,2938,2985,4117,11534
California,Antioch,107501,1502,1432,5866,6886,8169,23855
California,Anza,2771,81,61,65,148,42,397
California,Apple Valley,71083,1032,716,4062,3900,5064,14774
California,Aptos,6048,89,27,237,382,385,1120
California,Aptos Hills-Larkin Valley,2221,45,23,55,106,184,413
California,Arbuckle,3360,67,52,171,174,312,776
California,Arcadia,57564,791,573,2472,3407,3695,10938
California,Arcata,17752,170,97,449,560,565,1841
California,Timber Cove,127,0,0,0,0,2,2
California,Armona,3724,36,38,464,330,302,1170
California,Arnold,2554,0,0,58,131,68,257
California,Aromas,2860,0,32,102,140,115,389
California,Arroyo Grande,17720,295,218,564,730,1309,3116
California,Artesia,16785,138,151,685,976,1143,3093
California,Artois,225,0,0,12,21,19,52
California,Arvin,20328,357,321,1718,1625,1747,5768
California,Ashland,24226,542,394,1349,1619,1955,5859
California,Aspen Springs,45,0,8,0,0,0,8
California,Atascadero,29084,500,340,1372,1352,1436,5000
California,Angels,3753,9,28,85,97,166,385
California,Albany,19249,604,221,1180,1066,1145,4216
California,Anderson,10122,139,98,585,643,534,1999
California,Anaheim,345578,4634,4806,19854,19520,20432,69246
California,Alderpoint,311,19,0,0,0,0,19
California,Alhambra,84782,1372,772,3630,3029,3665,12468
California,Alhambra Valley,557,0,0,0,0,23,23
California,Aliso Viejo,49829,1145,697,2721,3016,2792,10371
California,Alleghany,116,0,0,0,0,0,0
California,Allendale,1528,15,0,54,79,83,231
California,Allensworth,565,9,5,46,48,64,172
California,Almanor,0,0,0,0,0,0,0
California,Alondra Park,7865,115,173,426,503,378,1595
California,Alpaugh,1103,29,27,128,117,72,373
California,Alpine,14830,247,138,454,713,1057,2609
California,Alpine Village,116,0,0,5,2,8,15
California,Alta,455,10,4,13,20,22,69
California,Altadena,44621,788,537,1980,1697,2794,7796
California,Alta Sierra,6624,68,53,161,314,326,922
California,Alto,735,0,0,35,26,75,136
California,Alturas,2660,50,0,94,249,134,527
California,Alum Rock,11051,111,211,539,637,695,2193
California,Amador City,152,4,0,11,0,2,17
California,American Canyon,20271,417,348,1019,1534,1267,4585
California,Amesti,3274,13,70,251,291,281,906
California,Anchor Bay,329,0,0,0,0,0,0
California,Arden-Arcade,93993,1213,1190,4277,4585,3998,15263
California,Smartsville,82,0,0,0,0,0,0
California,Auburn,13785,179,178,554,595,487,1993
California,Camp Pendleton South,11394,235,564,696,277,405,2177
California,Camp Pendleton North,7457,209,175,298,377,21,1080
California,Campo,2883,0,34,130,31,231,426
California,Camp Nelson,101,0,0,0,0,0,0
California,Campbell,40688,801,450,2025,1821,1998,7095
California,Camino Tassajara,2247,60,31,263,221,252,827
California,Camptonville,172,5,0,4,3,4,16
California,Camino,1905,47,32,87,78,112,356
California,Cambrian Park,3363,27,72,312,187,180,778
California,Cambria,6279,67,23,221,198,137,646
California,Camarillo,66445,1252,836,3418,3455,3172,12133
California,Camanche Village,720,5,7,24,10,25,71
California,Camanche North Shore,696,17,7,25,8,59,116
California,Calwa,1282,55,53,59,80,93,340
California,Cameron Park,19437,224,164,895,1305,1449,4037
California,Calpine,207,0,0,0,0,0,0
California,San Diego Country Estates,10215,151,178,549,802,728,2408
California,San Fernando,24296,533,412,1516,1546,1851,5858
California,San Marcos,89578,1551,1536,6289,4424,5050,18850
California,San Luis Obispo,46337,467,347,1321,1261,1407,4803
California,San Lucas,384,0,9,34,33,19,95
California,San Lorenzo,24891,315,204,1300,1219,1549,4587
California,San Leandro,88329,1359,877,4078,4353,4326,14993
California,San Juan Capistrano,35897,613,515,1544,1884,2448,7004
California,San Dimas,34073,571,404,1400,1384,1839,5598
California,San Juan Bautista,2250,53,53,122,86,101,415
California,San Joaquin,4008,112,79,410,404,333,1338
California,San Jacinto,45977,742,669,2872,3142,3014,10439
California,San Geronimo,599,7,21,67,8,8,111
California,Sanger,24700,565,206,1853,1627,1577,5828
California,San Gabriel,40198,420,354,1548,1840,1987,6149
California,San Francisco,840763,11382,7056,22752,21948,22543,85681
California,San Jose,1000860,16576,14179,54183,50338,50801,186077
California,San Marino,13353,427,190,730,770,774,2891
California,Calpella,419,0,12,11,31,56,110
California,Baldwin Park,76602,1085,1032,4108,4871,5177,16273
California,Bella Vista,2860,34,33,90,82,161,400
California,Bell Canyon,2094,75,7,110,157,196,545
California,Bellflower,77756,1152,1168,4630,4890,5768,17608
California,Bell Gardens,42842,804,838,3151,3117,3638,11548
California,Belmont,26766,594,289,1318,1483,1089,4773
California,Belvedere,1992,26,12,98,113,138,387
California,Bell,35998,724,591,2358,2370,2661,8704
California,Benbow,230,0,0,4,0,0,4
California,Benicia,27657,495,258,1373,1743,1419,5288
California,Ben Lomond,6507,70,39,333,295,254,991
California,Benton,333,0,28,20,42,0,90
California,Berkeley,117384,1535,820,3075,3125,3231,11786
California,Bermuda Dunes,8219,135,94,401,345,334,1309
California,Berry Creek,1325,4,6,32,55,39,136
California,Bend,559,0,0,39,21,15,75
California,Bakersfield,363612,5550,6773,23471,22970,25580,84344
California,Belden,0,0,0,0,0,0,0
California,Beaumont,40899,676,540,2902,2616,2726,9460
California,Ballard,373,0,3,8,25,3,39
California,Ballico,315,0,11,33,0,22,66
California,Bangor,586,4,0,23,60,15,102
California,Banning,30515,296,345,1325,1112,1466,4544
California,Barstow,23281,586,386,1341,1496,1751,5560
California,Bass Lake,739,0,0,41,26,87,154
California,Beckwourth,238,0,0,0,0,0,0
California,Bay Point,22473,413,420,1588,1516,1609,5546
California,Bayview CDP (Humboldt County),2548,21,34,194,125,152,526
California,Beale AFB,1143,59,45,156,36,15,311
California,Bear Creek,167,0,0,0,0,0,0
California,Bear Valley CDP (Alpine County),25,0,0,0,0,0,0
California,Bear Valley CDP (Mariposa County),155,0,0,13,25,0,38
California,Bear Valley Springs,4661,0,41,133,308,366,848
California,Bayview CDP (Contra Costa County),1728,0,28,52,120,69,269
California,San Martin,7170,64,61,381,328,497,1331
California,San Mateo,101335,2152,1284,4449,3929,4253,16067
California,San Miguel CDP (Contra Costa County),3366,97,26,312,92,187,714
California,Carmel-by-the-Sea,3834,75,28,180,115,141,539
California,Carlsbad,110830,2367,1187,6420,6052,5422,21448
California,Caribou,0,0,0,0,0,0,0
California,Capitola,10077,84,149,315,528,373,1449
California,Canyon Lake,10918,168,50,563,456,474,1711
California,Canyondam,102,0,0,0,0,0,0
California,Carmel Valley Village,4302,0,36,89,345,276,746
California,Cantua Creek,529,0,0,94,17,57,168
California,Shandon,1227,23,65,95,32,30,245
California,Shafter,17513,230,252,1345,1476,1604,4907
California,Seville,545,5,6,33,20,32,96
California,Sereno del Mar,42,0,0,0,0,0,0
California,Sequoia Crest,27,0,0,0,0,0,0
California,Selma,24017,412,459,1767,1571,1512,5721
California,Canby,545,6,0,73,29,44,152
California,Seeley,1324,30,46,75,58,41,250
California,Carmet,15,0,0,0,0,0,0
California,Carnelian Bay,433,0,0,13,19,14,46
California,Castroville,6707,175,188,515,563,303,1744
California,Castro Valley,62044,1144,841,2725,3168,2980,10858
California,Castle Hill,1204,15,0,76,41,23,155
California,Castaic,19369,256,189,1242,1683,1694,5064
California,Cassel,362,31,0,0,0,0,31
California,Caspar,801,0,0,79,18,0,97
California,Carmichael,63712,695,900,2629,3023,3266,10513
California,Casmalia,116,0,0,16,0,0,16
California,Casa Conejo,3358,111,21,170,158,165,625
California,Caruthers,3128,28,70,157,258,177,690
California,Cartago,39,0,0,0,0,0,0
California,Carson,92691,1465,942,3956,4455,5610,16428
California,Carrick,67,0,0,0,0,0,0
California,Carpinteria,13449,260,76,379,478,645,1838
California,Casa de Oro-Mount Helix,20222,237,254,1089,967,1101,3648
California,Sebastopol,7583,77,24,269,245,419,1034
California,Seaside,33999,899,540,1858,1745,1625,6667
California,Searles Valley,1614,33,28,131,149,82,423
California,Santa Maria,102618,1530,1627,6928,7524,6947,24556
California,Santa Margarita,1582,40,0,39,87,161,327
California,Santa Fe Springs,17162,173,326,1146,848,1029,3522
California,Santa Cruz,62752,533,488,1606,1768,2000,6395
California,Santa Clarita,179950,2693,1857,10766,10221,12045,37582
California,Santa Clara,121374,2487,1342,5808,5074,4281,18992
California,Santa Monica,92169,1329,726,2530,2364,2943,9892
California,Santa Barbara,90401,1603,1039,3045,3504,3737,12928
California,San Simeon,284,0,29,27,0,0,56
California,San Ramon,74571,1853,1303,6092,5484,4864,19596
California,San Rafael,58819,1029,673,2543,2549,2566,9360
California,San Pasqual,2000,58,0,60,53,61,232
California,San Pablo,29777,489,536,1807,1592,1848,6272
California,San Miguel CDP (San Luis Obispo County),2461,23,63,203,158,113,560
California,Santa Ana,333268,4885,5593,21232,21793,23539,77042
California,Santa Nella,1517,0,0,193,55,131,379
California,Santa Paula,30246,402,319,2125,2139,1918,6903
California,Santa Rosa,172066,2503,2632,8762,8817,9251,31965
California,Sea Ranch,1068,0,0,0,0,11,11
California,Seal Beach,24551,360,98,748,759,667,2632
California,Seacliff,3256,50,18,109,107,179,463
California,Scotts Valley,11780,211,126,527,595,796,2255
California,Scotia,814,9,11,75,74,18,187
California,Sausalito,7094,25,56,124,83,87,375
California,Sattley,40,0,0,0,0,0,0
California,Saticoy,1251,12,17,161,79,88,357
California,Saratoga,30817,494,232,1600,2288,2206,6820
California,Saranap,5702,222,92,358,188,266,1126
California,Santee,56255,911,914,2741,2828,3608,11002
California,Santa Ynez,4489,13,9,109,236,436,803
California,Santa Venetia,5166,169,39,137,73,211,629
California,Santa Susana,1071,0,0,25,8,36,69
California,Santa Rosa Valley,3550,117,40,157,124,206,644
California,Bertsch-Oceanview,2516,34,38,158,155,130,515
California,Cathedral City,53020,460,744,3015,3177,3852,11248
California,Bethel Island,2172,0,51,23,23,25,122
California,Bieber,120,3,0,0,10,12,25
California,San Diego,1359791,22619,15673,62127,59591,65589,225599
California,Callender,1710,13,0,115,106,174,408
California,Calistoga,5267,144,53,302,252,382,1133
California,Calipatria,7557,98,80,224,349,405,1156
California,Calimesa,8269,0,120,421,428,310,1279
California,California Pines,335,6,0,34,11,42,93
California,Sand City,312,9,0,19,21,28,77
California,California Hot Springs,65,0,6,5,6,0,17
California,Calexico,39601,790,453,2516,2662,3169,9590
California,Calabasas,24075,294,405,1476,1550,1869,5594
California,Cabazon,3633,12,20,139,224,348,743
California,Bystrom,3889,45,58,290,203,207,803
California,Byron,1325,4,16,37,92,127,276
California,Buttonwillow,1425,29,49,137,188,70,473
California,California City,13201,126,198,690,577,566,2157
California,Butte Valley,498,0,0,24,8,19,51
California,San Clemente,65017,1409,903,3195,3786,3782,13075
California,San Buenaventura (Ventura),108899,2443,1247,4734,5492,5545,19461
California,Sacramento,480566,6859,6485,26431,23892,24942,88609
California,St. Helena,5943,58,87,238,273,244,900
California,Salida,13501,201,79,790,1086,1278,3434
California,Salinas,155366,2071,2741,11040,10098,10135,36085
California,Salmon Creek,44,0,0,0,0,0,0
California,Salton City,4782,39,72,463,275,282,1131
California,San Carlos,29454,774,445,1732,1519,1090,5560
California,Salton Sea Beach,551,0,0,83,31,39,153
California,San Andreas,2706,17,18,281,95,15,426
California,San Anselmo,12566,152,129,773,908,588,2550
California,San Antonio Heights,2963,27,8,96,123,157,411
California,San Ardo,746,28,35,63,13,59,198
California,San Bernardino,214112,2681,4100,14515,13731,16536,51563
California,San Bruno,42506,525,509,1775,1818,1594,6221
California,Samoa,268,5,0,8,13,9,35
California,Rutherford,232,26,0,6,0,28,60
California,Butte Meadows,27,0,0,0,0,0,0
California,Burnt Ranch,344,5,0,0,14,3,22
California,Brawley,25656,509,500,1920,1693,1789,6411
California,Bradley,125,0,2,9,2,13,26
California,Bradbury,839,4,2,12,16,30,64
California,Boyes Hot Springs,7229,198,159,483,633,202,1675
California,Bowles,194,4,0,5,9,0,18
California,Boulevard,461,0,47,0,74,24,145
California,Brea,40931,713,407,1984,2126,2422,7652
California,Boulder Creek,4481,39,59,140,89,119,446
California,Borrego Springs,2518,90,50,0,60,179,379
California,Boronda,1271,0,0,51,98,39,188
California,Boron,2326,32,36,166,174,180,588
California,Bootjack,836,0,0,2,63,141,206
California,Boonville,721,9,23,23,38,27,120
California,Bonsall,3896,38,94,182,82,135,531
California,Bostonia,16787,163,260,966,975,1269,3633
California,Butte Creek Canyon,938,17,30,24,25,22,118
California,Brentwood,55490,842,893,3388,3999,4399,13521
California,Bridgeport,909,0,0,0,0,121,121
California,Burney,3257,41,120,167,165,85,578
California,Burlingame,29941,875,443,1603,1212,1421,5554
California,Burbank,5736,179,67,262,329,145,982
California,Burbank,104725,1893,1220,4397,4374,4960,16844
California,Buena Vista,326,9,9,0,5,0,23
California,Buena Park,82683,1227,1140,4519,4038,4399,15323
California,Bret Harte,5188,57,122,346,500,711,1736
California,Buellton,4977,128,116,175,272,222,913
California,Buck Meadows,52,0,0,0,0,0,0
California,Buckhorn,2179,6,15,46,74,49,190
California,Brooktrails,3225,59,84,213,153,138,647
California,Brookdale,2282,33,13,66,31,229,372
California,Broadmoor,5409,74,196,86,122,271,749
California,Brisbane,4496,68,79,259,144,118,668
California,Bucks Lake,16,0,0,0,0,0,0
California,Ruth,108,0,0,0,0,0,0
California,Running Springs,4793,67,10,245,270,243,835
California,Rowland Heights,50440,632,516,1721,1898,2427,7194
California,Blythe,19839,190,136,845,748,1960,3879
California,Bodega,212,0,0,0,0,0,0
California,Bodega Bay,671,0,0,0,0,0,0
California,Bodfish,2066,0,0,86,91,41,218
California,Bolinas,1358,54,12,43,67,27,203
California,Bombay Beach,250,0,0,0,13,17,30
California,Bluewater,179,0,0,0,0,0,0
California,Bonadelle Ranchos-Madera Ranchos,8866,61,76,476,439,580,1632
California,Bonny Doon,2947,50,18,80,111,136,395
California,Richfield,214,0,2,13,8,25,48
California,Richgrove,2972,120,70,275,251,259,975
California,Richmond,107597,1833,1716,5329,5471,5698,20047
California,Richvale,111,0,0,0,0,0,0
California,Ridgecrest,28489,626,705,1552,1907,1608,6398
California,Bonita,12931,112,79,561,723,499,1974
California,Ridgemark,3499,21,15,115,213,303,667
California,Blue Lake,1310,22,8,26,44,27,127
California,Bloomfield,420,0,0,0,0,0,0
California,Big Bear City,13535,188,202,502,518,629,2039
California,Big Bear Lake,5145,31,53,261,315,263,923
California,Big Bend,94,2,2,2,0,2,8
California,Big Creek,248,2,0,27,12,17,58
California,Biggs,1765,17,0,150,152,79,398
California,Big Lagoon,92,0,0,0,0,0,0
California,Bloomington,24864,290,417,1609,1862,1977,6155
California,Big Pine,1661,41,30,107,69,44,291
California,Biola,1151,15,29,89,134,146,413
California,Bishop,3839,60,56,247,135,218,716
California,Blackhawk,9304,150,29,477,482,531,1669
California,Blacklake,727,0,0,0,0,0,0
California,Black Point-Green Point,1250,7,23,96,97,10,233
California,Blairsden,55,0,0,0,0,0,0
California,Big River,1068,4,0,38,4,35,81
California,Rio Dell,3385,21,54,168,181,92,516
California,Rio del Mar,8964,87,49,311,486,407,1340
California,Rio Linda,14688,194,226,842,798,979,3039
California,Romoland,1778,27,29,72,189,122,439
California,Rosamond,19540,260,244,1037,1405,1444,4390
California,Rosedale,15509,353,222,955,840,1013,3383
California,Rose Hills,3205,28,16,55,208,172,479
California,Roseland,5594,147,98,239,218,320,1022
California,Rosemead,54615,625,377,2341,2725,3014,9082
California,Rollingwood,2847,17,101,181,118,158,575
California,Rosemont,23515,313,311,1042,1206,1699,4571
California,Ross,2306,75,34,146,201,117,573
California,Rossmoor,10461,267,114,438,601,691,2111
California,Rough and Ready,1581,0,0,72,119,0,191
California,Round Mountain,113,0,0,0,0,0,0
California,Round Valley,485,0,0,3,6,20,29
California,Rouse,1820,22,7,144,95,139,407
California,Roseville,126327,1985,1707,7176,7337,7455,25660
California,Rolling Hills Estates,8188,154,89,379,514,539,1675
California,Rolling Hills,816,14,20,40,33,21,128
California,Rolling Hills,1820,28,5,92,123,105,353
California,Rio Oso,491,2,3,73,23,13,114
California,Rio Vista,7826,117,0,214,199,185,715
California,Ripley,601,17,14,78,24,27,160
California,Ripon,14801,179,390,894,1069,877,3409
California,Riverbank,23564,371,259,1594,1334,1505,5063
California,Riverdale,4081,22,139,375,286,241,1063
California,Riverdale Park,1023,0,7,48,27,14,96
California,River Pines,284,0,0,0,0,0,0
California,Riverside,316335,4007,4248,17504,17746,19436,62941
California,Robbins,334,0,7,0,15,7,29
California,Robinson Mill,0,0,0,0,0,0,0
California,Rocklin,59727,904,832,3758,3662,4039,13195
California,Rodeo,9724,107,142,565,422,347,1583
California,Rodriguez Camp,153,0,0,18,21,21,60
California,Rohnert Park,41651,366,367,1695,1538,2061,6027
California,Beverly Hills,34663,447,341,1682,1457,2101,6028
California,Auberry,2420,11,53,75,95,81,315
California,Catheys Valley,747,12,0,0,32,10,54
California,Cazadero,243,2,5,4,3,6,20
California,Tamalpais-Homestead Valley,10542,326,132,516,597,753,2324
California,Talmage,1547,11,0,115,18,42,186
California,Tahoma,943,0,10,86,34,54,184
California,Tahoe Vista,1367,0,43,49,52,25,169
California,Taft Mosswood,1117,20,20,53,52,93,238
California,Taft Heights,2859,77,43,270,110,271,771
California,Tara Hills,4778,113,17,281,293,231,935
California,Taft,9130,44,133,331,466,510,1484
California,Sutter Creek,2083,48,4,43,85,157,337
California,Sutter,3195,38,61,185,224,299,807
California,Susanville,16048,120,60,355,410,1400,2345
California,Sun Village,11322,124,220,524,726,1159,2753
California,Sunol,985,7,16,34,23,66,146
California,Sunnyvale,148178,3407,1839,7070,5665,6335,24316
California,Swall Meadows,243,0,3,6,5,30,44
California,Sunny Slopes,52,0,0,0,0,0,0
California,Tarpey Village,3460,0,48,276,176,227,727
California,Tecopa,128,0,0,4,5,11,20
California,Rialto,102018,1577,1689,6616,7309,8298,25489
California,Thermalito,7119,80,130,442,317,497,1466
California,Thermal,3106,0,24,225,235,157,641
California,Teviston,1623,59,44,182,208,174,667
California,Terra Bella,2526,8,52,195,275,262,792
California,Terminous,371,0,16,16,0,6,38
California,Taylorsville,317,35,0,34,0,21,90
California,Tennant,100,0,0,0,0,0,0
California,Temple City,36079,478,445,1660,1590,2070,6243
California,Temescal Valley,24654,429,271,1591,1535,1504,5330
California,Temelec,1543,0,0,0,0,0,0
California,Temecula,107153,1349,1391,6717,7775,9134,26366
California,Tehama,410,4,9,31,19,14,77
California,Tehachapi,13536,87,36,593,837,906,2459
California,Templeton,7377,179,209,338,389,399,1514
California,Reliez Valley,3656,50,8,55,273,69,455
California,Sunnyside-Tahoe City,1450,6,28,74,38,20,166
California,Summerland,1505,0,0,0,47,0,47
California,Cutler,4569,94,212,356,536,348,1546
California,Cupertino,60171,1305,1016,3945,4198,3900,14364
California,Culver City,39469,664,416,1479,2023,1653,6235
California,Cudahy,24138,521,371,1755,1782,2179,6608
California,Crows Landing,207,6,0,6,6,0,18
California,Crowley Lake,654,0,6,53,74,12,145
California,Cutten,2999,46,21,126,76,158,427
California,Cromberg,132,0,0,0,0,0,0
California,C-Road,99,0,0,0,0,0,0
California,Creston,22,0,0,0,0,0,0
California,Crestline,9240,61,50,396,539,524,1570
California,Crest,2712,6,31,100,112,101,350
California,Cressey,315,0,6,27,18,5,56
California,Crescent Mills,219,0,0,24,22,20,66
California,Crockett,3044,55,9,120,78,121,383
California,Sunnyside,4203,85,66,236,254,246,887
California,Cuyama,91,3,0,21,0,0,24
California,Daly City,104930,1318,1103,3850,3804,5088,15163
California,Sultana,916,0,30,99,93,84,306
California,Suisun City,28867,381,583,2053,1577,1721,6315
California,Sugarloaf Village,7,0,0,0,0,0,0
California,Sugarloaf Saw Mill,0,0,0,0,0,0,0
California,Sugarloaf Mountain Park,0,0,0,0,0,0,0
California,Strawberry CDP (Tuolumne County),246,0,0,0,0,80,80
California,Cypress,49008,603,482,1958,2853,3106,9002
California,Strawberry CDP (Marin County),5901,207,83,194,286,298,1068
California,Stratford,1020,38,35,57,59,74,263
California,Storrie,0,0,0,0,0,0,0
California,Stonyford,260,0,0,23,14,26,63
California,Stockton,299722,4567,5119,19385,19936,19978,68985
California,Danville,43410,1175,600,2594,3299,3017,10685
California,Dana Point,34003,503,410,1428,1254,1361,4956
California,Strathmore,2920,56,74,182,288,228,828
California,Reedley,25092,304,400,1743,1537,1562,5546
California,Redwood Valley,2372,0,0,93,158,239,490
California,Redwood City,81342,1865,1325,4418,4023,4087,15718
California,Pleasant Hill,34155,766,327,1473,1410,1237,5213
California,Pleasanton,75009,1178,1237,4309,5303,5269,17296
California,Pleasure Point,5952,107,75,107,203,108,600
California,Plumas Eureka,280,0,0,0,5,0,5
California,Plumas Lake,6548,216,129,463,460,301,1569
California,Plymouth,842,14,17,88,35,50,204
California,Planada,4392,86,161,214,246,418,1125
California,Point Arena,391,2,9,4,23,60,98
California,Pollock Pines,6797,43,171,167,260,451,1092
California,Pomona,151753,2574,2558,8787,8724,10095,32738
California,Ponderosa,87,0,0,0,0,0,0
California,Poplar-Cotton Center,2654,16,9,153,226,244,648
California,Port Costa,311,0,0,0,0,12,12
California,Porterville,55218,945,1184,4623,3742,4071,14565
California,Point Reyes Station,600,5,0,29,28,0,62
California,Port Hueneme,22058,258,267,1131,944,1237,3837
California,Plainview,1072,22,33,114,102,115,386
California,Placentia,52123,743,759,2700,2704,3136,10042
California,Auburn Lake Trails,3866,61,107,178,353,214,913
California,August,8369,143,102,634,815,591,2285
California,Avalon,3777,38,37,247,275,269,866
California,Avenal,14154,202,183,707,564,1350,3006
California,Avery,622,0,11,0,16,35,62
California,Avila Beach,1270,0,0,0,0,33,33
California,Placerville,10471,142,164,682,423,396,1807
California,Avocado Heights,15917,305,155,556,797,1146,2959
California,Baker,831,21,7,49,62,105,244
California,Pioneer,1090,0,0,42,0,79,121
California,Piru,2061,52,25,86,120,150,433
California,Pismo Beach,7890,18,120,423,249,164,974
California,Pittsburg,66947,803,1213,3804,3800,3425,13045
California,Pixley,3584,64,95,390,340,266,1155
California,Azusa,48033,527,762,2489,2337,2519,8634
California,Portola,2454,34,54,96,75,149,408
California,Portola Valley,4515,54,20,145,239,206,664
California,Posey,8,0,0,0,0,0,0
California,Rancho Murieta,5563,95,66,260,224,305,950
California,Rancho Palos Verdes,42464,712,566,2162,2363,2920,8723
California,Rancho San Diego,22062,134,198,654,1501,1379,3866
California,Rancho Santa Fe,2936,35,36,168,210,231,680
California,Rancho Santa Margarita,49026,841,674,2685,3315,3246,10761
California,Rancho Tehama Reserve,2156,8,0,65,109,221,403
California,Rancho Mirage,17770,60,29,483,507,470,1549
California,Randsburg,140,0,0,0,0,0,0
California,Red Corral,1713,0,0,121,57,141,319
California,Redcrest,50,0,0,0,0,0,0
California,Redding,91063,1270,1152,5167,4141,4415,16145
California,Redlands,70186,1236,862,3188,3989,3983,13258
California,Redondo Beach,67695,2009,962,3062,2840,2599,11472
California,Redway,1031,0,0,0,67,71,138
California,Red Bluff,14065,294,309,782,942,548,2875
California,Rancho Cucamonga,171858,2386,1960,8005,9681,12265,34297
California,Rancho Cordova,68326,1257,890,3895,3789,3581,13412
California,Rancho Calaveras,6023,85,125,251,373,481,1315
California,Poso Park,6,0,0,0,0,0,0
California,Potrero,819,0,0,159,154,82,395
California,Potter Valley,520,5,0,45,40,0,90
California,Poway,49484,1148,384,2665,2551,3332,10080
California,Prattville,10,0,0,0,0,0,0
California,Princeton,198,0,0,0,11,3,14
California,Proberta,247,0,0,0,0,0,0
California,Prunedale,18932,225,132,863,987,1431,3638
California,Quartz Hill,10619,105,159,558,629,613,2064
California,Quincy,1543,0,0,27,45,106,178
California,Rackerby,96,0,0,0,2,7,9
California,Rail Road Flat,349,0,11,0,10,0,21
California,Rainbow,1613,8,11,44,53,44,160
California,Raisin City,234,11,6,14,12,19,62
California,Ramona,21824,386,328,1222,1192,1332,4460
California,Crescent City,7120,28,50,215,233,340,866
California,Cayucos,2758,0,38,12,33,68,151
California,Cowan,525,0,0,55,31,39,125
California,Covelo,1346,41,16,138,77,66,338
California,Signal Hill,11332,133,100,592,716,763,2304
California,Sierraville,55,0,0,0,0,0,0
California,Sierra Village,521,0,0,37,0,37,74
California,Sierra Madre,11084,304,244,500,655,198,1901
California,Sierra City,218,0,0,0,0,0,0
California,Sierra Brooks,410,9,6,26,56,0,97
California,Silverado Resort,893,0,9,5,15,20,49
California,Shoshone,25,0,0,0,0,0,0
California,Shingle Springs,4533,65,30,171,172,301,739
California,Sheridan,1567,0,39,101,22,0,162
California,Shelter Cove,412,0,0,58,0,29,87
California,Shell Ridge,1039,33,0,125,50,89,297
California,Shaver Lake,742,0,10,45,8,69,132
California,Shasta Lake,10146,102,226,515,641,386,1870
California,Shingletown,2432,0,12,93,81,128,314
California,Shasta,1669,20,5,50,101,45,221
California,Silver City,0,0,0,0,0,0,0
California,Simi Valley,126103,2029,1471,5642,7231,7730,24103
California,Sonora,4827,10,92,182,264,173,721
California,Sonoma,10897,129,155,436,612,409,1741
California,Solvang,5456,50,56,171,195,222,694
California,Soledad,25826,300,257,1483,1156,1059,4255
California,Solana Beach,13253,159,87,468,578,595,1887
California,Soda Springs,59,0,0,0,0,0,0
California,Silver Lakes,5992,135,76,317,199,321,1048
California,Soda Bay,1429,0,0,0,27,31,58
California,Smith River,767,0,33,63,89,94,279
California,Smith Corner,648,15,21,39,49,88,212
California,Diablo,818,0,0,96,80,39,215
California,Sleepy Hollow,2489,13,0,114,108,200,435
California,Sky Valley,2729,6,50,80,222,101,459
California,Sisquoc,291,4,7,53,23,4,91
California,Snelling,104,0,3,0,5,13,21
California,Soquel,10827,266,193,491,437,570,1957
California,Cleone,648,0,19,27,0,0,46
California,Clearlake Oaks,1651,0,0,0,44,29,73
California,Cherry Valley,6798,35,61,321,167,310,894
California,Cherryland,15470,263,214,1033,735,657,2902
California,Cherokee Strip,243,0,3,20,2,22,47
California,Cherokee,111,0,0,0,8,7,15
California,Charter Oak,9247,143,178,550,588,659,2118
California,Channel Islands Beach,3072,0,45,134,56,179,414
California,Chester,2044,19,17,152,80,34,302
California,Challenge-Brownsville,788,0,46,99,0,0,145
California,Cerritos,49701,638,555,1904,2264,3137,8498
California,Ceres,46952,691,611,3411,3120,3141,10974
California,Centerville,404,0,0,34,17,5,56
California,Cedarville,298,0,3,2,18,33,56
California,Cedar Slope,0,0,0,0,0,0,0
California,Cedar Ridge,1250,0,3,89,68,69,229
California,Chalfant,581,0,24,66,31,7,128
California,Clearlake Riviera,2973,53,49,160,115,141,518
California,Chico,88455,1483,620,3318,3743,4207,13371
California,China Lake Acres,1820,0,0,47,48,120,215
California,Clearlake,15097,142,167,797,757,775,2638
California,Clear Creek,217,0,0,16,15,17,48
California,Clayton,11497,197,42,544,613,934,2330
California,Clay,1113,8,22,30,38,74,172
California,Clarksburg,472,14,0,25,83,21,143
California,Claremont,35762,470,373,1455,1973,1866,6137
California,Chilcoot-Vinton,46,0,0,0,0,0,0
California,Citrus Heights,85408,990,853,4317,3969,4091,14220
California,Chula Vista,257296,3464,3673,15597,15544,16834,55112
California,Chualar,1229,31,0,117,88,83,319
California,Chowchilla,18384,110,164,626,1012,831,2743
California,Chino Hills,76796,1263,894,3803,5155,5234,16349
California,Chino,82208,1182,1152,3616,3878,5418,15246
California,Chinese Camp,170,0,0,28,28,0,56
California,Citrus,11460,150,102,585,635,852,2324
California,Soulsbyville,2071,0,16,81,184,197,478
California,South Dos Palos,2537,75,20,168,182,214,659
California,South El Monte,20483,239,296,1118,1213,1299,4165
California,Compton,97955,2006,1645,6594,6708,7019,23972
California,Comptche,73,0,0,0,0,0,0
California,Commerce,13017,225,231,782,653,903,2794
California,Colusa,5939,136,130,400,337,288,1291
California,Columbia,2597,35,34,60,67,282,478
California,Colton,53566,607,973,3722,3778,3645,12725
California,Concord,126268,2164,1457,6800,5794,5964,22179
California,Coloma,874,0,0,34,0,38,72
California,Collierville,1697,0,6,203,74,189,472
California,College City,188,0,0,10,10,0,20
California,Colfax,2210,70,24,95,60,126,375
California,Coleville,368,14,0,0,0,0,14
California,Cold Springs CDP (Tuolumne County),163,0,0,17,0,22,39
California,Cold Springs CDP (El Dorado County),573,12,13,0,6,85,116
California,Colma,1571,22,0,52,35,48,157
California,Cohasset,933,0,14,20,21,105,160
California,Concow,550,0,0,31,21,22,74
California,Copperopolis,4396,64,75,247,166,238,790
California,Courtland,512,0,0,0,15,17,32
California,Country Club,9997,67,182,492,502,615,1858
California,Coulterville,224,0,0,0,23,33,56
California,Cottonwood,3801,90,63,169,225,216,763
California,Coto de Caza,14554,295,169,613,1261,1302,3640
California,Cotati,7376,94,134,378,339,381,1326
California,Contra Costa Centre,5940,114,0,112,73,42,341
California,Costa Mesa,112377,1791,1121,5402,4734,5198,18246
California,Corralitos,2646,32,0,87,248,245,612
California,Coronita,3079,10,49,195,161,245,660
California,Coronado,24447,316,222,996,1018,1078,3630
California,Corona,159595,2229,2318,9062,9940,10539,34088
California,Corning,7586,120,197,514,624,662,2117
California,Corcoran,23216,184,196,966,821,2601,4768
California,Corte Madera,9595,228,88,622,530,513,1981
California,Coffee Creek,142,0,0,0,10,4,14
California,Cobb,1016,19,0,46,77,15,157
California,Coarsegold,994,0,0,11,15,43,69
California,Spring Valley CDP (Lake County),1099,2,26,27,0,46,101
California,Spring Garden,0,0,0,0,0,0,0
California,Spreckels,761,31,39,73,43,6,192
California,Spaulding,196,0,0,15,0,0,15
California,South Whittier,59358,953,936,3509,3364,4224,12986
California,South Taft,1740,8,36,75,94,82,295
California,Spring Valley CDP (San Diego County),30392,652,276,1410,1844,1887,6069
California,South San Jose Hills,21015,253,237,1437,1346,1337,4610
California,South San Francisco,66217,980,707,2849,3364,3079,10979
California,South Pasadena,25999,607,262,1332,1427,1598,5226
California,South Oroville,6124,77,73,489,407,518,1564
California,South Monrovia Island,6768,37,78,275,306,361,1057
California,South Lake Tahoe,21437,257,345,918,711,974,3205
California,South Gate,95350,1548,1338,5885,5819,7083,21673
California,South San Gabriel,8886,130,62,240,302,327,1061
California,Spring Valley Lake,7849,36,52,473,534,565,1660
California,Springville,763,30,18,58,0,37,143
California,Squaw Valley,2796,0,0,95,236,273,604
California,Coalinga,16940,288,323,682,780,1134,3207
California,Coachella,43308,489,818,3702,3745,3419,12173
California,Clyde,751,0,0,0,30,45,75
California,Clovis,100437,1623,1578,6431,6251,6735,22618
California,Cloverdale,8735,183,86,597,432,436,1734
California,Clipper Mills,94,21,0,20,0,0,41
California,Clio,47,0,0,0,0,0,0
California,Stirling City,176,0,0,33,33,0,66
California,Stinson Beach,462,13,0,0,10,12,35
California,Stevinson,290,11,10,0,0,22,43
California,Stevenson Ranch,19408,460,314,1326,1929,1539,5568
California,Stanton,38625,515,670,2252,2099,2457,7993
California,Stanford,14213,150,21,226,190,144,731
California,Stallion Springs,3263,41,35,191,85,484,836
California,Squirrel Mountain Valley,1120,0,0,0,97,170,267
California,Covina,48587,872,601,2645,2784,3080,9982
California,Diablo Grande,1104,0,21,113,67,35,236
California,Healdsburg,11539,149,202,440,580,540,1911
California,Diamond Springs,12459,149,228,457,487,511,1832
California,Imperial,16215,234,242,935,1258,1380,4049
California,Imperial Beach,27051,547,249,1475,1547,1735,5553
California,Independence,657,0,4,17,14,17,52
California,Indian Falls,115,0,0,0,0,0,0
California,Indianola,909,34,15,57,17,21,144
California,Indian Wells,5158,0,0,36,44,62,142
California,Indio,84094,901,1473,5399,5660,5800,19233
California,Indio Hills,1042,0,23,53,62,89,227
California,Industry,433,0,0,95,7,27,129
California,Inglewood,111411,2266,1843,6673,5701,6433,22916
California,Interlaken,6817,39,107,418,403,373,1340
California,Idyllwild-Pine Cove,2616,31,14,25,44,39,153
California,Inverness,1089,0,0,37,0,20,57
California,Ione,7171,46,99,351,306,377,1179
California,Iron Horse,292,0,0,0,0,51,51
California,Irvine,238474,4038,2947,12033,11602,11805,42425
California,Irwindale,1426,32,29,90,93,81,325
California,Isla Vista,26275,84,79,124,100,171,558
California,Isleton,806,0,15,59,36,32,142
California,Ivanhoe,3837,102,0,163,262,461,988
California,Jackson,4613,53,134,236,185,271,879
California,Jacumba,144,0,0,0,0,0,0
California,Jamestown,2867,51,34,168,151,162,566
California,Jamul,5788,30,0,199,280,357,866
California,Inyokern,702,7,7,0,0,0,14
California,Janesville,1486,24,9,57,52,108,250
California,Idlewild,15,0,0,0,0,4,4
California,Hyampom,183,0,0,0,0,0,0
California,Highland,54314,694,1047,3717,4105,3977,13540
California,Highlands-Baywood Park,4217,134,65,183,212,329,923
California,Hillsborough,11253,414,156,716,786,797,2869
California,Hilmar-Irwin,5313,14,30,231,228,374,877
California,Diamond Bar,56471,706,502,1981,2957,3786,9932
California,Hiouchi,327,0,0,8,7,38,53
California,Hollister,36529,506,637,2458,2704,2409,8714
California,Holtville,6172,76,113,608,327,345,1469
California,Home Garden,1816,16,12,186,125,168,507
California,Home Gardens,11420,105,306,684,941,839,2875
California,Homeland,6038,46,32,210,399,336,1023
California,Hydesville,1272,16,6,70,69,85,246
California,Homestead Valley,3317,0,6,107,147,216,476
California,Honcut,166,0,0,0,0,0,0
California,Hood,293,0,9,26,3,0,38
California,Hoopa,2958,53,77,223,173,162,688
California,Hopland,819,33,9,73,12,12,139
California,Hornbrook,269,14,3,11,34,20,82
California,Hornitos,51,0,0,0,23,0,23
California,Hughson,7032,15,177,445,617,475,1729
California,Humboldt Hill,3812,100,0,195,79,142,516
California,Huntington Beach,197752,3174,2040,8960,9237,8934,32345
California,Huntington Park,59003,1319,1194,3590,3727,4230,14060
California,Huron,6792,239,78,523,585,679,2104
California,Homewood Canyon,8,0,0,0,0,0,0
California,Highgrove,3784,43,77,280,162,191,753
California,Jenner,104,0,0,0,0,0,0
California,Johnstonville,1223,21,3,99,75,131,329
California,Moskowite Corner,202,0,0,15,16,11,42
California,Morro Bay,10471,164,177,220,380,277,1218
California,Morongo Valley,3242,19,43,38,108,233,441
California,Morgan Hill,40872,589,470,2654,2462,2697,8872
California,Moreno Valley,200788,2393,3032,13260,12981,16308,47974
California,Moraga,16787,288,171,960,913,835,3167
California,Morada,4518,0,0,349,351,177,877
California,Moorpark,35339,568,582,1623,2138,2388,7299
California,Monument Hills,1725,0,0,57,148,0,205
California,Montgomery Creek,141,0,4,0,17,16,37
California,Monte Sereno,3508,39,16,159,237,273,724
California,Moss Beach,3704,93,159,216,247,315,1030
California,Monte Rio,1005,0,0,10,34,50,94
California,Monterey Park,61085,867,588,1845,2871,2602,8773
California,Monterey,28283,484,278,944,708,937,3351
California,Montecito,9471,111,97,352,491,538,1589
California,Montebello,63530,815,608,2606,3233,3634,10896
California,Montclair,38025,389,753,1702,2432,2578,7854
California,Montara,2903,54,33,99,69,151,406
California,Montalvin Manor,3164,14,117,179,80,324,714
California,Montague,1518,21,20,104,97,75,317
California,Monson,237,17,12,10,0,12,51
California,Monrovia,37164,749,550,1881,1496,1745,6421
California,Mono Vista,2334,41,122,50,41,41,295
California,Monterey Park Tract,86,0,0,0,20,10,30
California,Johannesburg,118,0,0,0,0,0,0
California,Moss Landing,153,0,0,0,0,0,0
California,Mountain Gate,1156,0,0,69,35,31,135
California,Johnsville,43,0,0,0,0,0,0
California,Joshua Tree,7357,103,140,307,418,363,1331
California,Julian,1190,9,33,0,82,42,166
California,Junction City,790,0,1,30,38,33,102
California,June Lake,512,0,0,24,49,0,73
California,Jurupa Valley,98231,1289,1739,6319,6251,6588,22186
California,Keddie,58,0,0,0,0,17,17
California,Keeler,82,10,0,0,0,0,10
California,Keene,351,16,0,37,2,0,55
California,Kelly Ridge,2713,39,8,48,40,20,155
California,Kelseyville,3783,56,155,140,225,287,863
California,Mountain Center,78,0,0,12,12,0,24
California,Kennedy,3296,88,105,252,245,276,966
California,Kensington,5595,82,43,194,252,219,790
California,Kentfield,6813,88,96,379,565,445,1573
California,Kenwood,1306,63,63,0,19,18,163
California,Mount Hermon,910,19,9,21,72,11,132
California,Mount Hebron,78,0,0,0,0,10,10
California,Mountain View Acres,3578,15,0,175,286,423,899
California,Mountain View,77973,1582,1216,3626,2939,3038,12401
California,Mountain View,2295,20,29,134,68,64,315
California,Mountain Ranch,1378,36,21,32,0,51,140
California,Mountain Mesa,710,0,0,48,30,45,123
California,Mountain House,12916,396,475,918,982,808,3579
California,Kennedy Meadows,21,0,0,0,0,0,0
California,Hidden Valley Lake,5986,126,81,409,318,436,1370
California,Hidden Meadows,3388,70,0,134,83,124,411
California,Hidden Hills,1557,31,30,74,129,167,431
California,Nipomo,16727,340,326,685,1015,1263,3629
California,Nipinnawasee,539,0,49,0,53,0,102
California,Niland,836,33,0,23,8,20,84
California,Nicolaus,213,3,0,4,7,6,20
California,Nice,2204,44,38,36,17,127,262
California,Nicasio,93,0,1,12,7,6,26
California,Newport Beach,86911,1336,870,3355,4200,3899,13660
California,New Pine Creek,59,0,0,0,15,0,15
California,Newman,10667,305,189,706,806,532,2538
California,Newell,307,0,5,10,44,39,98
California,New Cuyama,665,24,4,52,102,27,209
California,Norco,26966,349,424,1202,1555,1778,5308
California,Newcastle,1416,5,0,41,27,63,136
California,Nevada City,3101,32,0,116,47,147,342
California,Needles,4942,43,40,314,309,305,1011
California,National City,60043,912,798,2890,2939,3958,11497
California,Napa,79113,1067,837,4182,4528,4673,15287
California,Myrtletown,5307,19,0,380,239,303,941
California,Myers Flat,0,0,0,0,0,0,0
California,Muscoy,12417,138,232,910,1082,1371,3733
California,Murrieta,107507,1499,1619,6983,7613,8306,26020
California,Murphys,2091,25,0,88,66,76,255
California,Muir Beach,275,0,7,11,6,11,35
California,Mount Shasta,3312,9,20,219,109,88,445
California,Newark,44207,443,662,2251,2395,2229,7980
California,Mount Laguna,12,0,0,0,0,0,0
California,Nord,181,0,0,0,0,0,0
California,North Auburn,14496,273,279,559,845,999,2955
California,Oakville,66,0,0,0,0,12,12
California,Oak View,4317,32,93,121,127,274,647
California,Oak Shores,148,0,0,0,0,0,0
California,Oak Park,15087,413,118,929,1176,1122,3758
California,Oakley,38243,720,751,2419,1929,3078,8897
California,Oakland,408073,6765,5224,17798,18206,18594,66587
California,Oakhurst,2632,0,15,139,115,148,417
California,Oak Hills,9363,14,52,431,404,516,1417
California,Oak Glen,776,0,0,56,47,43,146
California,Oakdale,21543,363,329,1262,1233,1424,4611
California,Nuevo,7738,83,144,497,677,559,1960
California,Norris Canyon,1093,51,8,64,150,74,347
California,Nubieber,16,0,0,0,0,0,0
California,Norwalk,106659,1729,1526,5710,6442,6424,21831
California,North Tustin,26454,411,314,1286,1313,1557,4881
California,North Shore,3804,15,43,348,305,415,1126
California,North San Juan,295,0,17,33,38,7,95
California,North Richmond,3988,100,98,251,247,390,1086
California,North Lakeport,2633,21,0,111,129,125,386
California,North Highlands,46376,608,558,3018,3386,2671,10241
California,North Gate,534,0,0,67,13,29,109
California,North Fair Oaks,14793,230,197,853,1136,1025,3441
California,North El Monte,4118,50,76,151,377,193,847
California,North Edwards,1014,29,0,62,50,28,169
California,Novato,54133,1028,818,2434,2725,2441,9446
California,Good Hope,8500,164,102,471,604,720,2061
California,Goodyears Bar,25,0,0,0,0,0,0
California,Goshen,3734,58,128,382,381,336,1285
California,Hacienda Heights,55158,732,456,2524,2966,2791,9469
California,Half Moon Bay,12052,216,196,473,436,726,2047
California,Hamilton Branch,602,0,5,13,13,9,40
California,Hamilton City,1917,86,52,201,103,164,606
California,Hanford,54790,804,1138,3743,4040,3420,13145
California,Happy Camp,986,10,23,37,35,38,143
California,Harbison Canyon,4130,44,36,197,139,215,631
California,Hardwick,145,0,7,19,6,7,39
California,Hartland,0,0,0,0,0,0,0
California,Hartley,2908,9,58,23,232,176,498
California,Hasley Canyon,1144,14,10,78,66,80,248
California,Gustine,5656,19,62,341,151,353,926
California,Hat Creek,267,0,0,0,9,15,24
California,Hawthorne,86564,1204,1504,5016,5193,5708,18625
California,Hayfork,2785,41,40,24,27,114,246
California,Hayward,152401,1999,1962,8015,6996,8186,27158
California,Heber,4370,151,105,282,268,334,1140
California,Hemet,82118,851,1115,4620,5028,4858,16472
California,Herald,1210,0,6,16,110,92,224
California,Hercules,24838,190,369,925,1189,1607,4280
California,Herlong,1583,1,7,1,14,95,118
California,Hermosa Beach,19747,479,295,873,732,533,2912
California,Hesperia,92309,847,1709,6440,6534,7068,22598
California,Hickman,526,13,12,39,27,30,121
California,Hawaiian Gardens,14475,291,207,913,736,923,3070
California,Guinda,749,0,0,56,124,178,358
California,Guerneville,3788,14,9,92,97,29,241
California,Guadalupe,7218,200,156,573,413,396,1738
California,Graeagle,597,0,0,32,0,5,37
California,Grand Terrace,12331,187,118,612,682,727,2326
California,Grangeville,549,0,0,51,35,69,155
California,Granite Bay,22387,356,253,1109,1599,1793,5110
California,Granite Hills,3282,39,18,151,81,251,540
California,Graniteville,0,0,0,0,0,0,0
California,Grass Valley,12855,218,210,347,411,567,1753
California,Graton,1643,5,52,60,52,67,236
California,Grayson,855,48,20,19,66,40,193
California,Greeley Hill,530,0,0,0,0,20,20
California,Greenacres,5321,5,82,287,419,193,986
California,Green Acres,2460,53,148,128,161,116,606
California,Greenfield,4347,0,24,241,285,266,816
California,Greenfield,16869,248,321,1521,1015,1209,4314
California,Greenhorn,180,0,0,11,0,0,11
California,Green Valley CDP (Los Angeles County),1012,8,11,27,25,46,117
California,Green Valley CDP (Solano County),1298,0,0,34,0,50,84
California,Greenview,161,0,8,0,0,0,8
California,Greenville,997,0,0,116,24,39,179
California,Grenada,484,12,11,19,13,4,59
California,Gridley,6579,144,101,469,391,333,1438
California,Grimes,387,0,18,78,79,0,175
California,Grizzly Flats,880,0,0,36,144,12,192
California,Groveland,653,0,0,26,41,19,86
California,Grover Beach,13409,172,183,561,593,631,2140
California,Mono City,67,0,0,12,1,0,13
California,Monmouth,209,0,0,0,12,16,28
California,Mokelumne Hill,719,0,0,35,22,22,79
California,Mojave,4297,28,68,314,137,216,763
California,Lomita,20622,299,246,787,835,1073,3240
California,Lompico,988,40,22,40,26,20,148
California,Lompoc,43428,681,531,2522,2207,3115,9056
California,London,2056,59,28,154,165,236,642
California,Lone Pine,1923,51,1,121,113,141,427
California,Long Barn,143,0,0,0,0,0,0
California,Long Beach,470237,7954,6424,23769,23426,28259,89832
California,Lookout,59,0,0,0,5,0,5
California,Loomis,6648,76,44,390,451,572,1533
California,Los Alamitos,11658,201,183,622,702,881,2589
California,Los Alamos,1607,0,20,72,161,135,388
California,Loma Rica,2584,56,67,157,81,46,407
California,Los Altos,30075,985,601,2105,1852,1672,7215
California,Los Angeles,3900794,62835,49781,179653,181483,208012,681764
California,Mentone,9844,227,192,486,592,570,2067
California,Menlo Park,33064,892,550,2037,1642,1419,6540
California,Menifee,83442,1264,1006,4523,3902,5346,16041
California,Mendota,11402,239,228,911,695,838,2911
California,Mendocino,701,0,0,26,22,11,59
California,Meiners Oaks,3595,35,14,187,138,187,561
California,Mecca,9472,138,143,831,919,652,2683
California,Mead Valley,19110,261,422,1201,1182,1326,4392
California,Meadow Vista,3129,18,37,73,204,154,486
California,Meadow Valley,425,11,0,16,16,12,55
California,Los Altos Hills,8314,88,85,316,564,591,1644
California,Meadowbrook,3059,9,24,170,185,177,565
California,Loma Mar,149,0,0,34,31,0,65
California,Loleta,570,11,0,10,7,28,56
California,Leona Valley,1664,20,23,59,88,90,280
California,Lewiston,1385,44,13,13,51,68,189
California,Lexington Hills,2581,81,103,181,94,110,569
California,Likely,37,0,0,0,0,0,0
California,Lincoln,45038,774,633,2569,2504,1729,8209
California,Lincoln Village,4108,125,66,197,178,197,763
California,Linda,18256,344,344,1202,1161,1857,4908
California,Lindcove,494,0,3,25,41,39,108
California,Linden,1845,45,12,53,124,133,367
California,Lindsay,12980,253,246,1045,1056,975,3575
California,Linnell Camp,875,0,25,0,75,89,189
California,Loma Linda,23751,222,213,1192,981,1051,3659
California,Litchfield,106,0,13,13,0,0,26
California,Little River,94,0,0,0,0,0,0
California,Littlerock,2228,48,37,129,212,356,782
California,Little Valley,36,0,0,0,0,0,0
California,Live Oak,18038,213,360,925,917,776,3191
California,Live Oak,8467,174,109,642,551,436,1912
California,Livermore,85286,1574,1163,4426,4721,4511,16395
California,Livingston,13611,192,136,979,1025,1101,3433
California,Lockeford,3410,40,87,266,304,87,784
California,Lockwood,446,0,14,41,37,15,107
California,Lodi,63589,859,748,3718,3957,4277,13559
California,Lodoga,159,0,0,0,0,0,0
California,Little Grass Valley,0,0,0,0,0,0,0
California,Maywood,27739,552,576,2141,1807,1880,6956
California,Mayflower Village,5421,67,60,228,194,327,876
California,Mayfair,4200,127,34,295,139,347,942
California,McGee Creek,149,0,0,0,0,0,0
California,McFarland,13028,315,301,1135,1084,923,3758
California,Macdoel,158,0,0,6,4,21,31
California,McCloud,1175,4,9,73,61,74,221
California,McClenney Tract,6,0,0,0,0,0,0
California,McClellan Park,1098,16,11,109,65,0,201
California,McArthur,283,0,0,0,0,19,19
California,Mabie,47,0,0,0,0,0,0
California,Lytle Creek,1111,0,17,47,58,39,161
California,Lynwood,71191,1544,1246,4707,4588,6285,18370
California,Lucerne Valley,5425,15,40,217,311,144,727
California,McKinleyville,16291,211,447,1048,585,830,3121
California,Lucerne,3162,99,59,173,140,246,717
California,Loyola,3539,69,36,275,222,254,856
California,Loyalton,890,12,8,52,39,67,178
California,Lower Lake,1639,30,0,76,95,76,277
California,Lost Hills,2126,22,65,260,165,147,659
California,Los Ranchos,1687,10,41,127,80,77,335
California,Los Osos,15388,307,133,476,507,709,2132
California,Los Olivos,1007,10,9,33,70,49,171
California,Los Molinos,2149,7,43,107,41,112,310
California,Los Gatos,30398,546,457,1584,1741,1799,6127
California,Los Berros,908,85,0,89,72,115,361
California,Los Banos,36847,563,748,2850,2830,2421,9412
California,Lucas Valley-Marinwood,6250,96,101,231,342,268,1038
California,McKittrick,115,0,4,5,5,1,15
California,McSwain,4562,31,40,223,266,334,894
California,Madera,63053,942,1313,4883,4534,4862,16534
California,Maxwell,1033,24,11,71,57,35,198
California,Mather,4425,87,29,309,301,266,992
California,Matheny,1043,30,33,82,46,80,271
California,Marysville,12161,187,140,822,717,671,2537
California,Martinez,37300,492,352,1716,1559,1951,6070
California,Martell,234,0,0,22,25,13,60
California,Markleeville,205,0,0,19,7,14,40
California,Mariposa,1580,0,47,30,136,21,234
California,Marin City,3048,68,35,221,253,90,667
California,Marina del Rey,9289,63,75,316,48,115,617
California,Marina,20537,382,183,899,1168,704,3336
California,Maricopa,1221,7,9,101,95,72,284
California,March ARB,1004,11,0,0,5,22,38
California,Manton,423,1,1,27,77,11,117
California,Manteca,72251,1239,1100,4045,4497,4850,15731
California,Manila,724,8,0,13,0,15,36
California,Manhattan Beach,35603,952,547,1934,2070,2057,7560
California,Manchester,226,0,0,6,19,9,34
California,Mammoth Lakes,8104,187,144,304,376,375,1386
California,Malibu,12856,118,127,453,610,753,2061
California,Malaga,862,0,4,57,89,136,286
California,Magalia,11306,73,157,329,540,564,1663
California,Mad River,482,8,6,2,24,39,79
California,Madison,555,13,16,31,12,76,148
California,Madera Acres,9747,146,130,639,789,668,2372
California,Lenwood,3844,0,105,411,301,213,1030
California,Oasis,5182,23,102,504,473,522,1624
California,Lennox,21850,395,541,1138,1650,1702,5426
California,Lemoore,24974,475,364,1990,1222,1756,5807
California,Kettleman City,1651,28,7,123,131,77,366
California,Keyes,6669,79,143,570,586,454,1832
California,King City,13389,183,359,942,1109,1129,3722
California,Kings Beach,3620,159,9,74,179,165,586
California,Kingsburg,11681,144,242,856,722,774,2738
California,Kingvale,129,0,0,0,0,0,0
California,Kirkwood,75,0,0,0,0,0,0
California,Klamath,954,6,9,50,27,55,147
California,Knightsen,1531,6,73,85,70,89,323
California,Knights Landing,1214,23,23,94,89,91,320
California,La Cañada Flintridge,20526,498,202,1066,1304,1853,4923
California,Keswick,454,16,0,27,20,6,69
California,La Crescenta-Montrose,19940,434,218,1109,1118,1218,4097
California,Ladera Heights,7509,96,83,205,372,477,1233
California,Ladera Ranch,26714,1114,670,2605,2101,1882,8372
California,Lafayette,25082,640,268,1508,1658,1611,5685
California,Laguna Beach,23230,211,194,712,1217,1103,3437
California,Laguna Hills,31017,452,331,1230,1622,1746,5381
California,Laguna Niguel,64825,1402,570,2994,2959,3089,11014
California,Laguna Woods,16359,0,0,0,0,0,0
California,Lagunitas-Forest Knolls,1485,31,8,41,79,67,226
California,La Habra,61725,1210,799,3328,3320,3583,12240
California,La Habra Heights,5425,88,15,244,179,406,932
California,La Honda,640,0,0,0,0,28,28
California,Ladera,1461,84,18,198,97,22,419
California,Lake Almanor Country Club,507,0,0,0,0,0,0
California,Kernville,1443,0,0,24,37,0,61
California,Merced,81120,1384,1500,5366,5565,5501,19316
California,Mohawk Vista,85,0,0,6,0,0,6
California,Modesto,207482,2922,2768,11486,11976,12937,42089
California,Mi-Wuk Village,1191,0,0,94,43,16,153
California,Mission Viejo,95979,1405,913,4473,4410,5577,16778
California,Mission Hills,3679,67,27,119,363,304,880
California,Mission Canyon,2520,9,10,106,123,133,381
California,Miranda,525,0,0,45,32,0,77
California,Mira Monte,6990,92,66,355,181,266,960
California,Minkler,1200,0,0,46,12,18,76
California,Mineral,199,0,4,6,0,0,10
California,Milpitas,71533,1095,898,3292,3165,3467,11917
California,Kerman,14285,193,303,1059,1077,897,3529
California,Millville,821,17,3,72,35,41,168
California,Millbrae,22416,452,175,904,852,1281,3664
California,Milford,192,0,0,0,0,0,0
California,Midway City,9500,84,163,566,420,427,1660
California,Midpines,826,0,6,33,27,19,85
California,Middletown,953,11,0,0,92,61,164
California,Mexican Colony,242,0,10,31,27,26,94
California,Mettler,108,0,7,3,11,0,21
California,Mesa Vista,208,9,0,10,6,15,40
California,Mesa Verde,739,0,0,48,37,99,184
California,Mesa,301,3,0,6,5,10,24
California,Meridian,500,8,3,33,32,37,113
California,Mill Valley,14243,380,223,962,831,848,3244
California,Lake Almanor Peninsula,485,0,18,21,5,3,47
California,Lake Almanor West,239,0,0,0,0,4,4
California,Lake Arrowhead,11333,152,98,597,698,774,2319
California,La Porte,0,0,0,0,0,0,0
California,La Presa,36875,677,536,1989,2118,2514,7834
California,La Puente,40496,551,602,2396,2763,2383,8695
California,La Quinta,39301,282,282,2127,1885,2472,7048
California,La Riviera,11062,243,121,483,379,312,1538
California,Larkfield-Wikiup,9090,210,104,441,537,467,1759
California,Larkspur,12219,156,48,435,890,680,2209
California,La Selva Beach,2708,104,0,117,87,100,408
California,Las Flores CDP (Orange County),6339,408,0,419,515,423,1765
California,Las Flores CDP (Tehama County),191,0,0,19,10,23,52
California,Las Lomas,2952,15,39,283,186,290,813
California,La Palma,15842,215,120,735,785,846,2701
California,Lathrop,19678,417,305,1374,1201,1755,5052
California,La Verne,31920,500,362,1550,1445,1518,5375
California,La Vina,409,31,23,38,29,60,181
California,Lawndale,33231,786,469,2060,1929,1929,7173
California,Laytonville,1274,8,63,143,42,44,300
California,Lebec,1187,34,39,19,119,52,263
California,Lee Vining,90,0,0,0,0,0,0
California,Leggett,74,0,10,7,0,2,19
California,Le Grand,1800,21,21,91,143,178,454
California,Lemon Cove,260,10,0,11,0,19,40
California,Lemon Grove,26225,485,277,1422,1672,1667,5523
California,Lemon Hill,13128,179,433,851,748,835,3046
California,Laton,1473,5,37,50,94,183,369
California,Lancaster,159774,2213,2677,9334,10619,11727,36570
California,Lanare,304,20,18,16,21,30,105
California,Lamont,15941,206,449,1450,1156,1073,4334
California,Lake California,2979,27,46,212,127,77,489
California,Lake City,23,0,0,0,0,0,0
California,Lake Davis,26,0,0,0,0,0,0
California,Lake Don Pedro,1054,14,0,79,3,71,167
California,Lake Elsinore,58003,830,1017,4304,4296,4226,14673
California,Lake Forest,79928,1225,855,4026,4577,4615,15298
California,Lakehead,673,0,0,52,57,13,122
California,Lake Hughes,395,0,0,0,10,10,20
California,Lake Isabella,2966,0,0,42,100,19,161
California,Lakeland Village,11995,139,76,731,824,958,2728
California,Lake Los Angeles,12136,173,166,920,875,1253,3387
California,Lake Mathews,5511,51,46,263,359,435,1154
California,Lake Nacimiento,2910,73,57,203,136,92,561
California,Lake of the Pines,3627,41,6,62,195,256,560
California,Lake of the Woods,753,0,0,24,0,36,60
California,Lakeport,4740,51,53,213,184,317,818
California,Lake Riverside,876,15,0,52,67,66,200
California,Lake San Marcos,4798,35,13,201,231,105,585
California,Lake Sherwood,1769,22,4,57,62,136,281
California,Lakeside,21413,223,279,1343,1129,1236,4210
California,Lakeview,2142,71,36,126,92,142,467
California,Lake Wildwood,5375,17,78,212,141,229,677
California,Lakewood,81173,1213,922,3960,4132,5080,15307
California,La Mesa,58858,954,711,2361,2459,2372,8857
California,La Mirada,49182,636,461,2114,2329,2296,7836
California,Lemoore Station,6875,123,122,414,336,204,1199
California,Occidental,1159,13,0,44,46,26,129
California,Flournoy,139,0,0,5,6,13,24
California,Oceanside,173050,2490,1620,8607,8201,9302,30220
California,Petaluma,59340,1218,991,3444,3035,3012,11700
California,Pescadero,1026,0,68,48,119,75,310
California,Perris,72547,994,1229,6215,5891,6193,20522
California,Penryn,767,6,15,17,29,33,100
California,Penn Valley,1843,27,0,99,94,107,327
California,Penngrove,2799,0,86,186,71,79,422
California,Pearsonville,25,0,0,0,0,0,0
California,Paynes Creek,70,0,0,0,0,1,1
California,Paxton,0,0,0,0,0,0,0
California,Patton Village,575,18,0,29,45,4,96
California,Patterson Tract,1905,42,13,116,173,82,426
California,Patterson,20967,503,390,1532,1573,1451,5449
California,Paskenta,84,0,0,9,0,0,9
California,Pasatiempo,1210,17,0,119,18,114,268
California,Pasadena,139899,2506,1454,5069,5696,6228,20953
California,Parlier,14870,247,474,1295,921,1189,4126
California,Parkwood,2994,81,0,277,145,213,716
California,Parkway,15369,303,273,1219,1013,1132,3940
California,Parksdale,3280,12,87,333,175,224,831
California,Parklawn,1405,17,0,133,90,34,274
California,Paramount,55023,889,842,3714,4085,4583,14113
California,Paradise Park,515,7,0,0,19,18,44
California,Paradise,170,0,0,0,3,12,15
California,Paradise,26289,144,196,909,1290,974,3513
California,Panorama Heights,31,0,0,0,0,0,0
California,Palo Verde,56,0,0,0,0,0,0
California,Palos Verdes Estates,13614,334,236,728,688,959,2945
California,Palo Cedro,1543,32,32,59,129,104,356
California,Palo Alto,66478,1408,674,3341,4028,3992,13443
California,Peters,440,17,0,27,27,35,106
California,Palm Springs,46305,375,427,1279,1300,1627,5008
California,Phelan,13719,223,68,616,970,805,2682
California,Philo,341,11,0,0,26,58,95
California,El Rancho,97,0,0,0,8,0,8
California,El Rio,7080,58,97,507,507,450,1619
California,El Segundo,16929,288,297,538,976,1095,3194
California,El Sobrante CDP (Contra Costa County),13388,227,249,792,530,628,2426
California,El Sobrante CDP (Riverside County),15788,335,289,1284,1224,564,3696
California,El Verano,4008,96,27,151,225,183,682
California,Elverta,5551,20,49,274,292,468,1103
California,Emerald Lake Hills,4495,52,55,187,278,272,844
California,Emeryville,10830,122,47,168,125,149,611
California,Empire,4675,64,96,423,405,277,1265
California,Encinitas,61682,1274,658,2922,2468,2608,9930
California,Escalon,7320,69,84,215,481,1093,1942
California,Escondido,149079,2272,1817,7878,7924,9343,29234
California,Esparto,3298,84,88,270,112,175,729
California,Etna,717,5,3,49,52,18,127
California,Pi?on Hills,6969,0,98,238,284,324,944
California,Pinole,18922,379,134,990,955,722,3180
California,Pine Valley,1754,32,13,101,98,93,337
California,Pine Mountain Lake,2471,14,6,107,107,94,328
California,Pine Mountain Club,1774,0,0,65,29,262,356
California,Pine Hills,3167,81,0,176,255,166,678
California,Pine Grove,1578,0,0,28,73,31,132
California,Pine Flat,143,0,0,0,5,6,11
California,Pine Canyon,1866,0,68,54,94,114,330
California,Pike,133,0,0,0,5,0,5
California,Pierpoint,25,0,0,0,0,0,0
California,Piedmont,11099,314,77,998,806,678,2873
California,Pico Rivera,63839,1370,739,3403,3471,4039,13022
California,Phoenix Lake,4741,66,29,220,220,175,710
California,Phillipsville,71,0,0,0,0,0,0
California,El Portal,467,0,17,35,58,14,124
California,Palm Desert,50565,687,336,2221,1612,2270,7126
California,Palermo,5895,62,78,455,221,358,1174
California,Farmersville,10704,132,321,901,706,904,2964
California,Farmington,80,0,0,0,0,0,0
California,Fellows,79,2,0,4,6,12,24
California,Felton,3991,38,86,152,209,174,659
California,Ferndale,1354,14,4,43,69,39,169
California,Fetters Hot Springs-Agua Caliente,5019,67,46,307,239,328,987
California,Fiddletown,83,0,0,0,0,0,0
California,Fieldbrook,823,22,0,46,36,15,119
California,Waterford,8649,42,217,586,687,902,2434
California,Waterloo,524,0,0,0,31,54,85
California,Watsonville,52543,895,926,3591,2958,3476,11846
California,Waukena,191,0,5,10,17,29,61
California,Wawona,323,0,0,4,35,4,43
California,Weaverville,3151,139,27,122,171,114,573
California,Weed,2823,45,20,138,183,132,518
California,Weedpatch,2328,27,53,187,80,166,513
California,Weldon,2752,12,0,63,111,72,258
California,Weott,237,0,0,0,0,23,23
California,West Athens,8320,89,119,264,340,573,1385
California,West Bishop,2873,8,17,160,142,178,505
California,West Carson,21437,307,412,807,807,780,3113
California,West Covina,107837,1406,1137,5314,5739,6773,20369
California,West Goshen,675,0,9,104,74,95,282
California,Westhaven-Moonstone,1031,5,10,17,24,34,90
California,West Hollywood,35332,103,104,344,216,313,1080
California,Westlake Village,8471,148,83,272,394,558,1455
California,Westley,759,0,0,158,135,114,407
California,West Menlo Park,3799,63,97,267,350,218,995
California,Westminster,91719,1015,992,3720,4517,5225,15469
California,Fall River Mills,548,0,0,0,0,9,9
California,Palmdale,156672,2505,3008,10313,11430,13195,40451
California,Fallbrook,31573,361,371,1644,1607,1577,5560
California,Fair Oaks,31537,457,454,1159,1275,1575,4920
California,Pala,999,26,42,90,72,44,274
California,Pajaro Dunes,320,0,0,29,9,12,50
California,Pajaro,3230,106,55,252,263,225,901
California,Pacific Grove,15505,216,140,470,573,732,2131
California,Pacifica,38665,629,377,1775,1712,1891,6384
California,Pacheco,4282,0,54,178,111,138,481
California,Oxnard,203495,3092,3423,12819,12302,12683,44319
California,Oroville East,8136,120,58,544,421,371,1514
California,Oroville,16060,253,291,1115,712,770,3141
California,Orosi,8796,261,240,646,849,487,2483
California,Orland,7488,25,208,259,649,491,1632
California,Orinda,18703,442,193,1096,1171,984,3886
California,Orick,267,0,0,0,0,13,13
California,Orcutt,29908,518,448,1520,1737,1715,5938
California,Orangevale,34836,475,482,1645,1840,1858,6300
California,Orange Cove,9565,209,422,747,818,808,3004
California,Adin,173,0,0,0,16,20,36
California,Adelanto,32059,562,776,2695,2267,2649,8949
California,Acton,7058,107,81,271,292,459,1210
California,Acampo,787,0,0,0,0,0,0
California,Acalanes Ridge,1139,0,0,41,96,132,269
California,Eucalyptus Hills,5292,60,124,324,436,216,1160
California,Eureka,26985,343,334,1033,1191,1215,4116
California,Oceano,7857,85,43,432,642,342,1544
California,Fairbanks Ranch,2939,42,36,72,239,390,779
California,Fairfax,7584,143,67,280,432,387,1309
California,Fairfield,109468,1733,1664,6410,6031,6425,22263
California,Fairhaven,222,1,2,0,0,12,15
California,Fairmead,2187,10,25,234,183,88,540
California,Fairview,10568,87,162,406,383,438,1476
California,West Modesto,6041,111,93,557,444,408,1613
California,El Paso de Robles (Paso Robles),30863,417,445,1618,1579,1634,5693
California,El Monte,115711,1460,1425,6135,5776,7662,22458
California,East Orosi,572,0,35,45,68,64,212
California,East Palo Alto,29198,828,645,1777,1550,2418,7218
California,East Pasadena,6063,131,102,342,170,314,1059
California,East Porterville,6395,110,102,600,518,439,1769
California,Traver,711,23,13,55,72,36,199
California,Tres Pinos,472,2,0,45,32,20,99
California,Trinidad,219,0,3,0,4,1,8
California,Trinity Center,211,0,0,0,18,0,18
California,Trinity Village,221,0,4,3,2,12,21
California,Trona,0,0,0,0,0,0,0
California,Trowbridge,220,0,18,13,5,5,41
California,Truckee,16184,265,304,777,1010,754,3110
California,Tulare,61204,929,1014,4852,4045,4351,15191
California,Tulelake,1000,30,32,39,38,71,210
California,Tuolumne City,1763,62,14,98,40,34,248
California,Tupman,206,0,4,9,21,14,48
California,Turlock,70596,758,1420,4205,3943,4564,14890
California,Tustin,78787,1396,770,4039,4324,4784,15313
California,Tuttle,0,0,0,0,0,0,0
California,Tuttletown,1068,6,19,51,38,32,146
California,Twain,31,0,0,0,0,0,0
California,Twain Harte,2297,0,0,19,105,65,189
California,Twentynine Palms,25769,304,261,1557,847,965,3934
California,Twin Lakes,5201,31,119,107,199,34,490
California,Ukiah,15936,177,251,816,808,990,3042
California,Union City,72690,979,842,3126,3190,3497,11634
California,University of California-Davis,6865,41,7,48,0,5,101
California,University of California-Merced,0,0,0,0,0,0,0
California,Upland,75542,1296,868,3370,3757,4599,13890
California,Easton,1964,29,43,90,128,135,425
California,Upper Lake,712,8,0,94,22,54,178
California,East Oakdale,2882,34,20,133,160,156,503
California,East Los Angeles,125415,2347,2450,7756,7255,9451,29259
California,Dillon Beach,139,7,0,8,8,0,23
California,Dinuba,23243,464,262,1714,1590,1548,5578
California,Discovery Bay,14650,321,200,821,1154,898,3394
California,Dixon,18908,222,219,1297,1529,1411,4678
California,Dixon Lane-Meadow Creek,2636,75,20,129,153,108,485
California,Dobbins,689,0,0,12,36,12,60
California,Dogtown,2337,55,30,60,83,154,382
California,Dollar Point,1135,19,43,28,23,25,138
California,Dorrington,286,0,0,1,0,0,1
California,Dorris,930,14,15,60,51,39,179
California,Dos Palos,5068,119,101,320,481,536,1557
California,Dos Palos Y,215,0,0,5,12,21,38
California,Douglas City,613,3,8,45,52,33,141
California,Downey,113407,2017,1266,5882,6799,7366,23330
California,Downieville,213,0,0,55,0,0,55
California,Doyle,452,0,0,0,20,0,20
California,Drytown,217,0,0,0,3,5,8
California,Duarte,21769,348,314,826,1263,1247,3998
California,Dublin,52063,1043,698,2927,2784,2320,9772
California,Ducor,661,0,36,75,36,55,202
California,Dunnigan,1183,17,37,39,76,30,199
California,Dunsmuir,1552,16,17,39,86,48,206
California,Durham,5637,74,45,323,375,384,1201
California,Dustin Acres,523,0,0,25,26,26,77
California,Dutch Flat,162,0,0,0,0,4,4
California,Eagleville,74,0,5,0,3,2,10
California,Earlimart,8709,137,307,720,642,695,2501
California,East Foothills,6437,87,103,328,333,286,1137
California,East Hemet,19180,280,248,1209,1334,1242,4313
California,East Nicolaus,213,4,0,13,8,2,27
California,El Nido,515,2,39,54,5,30,130
California,Vacaville,94795,1428,1116,4741,5445,5834,18564
California,Vallecito,482,0,55,11,11,92,169
California,Warm Springs,3190,0,21,237,230,176,664
California,Warner Valley,4,0,0,0,0,0,0
California,Wasco,25973,473,336,1770,1536,1435,5550
California,Washington,24,0,0,0,0,0,0
California,East Quincy,2827,0,31,58,243,89,421
California,East Rancho Dominguez,15615,200,333,908,902,1444,3787
California,East Richmond Heights,3272,17,16,120,125,62,340
California,East San Gabriel,15980,321,253,697,825,675,2771
California,East Shore,225,0,0,0,0,27,27
California,East Sonora,2368,0,16,27,73,45,161
California,East Tulare Villa,954,23,42,74,46,86,271
California,Eastvale,56275,1047,1096,4681,2996,4164,13984
California,East Whittier,10440,160,104,477,594,613,1948
California,Edgewood,27,0,3,4,0,0,7
California,Edmundson Acres,343,5,12,26,21,42,106
California,Edna,176,0,0,0,0,35,35
California,Edwards AFB,2401,84,51,233,112,58,538
California,El Cajon,102383,1396,1649,5208,5460,6144,19857
California,El Centro,43570,901,770,2873,2676,3277,10497
California,El Cerrito,24418,452,307,998,857,864,3478
California,El Cerrito,5581,70,73,229,256,404,1032
California,El Dorado Hills,43264,822,649,2968,3181,2786,10406
California,Eldridge,1287,1,10,43,49,13,116
California,El Granada,5681,151,167,158,261,273,1010
California,Elizabeth Lake,1735,6,25,57,130,59,277
California,Elk Creek,151,0,0,0,0,0,0
California,Elk Grove,161084,2632,2158,9559,11705,11956,38010
California,Elkhorn,1139,0,0,65,17,97,179
California,Elmira,345,0,0,28,0,0,28
California,Walnut Park,16054,161,231,813,974,1129,3308
California,Valinda,24026,416,269,1167,1518,1674,5044
California,Walnut Grove,1253,27,0,35,37,69,168
California,Walnut,29970,367,165,1258,1358,1849,4997
California,Vallejo,118995,1358,1317,5213,5433,6195,19516
California,Valle Vista,16127,207,274,762,973,999,3215
California,Valley Acres,584,0,0,23,16,57,96
California,Valley Center,10261,105,278,523,800,584,2290
California,Valley Ford,155,30,0,0,0,26,56
California,Valley Home,290,2,0,0,3,34,39
California,Valley Ranch,44,0,0,0,0,0,0
California,Valley Springs,3321,15,0,79,120,160,374
California,Valley Wells,0,0,0,0,0,0,0
California,Val Verde,2697,33,35,153,119,210,550
California,Vandenberg AFB,3317,70,96,231,146,59,602
California,Vandenberg Village,6763,81,43,468,427,384,1403
California,Verdi,107,0,0,0,0,0,0
California,Vernon,41,0,0,1,2,2,5
California,Victor,592,0,0,83,139,28,250
California,Victorville,120703,1332,2464,8478,8933,9955,31162
California,View Park-Windsor Hills,11648,227,105,346,429,606,1713
California,Villa Park,5947,105,71,318,220,344,1058
California,Vina,181,0,8,0,0,16,24
California,Vincent,17006,298,313,890,972,1124,3597
California,Vine Hill,4144,47,66,211,162,303,789
California,Vineyard,26452,230,375,1919,2057,1812,6393
California,Visalia,127842,2089,2139,8209,7777,8572,28786
California,Vista,97564,1028,1198,5725,4764,5177,17892
California,Vista Santa Rosa,3173,9,30,320,307,249,915
California,Volcano,20,0,0,0,0,0,0
California,Volta,172,0,0,0,19,0,19
California,Walker,832,0,8,38,90,0,136
California,Wallace,877,0,0,0,0,0,0
California,Walnut Creek,66799,739,533,2204,2832,2873,9181
California,Westmont,32566,396,569,2306,2115,2044,7430
California,Exeter,10481,62,198,664,915,834,2673
California,Fortuna,11904,173,149,579,723,848,2472
California,Woodcrest,16049,72,183,766,697,1032,2750
California,Woodbridge,3705,37,28,120,211,193,589
California,Woodacre,1623,16,0,55,64,69,204
California,Wofford Heights,1684,0,0,0,0,39,39
California,Winton,11669,128,184,916,1122,916,3266
California,Winters,6927,29,43,451,385,341,1249
California,Winterhaven,171,16,0,0,0,0,16
California,Winter Gardens,20703,385,318,1077,917,1480,4177
California,Windsor,27205,401,632,1390,1511,1901,5835
California,Winchester,2824,40,0,96,230,224,590
California,Wilton,5030,12,50,155,390,308,915
California,Wilsonia,0,0,0,0,0,0,0
California,Willows,6111,36,133,440,366,442,1417
California,Willow Creek,1553,24,27,102,79,10,242
California,Willowbrook,20685,459,262,1653,1640,1553,5567
California,Williams,5159,53,113,245,355,376,1142
California,Wilkerson,557,0,0,20,30,42,92
California,Wildomar,34220,348,313,1962,2045,2633,7301
California,Whittier,86688,1033,856,4627,4697,5204,16417
California,Whitley Gardens,280,0,0,19,0,0,19
California,Whitewater,611,11,0,59,90,40,200
California,Whitehawk,44,0,0,0,0,0,0
California,Wheatland,3543,45,17,135,331,243,771
California,Westwood,1595,28,0,86,54,106,274
California,West Whittier-Los Nietos,27114,367,376,1214,1394,1928,5279
California,Westside,279,0,9,20,28,30,87
California,West Sacramento,50747,925,727,2841,2799,2933,10225
California,West Rancho Dominguez,22605,332,220,1294,1292,1891,5029
California,West Puente Valley,24077,357,213,1306,1450,1411,4737
California,Woodlake,7525,266,193,582,332,612,1985
California,Woodland,56997,921,833,3285,3338,3666,12043
California,Woodlands,632,0,0,0,0,33,33
California,Woodside,5479,116,83,352,268,411,1230
California,Fountain Valley,56696,659,633,2311,2867,2861,9331
California,Foster City,32377,657,380,1598,1670,1328,5633
California,Fort Washington,734,69,0,125,97,66,357
California,Fort Jones,978,45,30,64,65,83,287
California,Fort Irwin,9238,281,234,570,805,349,2239
California,Fort Dick,918,0,0,54,29,93,176
California,Fort Bragg,7261,153,121,361,426,384,1445
California,Fort Bidwell,204,13,5,8,1,5,32
California,Forestville,3367,0,0,22,83,176,281
California,Forest Ranch,831,0,11,12,40,0,63
California,Forest Meadows,1568,0,15,52,39,16,122
California,Foresthill,1124,28,0,109,0,32,169
California,Ford City,4085,40,129,121,280,253,823
California,Forbestown,344,0,0,0,116,0,116
California,West Point,628,0,0,0,26,44,70
California,Foothill Farms,33090,605,368,1933,1595,1526,6027
California,Folsom,74156,1416,797,4314,4135,4554,15216
California,Floriston,40,0,0,0,0,0,0
California,Florin,50899,555,660,2967,3319,3070,10571
California,Florence-Graham,63177,1156,1100,4159,4165,5416,15996
California,Fish Camp,51,0,0,0,0,0,0
California,Firebaugh,8084,188,243,789,583,630,2433
California,Fillmore,15296,164,249,969,1067,1123,3572
California,Fields Landing,229,0,0,0,0,0,0
California,Yorba Linda,67033,1135,768,3354,4109,4069,13435
California,Yolo,577,0,0,109,66,34,209
California,Yettem,300,0,0,32,48,34,114
California,Yankee Hill,270,0,0,0,5,0,5
California,Wrightwood,4442,10,132,280,306,264,992
California,Woodville,1798,53,31,145,132,112,473
California,Fontana,203677,2759,3174,14726,14396,15670,50725
California,West Park,717,5,10,40,25,45,125
California,Willits,4853,71,39,208,158,167,643
California,Friant,244,0,0,0,0,0,0
California,Galt,24607,275,183,1626,2209,1919,6212
California,Furnace Creek,187,0,0,0,0,2,2
California,Fulton,638,62,0,55,8,5,130
California,Fullerton,138976,2517,1885,6457,6596,7706,25161
California,Fuller Acres,970,29,33,62,93,109,326
California,Fruitridge Pocket,5725,119,103,460,325,349,1356
California,Onyx,604,0,0,32,0,29,61
California,Ontario,168218,2063,3010,10290,10350,11914,37627
California,Olivehurst,14293,235,295,993,974,1136,3633
California,Old Station,109,0,0,0,25,0,25
California,Old Fig Garden,5493,71,68,254,227,314,934
California,Olancha,152,0,0,0,4,0,4
California,Ojai,7587,119,45,494,494,313,1465
California,Garberville,988,0,27,71,27,122,247
California,Oildale,33842,379,720,1855,2109,2188,7251
California,Fruitdale,980,11,11,59,0,9,90
California,Westmorland,1750,69,18,161,121,135,504
California,Fresno,510451,7044,8463,34234,31798,31792,113331
California,French Valley,27752,662,649,1740,2087,2212,7350
California,French Gulch,494,8,4,10,24,15,61
California,French Camp,4057,45,57,72,158,316,648
California,Fremont,225221,4369,3760,12300,11482,11220,43131
California,Freeport,51,0,0,0,14,0,14
California,Freedom,3027,124,0,216,197,132,669
California,Frazier Park,2654,30,40,148,296,89,603
California,Franklin CDP (Sacramento County),97,0,0,0,0,9,9
California,Franklin CDP (Merced County),7511,50,122,559,786,700,2217
California,Fowler,6006,180,102,304,523,455,1564
California,Ocotillo,252,0,6,0,30,47,83
California,Gardena,59931,1038,767,2879,2814,3249,10747
California,Orange,139761,2028,1748,6360,6406,7671,24213
California,Garden Farms,265,0,0,41,0,0,41
California,Zayante,881,7,0,27,56,70,160
California,Yucca Valley,21258,128,140,1275,1056,1427,4026
California,Yucaipa,52739,543,820,2485,2764,3390,10002
California,Yuba City,66038,1146,930,4366,3556,4527,14525
California,Garden Acres,11278,201,235,623,690,781,2530
California,Yountville,2985,114,0,16,66,31,227
California,Yosemite Valley,1067,0,13,25,12,0,50
California,Yosemite Lakes,4990,85,36,228,312,322,983
California,Gonzales,8378,157,175,816,607,716,2471
California,Goleta,30541,492,281,1492,1312,1674,5251
California,Gold River,7639,16,46,380,326,469,1237
California,Gold Mountain,21,0,0,0,0,0,0
California,Golden Hills,8313,147,116,601,438,555,1857
California,Yreka,7635,148,115,493,338,347,1441
California,Glen Ellen,593,0,0,0,21,20,41
California,Garden Grove,174721,2196,2295,9525,9178,10981,34175
California,Garey,170,0,0,0,0,0,0
California,Gasquet,596,0,0,64,37,7,108
California,Gazelle,56,0,0,2,0,0,2
California,Georgetown,2473,0,40,141,175,163,519
California,Garnet,6844,129,283,549,392,306,1659
California,Gerber,1129,11,9,112,0,96,228
California,Geyserville,1088,3,9,57,52,41,162
California,Gilroy,51649,1003,889,3183,3501,3569,12145
California,Glendale,196984,3198,1737,7074,7973,8365,28347
California,Glendora,51137,877,771,2605,2831,2922,10006
Colorado,Montrose,18970,240,218,940,869,992,3259
Colorado,Milliken,5975,56,127,388,364,240,1175
Colorado,Minturn,1050,35,7,36,51,17,146
Colorado,Moffat,131,4,0,2,0,6,12
Colorado,Monte Vista,4366,77,121,122,320,241,881
Colorado,Castle Pines Village,4504,41,45,359,453,491,1389
Colorado,Montezuma,57,0,0,0,10,0,10
Colorado,Midland,163,0,0,11,0,17,28
Colorado,Monument,6252,142,210,558,424,457,1791
Colorado,Mount Crested Butte,859,3,14,34,24,19,94
Colorado,Morrison,394,0,2,8,4,1,15
Colorado,Mountain Meadows,192,15,0,0,0,0,15
Colorado,Mountain View,607,0,2,35,32,19,88
Colorado,Mountain Village,1405,24,6,64,71,32,197
Colorado,Mulford,169,0,7,7,8,0,22
Colorado,Nederland,1531,6,24,105,138,97,370
Colorado,Naturita,461,10,7,9,9,32,67
Colorado,Merino,245,5,0,25,15,33,78
Colorado,Morgan Heights,386,0,0,7,26,35,68
Colorado,Meridian,3107,22,21,102,107,99,351
Colorado,Aguilar,660,4,0,24,31,55,114
Colorado,Mead,3967,148,120,212,297,210,987
Colorado,Aetna Estates,1165,26,10,126,153,37,352
Colorado,Acres Green,2921,18,89,116,192,209,624
Colorado,New Castle,4569,87,81,455,365,257,1245
Colorado,Carbondale,6516,94,25,183,496,400,1198
Colorado,Louviers,152,0,3,3,8,0,14
Colorado,Cascade-Chipita Park,1561,33,0,52,67,128,280
Colorado,Castle Pines,10399,233,186,814,969,757,2959
Colorado,Loveland,71755,958,805,3986,4021,3515,13285
Colorado,Meeker,2770,63,40,169,162,147,581
Colorado,Lynn,6,0,0,0,0,0,0
Colorado,McCoy,27,0,0,0,0,0,0
Colorado,Manassa,1060,24,2,60,85,83,254
Colorado,Mancos,1727,34,18,114,82,67,315
Colorado,Manitou Springs,5211,58,10,256,183,165,672
Colorado,Manzanola,445,3,3,13,27,39,85
Colorado,Marble,150,1,3,0,0,20,24
Colorado,Maybell,56,0,0,0,0,0,0
Colorado,Maysville,95,0,0,0,0,0,0
Colorado,Lyons,2056,29,77,129,32,105,372
Colorado,Niwot,4497,0,51,372,408,402,1233
Colorado,Estes Park,6103,87,35,238,129,64,553
Colorado,Norrie,0,0,0,0,0,0,0
Colorado,Brush,5488,217,105,294,251,386,1253
Colorado,Broomfield,60699,1454,959,3916,3392,3246,12967
Colorado,Brookside,247,11,0,8,30,13,62
Colorado,Brighton,35582,438,535,2374,2498,2253,8098
Colorado,Brick Center,34,0,0,0,0,0,0
Colorado,Breckenridge,4682,41,17,224,106,57,445
Colorado,Branson,41,0,2,0,4,0,6
Colorado,Brandon,18,0,0,0,0,0,0
Colorado,Bow Mar,1045,8,15,63,90,129,305
Colorado,Boulder,103919,1313,962,3206,3235,2911,11627
Colorado,Boone,346,2,3,31,22,14,72
Colorado,Bonanza Mountain Estates,96,0,0,0,0,0,0
Colorado,Bonanza,8,0,0,0,0,0,0
Colorado,Blue Sky,0,0,0,0,0,0,0
Colorado,Blue River,784,3,51,21,8,13,96
Colorado,Blende,727,4,5,59,53,26,147
Colorado,Blanca,478,16,5,26,27,34,108
Colorado,Black Hawk,155,0,0,0,0,0,0
Colorado,Black Forest,12918,116,237,748,738,1130,2969
Colorado,Buena Vista,2705,52,20,122,259,135,588
Colorado,Burlington,3931,61,0,172,208,100,541
Colorado,Byers,1357,29,23,76,61,59,248
Colorado,Calhan,832,14,20,50,56,60,200
Colorado,Peyton,307,0,0,38,38,36,112
Colorado,Perry Park,1727,17,15,76,74,38,220
Colorado,Peoria,178,0,3,7,25,5,40
Colorado,Penrose,3211,60,57,85,235,204,641
Colorado,Peetz,242,0,0,6,10,14,30
Colorado,Parshall,57,0,0,0,0,0,0
Colorado,Parker,47342,1069,1084,3684,3809,2891,12537
Colorado,Paragon Estates,848,0,0,29,24,104,157
Colorado,Parachute,1095,19,51,84,121,94,369
Colorado,Beulah Valley,768,0,0,28,111,56,195
Colorado,Paonia,1255,7,17,60,88,68,240
Colorado,Palmer Lake,2529,54,47,191,111,99,502
Colorado,Palisade,2654,40,22,173,134,183,552
Colorado,Pagosa Springs,1729,19,25,114,72,54,284
Colorado,Padroni,143,0,11,35,0,0,46
Colorado,Ovid,311,3,2,4,22,14,45
Colorado,Ouray,853,8,9,10,12,58,97
Colorado,Capulin,115,17,0,0,0,6,23
Colorado,Ca?on City,16408,353,298,542,871,969,3033
Colorado,Campo,41,0,0,0,0,0,0
Colorado,Paoli,63,0,0,0,0,0,0
Colorado,No Name,146,0,0,0,0,0,0
Colorado,Bethune,297,6,4,15,25,44,94
Colorado,Berkley,11599,249,155,460,824,641,2329
Colorado,Alamosa East,1576,38,0,36,147,154,375
Colorado,Alamosa,9592,251,184,587,422,396,1840
Colorado,Akron,1903,20,16,92,57,89,274
Colorado,Air Force Academy,5864,58,41,170,192,116,577
Colorado,Otis,438,8,10,17,45,19,99
Colorado,Ordway,1393,23,0,112,202,140,477
Colorado,Orchard Mesa,6385,73,33,183,271,331,891
Colorado,Orchard City,3047,8,9,136,252,180,585
Colorado,Orchard,113,3,0,0,3,0,6
Colorado,Ophir,226,32,2,28,4,0,66
Colorado,Olney Springs,507,17,13,48,38,16,132
Colorado,Olathe,1999,67,18,175,90,122,472
Colorado,Oak Creek,836,8,6,30,43,40,127
Colorado,Nunn,524,6,0,22,26,23,77
Colorado,Nucla,525,1,4,16,36,28,85
Colorado,Norwood,595,10,8,17,7,26,68
Colorado,North Washington,272,0,0,4,6,0,10
Colorado,North La Junta,449,9,0,35,41,28,113
Colorado,Northglenn,37754,528,505,2272,1667,1612,6584
Colorado,Allenspark,673,6,5,28,19,23,81
Colorado,Alma,302,9,3,14,18,2,46
Colorado,Alpine,146,0,0,9,0,0,9
Colorado,Altona,550,0,6,12,55,39,112
Colorado,Bennett,1915,31,12,98,159,95,395
Colorado,Bayfield,2478,28,55,106,106,139,434
Colorado,Battlement Mesa,4689,72,20,363,303,512,1270
Colorado,Basalt,3791,58,8,183,87,97,433
Colorado,Bark Ranch,222,0,0,0,14,45,59
Colorado,Avondale,803,20,0,10,0,20,50
Colorado,Avon,6414,287,186,362,267,336,1438
Colorado,Aurora,345867,5314,5222,20686,19570,19577,70369
Colorado,Castle Rock,52143,1276,900,3738,3441,3066,12421
Colorado,Berthoud,5497,33,28,354,394,352,1161
Colorado,Ault,1750,42,27,116,152,107,444
Colorado,Aspen Park,748,18,6,32,61,63,180
Colorado,Aspen,6740,47,118,139,317,345,966
Colorado,Arvada,111658,2101,1399,5702,5404,6055,20661
Colorado,Arriba,188,2,2,3,11,11,29
Colorado,Aristocrat Ranchettes,1275,0,17,127,84,69,297
Colorado,Arboles,246,6,3,0,6,0,15
Colorado,Applewood,7623,110,65,353,240,217,985
Colorado,Antonito,757,22,11,53,32,40,158
Colorado,Amherst,56,0,0,0,0,0,0
Colorado,Atwood,228,0,0,9,18,8,35
Colorado,Cathedral,17,0,0,0,0,3,3
Colorado,La Junta,7018,270,65,354,210,381,1280
Colorado,Cattle Creek,731,0,0,87,59,0,146
Colorado,East Pleasant View,425,0,0,28,16,31,75
Colorado,Eaton,4662,82,54,405,325,342,1208
Colorado,Eckley,342,5,8,35,17,27,92
Colorado,Edgewater,5237,197,49,192,168,106,712
Colorado,Edwards,9792,148,111,690,501,609,2059
Colorado,Elbert,187,0,3,7,13,22,45
Colorado,Eldora,119,0,0,27,0,0,27
Colorado,Eldorado Springs,782,0,0,11,78,39,128
Colorado,Elizabeth,1236,2,14,119,52,81,268
Colorado,Eagle,6553,353,135,736,460,327,2011
Colorado,El Jebel,3526,0,35,211,294,359,899
Colorado,El Moro,325,2,0,5,33,14,54
Colorado,Empire,312,8,4,7,9,25,53
Colorado,Englewood,31877,628,343,1325,968,938,4202
Colorado,Haswell,74,0,1,2,2,3,8
Colorado,Hasty,96,6,3,3,5,6,23
Colorado,Hartman,62,0,0,5,4,2,11
Colorado,Gypsum,6685,150,93,691,88,484,1506
Colorado,Gunnison,5955,80,76,152,204,173,685
Colorado,Gunbarrel,9184,137,61,222,350,394,1164
Colorado,Ellicott,703,21,15,28,35,38,137
Colorado,Eads,612,30,10,36,16,30,122
Colorado,Durango,17486,139,163,568,651,589,2110
Colorado,Downieville-Lawson-Dumont,474,0,13,25,0,15,53
Colorado,Crested Butte,1445,34,14,98,37,68,251
Colorado,Crestone,107,0,0,0,11,10,21
Colorado,Cripple Creek,1341,62,9,74,41,93,279
Colorado,Crisman,351,16,15,14,59,0,104
Colorado,Crook,143,1,5,8,8,0,22
Colorado,Crowley,284,7,1,18,3,30,59
Colorado,Dacono,4461,89,73,267,181,274,884
Colorado,Dakota Ridge,33580,576,503,1713,1884,2221,6897
Colorado,De Beque,369,11,9,25,7,19,71
Colorado,Deer Trail,573,25,0,15,50,20,110
Colorado,Del Norte,1984,77,12,95,94,98,376
Colorado,Delta,8779,218,134,447,458,278,1535
Colorado,Denver,649654,11405,8763,30931,26304,23397,100800
Colorado,Derby,8565,114,230,783,716,495,2338
Colorado,Dillon,865,27,0,14,18,40,99
Colorado,Dinosaur,313,4,3,16,11,1,35
Colorado,Divide,124,19,20,0,0,0,39
Colorado,Dolores,1048,34,28,62,40,49,213
Colorado,Dotsero,863,0,9,53,63,90,215
Colorado,Dove Creek,707,20,5,45,49,34,153
Colorado,Dove Valley,5600,122,63,432,406,339,1362
Colorado,Guffey,81,0,0,0,0,0,0
Colorado,Crawford,287,4,4,9,15,20,52
Colorado,Grover,83,1,6,3,3,1,14
Colorado,Green Mountain Falls,671,0,0,14,29,42,85
Colorado,Fraser,1102,20,16,51,35,32,154
Colorado,Franktown,203,0,0,0,0,0,0
Colorado,Foxfield,683,10,15,23,37,35,120
Colorado,Fowler,1144,22,16,53,105,31,227
Colorado,Fountain,27062,561,643,1818,2091,1864,6977
Colorado,Fort Morgan,11377,267,203,822,689,762,2743
Colorado,Fort Lupton,7669,103,217,519,516,495,1850
Colorado,Fort Garland,470,15,0,28,14,42,99
Colorado,Fort Collins,153292,2319,1555,6680,6587,6031,23172
Colorado,Frederick,10186,344,164,775,735,474,2492
Colorado,Fort Carson,14742,248,358,1001,636,438,2681
Colorado,Florissant,77,0,0,0,9,0,9
Colorado,Florence,3884,42,24,204,341,249,860
Colorado,Fleming,608,24,23,22,54,22,145
Colorado,Flagler,596,15,12,29,37,59,152
Colorado,Firestone,11255,146,278,850,697,394,2365
Colorado,Federal Heights,12037,34,139,784,844,717,2518
Colorado,Fairplay,817,6,12,10,55,90,173
Colorado,Fairmount,8222,140,83,408,504,425,1560
Colorado,Evergreen,8688,94,149,434,448,586,1711
Colorado,Floyd Hill,1153,12,0,22,42,12,88
Colorado,Frisco,2855,0,35,74,135,105,349
Colorado,Fruita,12750,223,132,427,932,1108,2822
Colorado,Fruitvale,7458,77,62,422,347,413,1321
Colorado,Greeley,97074,1292,1348,6030,5506,5047,19223
Colorado,Grand View Estates,689,56,0,56,13,63,188
Colorado,Grand Lake,329,0,0,4,6,0,10
Colorado,Grand Junction,59945,978,790,3207,2982,2345,10302
Colorado,Granby,1864,6,15,106,81,43,251
Colorado,Granada,507,17,0,35,16,42,110
Colorado,Gold Hill,189,0,0,0,0,0,0
Colorado,Goldfield,41,0,0,7,4,3,14
Colorado,Golden,19780,371,125,851,821,788,2956
Colorado,Glenwood Springs,9756,226,199,290,298,503,1516
Colorado,Gleneagle,6470,125,109,507,246,347,1334
Colorado,Glendale,112,0,0,0,0,32,32
Colorado,Glendale,4744,43,43,11,30,82,209
Colorado,Gilcrest,917,32,8,67,31,88,226
Colorado,Gerrard,122,0,0,0,0,0,0
Colorado,Georgetown,1031,15,12,43,30,46,146
Colorado,Genoa,85,0,0,1,6,3,10
Colorado,Genesee,3703,43,24,238,170,138,613
Colorado,Garfield,8,0,0,0,0,0,0
Colorado,Garden City,277,0,6,10,18,0,34
Colorado,Fulford,0,0,0,0,0,0,0
Colorado,Greenwood Village,14920,315,92,624,1092,1312,3435
Colorado,Catherine,288,30,16,20,0,19,85
Colorado,Craig,8983,219,111,495,635,460,1920
Colorado,Cortez,8571,92,181,397,545,566,1781
Colorado,Larkspur,248,1,0,5,6,6,18
Colorado,Laporte,2497,6,29,66,55,78,234
Colorado,Lamar,7744,156,79,378,507,512,1632
Colorado,Lakewood,147836,2016,1367,6044,6166,7046,22639
Colorado,Lakeside,5,0,0,0,0,0,0
Colorado,Lake City,354,5,5,6,7,8,31
Colorado,La Junta Gardens,25,0,0,0,0,0,0
Colorado,Erie,19948,471,353,1483,1245,1072,4624
Colorado,La Jara,713,3,16,42,23,36,120
Colorado,La Salle,2571,61,37,223,202,128,651
Colorado,Laird,30,0,0,0,0,0,0
Colorado,Kremmling,2090,18,28,63,176,188,473
Colorado,Kittredge,1324,10,10,96,69,94,279
Colorado,Kit Carson,263,9,0,16,35,17,77
Colorado,Kirk,102,0,0,0,3,0,3
Colorado,Kiowa,859,7,20,45,43,55,170
Colorado,Kim,61,0,0,2,2,10,14
Colorado,Keystone,1067,0,0,0,0,24,24
Colorado,Kersey,1585,10,23,100,124,115,372
Colorado,Ken Caryl,33021,567,254,1587,1789,2176,6373
Colorado,Lafayette,26430,553,255,1357,1291,1422,4878
Colorado,Las Animas,1813,14,30,74,165,94,377
Colorado,La Veta,729,0,5,33,13,4,55
Colorado,Lazy Acres,977,40,10,47,42,79,218
Colorado,Cedaredge,2272,24,7,157,106,163,457
Colorado,Centennial,106604,1899,1456,5111,6314,7056,21836
Colorado,Center,2105,63,41,92,115,216,527
Colorado,Central City,771,36,0,30,35,18,119
Colorado,Chacra,544,13,19,48,25,73,178
Colorado,Cheraw,175,4,4,12,6,5,31
Colorado,Cherry Creek,12087,260,244,791,943,1029,3267
Colorado,Louisville,19548,388,263,1079,1083,1136,3949
Colorado,Longmont,89814,1681,1450,5607,5079,5467,19284
Colorado,Lone Tree,12462,233,65,620,831,876,2625
Colorado,Loma,1254,26,0,14,67,104,211
Colorado,Log Lane Village,1003,8,27,67,95,44,241
Colorado,Loghill Village,452,0,0,12,7,8,27
Colorado,Lochbuie,5222,166,54,433,346,321,1320
Colorado,Littleton,44553,748,469,2095,2021,2068,7401
Colorado,Lincoln Park,3222,28,20,99,89,155,391
Colorado,Limon,1425,31,27,93,66,132,349
Colorado,Leyner,30,0,0,0,0,0,0
Colorado,Lewis,391,0,0,72,40,0,112
Colorado,Leadville North,1815,0,15,151,68,63,297
Colorado,Leadville,2595,23,44,131,18,92,308
Colorado,Keenesburg,1319,26,26,40,100,89,281
Colorado,Cotopaxi,7,0,0,0,0,0,0
Colorado,Julesburg,1218,26,16,55,62,74,233
Colorado,Johnson Village,224,0,0,25,0,5,30
Colorado,Hayden,1819,10,9,60,117,176,372
Colorado,Haxtun,1005,28,10,79,67,59,243
Colorado,Cherry Hills Village,6329,140,71,440,695,520,1866
Colorado,Cimarron Hills,16746,162,212,1370,1040,1058,3842
Colorado,City of Creede,189,0,0,0,1,5,6
Colorado,Clifton,20079,412,316,1345,1137,869,4079
Colorado,Coal Creek,1894,0,12,45,16,51,124
Colorado,Coal Creek,335,3,5,13,2,13,36
Colorado,Coaldale,364,0,27,27,45,21,120
Colorado,Heeney,251,0,0,0,0,0,0
Colorado,Cokedale,140,0,0,7,7,0,14
Colorado,Colona,0,0,0,0,0,0,0
Colorado,Colorado City,2249,27,47,97,139,88,398
Colorado,Colorado Springs,442040,7079,6312,22888,23021,23311,82611
Colorado,Columbine,24709,458,367,1300,1360,1344,4829
Colorado,Columbine Valley,1164,27,8,38,58,74,205
Colorado,Comanche Creek,375,0,9,18,8,16,51
Colorado,Commerce City,50346,970,832,3591,3888,3097,12378
Colorado,Conejos,76,0,0,10,10,0,20
Colorado,Copper Mountain,268,0,0,0,0,0,0
Colorado,Collbran,646,10,2,18,14,171,215
Colorado,Hidden Lake,0,0,0,0,0,0,0
Colorado,Highlands Ranch,104432,2795,1834,7963,7419,7447,27458
Colorado,Hillrose,280,1,3,7,15,16,42
Colorado,Joes,45,4,0,4,0,3,11
Colorado,Jansen,131,0,0,0,0,0,0
Colorado,Jamestown,256,3,3,7,11,3,27
Colorado,Jackson Lake,178,3,0,7,10,10,30
Colorado,Inverness,1109,0,0,0,33,0,33
Colorado,Indian Hills,1380,38,47,94,56,70,305
Colorado,Iliff,212,10,0,5,21,10,46
Colorado,Ignacio,887,18,7,63,32,48,168
Colorado,Idledale,282,0,0,23,30,0,53
Colorado,Idalia,45,0,0,3,4,4,11
Colorado,Idaho Springs,1996,51,0,74,102,84,311
Colorado,Hugo,670,2,12,30,38,28,110
Colorado,Hudson,2138,32,9,86,100,135,362
Colorado,Howard,794,9,0,9,9,10,37
Colorado,Hot Sulphur Springs,772,7,7,87,63,15,179
Colorado,Hotchkiss,932,6,17,69,54,46,192
Colorado,Hooper,55,0,0,0,0,0,0
Colorado,Holyoke,2185,47,2,153,169,106,477
Colorado,Holly Hills,2560,89,15,107,98,120,429
Colorado,Holly,882,23,0,60,38,35,156
Colorado,Hoehne,128,0,1,0,0,0,1
Colorado,Johnstown,12818,214,122,923,1347,689,3295
Colorado,Cheyenne Wells,909,11,13,48,21,53,146
Colorado,Evans,20308,381,499,1624,1245,1190,4939
Colorado,Williamsburg,680,8,7,34,61,91,201
Colorado,Seven Hills,83,0,0,0,0,0,0
Colorado,Windsor,20455,468,262,1227,1367,1433,4757
Colorado,Winter Park,578,0,0,47,15,0,62
Colorado,Wolcott,0,0,0,0,0,0,0
Colorado,Woodland Park,7155,158,84,410,263,622,1537
Colorado,Woodmoor,8427,73,193,542,556,817,2181
Colorado,Woody Creek,276,0,0,13,13,51,77
Colorado,Wray,2714,97,30,257,169,240,793
Colorado,Yampa,417,4,6,34,21,24,89
Colorado,Yuma,3601,81,0,108,0,84,273
Colorado,Wiley,350,4,9,15,21,27,76
Colorado,Stonegate,9264,165,182,760,979,621,2707
Colorado,Steamboat Springs,12148,104,107,589,398,458,1656
Colorado,Starkville,31,0,0,0,2,0,2
Colorado,Springfield,1392,17,17,68,54,83,239
Colorado,South Fork,589,7,14,40,37,20,118
Colorado,Southern Ute,156,0,0,2,3,16,21
Colorado,Snyder,145,3,5,0,0,7,15
Colorado,Snowmass Village,2865,24,0,80,115,255,474
Colorado,Smeltertown,174,0,0,0,0,44,44
Colorado,Simla,555,19,9,34,26,33,121
Colorado,Silverton,552,9,0,10,11,4,34
Colorado,Sterling,14046,190,217,676,417,535,2035
Colorado,Silverthorne,4117,148,43,138,196,336,861
Colorado,Wiggins,1054,11,16,55,35,72,189
Colorado,West Pleasant View,3830,64,23,136,128,162,513
Colorado,Two Buttes,63,4,0,2,5,0,11
Colorado,Upper Bear Creek,1143,0,0,61,10,73,144
Colorado,Vail,5321,38,109,122,188,101,558
Colorado,Valdez,18,0,0,0,0,4,4
Colorado,Valmont,104,0,0,4,4,0,8
Colorado,Vernon,10,0,0,0,0,0,0
Colorado,Victor,374,0,4,6,8,17,35
Colorado,Vilas,214,0,10,29,37,9,85
Colorado,Vineland,166,0,0,23,7,0,30
Colorado,Vona,45,0,0,1,5,1,7
Colorado,Wheat Ridge,30863,362,322,1146,1322,1351,4503
Colorado,Walden,535,19,0,30,18,6,73
Colorado,Walsh,618,21,0,11,25,19,76
Colorado,Ward,115,0,6,11,2,5,24
Colorado,Watkins,492,0,0,8,17,61,86
Colorado,Welby,16408,289,283,754,1080,963,3369
Colorado,Weldona,104,0,2,5,9,0,16
Colorado,Wellington,6934,228,75,355,625,295,1578
Colorado,Westcliffe,440,7,7,20,15,54,103
Colorado,Westcreek,117,4,0,0,4,0,8
Colorado,Westminster,110598,2035,1509,5525,5573,5676,20318
Colorado,Weston,51,0,0,0,5,0,5
Colorado,Walsenburg,2930,35,11,273,144,105,568
Colorado,Silver Plume,239,3,1,4,7,13,28
Colorado,Silver Cliff,789,37,7,29,64,34,171
Colorado,Silt,2976,44,39,129,193,301,706
Colorado,Rock Creek Park,20,0,0,0,0,0,0
Colorado,Rockvale,475,9,0,17,58,20,104
Colorado,Rocky Ford,3877,133,0,221,159,219,732
Colorado,Rollinsville,15,0,0,0,0,0,0
Colorado,Romeo,337,2,2,14,23,40,81
Colorado,Roxborough Park,9859,259,301,837,435,477,2309
Colorado,Rye,209,5,0,0,22,8,35
Colorado,Saddle Ridge,64,0,0,8,0,0,8
Colorado,Saguache,536,7,0,27,0,13,47
Colorado,St. Ann Highlands,350,20,18,0,0,0,38
Colorado,Rifle,9451,265,210,771,589,477,2312
Colorado,St. Mary's,291,0,0,36,78,0,114
Colorado,Salt Creek,662,0,12,28,47,20,107
Colorado,San Acacio,14,0,0,0,0,0,0
Colorado,Sanford,918,29,19,54,79,47,228
Colorado,San Luis,642,11,9,44,39,27,130
Colorado,Sawpit,30,0,2,2,2,0,6
Colorado,Security-Widefield,34836,543,548,2246,2345,2185,7867
Colorado,Sedalia,131,0,0,8,0,0,8
Colorado,Sedgwick,155,0,0,2,5,4,11
Colorado,Segundo,153,22,12,0,16,4,54
Colorado,Seibert,182,2,0,2,8,24,36
Colorado,Salida,5373,160,79,194,160,173,766
Colorado,Ridgway,898,15,7,29,75,24,150
Colorado,Rico,199,1,7,5,9,4,26
Colorado,Redvale,171,4,0,0,9,31,44
Colorado,Sherrelwood,19209,275,277,1113,1046,929,3640
Colorado,Sheridan Lake,85,3,4,10,15,7,39
Colorado,Sheridan,5912,79,29,333,349,359,1149
Colorado,Shaw Heights,4760,50,21,270,243,324,908
Colorado,Phippsburg,139,0,4,3,0,0,7
Colorado,Piedra,61,0,0,7,0,0,7
Colorado,Pierce,946,16,6,16,51,48,137
Colorado,Pine Brook Hill,1263,0,12,95,135,64,306
Colorado,Pitkin,104,0,0,17,0,5,22
Colorado,Platteville,2574,39,27,123,242,195,626
Colorado,Poncha Springs,1172,21,2,51,63,41,178
Colorado,Ponderosa Park,3211,17,25,103,164,234,543
Colorado,Portland,168,5,0,4,0,0,9
Colorado,Pritchett,130,0,0,0,3,10,13
Colorado,Pueblo,108073,1844,1557,5363,5888,5784,20436
Colorado,Pueblo West,30440,241,363,1560,2107,2058,6329
Colorado,Ramah,72,0,0,1,2,9,12
Colorado,Rangely,2322,56,60,156,126,105,503
Colorado,Raymer (New Raymer),88,0,0,4,9,9,22
Colorado,Red Cliff,279,2,2,9,7,2,22
Colorado,Red Feather Lakes,181,0,5,0,0,18,23
Colorado,Redlands,10086,152,33,382,726,461,1754
Colorado,Redstone,26,0,0,0,0,0,0
Colorado,Twin Lakes CDP (Lake County),140,0,0,0,0,15,15
Colorado,Twin Lakes CDP (Adams County),6698,142,58,429,283,399,1311
Colorado,Severance,3448,109,84,159,224,224,800
Colorado,Trail Side,82,0,0,14,0,0,14
Colorado,Stonewall Gap,41,0,0,0,0,0,0
Colorado,Strasburg,3027,119,117,167,206,257,866
Colorado,Stratmoor,6035,146,126,392,320,186,1170
Colorado,Stratton,627,15,13,17,29,42,116
Colorado,Sugar City,434,0,3,3,19,28,53
Colorado,Sugarloaf,305,0,0,0,0,31,31
Colorado,Sunshine,151,0,0,0,0,0,0
Colorado,Superior,12815,296,198,908,888,821,3111
Colorado,Swink,659,6,10,72,36,41,165
Colorado,Trinidad,8470,175,86,412,525,311,1509
Colorado,Tall Timber,217,11,0,0,0,11,22
Colorado,Telluride,2019,29,9,109,86,46,279
Colorado,The Pinery,11384,201,141,730,917,820,2809
Colorado,Thornton,127688,2226,2148,8384,8331,7882,28971
Colorado,Timnath,1204,18,33,95,94,81,321
Colorado,Todd Creek,3879,98,79,165,170,112,624
Colorado,Towaoc,787,16,16,29,48,52,161
Colorado,Towner,43,0,0,3,6,8,17
Colorado,Tabernash,355,0,0,0,41,30,71
Connecticut,South Woodstock,1155,0,0,28,91,89,208
Connecticut,Southwood Acres,7731,50,81,377,549,338,1395
Connecticut,South Windham,1458,12,3,79,55,65,214
Connecticut,Southport,1667,0,54,18,107,83,262
Connecticut,South Coventry,1117,0,16,65,32,33,146
Connecticut,Somers,1927,39,7,81,147,133,407
Connecticut,Sharon,666,24,0,18,56,39,137
Connecticut,Sherwood Manor,5457,63,42,229,220,308,862
Connecticut,Shelton,40783,509,354,1750,1794,2439,6846
Connecticut,Stafford Springs,5061,39,172,232,192,340,975
Connecticut,Saybrook Manor,1103,0,31,23,15,85,154
Connecticut,Salmon Brook,2676,20,33,155,119,67,394
Connecticut,Rockville,7459,368,132,289,299,179,1267
Connecticut,Simsbury Center,5926,152,52,387,258,401,1250
Connecticut,Stamford,126592,2391,1707,5566,6510,6456,22630
Connecticut,Tariffville,1272,15,23,83,96,76,293
Connecticut,Storrs,15914,6,25,33,84,44,192
Connecticut,Bridgeport,147340,3025,2352,8620,7430,8184,29611
Connecticut,Bristol,60554,824,507,2969,3218,3355,10873
Connecticut,Broad Brook,4504,124,23,459,287,152,1045
Connecticut,Waterbury,109551,2180,1410,6161,6258,6709,22718
Connecticut,Wallingford Center,17710,278,142,684,599,1139,2842
Connecticut,Trumbull,36571,596,445,2181,2451,2660,8333
Connecticut,Stonington borough,971,3,2,22,32,19,78
Connecticut,Torrington,35493,533,373,1285,1406,1568,5165
Connecticut,Thompsonville,8878,63,106,232,549,579,1529
Connecticut,Thomaston,1909,25,30,97,62,63,277
Connecticut,Terryville,5180,73,39,188,246,276,822
Connecticut,Terramuggus,862,17,0,29,0,20,66
Connecticut,Suffield Depot,1468,0,17,52,68,85,222
Connecticut,Stratford,52316,861,563,2304,2403,2754,8885
Connecticut,Riverside,8592,285,188,565,713,650,2401
Connecticut,Ridgefield,7725,129,110,795,552,546,2132
Connecticut,Orange,13946,321,134,648,788,793,2684
Connecticut,Putnam,7147,224,15,453,276,237,1205
Connecticut,Noank,2133,9,47,57,149,143,405
Connecticut,Niantic,3005,24,36,97,96,91,344
Connecticut,Glastonbury Center,7409,173,62,429,390,344,1398
Connecticut,Glenville,2478,100,18,90,56,56,320
Connecticut,Greenwich,13499,521,141,579,455,688,2384
Connecticut,Groton,9305,107,158,429,213,418,1325
Connecticut,Norfolk,591,6,0,41,46,25,118
Connecticut,Groton Long Point borough,510,5,1,17,13,13,49
Connecticut,Hartford,124795,2429,2014,7295,6609,8039,26386
Connecticut,Lakeville,858,8,8,0,0,39,55
Connecticut,Lake Pocotopaug,3313,29,0,163,205,188,585
Connecticut,Kensington,8824,229,0,426,567,556,1778
Connecticut,Jewett City borough,3472,20,35,160,163,148,526
Connecticut,Higganum,1683,38,62,91,60,96,347
Connecticut,Guilford Center,2476,17,10,79,113,90,309
Connecticut,North Granby,1781,52,0,131,123,135,441
Connecticut,North Grosvenor Dale,1707,33,55,84,67,38,277
Connecticut,North Haven,23937,493,179,1071,1087,1052,3882
Connecticut,Portland,5619,58,39,180,317,421,1015
Connecticut,Poquonock Bridge,1828,20,19,48,42,156,285
Connecticut,Plantsville,1672,17,20,10,28,52,127
Connecticut,Plainfield Village,2244,17,35,103,78,176,409
Connecticut,Pemberwick,3935,65,27,211,82,207,592
Connecticut,Pawcatuck,5242,79,67,286,283,458,1173
Connecticut,Oxoboxo River,3081,42,67,156,79,190,534
Connecticut,Branford Center,6015,68,32,157,324,266,847
Connecticut,Old Saybrook Center,2139,15,13,181,81,147,437
Connecticut,Old Mystic,3625,119,29,134,100,177,559
Connecticut,Old Greenwich,6764,404,246,624,506,350,2130
Connecticut,Georgetown,1845,49,18,171,76,132,446
Connecticut,Norwich,40254,587,472,2246,1808,2382,7495
Connecticut,Norwalk,87701,1676,825,3397,3815,4378,14091
Connecticut,Northwest Harwinton,3167,21,30,168,181,174,574
Connecticut,Quinebaug,1102,0,17,57,20,54,148
Connecticut,Blue Hills,2872,46,8,155,68,110,387
Connecticut,Westbrook Center,2125,0,0,46,54,157,257
Connecticut,Bethel,9731,81,126,616,628,554,2005
Connecticut,Deep River Center,2417,41,24,159,91,190,505
Connecticut,Darien,21392,789,284,1655,1867,1888,6483
Connecticut,Danielson borough,4026,70,74,121,201,134,600
Connecticut,Litchfield borough,1474,13,13,61,66,94,247
Connecticut,Long Hill,4269,78,14,64,103,177,436
Connecticut,Madison Center,2421,61,10,141,168,189,569
Connecticut,Derby,12796,193,102,765,517,749,2326
Connecticut,Manchester,30883,737,280,1558,1567,1462,5604
Connecticut,Mashantucket,167,3,5,8,9,8,33
Connecticut,Meriden,60439,1180,479,2383,2410,2783,9235
Connecticut,Middletown,47218,823,375,1676,1745,2341,6960
Connecticut,Milford city (balance),51643,629,624,2116,2562,2448,8379
Connecticut,Moodus,1212,0,0,40,82,79,201
Connecticut,Moosup,3192,0,41,217,98,137,493
Connecticut,Mansfield Center,1127,0,28,109,85,56,278
Connecticut,Mystic,3981,11,11,105,140,36,303
Connecticut,Durham,2932,59,13,72,269,203,616
Connecticut,East Hampton,2643,41,27,129,95,149,441
Connecticut,Woodmont borough,1563,12,0,33,55,113,213
Connecticut,Woodbury Center,1438,0,33,22,72,31,158
Connecticut,Winsted,7753,46,124,254,190,418,1032
Connecticut,Windsor Locks,12564,148,148,392,526,599,1813
Connecticut,Wilton Center,712,0,0,44,22,50,116
Connecticut,Falls Village,403,0,0,14,11,7,32
Connecticut,East Brooklyn,1672,0,44,155,103,15,317
Connecticut,Fenwick borough,81,0,0,0,0,0,0
Connecticut,Willimantic,17411,224,149,612,607,789,2381
Connecticut,Wethersfield,26510,542,257,1113,1237,1236,4385
Connecticut,West Simsbury,2466,29,22,170,109,159,489
Connecticut,Essex Village,2196,0,0,25,103,97,225
Connecticut,East Haven,29104,332,204,1479,1093,1414,4522
Connecticut,East Hartford,51137,864,829,2365,2500,2664,9222
Connecticut,Gales Ferry,824,20,14,64,27,59,184
Connecticut,Bethlehem Village,1850,10,17,62,96,126,311
Connecticut,Naugatuck borough,31722,490,370,1946,1135,1482,5423
Connecticut,New Hartford Center,1557,56,0,92,54,78,280
Connecticut,Canaan,1098,48,36,80,41,46,251
Connecticut,Byram,4836,142,50,291,213,276,972
Connecticut,Brooklyn,908,0,0,0,7,61,68
Connecticut,Heritage Village,3934,43,9,31,54,50,187
Connecticut,Westport,27343,837,501,1903,1825,2205,7271
Connecticut,West Haven,55189,760,582,2781,2810,2374,9307
Connecticut,Cannondale,117,0,7,7,8,7,29
Connecticut,West Hartford,63288,1153,715,3217,3544,3703,12332
Connecticut,Wauregan,1428,57,28,169,83,146,483
Connecticut,Watertown,2996,83,8,137,136,123,487
Connecticut,Waterford,2948,23,44,204,93,118,482
Connecticut,Ansonia,19035,251,270,891,1229,1147,3788
Connecticut,Baltic,1026,11,0,59,71,42,183
Connecticut,Bantam borough,842,5,9,19,17,37,87
Connecticut,Weatogue,3020,52,27,143,149,263,634
Connecticut,New Britain,72988,787,870,4060,4126,3854,13697
Connecticut,Canton Valley,1659,25,34,46,13,45,163
Connecticut,Chester Center,1847,11,25,73,127,98,334
Connecticut,New Haven,130612,2139,1962,6509,6494,7064,24168
Connecticut,Newington,30638,350,271,1259,1200,1658,4738
Connecticut,New London,27423,518,323,1197,1206,1395,4639
Connecticut,New Milford,6915,55,40,384,305,372,1156
Connecticut,New Preston,915,3,0,22,44,57,126
Connecticut,Newtown borough,2009,23,22,78,178,208,509
Connecticut,Cheshire Village,5730,64,58,292,318,363,1095
Connecticut,Danbury,83476,1098,803,3681,3377,4671,13630
Connecticut,Coventry Lake,3393,23,18,137,169,164,511
Connecticut,Cos Cob,6433,194,97,408,358,404,1461
Connecticut,Conning Towers Nautilus Park,9814,199,257,487,287,198,1428
Connecticut,Collinsville,3518,33,47,118,221,228,647
Connecticut,Colchester,4309,55,0,210,233,327,825
Connecticut,Clinton,3498,14,54,186,141,154,549
Connecticut,Crystal Lake,2220,37,33,104,122,188,484
Connecticut,Oakville,9246,75,118,454,563,654,1864
Connecticut,Hazardville,4868,28,62,153,221,228,692
Delaware,Wilmington Manor,7912,160,80,302,487,385,1414
Delaware,Viola,164,7,5,3,3,2,20
Delaware,Townsend,2617,81,45,292,255,224,897
Delaware,South Bethany,423,0,0,1,0,11,12
Delaware,Smyrna,10904,148,273,876,694,795,2786
Delaware,Slaughter Beach,211,0,0,3,2,4,9
Delaware,Selbyville,2675,35,104,166,106,128,539
Delaware,Seaford,7290,175,115,447,384,320,1441
Delaware,St. Georges,1141,32,25,80,87,71,295
Delaware,Rodney Village,1586,21,9,25,76,74,205
Delaware,Riverview,2863,36,139,138,117,156,586
Delaware,Felton,1658,28,37,97,85,87,334
Delaware,Fenwick Island,396,2,0,5,2,4,13
Delaware,Frankford,988,19,10,59,53,51,192
Delaware,Lewes,2887,3,45,90,42,43,223
Delaware,Little Creek,190,2,1,2,5,5,15
Delaware,Long Neck,2359,0,17,130,51,41,239
Delaware,Magnolia,192,0,0,16,1,2,19
Delaware,Middletown,19744,396,505,1397,1141,1593,5032
Delaware,Milford,9993,152,83,475,574,401,1685
Delaware,Millsboro,4050,23,46,250,308,263,890
Delaware,Millville,1510,8,31,131,161,97,428
Delaware,Milton,2717,37,10,69,123,84,323
Delaware,Newark,32740,323,112,773,844,835,2887
Delaware,Wilmington,71549,1352,886,3677,3550,3401,12866
Delaware,New Castle,5371,45,5,140,212,298,700
Delaware,Farmington,91,0,0,8,8,4,20
Delaware,Woodside East,2027,0,0,74,150,187,411
Delaware,Dover Base Housing,3417,123,104,166,159,128,680
Delaware,Dover,37144,724,435,1562,1605,1666,5992
Delaware,Dewey Beach,250,0,2,2,8,3,15
Delaware,Delmar,1784,20,30,62,87,108,307
Delaware,Delaware City,1933,12,24,100,80,121,337
Delaware,Dagsboro,980,17,16,39,87,58,217
Delaware,Clayton,3034,91,71,225,205,119,711
Delaware,Claymont,9060,223,167,477,498,373,1738
Delaware,Cheswold,1219,16,9,101,52,65,243
Delaware,Camden,3501,96,37,154,270,212,769
Delaware,Brookside,13743,254,162,558,571,681,2226
Delaware,Bridgeville,2364,34,39,170,79,68,390
Delaware,Bowers,320,5,1,8,12,20,46
Delaware,Blades,1303,16,10,88,122,43,279
Delaware,Bethel,171,2,1,3,8,6,20
Delaware,Bethany Beach,908,0,3,26,7,7,43
Delaware,Bellefonte,1318,41,14,41,51,50,197
Delaware,Bear,19886,271,151,1157,1422,1279,4280
Delaware,Ardentown village,297,4,0,13,4,10,31
Delaware,Ardencroft village,262,6,0,5,13,14,38
Delaware,Arden village,538,0,0,10,25,47,82
Delaware,Elsmere,6154,107,86,346,304,321,1164
Delaware,Wyoming,1673,24,33,38,113,116,324
Delaware,Woodside,150,0,2,3,6,19,30
Delaware,Edgemoor,6257,60,84,249,327,417,1137
Delaware,Newport,1165,91,47,33,19,48,238
Delaware,Georgetown,6775,33,143,295,358,299,1128
Delaware,North Star,7596,115,76,309,468,587,1555
Delaware,Ocean View,1880,0,0,34,22,23,79
Delaware,Odessa,598,8,16,30,11,18,83
Delaware,Pike Creek,8463,184,47,538,545,394,1708
Delaware,Pike Creek Valley,10672,142,130,520,409,342,1543
Delaware,Rehoboth Beach,1098,5,0,9,3,0,17
Delaware,Rising Sun-Lebanon,3970,62,108,187,132,159,648
Delaware,Frederica,1053,20,8,58,69,33,188
Delaware,Leipsic,118,2,5,1,3,6,17
Delaware,Laurel,3916,74,83,321,251,195,924
Delaware,Ellendale,363,7,8,37,16,12,80
Delaware,Kent Acres,2283,70,63,139,231,72,575
Delaware,Houston,390,8,4,5,15,23,55
Delaware,Glasgow,14640,150,182,891,700,748,2671
Delaware,Greenville,2378,35,12,104,170,71,392
Delaware,Greenwood,1289,38,17,42,44,33,174
Delaware,Harrington,3665,119,61,206,325,277,988
Delaware,Hartly,54,0,0,1,0,0,1
Delaware,Henlopen Acres,157,1,0,3,7,7,18
Delaware,Highland Acres,3966,54,57,214,202,303,830
Delaware,Kenton,299,6,10,5,22,26,69
Delaware,Hockessin,13230,203,231,636,689,849,2608
Florida,Palm Bay,105212,1353,1363,5496,5273,5774,19259
Florida,Palm Beach,8418,62,53,111,154,138,518
Florida,Palm Beach Gardens,50977,833,547,1856,1480,1780,6496
Florida,Palmetto Bay village,24443,631,369,1153,1739,2148,6040
Florida,Palm City,23413,311,133,770,1363,1461,4038
Florida,Palm Coast,79297,852,958,3952,3689,3680,13131
Florida,Palmetto,12973,143,123,602,664,666,2198
Florida,Palmetto Estates,16175,335,310,789,792,1041,3267
Florida,Palm Beach Shores,1077,0,0,7,13,20,40
Florida,Palatka,10414,73,232,800,545,574,2224
Florida,Page Park,549,12,26,7,43,17,105
Florida,Pahokee,6003,129,86,304,393,498,1410
Florida,Olga,2104,19,23,97,54,99,292
Florida,Olympia Heights,14645,116,101,340,498,523,1578
Florida,Ona,94,0,17,20,0,0,37
Florida,Opa-locka,16139,362,296,1355,985,854,3852
Florida,Orange City,11023,86,124,371,502,398,1481
Florida,Orange Park,8545,168,127,329,410,385,1419
Florida,Orangetree,5248,20,99,335,516,489,1459
Florida,Paisley,1159,16,0,32,115,48,211
Florida,Orchid,374,0,0,5,5,0,10
Florida,Orlando,256738,4792,2759,11726,12140,11180,42597
Florida,Orlovista,5978,50,72,306,612,315,1355
Florida,Ormond Beach,39938,451,286,1601,1623,1906,5867
Florida,Osprey,6664,18,49,99,355,266,787
Florida,Otter Creek,134,0,0,4,8,13,25
Florida,Oviedo,36617,688,624,2236,2590,2581,8719
Florida,Pace,21997,314,200,1367,1487,1527,4895
Florida,Oriole Beach,1608,41,0,159,61,115,376
Florida,Ormond-by-the-Sea,7678,46,31,181,178,207,643
Florida,Dania Beach,30878,645,474,1491,1083,1192,4885
Florida,Palm Harbor,59769,393,577,1757,2365,2856,7948
Florida,Jasmine Estates,19604,198,193,850,824,1004,3069
Florida,Jasper,4243,43,28,97,75,83,326
Florida,Jay,420,14,3,16,11,25,69
Florida,Jennings,668,14,15,69,34,44,176
Florida,Jensen Beach,12266,95,168,203,533,496,1495
Florida,June Park,3981,7,25,38,139,247,456
Florida,Juno Beach,3325,26,0,21,57,41,145
Florida,Juno Ridge,566,12,12,17,4,6,51
Florida,Wabasso Beach,1549,0,0,15,45,16,76
Florida,Wabasso,575,0,0,45,34,15,94
Florida,Jan Phyl Village,4690,64,78,370,322,272,1106
Florida,Virginia Gardens village,2957,51,27,102,144,219,543
Florida,Villas,10349,101,46,176,275,509,1107
Florida,Villano Beach,3051,0,74,97,83,168,422
Florida,Viera West,8365,212,74,346,430,461,1523
Florida,Viera East,11264,105,20,384,619,707,1835
Florida,Verona Walk,2645,21,0,35,36,49,141
Florida,Vero Beach South,23973,457,175,988,944,1054,3618
Florida,Vero Beach,15788,77,165,487,429,601,1759
Florida,Vernon,1144,5,45,129,82,77,338
Florida,Venice Gardens,7659,106,51,177,217,271,822
Florida,Venice,21402,77,87,228,227,350,969
Florida,Vineyards,3983,74,7,81,74,46,282
Florida,Oldsmar,13860,222,187,790,694,556,2449
Florida,Jacob City,383,0,0,26,28,30,84
Florida,Jacksonville,846951,14584,11793,46336,40200,41911,154824
Florida,Okeechobee,5566,80,66,286,419,268,1119
Florida,Okahumpka,48,0,0,0,0,0,0
Florida,Highland City,10120,153,256,499,551,610,2069
Florida,Gulf Gate Estates,10358,158,130,358,315,251,1212
Florida,Gulfport,12167,108,77,256,273,384,1098
Florida,Gulf Stream,677,2,0,32,40,30,104
Florida,Gun Club Estates,1174,13,0,0,167,107,287
Florida,Haines City,21624,314,717,1825,1111,1031,4998
Florida,Hallandale Beach,38725,707,265,1540,1108,1390,5010
Florida,Hampton,412,0,8,24,19,17,68
Florida,Jacksonville Beach,22149,281,245,702,1091,927,3246
Florida,Harbor Bluffs,2786,100,50,132,42,133,457
Florida,Harlem,2347,82,43,153,261,91,630
Florida,Harlem Heights,1423,0,0,51,104,108,263
Florida,Inverness,7184,57,55,345,344,405,1206
Florida,Inverness Highlands North,2944,66,15,266,218,112,677
Florida,Inverness Highlands South,6375,77,67,204,253,386,987
Florida,Inwood,6739,150,145,548,429,272,1544
Florida,Iona,13830,66,108,295,230,165,864
Florida,Island Walk,3041,0,0,0,20,210,230
Florida,Istachatta,215,0,0,0,37,27,64
Florida,Ives Estates,20510,456,382,839,666,1242,3585
Florida,Harbour Heights,3400,38,31,116,151,190,526
Florida,Palmona Park,1245,14,21,98,61,28,222
Florida,Perry,7058,166,56,278,569,515,1584
Florida,Palm Shores,1123,5,5,66,94,51,221
Florida,Hillsboro Beach,1568,49,10,0,31,0,90
Florida,Hill 'n Dale,1906,127,92,116,98,76,509
Florida,Hilliard,3121,21,25,270,193,234,743
Florida,Hillcrest Heights,280,6,3,6,8,32,55
Florida,High Springs,5591,87,61,473,432,252,1305
Florida,High Point,3409,19,0,46,42,126,233
Florida,Highland Park village,309,8,6,15,9,22,60
Florida,Fountainebleau,55596,716,656,2045,2022,1891,7330
Florida,Four Corners,32727,321,275,1661,2077,1396,5730
Florida,Franklin Park,958,0,47,92,83,86,308
Florida,Freeport,2346,86,52,170,141,75,524
Florida,Frostproof,3062,15,12,113,133,225,498
Florida,Fruit Cove,31146,564,334,1882,2214,2724,7718
Florida,Fruitland Park,4330,233,74,229,324,144,1004
Florida,Fruitville,13725,184,198,791,535,513,2221
Florida,Fuller Heights,9777,76,193,540,560,646,2015
Florida,Fussels Corner,5064,19,79,222,220,174,714
Florida,Gainesville,127559,1522,1002,3495,2838,3339,12196
Florida,Garcon Point,468,0,0,0,0,42,42
Florida,Garden Grove,462,19,0,20,0,0,39
Florida,Gardner,277,0,0,7,0,0,7
Florida,Gateway,8208,150,136,146,342,683,1457
Florida,Geneva,2459,43,16,97,150,98,404
Florida,Gibsonton,18070,403,302,1130,1418,1025,4278
Florida,Gifford,8750,162,74,337,476,479,1528
Florida,Hillsboro Pines,401,12,0,16,13,62,103
Florida,Hobe Sound,13545,145,183,567,431,656,1982
Florida,Holden Heights,4065,56,47,135,165,113,516
Florida,Holiday,20636,115,248,703,670,768,2504
Florida,Indiantown,6065,141,172,415,357,360,1445
Florida,Indian Shores,1469,4,0,6,12,18,40
Florida,Indian Rocks Beach,4172,42,24,56,114,112,348
Florida,Indian River Shores,4026,0,0,17,32,19,68
Florida,Indian River Estates,6439,14,56,113,317,123,623
Florida,Indian Harbour Beach,8315,138,19,279,475,389,1300
Florida,Indian Creek village,60,2,0,1,0,5,8
Florida,Indialantic,2764,26,8,132,162,159,487
Florida,Immokalee,24879,359,388,1818,1644,1742,5951
Florida,Hypoluxo,2668,11,23,9,53,78,174
Florida,Hutchinson Island South,5026,0,0,0,13,26,39
Florida,Hunters Creek,22327,296,358,1506,1284,1219,4663
Florida,Gladeview,12525,308,275,847,1089,881,3400
Florida,Hudson,12033,62,89,480,490,211,1332
Florida,Hosford,740,21,12,80,35,4,152
Florida,Horseshoe Beach,123,0,0,3,2,0,5
Florida,Horizon West,19706,436,224,1786,1417,714,4577
Florida,Homosassa Springs,13012,125,77,469,498,713,1882
Florida,Homosassa,1673,14,0,23,11,12,60
Florida,Homestead Base,1141,65,27,91,104,98,385
Florida,Homestead,64676,1582,1257,5437,4061,3085,15422
Florida,Homeland,212,0,0,33,11,25,69
Florida,Holmes Beach,4045,11,15,53,12,59,150
Florida,Hollywood,146791,2284,1630,7181,6287,6820,24202
Florida,Holly Hill,11726,63,95,554,663,388,1763
Florida,Holley,1531,24,33,95,67,41,260
Florida,Howey-in-the-Hills,1234,12,3,57,59,68,199
Florida,Palm River-Clair Mel,23017,172,250,1314,1415,1230,4381
Florida,Glencoe,2843,0,81,144,109,178,512
Florida,Glen St. Mary,567,20,16,65,34,18,153
Florida,Pine Hills,66906,1356,1095,4839,3761,4431,15482
Florida,Pinecrest village,19174,445,243,1273,1473,1503,4937
Florida,Pine Castle,10796,120,150,556,496,596,1918
Florida,Pine Air,2450,27,61,119,166,51,424
Florida,Pierson,1466,17,23,93,67,114,314
Florida,Vamo,4768,9,39,35,162,174,419
Florida,Pensacola,52752,719,667,2167,2395,2752,8700
Florida,Penney Farms,618,0,0,0,0,0,0
Florida,Pembroke Pines,162243,3033,1587,7393,9641,8615,30269
Florida,Pembroke Park,6244,86,0,509,601,268,1464
Florida,Pelican Bay,5230,0,0,15,37,17,69
Florida,Pebble Creek,8111,131,97,443,611,456,1738
Florida,Pea Ridge,4036,20,87,229,270,339,945
Florida,Paxton,577,0,7,17,33,56,113
Florida,Patrick AFB,1371,42,25,73,77,42,259
Florida,Pasadena Hills,8292,74,83,239,380,309,1085
Florida,Parkland,27114,692,314,2045,2394,2068,7513
Florida,Parker,4462,52,67,150,111,175,555
Florida,Paradise Heights,823,11,0,111,69,80,271
Florida,Panama City Beach,12092,117,78,551,294,456,1496
Florida,Panama City,36917,640,752,2178,1668,1443,6681
Florida,Panacea,937,0,0,0,0,109,109
Florida,Palm Valley,21630,335,147,958,1214,1545,4199
Florida,Palm Springs North,5648,105,57,352,338,309,1161
Florida,Palm Springs village,21832,381,415,1350,966,994,4106
Florida,Pine Island,0,0,0,0,0,0,0
Florida,Pine Island Center,1877,0,17,68,11,95,191
Florida,Pine Lakes,626,0,4,62,36,22,124
Florida,Pineland,293,0,0,15,16,0,31
Florida,Glenvar Heights,17881,212,138,649,776,801,2576
Florida,Golden Beach,709,12,4,30,70,77,193
Florida,Golden Gate,29258,639,715,1932,1861,1414,6561
Florida,Golden Glades,33806,608,282,1789,1565,2092,6336
Florida,Goldenrod,12603,208,139,577,621,548,2093
Florida,Golf village,170,0,0,0,0,1,1
Florida,Gonzalez,14187,85,282,705,824,608,2504
Florida,Goodland,330,0,0,0,0,0,0
Florida,Gotha,1810,68,24,149,166,126,533
Florida,Goulding,4274,0,23,94,174,277,568
Florida,Goulds,10909,191,222,946,959,702,3020
Florida,Graceville,2321,35,26,142,221,116,540
Florida,Glen Ridge,204,0,0,3,14,18,35
Florida,Grand Ridge,825,13,8,35,35,61,152
Florida,Greenacres,38840,560,611,1878,2287,2144,7480
Florida,Greenbriar,2385,14,16,79,40,210,359
Florida,Green Cove Springs,7054,261,110,415,182,352,1320
Florida,Greensboro,664,4,16,57,22,15,114
Florida,Greenville,1080,11,15,30,86,126,268
Florida,Greenwood,882,17,7,81,84,36,225
Florida,Grenelefe,1800,17,13,0,190,67,287
Florida,Gretna,1271,22,12,73,40,92,239
Florida,Grove City,1982,17,14,8,21,94,154
Florida,Groveland,9931,70,137,542,671,574,1994
Florida,Gulf Breeze,6092,49,38,270,475,338,1170
Florida,Pine Level,168,0,0,22,7,0,29
Florida,Grant-Valkaria,3938,39,14,133,188,185,559
Florida,Valrico,36975,589,528,2338,2359,2244,8058
Florida,Hernando,9699,115,248,358,364,458,1543
Florida,Upper Grand Lagoon,14216,65,119,415,788,893,2280
Florida,Marco Island,17148,93,136,292,505,429,1455
Florida,Marathon,8563,64,59,313,335,530,1301
Florida,Mangonia Park,1929,40,82,126,111,101,460
Florida,Mango,12267,229,211,685,850,725,2700
Florida,Manatee Road,2790,8,50,220,147,29,454
Florida,Manasota Key,1131,0,0,0,22,0,22
Florida,Manalapan,265,3,5,7,3,8,26
Florida,Stuart,16037,190,87,724,366,791,2158
Florida,Madeira Beach,4320,20,30,78,99,117,344
Florida,Sumatra,197,0,0,0,59,0,59
Florida,Sun City Center,20554,79,24,207,54,93,457
Florida,Suncoast Estates,4570,0,76,165,219,209,669
Florida,Sunny Isles Beach,21837,172,225,648,461,755,2261
Florida,Margate,55678,472,452,2480,2403,2753,8560
Florida,Sunrise,89942,1717,1202,4441,3837,4022,15219
Florida,Surfside,5987,221,82,340,286,200,1129
Florida,Sweetwater,20739,272,230,818,934,995,3249
Florida,Taft,1852,23,33,81,40,52,229
Florida,Tallahassee,187024,2923,2082,7016,7373,7126,26520
Florida,Tamarac,63227,762,679,1938,2368,3217,8964
Florida,Tamiami,57195,782,578,1585,2284,2737,7966
Florida,Tampa,355603,5741,4913,16825,17254,17162,61895
Florida,Tangelo Park,2346,9,55,90,110,246,510
Florida,Tangerine,2538,28,25,196,115,69,433
Florida,Chattahoochee,3229,40,49,67,131,104,391
Florida,Cheval,10833,224,111,872,628,632,2467
Florida,Chiefland,2234,94,35,125,67,57,378
Florida,Chipley,3564,71,0,276,136,139,622
Florida,Sunset,16069,352,181,802,614,659,2608
Florida,Chokoloskee,418,0,0,0,59,103,162
Florida,Marianna,8860,114,14,387,451,656,1622
Florida,Mary Esther,4109,71,12,109,145,175,512
Florida,Munson,257,0,0,12,0,0,12
Florida,Mulberry,3900,32,45,333,101,89,600
Florida,Mulat,466,0,0,29,46,30,105
Florida,Mount Plymouth,5305,214,132,474,286,126,1232
Florida,Mount Dora,12929,109,103,690,346,347,1595
Florida,Mount Carmel,219,0,0,0,65,6,71
Florida,Morriston,70,0,0,0,0,0,0
Florida,Moore Haven,2818,57,46,176,78,108,465
Florida,Moon Lake,4774,50,93,229,182,321,875
Florida,Montverde,1594,9,7,151,107,124,398
Florida,Montura,3087,12,27,84,286,188,597
Florida,Monticello,2006,24,29,81,126,121,381
Florida,Molino,1256,32,30,9,59,186,316
Florida,Marineland,13,0,0,0,0,0,0
Florida,Miramar Beach,7120,51,0,289,161,208,709
Florida,Minneola,10086,352,72,384,810,636,2254
Florida,Mims,6334,14,71,215,272,238,810
Florida,Milton,9276,75,134,458,397,327,1391
Florida,Midway CDP (Seminole County),1485,56,24,28,62,42,212
Florida,Midway CDP (Santa Rosa County),17434,228,277,1107,926,852,3390
Florida,Midway,3234,84,70,209,210,181,754
Florida,Meadow Woods,28943,671,601,1332,1099,2812,6515
Florida,Meadow Oaks,2343,31,43,57,78,80,289
Florida,Mayo,1145,8,22,53,53,85,221
Florida,Matlacha Isles-Matlacha Shores,354,0,21,0,0,26,47
Florida,Matlacha,851,0,0,0,0,0,0
Florida,Mascotte,5267,64,133,416,339,347,1299
Florida,Masaryktown,888,0,0,38,6,9,53
Florida,Miramar,131384,2510,1955,7774,8167,8802,29208
Florida,Myrtle Grove,16134,256,236,789,519,557,2357
Florida,Christmas,2211,48,0,51,72,69,240
Florida,Chumuckla,767,7,21,31,9,38,106
Florida,Cross City,2198,31,26,139,102,155,453
Florida,Crystal Lake,6452,86,134,555,379,317,1471
Florida,Crystal River,3060,32,20,138,115,190,495
Florida,Crystal Springs,968,0,6,73,54,40,173
Florida,Cudjoe Key,1833,6,31,28,29,18,112
Florida,Cutler Bay,43474,1136,480,2924,2420,2261,9221
Florida,Cypress Gardens,8955,151,26,464,380,446,1467
Florida,Cypress Lake,11964,116,128,307,183,166,900
Florida,Cypress Quarters,1281,21,39,112,8,111,291
Florida,Dade City,6655,150,150,294,150,200,944
Florida,Malone,1926,2,12,41,60,142,257
Florida,Malabar,2822,18,78,81,52,130,359
Florida,Maitland,16630,187,185,682,875,924,2853
Florida,Crooked Lake Park,1564,51,37,116,79,34,317
Florida,Madison,2940,68,18,172,116,168,542
Florida,Deltona,86418,1048,1262,4397,4970,4498,16175
Florida,Delray Beach,63939,750,416,2218,2001,2685,8070
Florida,De Leon Springs,2418,16,8,158,80,158,420
Florida,DeLand Southwest,826,8,0,73,49,51,181
Florida,DeLand,28524,271,329,1424,1567,1383,4974
Florida,DeFuniak Springs,5543,117,59,231,350,435,1192
Florida,Deerfield Beach,78227,725,518,4160,3260,3190,11853
Florida,DeBary,19547,292,243,911,627,793,2866
Florida,Daytona Beach Shores,4294,19,0,42,58,32,151
Florida,Daytona Beach,62726,766,461,1757,2045,2088,7117
Florida,Day,168,0,0,5,0,0,5
Florida,Davie,97372,1348,803,4624,5323,5783,17881
Florida,Davenport,3137,19,30,108,136,317,610
Florida,Desoto Lakes,3692,143,24,162,129,179,637
Florida,Chuluota,2481,111,0,57,176,100,444
Florida,Crestview,22524,492,527,1654,1062,1035,4770
Florida,Crescent Beach,859,0,0,10,0,23,33
Florida,Cinco Bayou,348,0,9,15,7,5,36
Florida,Citrus Hills,8039,27,0,86,138,158,409
Florida,Citrus Park,25570,371,304,1445,1571,1124,4815
Florida,Citrus Springs,8695,87,129,384,324,363,1287
Florida,Clarcona,2785,0,45,66,110,112,333
Florida,Clearwater,110381,1440,1094,4529,4287,4343,15693
Florida,Clermont,30319,588,468,1825,1899,2058,6838
Florida,Cleveland,2881,0,0,59,101,206,366
Florida,Clewiston,7240,85,104,361,623,715,1888
Florida,Cloud Lake,114,1,0,11,6,2,20
Florida,Cobbtown,53,0,0,11,0,0,11
Florida,Cocoa,17339,299,199,1080,1031,840,3449
Florida,Cocoa Beach,11355,47,67,223,377,307,1021
Florida,Crescent City,1814,22,29,56,49,137,293
Florida,Cocoa West,4910,97,97,180,153,246,773
Florida,Coleman,575,0,0,19,35,11,65
Florida,Combee Settlement,5921,97,9,347,468,308,1229
Florida,Connerton,3573,0,21,79,199,31,330
Florida,Conway,15187,301,179,668,815,867,2830
Florida,Cooper City,33382,714,463,2027,1749,2461,7414
Florida,Coral Gables,50059,876,463,1594,1953,2036,6922
Florida,Coral Springs,126673,2657,1463,6456,7521,9468,27565
Florida,Coral Terrace,23994,373,228,753,872,1073,3299
Florida,Cortez,4043,9,28,0,180,110,327
Florida,Cottondale,947,20,19,59,77,73,248
Florida,Country Club,48622,878,580,2566,2038,2726,8788
Florida,Country Walk,16485,231,334,1149,1063,1062,3839
Florida,Crawfordville,3998,24,68,177,206,305,780
Florida,Coconut Creek,56816,1117,843,2359,2673,3095,10087
Florida,Valparaiso,5069,75,0,236,198,81,590
Florida,Naples,20603,145,119,317,439,512,1532
Florida,Naples Park,6691,0,59,316,321,209,905
Florida,The Crossings,23938,646,348,1269,1110,1275,4648
Florida,The Acreage,37853,932,261,1712,2331,2557,7793
Florida,Tequesta village,5819,94,61,249,326,310,1040
Florida,Temple Terrace,25354,387,311,1236,1251,1148,4333
Florida,Taylor Creek,3600,11,0,60,130,94,295
Florida,Tavernier,2435,14,18,80,114,91,317
Florida,Tavares,14608,203,177,494,571,627,2072
Florida,Tarpon Springs,24003,167,184,837,835,903,2926
Florida,Middleburg,13062,310,226,547,467,663,2213
Florida,Micco,8293,9,38,74,115,141,377
Florida,Micanopy,668,0,12,41,38,26,117
Florida,Miami Springs,14397,136,153,713,773,788,2563
Florida,Miami Shores village,10784,409,209,677,376,336,2007
Florida,The Hammocks,55713,865,699,2401,2511,3162,9638
Florida,Miami Lakes,30728,361,204,1656,1615,1651,5487
Florida,Miami Beach,91564,1866,857,3071,2774,2701,11269
Florida,Miami,424632,7458,4531,16101,15567,15415,59072
Florida,Mexico Beach,1355,9,4,11,7,26,57
Florida,Merritt Island,35900,516,390,1765,1542,1531,5744
Florida,Memphis,8152,73,65,496,493,503,1630
Florida,Melbourne Village,769,19,7,31,22,37,116
Florida,Melbourne Beach,3146,33,31,73,167,218,522
Florida,Melbourne,78012,1038,753,2686,2814,3089,10380
Florida,Medulla,8334,144,74,598,507,390,1713
Florida,Lealman,20783,170,230,958,1005,839,3202
Florida,Lecanto,5415,19,35,167,227,275,723
Florida,Lee,561,1,27,49,37,9,123
Florida,Leesburg,21209,209,321,1551,1298,851,4230
Florida,Miami Gardens,112021,2115,1291,5992,6102,6849,22349
Florida,Lehigh Acres,110244,1895,1790,7123,7168,7081,25057
Florida,The Meadows,4022,8,0,98,104,85,295
Florida,Thonotosassa,13292,140,131,737,694,855,2557
Florida,University Park,25870,387,209,792,686,1016,3090
Florida,Hernando Beach,2376,0,16,52,31,54,153
Florida,Dade City North,2467,11,9,201,81,251,553
Florida,Heritage Pines,1987,0,0,0,0,0,0
Florida,Heathrow,5962,59,84,178,375,253,949
Florida,Hawthorne,1670,10,32,119,189,98,448
Florida,Haverhill,1979,47,57,92,112,146,454
Florida,Havana,1895,72,38,42,84,108,344
Florida,Hastings,682,5,0,28,23,8,64
Florida,Harold,908,0,0,14,131,40,185
Florida,University CDP (Orange County),32937,534,141,877,659,746,2957
Florida,University CDP (Hillsborough County),41858,572,611,1691,1588,1522,5984
Florida,Union Park,10498,173,144,597,641,417,1972
Florida,The Villages,66083,0,0,0,46,139,185
Florida,Umatilla,3586,41,68,286,96,133,624
Florida,Trinity,10459,136,151,487,650,575,1999
Florida,Trilby,333,0,0,19,10,0,29
Florida,Trenton,2199,36,33,150,105,148,472
Florida,Treasure Island,6783,142,21,96,171,70,500
Florida,Town 'n' Country,82219,826,1223,4157,3621,4059,13886
Florida,Titusville,44363,596,473,1757,1846,1796,6468
Florida,Timber Pines,5305,0,9,21,0,0,30
Florida,Tildenville,1921,0,0,142,623,0,765
Florida,Tiger Point,2978,0,0,185,140,240,565
Florida,Tierra Verde,3359,28,25,119,70,51,293
Florida,Tice,4293,42,52,264,278,146,782
Florida,Three Oaks,3188,75,62,168,179,168,652
Florida,Three Lakes,16749,540,272,764,598,1156,3330
Florida,Tyndall AFB,3128,68,97,312,172,110,759
Florida,Naples Manor,5566,33,37,273,632,424,1399
Florida,Leisure City,25952,647,462,1679,1437,1574,5799
Florida,Lely Resort,5088,57,16,229,76,161,539
Florida,North Sarasota,7587,141,114,296,373,469,1393
Florida,North River Shores,4068,14,91,177,119,291,692
Florida,North Redington Beach,1484,4,28,27,23,44,126
Florida,North Port,59555,710,1380,3078,2735,3398,11301
Florida,North Palm Beach village,12425,162,118,363,489,446,1578
Florida,North Miami Beach,43489,454,682,2017,2234,2587,7974
Florida,North Miami,62042,759,741,2685,3153,3837,11175
Florida,North Lauderdale,42853,749,615,2577,2249,2848,9038
Florida,North Key Largo,1024,19,9,8,14,10,60
Florida,North Fort Myers,40560,176,57,759,1001,1098,3091
Florida,North DeLand,1511,54,45,118,39,39,295
Florida,Northdale,22725,319,311,1022,1217,1625,4494
Florida,North Brooksville,3695,68,60,336,62,139,665
Florida,North Weeki Wachee,8436,34,78,176,469,462,1219
Florida,North Bay Village,7689,129,73,209,213,159,783
Florida,Nokomis,3152,44,9,58,26,113,250
Florida,Nocatee,7306,306,259,580,968,396,2509
Florida,Nobleton,335,0,0,0,26,0,26
Florida,Niceville,13929,308,220,935,570,600,2633
Florida,New Smyrna Beach,23356,239,305,776,587,711,2618
Florida,New Port Richey East,8686,151,105,313,321,346,1236
Florida,New Port Richey,15260,129,101,701,462,675,2068
Florida,Newberry,5307,57,69,266,493,210,1095
Florida,Neptune Beach,6683,140,7,130,351,355,983
Florida,Medley,998,2,13,41,25,160,241
Florida,Navarre,32949,691,208,2009,2082,2297,7287
Florida,Nassau Village-Ratliff,5228,100,32,281,323,352,1088
Florida,Naranja,9392,290,196,833,630,566,2515
Florida,Noma,258,0,2,23,28,9,62
Florida,Lely,3589,0,9,90,56,158,313
Florida,Oak Hill,1517,7,10,73,54,56,200
Florida,Oakland Park,43347,770,471,1867,1729,1816,6653
Florida,Lemon Grove,678,34,0,57,31,7,129
Florida,Lighthouse Point,10842,107,46,387,411,361,1312
Florida,Limestone,269,0,0,48,51,0,99
Florida,Limestone Creek,1022,36,0,113,114,20,283
Florida,Lisbon,44,0,0,0,0,0,0
Florida,Live Oak,6920,115,81,383,481,410,1470
Florida,Lloyd,378,0,19,55,82,6,162
Florida,Lochmoor Waterway Estates,4561,35,13,62,329,296,735
Florida,Lockhart,14312,295,239,843,737,743,2857
Florida,Longboat Key,7072,0,29,8,52,47,136
Florida,Longwood,13848,222,114,432,590,630,1988
Florida,Loughman,2877,0,47,111,173,157,488
Florida,Lower Grand Lagoon,3722,0,15,41,69,65,190
Florida,Oakland,2721,71,13,88,227,160,559
Florida,Loxahatchee Groves,3306,17,47,72,105,253,494
Florida,Lynn Haven,19355,301,264,956,981,1065,3567
Florida,Macclenny,6414,136,132,460,671,240,1639
Florida,McGregor,7652,145,50,178,357,293,1023
Florida,McIntosh,357,0,0,8,6,9,23
Florida,Ojus,19030,462,229,925,958,1140,3714
Florida,Odessa,7404,82,143,432,570,482,1709
Florida,Ocoee,39884,762,728,2567,2646,2221,8924
Florida,Ocean Ridge,1590,38,0,20,60,39,157
Florida,Ocean City,6120,135,33,357,256,188,969
Florida,Ocean Breeze Park,241,0,0,0,0,0,0
Florida,Ocala,57209,1394,698,3447,2696,2969,11204
Florida,Oak Ridge,23108,228,204,1242,1060,1047,3781
Florida,Oakleaf Plantation,23087,542,286,2136,1475,1991,6430
Florida,Lutz,20398,427,346,1276,971,1170,4190
Florida,Navarre Beach,1079,61,0,0,19,0,80
Florida,Sugarmill Woods,9129,30,0,114,261,211,616
Florida,Dickerson City,73,0,0,0,0,0,0
Florida,South Pasadena,5009,6,35,30,24,28,123
Florida,South Palm Beach,1350,0,0,15,0,3,18
Florida,South Miami Heights,38255,740,530,2307,1826,2215,7618
Florida,South Miami,12156,303,145,561,642,382,2033
Florida,South Highpoint,4624,54,58,225,274,185,796
Florida,South Gate Ridge,5902,88,45,352,157,333,975
Florida,South Patrick Shores,6529,23,54,230,316,415,1038
Florida,Southgate,7329,31,62,277,290,346,1006
Florida,South Daytona,12343,160,190,424,446,514,1734
Florida,Southchase,14987,393,328,708,788,672,2889
Florida,South Brooksville,3701,95,4,150,79,79,407
Florida,South Bradenton,23822,345,351,1028,847,629,3200
Florida,South Beach,3320,19,0,0,37,112,168
Florida,South Bay,4976,81,49,294,192,432,1048
Florida,Southeast Arcadia,8129,150,158,455,579,360,1702
Florida,South Sarasota,4973,17,9,102,165,216,509
Florida,South Venice,14652,122,113,394,539,811,1979
Florida,Southwest Ranches,7676,82,128,234,416,487,1347
Florida,Destin,13055,263,22,709,386,672,2052
Florida,White City,3407,42,6,73,125,155,401
Florida,White Springs,961,20,2,78,49,45,194
Florida,Whitfield CDP (Manatee County),3173,151,21,42,59,115,388
Florida,Whitfield CDP (Santa Rosa County),110,0,0,0,0,0,0
Florida,Wildwood,6052,66,75,330,189,148,808
Florida,Stock Island,3901,80,37,190,185,161,653
Florida,Steinhatchee,962,0,0,42,38,56,136
Florida,Starke,5401,121,71,298,192,153,835
Florida,Stacey Street,516,0,0,0,44,69,113
Florida,Spring Ridge,319,0,4,10,8,8,30
Florida,Spring Lake,454,0,0,0,0,3,3
Florida,Springhill,114,0,0,0,0,0,0
Florida,Spring Hill,101709,1386,1239,5192,5179,5028,18024
Florida,Springfield,9186,85,130,418,386,446,1465
Florida,South Apopka,5372,118,9,246,242,420,1035
Florida,Wewahitchka,1979,21,4,45,46,124,240
Florida,Sorrento,514,0,0,0,17,0,17
Florida,Solana,289,0,0,0,0,0,0
Florida,Sarasota Springs,15547,147,56,670,583,748,2204
Florida,Sarasota,53583,666,537,1659,1859,1633,6354
Florida,Sanibel,6899,21,10,131,159,142,463
Florida,Sanford,56170,1141,1125,3708,3075,3087,12136
Florida,San Castle,4358,76,17,101,83,394,671
Florida,San Carlos Park,18443,104,222,862,988,888,3064
Florida,Satellite Beach,10351,290,108,510,636,460,2004
Florida,San Antonio,1107,12,12,48,73,90,235
Florida,Samoset,4695,88,112,259,216,183,858
Florida,St. Petersburg,250713,3021,2699,10553,10823,10534,37630
Florida,St. Pete Beach,9466,58,25,302,330,178,893
Florida,St. Marks,255,0,0,6,19,17,42
Florida,St. Lucie Village,613,14,11,35,13,11,84
Florida,St. Leo,1343,3,2,9,6,15,35
Florida,Samsula-Spruce Creek,6314,99,0,177,363,156,795
Florida,Sawgrass,5321,12,83,212,225,188,720
Florida,Schall Circle,1253,57,16,128,102,52,355
Florida,Sea Ranch Lakes village,701,30,2,60,38,50,180
Florida,Sneads,1849,10,27,80,85,87,289
Florida,Sky Lake,6260,50,66,332,257,452,1157
Florida,Silver Springs Shores,7809,267,237,512,429,492,1937
Florida,Silver Lake,1555,0,7,35,76,89,207
Florida,Siesta Key,6058,120,25,136,125,95,501
Florida,Sharpes,2885,47,4,82,141,51,325
Florida,Shalimar,676,19,10,24,6,44,103
Florida,Shady Hills,10817,106,55,342,556,647,1706
Florida,Sewall's Point,2057,30,8,78,91,191,398
Florida,Seville,568,42,0,93,40,9,184
Florida,Seminole Manor,2866,24,0,261,215,178,678
Florida,Seminole,17637,172,105,412,671,589,1949
Florida,Seffner,7907,101,75,352,557,562,1647
Florida,Sebring,10371,289,110,519,434,427,1779
Florida,Sebastian,22920,449,152,1058,860,1268,3787
Florida,Sopchoppy,389,13,9,10,16,35,83
Florida,Westwood Lakes,12449,170,107,425,450,393,1545
Florida,Westville,362,6,4,20,8,38,76
Florida,Westview,10624,152,165,376,504,714,1911
Florida,Asbury Lake,8078,347,165,478,400,368,1758
Florida,Astatula,1541,3,23,118,81,93,318
Florida,Astor,1742,25,0,51,88,60,224
Florida,Atlantic Beach,12961,233,103,404,470,736,1946
Florida,Atlantis,2175,21,0,116,94,74,305
Florida,Auburndale,14281,157,235,879,919,981,3171
Florida,Aripeka,105,0,0,0,0,0,0
Florida,Aucilla,112,0,1,0,10,0,11
Florida,Aventura,37357,757,389,1407,1447,1223,5223
Florida,Avon Park,9974,93,92,629,608,547,1969
Florida,Azalea Park,13287,119,217,719,367,724,2146
Florida,Babson Park,1337,42,31,100,28,78,279
Florida,Bagdad,3951,46,48,173,244,127,638
Florida,Baldwin,1929,26,67,52,206,90,441
Florida,Avalon,571,0,0,16,45,13,74
Florida,Archer,1180,3,38,97,75,71,284
Florida,Arcadia,7704,99,70,617,539,429,1754
Florida,Apopka,45801,784,419,2450,1999,3136,8788
Florida,Welaka,642,23,2,22,31,67,145
Florida,Acacia Villas,375,0,0,37,14,31,82
Florida,Alachua,9435,177,117,393,367,417,1471
Florida,Alafaya,85167,1420,1242,5887,4653,4880,18082
Florida,Alford,538,10,9,29,38,35,121
Florida,Allentown,946,6,6,25,55,50,142
Florida,Altamonte Springs,42218,639,610,1429,1835,1858,6371
Florida,Altha,670,7,31,38,34,20,130
Florida,Altoona,123,0,0,20,0,0,20
Florida,Alturas,3756,9,38,101,249,160,557
Florida,Alva,2088,6,8,56,124,38,232
Florida,Andrews,1191,0,0,125,61,0,186
Florida,Anna Maria,1219,0,0,21,18,37,76
Florida,Apalachicola,2077,19,6,106,158,84,373
Florida,Apollo Beach,16336,190,225,903,663,620,2601
Florida,Bal Harbour village,2677,31,74,171,72,18,366
Florida,Balm,1880,69,13,94,188,103,467
Florida,Bardmoor,9448,96,130,323,398,365,1312
Florida,Bartow,18094,384,299,811,1086,1318,3898
Florida,Westchase,23222,522,437,1367,1461,1113,4900
Florida,Westchester,30585,348,388,1115,1307,1237,4395
Florida,West DeLand,3997,19,49,431,135,261,895
Florida,Westgate,8310,132,221,471,575,590,1989
Florida,West Lealman,15838,111,155,514,665,535,1980
Florida,West Little River,30749,675,422,1256,1445,1587,5385
Florida,West Melbourne,19667,387,326,990,889,949,3541
Florida,West Miami,6400,64,43,239,239,191,776
Florida,Weston,68423,1324,781,4783,6072,5916,18876
Florida,West Palm Beach,103588,1569,1247,4473,4156,4049,15494
Florida,West Park,14779,256,190,1011,750,905,3112
Florida,West Pensacola,20538,289,252,1079,1251,808,3679
Florida,West Perrine,10399,252,142,758,661,358,2171
Florida,West Samoset,7010,112,247,517,612,288,1776
Florida,West Vero Corridor,6945,0,0,9,222,260,491
Florida,West Bradenton,4492,33,20,242,206,276,777
Florida,St. James City,3900,0,0,0,141,121,262
Florida,Wesley Chapel,49735,861,1183,3237,3602,3332,12215
Florida,Belleair Bluffs,2236,45,40,85,27,20,217
Florida,Bascom,94,0,0,2,0,6,8
Florida,Bay Harbor Islands,5921,90,105,377,432,117,1121
Florida,Bay Hill,5133,99,16,186,261,371,933
Florida,Bay Lake,31,1,0,5,3,0,9
Florida,Bayonet Point,25453,171,155,964,928,815,3033
Florida,Bay Pines,3240,32,22,39,108,169,370
Florida,Bayport,452,0,0,0,0,0,0
Florida,Bayshore Gardens,19446,248,133,990,707,749,2827
Florida,Beacon Square,6564,44,49,494,230,182,999
Florida,Bear Creek,1840,13,8,59,22,15,117
Florida,Bee Ridge,9836,147,93,257,386,364,1247
Florida,Bell,505,3,1,43,32,53,132
Florida,Bellair-Meadowbrook Terrace,13987,146,212,583,468,974,2383
Florida,Belleair,3941,112,59,153,159,198,681
Florida,Belleair Beach,1685,25,23,36,35,55,174
Florida,Wellington village,60155,1085,816,3227,4076,4821,14025
Florida,Pinellas Park,50433,689,494,1789,1948,2435,7355
Florida,Pine Manor,4451,39,150,430,348,207,1174
Florida,Pine Ridge CDP (Citrus County),10402,84,0,182,433,495,1194
Florida,Lake Harbor,0,0,0,0,0,0,0
Florida,Lake Hamilton,1080,11,16,49,24,42,142
Florida,Lake Clarke Shores,3483,25,15,141,43,116,340
Florida,Lake City,12082,271,257,693,577,464,2262
Florida,Lake Butler,2224,70,83,127,156,150,586
Florida,Lake Butler,16871,383,207,1118,1570,1097,4375
Florida,Lake Hart,280,0,1,0,7,24,32
Florida,Lake Buena Vista,7,0,0,0,0,0,0
Florida,Lake Alfred,5213,92,121,310,491,72,1086
Florida,Laguna Beach,3665,10,23,53,131,10,227
Florida,Lady Lake,14312,0,210,534,491,329,1564
Florida,La Crosse,261,4,5,12,3,20,44
Florida,Lacoochee,1630,32,0,103,145,150,430
Florida,LaBelle,4648,42,125,224,405,260,1056
Florida,Lake Belvedere Estates,3475,90,27,195,186,148,646
Florida,Lake Helen,2643,71,14,64,84,116,349
Florida,Lake Kathryn,920,0,0,64,42,14,120
Florida,Lakeland,101302,1670,1280,4826,4618,4799,17193
Florida,Lakewood Park,11511,57,39,396,487,304,1283
Florida,Lake Wales,14929,341,156,1156,744,661,3058
Florida,Lakeside,31223,351,317,1492,1919,1917,5996
Florida,Lake Sarasota,4759,46,28,261,229,286,850
Florida,Lake Placid,2541,62,58,173,87,99,479
Florida,Lake Park,8376,129,183,442,190,339,1283
Florida,Lake Panasoffkee,3311,44,49,121,48,134,396
Florida,Lake Mystic,381,0,0,0,11,72,83
Florida,Lake Mary Jane,1430,0,0,54,112,132,298
Florida,Lake Mary,15038,127,207,625,767,845,2571
Florida,Lake Magdalene,28560,419,183,1447,1113,1399,4561
Florida,Lake Mack-Forest Hills,568,0,0,0,0,88,88
Florida,Lake Lorraine,7152,41,42,176,462,524,1245
Florida,Lake Lindsey,39,0,0,0,0,0,0
Florida,Lakeland Highlands,11728,238,187,512,483,735,2155
Florida,Kissimmee,65422,864,802,3606,3799,3824,12895
Florida,Key West,25366,420,57,932,866,686,2961
Florida,Key Vista,1559,34,53,51,85,86,309
Florida,Keystone Heights,1652,49,0,111,97,126,383
Florida,Wilton Manors,12133,63,7,311,296,294,971
Florida,Wimauma,6405,109,177,529,548,411,1774
Florida,Windermere,3106,74,12,156,253,291,786
Florida,Windsor,157,0,0,20,0,0,20
Florida,Winter Beach,2594,120,42,106,104,68,440
Florida,Winter Garden,37955,961,351,2576,2363,1810,8061
Florida,Winter Haven,35835,418,331,1742,1598,2091,6180
Florida,Winter Park,29182,708,504,1471,1027,1088,4798
Florida,Winter Springs,33973,465,386,1921,1329,2083,6184
Florida,Wiscon,414,0,0,10,7,16,33
Florida,Woodlawn Beach,2026,0,14,40,126,144,324
Florida,Woodville,2695,45,39,145,85,113,427
Florida,World Golf Village,13323,734,223,867,833,716,3373
Florida,Worthington Springs,616,1,36,41,20,18,116
Florida,Wright,24862,648,339,1197,922,1188,4294
Florida,Willow Oak,4948,88,66,392,150,323,1019
Florida,Lake Worth,36403,462,603,1974,1826,1438,6303
Florida,Williston Highlands,2142,49,14,42,197,82,384
Florida,Williamsburg,8148,66,31,317,175,248,837
Florida,Keystone,23271,327,395,1377,1536,1651,5286
Florida,Key Largo,10496,101,155,424,337,433,1450
Florida,Key Colony Beach,739,0,0,0,0,0,0
Florida,Key Biscayne village,12888,330,234,1004,991,677,3236
Florida,Kenwood Estates,1451,16,53,98,116,96,379
Florida,Kensington Park,4185,60,23,277,321,87,768
Florida,Kenneth City,5013,59,32,160,161,159,571
Florida,Kendall West,39347,456,452,1552,1792,2253,6505
Florida,Kendall,76267,939,810,2849,3163,4242,12003
Florida,Kendale Lakes,59354,641,511,2261,2274,2657,8344
Florida,Kathleen,5895,52,110,226,385,377,1150
Florida,Jupiter Island,656,0,0,0,18,18,36
Florida,Jupiter Inlet Colony,390,9,0,30,39,13,91
Florida,Jupiter Farms,11514,193,102,609,616,711,2231
Florida,Jupiter,59054,969,497,2200,2910,2540,9116
Florida,Williston,2730,24,46,171,184,203,628
Florida,Wekiwa Springs,23500,522,196,1114,1536,1542,4910
Florida,Lamont,191,0,0,0,0,46,46
Florida,Lantana,10910,145,133,634,608,703,2223
Florida,Port Richey,2699,35,42,87,78,95,337
Florida,Port St. Joe,3413,80,14,77,96,240,507
Florida,Port St. John,11335,204,55,537,543,803,2142
Florida,Port St. Lucie,172054,2894,2414,9508,10865,9556,35237
Florida,Port Salerno,9999,80,77,340,319,455,1271
Florida,Pretty Bayou,3432,49,43,178,243,139,652
Florida,Port Orange,57858,479,587,2103,2612,2595,8376
Florida,Princeton,26992,523,366,1963,2320,2039,7211
Florida,Punta Gorda,17288,42,0,327,273,429,1071
Florida,Punta Rassa,1767,0,0,0,0,90,90
Florida,Quail Ridge,1263,10,9,66,64,89,238
Florida,Quincy,7947,98,146,462,520,411,1637
Florida,Raiford,121,0,3,5,3,2,13
Florida,Raleigh,165,0,0,0,0,0,0
Florida,Progress Village,7366,199,73,387,510,431,1600
Florida,Port LaBelle,4385,78,87,248,329,294,1036
Florida,Port Charlotte,56434,565,424,2013,2239,2387,7628
Florida,Ponce Inlet,3086,0,20,32,60,124,236
Florida,Pine Ridge CDP (Collier County),1994,0,15,58,38,167,278
Florida,Pinewood,16992,395,279,724,856,1138,3392
Florida,Pioneer,728,13,0,0,0,5,18
Florida,Pittman,279,0,0,20,18,18,56
Florida,Plantation,89904,2206,1169,4623,4185,3900,16083
Florida,Plantation,4933,8,0,19,26,57,110
Florida,Plantation Island,452,46,37,73,33,64,253
Florida,Plantation Mobile Home Park,1123,56,0,116,51,33,256
Florida,Plant City,36382,456,646,2118,2207,2407,7834
Florida,Poinciana,59927,956,680,3752,4989,4265,14642
Florida,Point Baker,3440,153,59,85,116,76,489
Florida,Polk City,2413,19,51,191,164,146,571
Florida,Pomona Park,732,3,10,25,49,84,171
Florida,Pompano Beach,104741,1823,850,4333,4351,4350,15707
Florida,Ponce de Leon,496,4,0,68,26,10,108
Florida,Reddick,559,6,10,68,62,22,168
Florida,Redington Beach,1565,18,7,57,41,33,156
Florida,Redington Shores,2046,13,19,61,25,14,132
Florida,Richmond Heights,9985,56,212,307,325,904,1804
Florida,St. Augustine,13676,82,103,300,357,420,1262
Florida,St. Augustine Beach,6564,61,17,346,339,175,938
Florida,St. Augustine Shores,8024,205,122,292,419,223,1261
Florida,St. Augustine South,5349,147,15,265,224,233,884
Florida,St. Cloud,41502,603,558,2019,2317,2271,7768
Florida,St. George Island,587,0,0,7,13,18,38
Florida,Lazy Lake village,33,0,0,0,0,0,0
Florida,Layton,122,0,0,5,0,2,7
Florida,Lawtey,1051,33,15,65,43,57,213
Florida,Laurel Hill,609,16,3,32,13,42,106
Florida,Laurel,9390,52,61,305,326,366,1110
Florida,Lauderhill,69979,1355,872,3691,3799,4122,13839
Florida,Lauderdale Lakes,34103,649,526,1971,1539,2051,6736
Florida,Lauderdale-by-the-Sea,6313,31,26,69,116,47,289
Florida,Largo,79737,1041,615,3211,3021,2131,10019
Florida,Safety Harbor,17142,292,47,725,969,664,2697
Florida,Land O' Lakes,33812,459,399,1500,1868,1656,5882
Florida,Ruskin,20643,349,564,1263,1231,1146,4553
Florida,Royal Palm Beach village,36175,830,434,2267,2545,2231,8307
Florida,Richmond West,35693,526,588,1925,1895,2152,7086
Florida,Ridgecrest,3237,23,43,223,146,230,665
Florida,Ridge Manor,4593,16,40,145,233,207,641
Florida,Ridge Wood Heights,4760,92,73,208,149,171,693
Florida,Rio,1022,0,0,0,33,32,65
Florida,Rio Pinar,5490,145,28,211,364,224,972
Florida,River Park,5622,106,0,79,292,223,700
Florida,River Ridge,4601,78,36,196,212,254,776
Florida,Riverview,79886,1751,1346,5333,4683,4089,17202
Florida,Riviera Beach,33445,678,392,1677,1499,1929,6175
Florida,Rockledge,25798,297,321,1276,1107,843,3844
Florida,Roeville,513,10,0,9,60,45,124
Florida,Roosevelt Gardens,2760,40,34,248,151,262,735
Florida,Roseland,1669,0,16,8,8,29,61
Florida,Rotonda,8337,17,11,81,267,260,636
Florida,Royal Palm Estates,3014,33,25,91,181,123,453
Florida,Weeki Wachee Gardens,1527,0,0,49,32,47,128
Florida,Whiskey Creek,4973,91,38,153,167,222,671
Florida,Wedgefield,7800,152,135,520,560,464,1831
Florida,Cape Coral,165843,1766,1911,7938,9795,8697,30107
Florida,Cape Canaveral,10031,46,37,157,161,153,554
Florida,Canal Point,376,10,9,0,0,0,19
Florida,Campbellton,169,0,0,6,5,1,12
Florida,Campbell,2561,0,0,0,153,53,206
Florida,Callaway,14760,333,171,796,745,697,2742
Florida,Captiva,163,0,0,0,0,12,12
Florida,Callahan,1291,18,37,47,78,89,269
Florida,Butler Beach,5629,53,0,64,115,248,480
Florida,Bushnell,2973,50,4,90,71,56,271
Florida,Burnt Store Marina,1903,0,0,0,0,15,15
Florida,Bunnell,2762,32,94,153,99,146,524
Florida,Buenaventura Lakes,31348,177,364,1812,1769,2188,6310
Florida,Buckingham,4316,87,23,171,254,131,666
Florida,Cabana Colony,2266,46,72,57,162,124,461
Florida,Buckhead Ridge,1595,0,0,63,0,0,63
Florida,Carrabelle,2770,13,15,106,115,79,328
Florida,Caryville,300,2,5,8,23,15,53
Florida,Fort Pierce North,7058,139,79,495,477,411,1601
Florida,Fort Pierce South,4646,0,31,257,282,218,788
Florida,Fort Walton Beach,20767,337,298,676,843,970,3124
Florida,Fort White,728,26,2,48,94,33,203
Florida,Weeki Wachee,1,0,0,0,0,0,0
Florida,Charlotte Park,2475,17,0,32,49,17,115
Florida,Carrollwood,35027,577,308,1487,1469,1884,5725
Florida,Charlotte Harbor,4001,12,24,50,158,43,287
Florida,Century,1529,15,11,44,34,30,134
Florida,Center Hill,1150,5,9,86,52,116,268
Florida,Celebration,7816,182,127,619,576,329,1833
Florida,Cedar Key,667,0,9,5,25,20,59
Florida,Cedar Grove,3313,34,40,121,155,159,509
Florida,Casselberry,26663,319,184,872,1112,767,3254
Florida,Charleston Park,146,0,0,0,0,0,0
Florida,Brownsville,16410,573,226,1089,921,1032,3841
Florida,Brownsdale,518,19,0,17,8,0,44
Florida,Brooksville,7752,57,92,356,220,287,1012
Florida,Blountstown,2625,20,23,263,80,84,470
Florida,Bloomingdale,22882,431,175,1339,1459,1600,5004
Florida,Black Hammock,963,0,14,17,17,72,120
Florida,Black Diamond,1114,0,0,28,137,94,259
Florida,Bithlo,8559,171,161,477,583,534,1926
Florida,Biscayne Park village,3193,93,0,117,112,167,489
Florida,Boca Raton,89793,1393,698,3178,4040,4312,13621
Florida,Big Pine Key,4716,80,0,77,109,115,381
Florida,Beverly Hills,8593,145,32,403,274,251,1105
Florida,Beverly Beach,342,0,0,7,0,0,7
Florida,Berrydale,406,20,0,0,16,16,52
Florida,Bellview,22341,456,185,1162,967,1202,3972
Florida,Belleview,4612,25,19,395,50,126,615
Florida,Belle Isle,6403,52,73,201,197,279,802
Florida,Big Coppitt Key,2567,19,43,76,53,105,296
Florida,Bokeelia,1339,7,8,44,17,50,126
Florida,Bonifay,2756,7,42,178,254,137,618
Florida,Bonita Springs,47915,368,284,2162,1343,1458,5615
Florida,Brookridge,4429,0,51,48,120,111,330
Florida,Brooker,394,8,6,16,24,16,70
Florida,Bronson,955,4,7,42,68,65,186
Florida,Broadview Park,7593,37,49,387,357,244,1074
Florida,Bristol,1107,17,19,43,24,77,180
Florida,Briny Breezes,812,0,0,8,4,12,24
Florida,Brent,21957,312,203,1115,730,753,3113
Florida,Branford,867,22,19,31,52,32,156
Florida,Brandon,108287,1492,1435,4724,4873,5814,18338
Florida,Bradley Junction,480,0,0,19,26,25,70
Florida,Bradenton Beach,946,20,11,8,5,17,61
Florida,Bradenton,51811,654,532,2396,2323,2720,8625
Florida,Boynton Beach,71530,1259,1039,2741,2802,2751,10592
Florida,Bowling Green,2916,46,45,294,168,55,608
Florida,Boulevard Gardens,1870,49,0,30,46,108,233
Florida,Fort Pierce,43267,605,716,2286,2011,2413,8031
Florida,Fort Myers Shores,5541,17,47,107,392,130,693
Florida,Fort Myers Beach,6668,4,47,41,41,85,218
Florida,Fort Myers,68472,959,675,3392,3101,3168,11295
Florida,Dundee,3908,106,80,148,112,89,535
Florida,Dunedin,35712,355,280,1010,1335,1452,4432
Florida,Dunnellon,1783,20,0,83,36,106,245
Florida,Eagle Lake,2486,29,44,183,177,148,581
Florida,East Bronson,2355,11,0,196,95,204,506
Florida,East Lake,32054,700,369,1146,1251,1904,5370
Florida,Duck Key,665,0,0,0,58,30,88
Florida,East Lake-Orient Park,25373,455,466,1364,1066,1400,4751
Florida,East Palatka,1852,76,23,86,54,105,344
Florida,Eastpoint,2165,41,33,117,101,73,365
Florida,East Williston,731,25,12,0,12,45,94
Florida,Eatonville,2299,51,29,115,78,132,405
Florida,Ebro,259,6,6,16,8,2,38
Florida,Edgewater,21050,169,201,615,873,1060,2918
Florida,East Milton,12490,72,188,507,568,948,2283
Florida,Dover,3817,44,75,285,252,157,813
Florida,Doral,51382,1359,1073,3151,3297,3315,12195
Florida,Zolfo Springs,2003,11,60,144,241,136,592
Florida,Dixonville,182,0,0,0,0,0,0
Florida,Doctor Phillips,11501,360,195,406,503,697,2161
Florida,Highland Beach,3654,9,3,82,36,45,175
Florida,Hialeah Gardens,23092,339,253,1049,1146,1043,3830
Florida,Hialeah,234714,2642,2158,8623,9272,10225,32920
Florida,Inglis,1370,8,0,45,26,56,135
Florida,Yalaha,1117,18,0,0,21,69,108
Florida,Yankeetown,514,0,15,33,8,3,59
Florida,Yeehaw Junction,213,0,0,0,0,0,0
Florida,Yulee,11672,101,117,643,502,684,2047
Florida,Zellwood,3302,0,0,19,72,245,336
Florida,Zephyrhills,14275,125,81,486,484,741,1917
Florida,Zephyrhills North,2310,0,8,95,74,20,197
Florida,Zephyrhills South,5359,5,10,226,216,201,658
Florida,Zephyrhills West,5207,23,17,17,81,78,216
Florida,Edgewood,2690,56,55,115,101,133,460
Florida,Belle Glade,17950,436,317,1146,972,969,3840
Florida,Eglin AFB,2384,50,28,108,150,113,449
Florida,Elfers,13982,153,127,644,527,493,1944
Florida,Five Points,812,0,0,0,36,0,36
Florida,Flagler Beach,4682,0,9,91,106,220,426
Florida,Flagler Estates,3051,8,35,191,187,231,652
Florida,Fleming Island,30350,468,399,1599,2595,2506,7567
Florida,Floral City,4919,41,57,122,241,267,728
Florida,Florida City,12024,325,209,826,905,846,3111
Florida,Fish Hawk,16297,302,183,1454,1755,1491,5185
Florida,Florida Ridge,19701,156,401,627,1131,936,3251
Florida,Forest City,14924,149,237,838,982,812,3018
Florida,Fort Denaud,1639,11,32,30,0,55,128
Florida,Fort Green,161,0,0,0,0,0,0
Florida,Fort Green Springs,325,0,0,14,63,64,141
Florida,Fort Lauderdale,173570,2770,2276,6774,6075,7518,25413
Florida,Fort Meade,5824,114,52,344,435,262,1207
Florida,Floridatown,326,0,4,8,7,15,34
Florida,Fisher Island,232,0,0,44,0,0,44
Florida,Fidelis,37,0,0,0,0,7,7
Florida,Ferry Pass,32077,393,442,1096,1694,1170,4795
Florida,Ellenton,3009,0,14,76,49,46,185
Florida,El Portal village,2492,64,4,67,123,81,339
Florida,Englewood,14515,97,82,238,271,284,972
Florida,Ensley,21981,705,428,948,1146,1035,4262
Florida,Estero village,29588,216,237,669,865,844,2831
Florida,Esto,375,17,7,17,19,21,81
Florida,Eustis,19198,213,77,1151,815,1132,3388
Florida,Everglades,268,0,14,13,4,11,42
Florida,Fairview Shores,10586,128,82,225,533,416,1384
Florida,Fanning Springs,1046,13,7,27,70,46,163
Florida,Feather Sound,3370,46,25,100,156,75,402
Florida,Fellsmere,5390,81,85,313,515,191,1185
Florida,Fernandina Beach,11990,196,74,174,459,476,1379
Florida,Ferndale,469,0,0,38,48,0,86
Florida,Fern Park,8161,55,49,141,361,491,1097
Florida,Egypt Lake-Leto,37408,512,353,1953,1380,2076,6274
Florida,Belleair Shore,62,0,0,4,1,0,5
Florida,Interlachen,1430,24,31,100,111,48,314
Florida,Wacissa,229,0,0,20,20,7,47
Florida,Wahneta,5372,52,117,603,418,239,1429
Florida,Waldo,1004,41,8,24,25,20,118
Florida,Wallace,1502,0,24,72,31,83,210
Florida,Warrington,13053,285,237,574,656,546,2298
Florida,Washington Park,1310,10,89,124,45,64,332
Florida,Watergate,3245,24,36,174,245,284,763
Florida,Warm Mineral Springs,4935,0,0,30,0,15,45
Florida,Wauchula,4909,0,123,333,197,138,791
Florida,Waukeenah,148,6,7,17,7,4,41
Florida,Wausau,486,0,8,47,30,53,138
Florida,Waverly,828,35,34,128,29,0,226
Florida,Webster,813,7,0,56,52,31,146
Florida,Watertown,3318,24,5,235,221,70,555
Georgia,Tifton,16656,299,190,966,865,913,3233
Georgia,The Rock,192,0,0,20,4,0,24
Georgia,Thomaston,9032,190,130,400,343,690,1753
Georgia,Thomasville,18612,359,433,1024,1220,975,4011
Georgia,Thomson,6697,196,208,386,396,511,1697
Georgia,Thunderbolt,2594,33,41,94,60,70,298
Georgia,Tiger,412,12,3,15,38,17,85
Georgia,Metter,4145,56,27,344,171,215,813
Georgia,Toccoa,8302,136,137,498,491,634,1896
Georgia,Toomsboro,345,0,5,6,31,6,48
Georgia,Trenton,2123,40,8,77,113,117,355
Georgia,Trion,2210,57,41,209,138,96,541
Georgia,Tucker,27761,343,501,1544,1713,1321,5422
Georgia,Tennille,1499,35,41,65,73,98,312
Georgia,Tignall,523,0,0,29,38,45,112
Georgia,Temple,4248,59,95,245,57,197,653
Georgia,Talbotton,1147,7,7,15,59,62,150
Georgia,Tate City,0,0,0,0,0,0,0
Georgia,Sunset Village,803,13,13,51,39,49,165
Georgia,Surrency,184,0,3,1,10,6,20
Georgia,Suwanee,17291,537,356,1052,1195,1090,4230
Georgia,Swainsboro,7456,150,129,543,509,524,1855
Georgia,Sycamore,788,8,2,9,61,65,145
Georgia,Sylvania,2550,93,10,84,87,146,420
Georgia,Taylorsville,222,0,0,12,10,1,23
Georgia,Sylvester,6146,244,182,392,356,299,1473
Georgia,Riceboro,665,7,4,17,30,28,86
Georgia,Talking Rock,89,0,6,3,8,5,22
Georgia,Tallapoosa,3138,34,53,63,267,265,682
Georgia,Tallulah Falls,90,0,0,0,0,14,14
Georgia,Talmo,214,6,2,14,4,9,35
Georgia,Tarrytown,64,0,0,10,0,0,10
Georgia,Talahi Island,1237,0,0,8,61,17,86
Georgia,Richland,1692,29,17,100,85,63,294
Georgia,Roberta,843,18,7,18,44,51,138
Georgia,Riddleville,58,0,0,1,0,2,3
Georgia,Union City,20459,608,235,1587,1267,1253,4950
Georgia,Unadilla,3699,94,33,140,133,109,509
Georgia,Ty Ty,985,11,6,60,133,41,251
Georgia,Tyrone,7081,102,123,328,300,588,1441
Georgia,Tybee Island,3058,24,49,89,184,135,481
Georgia,Twin City,2161,28,17,109,103,162,419
Georgia,Turin,412,23,16,16,19,11,85
Georgia,Tunnel Hill,1096,8,28,49,74,62,221
Georgia,Sandy Springs,100691,1772,1296,5023,4840,4330,17261
Georgia,Sandersville,5831,13,121,274,316,348,1072
Georgia,Salem,293,10,0,16,7,8,41
Georgia,Sale City,459,10,7,30,24,24,95
Georgia,St. Simons,13287,322,29,398,734,515,1998
Georgia,St. Marys,17675,281,350,807,997,771,3206
Georgia,Rutledge,937,10,9,33,53,32,137
Georgia,Russell,1374,0,10,46,88,151,295
Georgia,Royston,2478,48,39,138,58,144,427
Georgia,Rincon,9487,179,410,569,1017,837,3012
Georgia,Ringgold,3668,79,17,48,336,183,663
Georgia,Riverdale,15650,220,195,1141,840,998,3394
Georgia,Riverside,22,0,0,0,0,2,2
Georgia,Lovejoy,6450,240,166,307,521,364,1598
Georgia,Robins AFB,1405,25,25,111,81,56,298
Georgia,Richmond Hill,10872,473,199,643,804,755,2874
Georgia,Rochelle,1076,11,11,55,33,52,162
Georgia,Rockmart,4197,94,137,176,96,204,707
Georgia,Rocky Ford,221,3,13,20,13,0,49
Georgia,Rome,36278,599,450,1931,1797,1738,6515
Georgia,Roopville,363,2,3,20,37,20,82
Georgia,Rossville,4035,7,40,322,308,186,863
Georgia,Roswell,93471,1895,1633,4617,5149,5464,18758
Georgia,Rockingham,411,0,6,48,131,64,249
Georgia,Louisville,2581,58,8,137,278,121,602
Georgia,Cadwell,611,10,17,19,14,14,74
Georgia,Lone Oak,62,0,0,2,0,6,8
Georgia,Mountain City,886,3,7,33,15,22,80
Georgia,Mountain Park,591,5,0,24,23,30,82
Georgia,Chattanooga Valley,3625,27,16,146,108,125,422
Georgia,Chauncey,345,5,2,34,24,11,76
Georgia,Cherry Log,159,0,0,0,0,0,0
Georgia,Chester,2037,7,10,24,37,24,102
Georgia,Chickamauga,3115,62,89,138,158,193,640
Georgia,Clarkesville,1937,52,14,168,39,106,379
Georgia,Clarkston,11990,214,155,1020,641,825,2855
Georgia,Claxton,2163,100,28,212,121,97,558
Georgia,Clayton,2068,9,26,126,55,125,341
Georgia,Clermont,1060,3,3,74,79,74,233
Georgia,Cleveland,3689,63,149,230,213,117,772
Georgia,Climax,165,0,0,8,5,6,19
Georgia,Cobbtown,339,0,3,18,20,23,64
Georgia,Cochran,4765,50,59,205,119,108,541
Georgia,Cohutta,666,0,8,22,66,26,122
Georgia,Newnan,35224,999,865,2474,2042,1657,8037
Georgia,Newington,284,4,6,16,12,8,46
Georgia,Newborn,641,11,13,31,51,41,147
Georgia,Nelson,1407,37,24,79,73,130,343
Georgia,Nashville,4914,107,32,284,426,269,1118
Georgia,Nahunta,1095,6,6,63,58,38,171
Georgia,Moultrie,14474,337,174,832,936,1016,3295
Georgia,Mount Zion,1850,50,9,141,119,98,417
Georgia,Mount Airy,1233,6,20,92,52,59,229
Georgia,Mountain Park,12702,194,242,724,675,858,2693
Georgia,Collins,484,7,4,47,26,26,110
Georgia,College Park,14026,405,208,890,880,653,3036
Georgia,Coleman,35,0,0,0,0,0,0
Georgia,Colbert,663,10,19,43,36,46,154
Georgia,Mount Vernon,2003,7,14,60,97,28,206
Georgia,Lookout Mountain,1664,46,26,87,115,84,358
Georgia,Morven,518,17,18,36,20,29,120
Georgia,Morganton,375,1,1,20,19,33,74
Georgia,Loganville,10855,376,128,654,761,541,2460
Georgia,Locust Grove,5666,19,0,619,395,389,1422
Georgia,Byromville,446,7,5,22,19,30,83
Georgia,Byron,4818,9,122,141,317,260,849
Georgia,Union Point,1485,17,59,50,70,89,285
Georgia,Cairo,9759,246,281,723,509,486,2245
Georgia,Calhoun,15948,261,364,886,978,711,3200
Georgia,Calvary,97,7,0,7,0,0,14
Georgia,Camak,187,9,3,26,11,0,49
Georgia,Camilla,5083,95,51,264,202,302,914
Georgia,Candler-McAfee,22835,597,229,871,1070,1002,3769
Georgia,Canon,790,3,8,36,32,40,119
Georgia,Canoochee,93,21,0,0,0,0,21
Georgia,Canton,24305,644,510,1710,1291,1073,5228
Georgia,Carl,224,6,3,14,10,3,36
Georgia,Carlton,355,5,0,21,13,19,58
Georgia,Carnesville,664,3,16,44,52,27,142
Georgia,Morgan,2679,0,0,4,4,249,257
Georgia,Moreland,379,3,4,20,34,29,90
Georgia,Moody AFB,637,29,39,38,0,5,111
Georgia,Chattahoochee Hills,2575,58,29,72,67,142,368
Georgia,Chatsworth,4297,64,58,162,145,196,625
Georgia,Chamblee,27654,130,286,1217,966,828,3427
Georgia,Morrow,6982,134,37,359,245,360,1135
Georgia,Centralhatchee,418,1,24,14,27,17,83
Georgia,Cedartown,9781,164,69,850,736,331,2150
Georgia,Cedar Springs,22,0,0,0,0,0,0
Georgia,Cecil,391,0,0,18,35,36,89
Georgia,Cave Spring,1355,18,33,99,71,120,341
Georgia,Cartersville,19964,417,263,1339,1427,953,4399
Georgia,Carrollton,25515,343,326,1243,1243,891,4046
Georgia,Centerville,7519,110,87,438,495,269,1399
Georgia,Unionville,1574,47,18,0,51,101,217
Georgia,Uvalda,565,12,3,63,22,32,132
Georgia,Valdosta,56504,1191,868,2731,2477,2385,9652
Georgia,Sparks,2373,129,126,180,81,132,648
Georgia,Sparta,1515,33,17,43,66,102,261
Georgia,Springfield,2826,48,43,117,251,145,604
Georgia,Stapleton,471,19,4,17,43,8,91
Georgia,Statenville,1142,9,16,69,137,35,266
Georgia,Statesboro,30059,290,176,697,1181,809,3153
Georgia,Statham,2564,30,27,148,152,224,581
Georgia,Stillmore,603,3,16,64,3,40,126
Georgia,Stockbridge,27328,582,369,1748,1858,1861,6418
Georgia,Stone Mountain,5991,68,56,304,176,411,1015
Georgia,Sugar Hill,20323,429,215,1276,1785,1374,5079
Georgia,Summertown,213,0,8,17,8,18,51
Georgia,Summerville,4422,20,65,135,171,137,528
Georgia,Sumner,402,1,2,22,32,23,80
Georgia,Buchanan,1260,5,30,60,57,91,243
Georgia,Soperton,3073,60,34,178,172,195,639
Georgia,Brunswick,15794,236,279,677,835,923,2950
Georgia,Social Circle,4304,87,58,317,244,95,801
Georgia,Smyrna,53829,1217,1014,2480,2707,1412,8830
Georgia,Matthews,250,0,0,33,58,18,109
Georgia,Buford,13244,292,169,930,934,657,2982
Georgia,Buena Vista,2231,31,47,107,121,130,436
Georgia,Buckhead,227,8,3,16,5,1,33
Georgia,Seville,155,0,0,15,0,0,15
Georgia,Shady Dale,321,0,4,22,14,10,50
Georgia,Shannon,1829,48,67,193,125,85,518
Georgia,Sharon,110,0,0,1,2,0,3
Georgia,Sharpsburg,538,10,1,21,19,19,70
Georgia,Shellman,1071,12,11,25,108,146,302
Georgia,Shiloh,558,6,2,18,33,36,95
Georgia,Siloam,393,11,5,13,27,38,94
Georgia,Skidaway Island,8042,96,44,176,347,357,1020
Georgia,Sky Valley,325,1,0,3,0,11,15
Georgia,Smithville,584,4,12,53,60,16,145
Georgia,Snellville,19199,407,304,741,974,985,3411
Georgia,Broxton,1101,10,18,73,64,65,230
Georgia,Brooks,637,11,11,28,33,50,133
Georgia,Brooklet,1540,19,12,59,55,132,277
Georgia,Molena,496,11,0,18,58,43,130
Georgia,Mitchell,194,9,2,12,17,7,47
Georgia,Mineral Bluff,96,0,0,0,0,0,0
Georgia,Milton,35799,656,625,2930,2636,2616,9463
Georgia,Milner,1140,60,5,129,57,38,289
Georgia,Millen,3003,98,189,226,209,201,923
Georgia,Milledgeville,18971,133,295,612,687,802,2529
Georgia,Milan,705,27,3,38,36,21,125
Georgia,Midway,2040,100,23,148,116,92,479
Georgia,Maxeys,301,7,3,22,18,9,59
Georgia,Maysville,2215,29,45,169,110,104,457
Georgia,Meansville,157,0,3,5,0,16,24
Georgia,Meigs,918,13,18,69,55,33,188
Georgia,Mendes,45,0,0,0,0,10,10
Georgia,Menlo,496,5,2,30,17,42,96
Georgia,Monroe,13476,54,127,702,731,864,2478
Georgia,Montezuma,3284,60,53,97,265,133,608
Georgia,Montgomery,4544,20,16,373,193,154,756
Georgia,Monticello,2607,63,36,108,206,160,573
Georgia,Brookhaven,50812,1030,847,2502,1771,1305,7455
Georgia,Bronwood,191,17,3,7,5,12,44
Georgia,Brinson,344,4,1,13,9,14,41
Georgia,Bremen,6224,139,184,410,413,339,1485
Georgia,Braswell,364,2,4,29,13,28,76
Georgia,Braselton,8074,123,220,594,576,481,1994
Georgia,Boykin,108,0,0,0,0,0,0
Georgia,Martinez,36895,487,248,2304,1804,2502,7345
Georgia,Bowman,842,11,8,47,45,35,146
Georgia,Bowdon,2252,39,36,144,84,124,427
Georgia,Bostwick,528,4,6,75,25,29,139
Georgia,Boston,1461,24,36,61,102,98,321
Georgia,Bonanza,3873,7,73,241,206,491,1018
Georgia,Bogart,1117,14,9,37,47,59,166
Georgia,Blythe,728,4,3,14,38,49,108
Georgia,Montrose,246,4,0,14,15,29,62
Georgia,Bowersville,414,3,6,13,35,24,81
Georgia,Martin,458,5,7,21,49,21,103
Georgia,Marshallville,1359,17,0,51,66,86,220
Georgia,Marietta,58906,1133,1065,3039,2761,1957,9955
Georgia,Waynesboro,5801,111,203,400,340,393,1447
Georgia,Webster County unified governme,2720,79,54,167,143,154,597
Georgia,West Point,3410,11,120,195,100,181,607
Georgia,Whigham,738,0,7,49,71,39,166
Georgia,White,762,6,22,52,35,34,149
Georgia,Sunnyside,1413,0,0,33,148,183,364
Georgia,Sunny Side,94,0,0,4,2,0,6
Georgia,Ludowici,2343,22,42,150,115,143,472
Georgia,Lula,2793,68,84,197,189,155,693
Georgia,Lumber City,1327,17,20,33,46,52,168
Georgia,Lumpkin,1311,58,59,69,30,27,243
Georgia,Luthersville,1214,26,19,32,52,105,234
Georgia,Lyerly,534,3,0,23,20,45,91
Georgia,Lyons,4362,59,83,520,237,247,1146
Georgia,Mableton,39589,751,990,2304,2419,2573,9037
Georgia,Waycross,14258,303,281,777,911,655,2927
Georgia,Waverly Hall,891,6,0,16,28,50,100
Georgia,Watkinsville,2871,61,22,171,138,156,548
Georgia,Washington,4001,91,10,241,56,118,516
Georgia,Varnell,1835,65,6,80,103,105,359
Georgia,Vernonburg,126,3,0,10,8,1,22
Georgia,Vidalia,10627,132,151,814,635,724,2456
Georgia,Vidette,127,2,0,5,9,2,18
Georgia,Vienna,3846,134,72,160,133,164,663
Georgia,Villa Rica,14435,183,351,1146,1093,626,3399
Georgia,Vinings,11224,165,127,171,186,391,1040
Georgia,McCaysville,1176,6,9,68,118,64,265
Georgia,Waco,474,14,0,10,26,21,71
Georgia,Waleska,642,2,2,6,16,7,33
Georgia,Walnut Grove,1213,22,5,65,58,90,240
Georgia,Walthourville,4136,51,13,283,401,311,1059
Georgia,Warm Springs,518,14,22,11,31,26,104
Georgia,Warner Robins,72520,1570,1523,5014,4221,3892,16220
Georgia,Warrenton,2136,62,50,127,111,56,406
Georgia,Warwick,418,22,2,9,19,33,85
Georgia,Wadley,1992,18,15,133,133,158,457
Georgia,Midville,296,0,2,10,22,15,49
Georgia,McDonough,22830,563,473,1771,1570,1303,5680
Georgia,Sardis,953,30,18,77,56,39,220
Georgia,Winterville,1084,13,14,50,81,40,198
Georgia,Winder,14928,314,204,1006,1138,1038,3700
Georgia,Wilmington Island,14781,346,223,695,861,757,2882
Georgia,Williamson,347,4,8,30,29,16,87
Georgia,Willacoochee,1547,61,27,99,122,105,414
Georgia,Whitesburg,581,4,0,28,20,25,77
Georgia,White Plains,205,5,0,6,5,5,21
Georgia,Whitemarsh Island,7202,189,79,301,384,333,1286
Georgia,McIntyre,718,6,6,8,13,38,71
Georgia,Macon-Bibb,154608,3054,2589,8967,8084,8034,30728
Georgia,McRae-Helena,8720,106,194,349,211,152,1012
Georgia,Madison,3991,75,39,227,257,263,861
Georgia,Butler,1647,78,27,53,14,92,264
Georgia,Manchester,4141,23,66,296,333,303,1021
Georgia,Mansfield,351,2,17,7,19,17,62
Georgia,Woodbine,1552,24,48,67,93,113,345
Georgia,Woodbury,803,46,7,47,46,36,182
Georgia,Woodland,326,6,0,14,3,0,23
Georgia,Woodstock,26793,710,441,2128,1544,1466,6289
Georgia,Sasser,356,5,16,23,11,31,86
Georgia,Satilla,419,0,22,8,36,50,116
Georgia,Sautee-Nacoochee,315,0,0,25,4,11,40
Georgia,Savannah,142919,2273,1620,7356,6264,6527,24040
Georgia,Scotland,371,13,10,16,26,6,71
Georgia,Scottdale,10672,163,279,770,626,406,2244
Georgia,Screven,893,9,3,83,52,25,172
Georgia,Santa Claus,270,0,0,52,8,14,74
Georgia,Senoia,3773,97,64,267,157,124,709
Georgia,Young Harris,1004,4,7,16,12,26,65
Georgia,Yonah,391,0,0,56,60,0,116
Georgia,Yatesville,420,6,6,27,9,21,69
Georgia,Wrightsville,3689,57,35,115,123,333,663
Georgia,Wrens,2532,17,15,98,306,292,728
Georgia,Woolsey,188,1,0,7,17,8,33
Georgia,Woodville,366,15,2,14,12,10,53
Georgia,Zebulon,1380,46,38,70,111,55,320
Georgia,Manassas,133,0,3,13,18,4,38
Georgia,Druid Hills,13928,228,111,405,389,370,1503
Georgia,Franklin Springs,924,3,0,11,22,13,49
Georgia,Alma,3513,21,37,214,108,228,608
Georgia,Allentown,233,6,7,6,15,10,44
Georgia,Allenhurst,577,0,22,27,24,15,88
Georgia,Aldora,89,0,0,11,8,1,20
Georgia,Albany,76466,1980,937,4603,4228,4667,16415
Georgia,Alapaha,735,1,9,94,49,35,188
Georgia,Alamo,4240,23,3,33,43,20,122
Georgia,Ailey,671,6,4,33,42,16,101
Georgia,Adrian,578,17,2,43,31,72,165
Georgia,Adel,5281,83,41,460,279,217,1080
Georgia,Adairsville,4712,37,178,409,276,351,1251
Georgia,Alpharetta,62054,1762,864,4086,4321,4215,15248
Georgia,Acworth,21512,449,338,1217,1264,1463,4731
Georgia,Rhine,508,3,15,27,39,28,112
Georgia,Reynolds,1257,0,17,83,49,87,236
Georgia,Rest Haven,94,0,1,0,4,3,8
Georgia,Resaca,915,5,12,49,87,71,224
Georgia,Rentz,352,1,7,31,17,19,75
Georgia,Remerton,1393,17,17,29,17,13,93
Georgia,Reidsville,2623,29,30,200,182,99,540
Georgia,Register,105,2,0,5,3,5,15
Georgia,Reed Creek,2967,0,29,101,142,136,408
Georgia,Redan,32614,460,339,1825,1745,2320,6689
Georgia,Rebecca,300,0,0,42,40,3,85
Georgia,Abbeville,2860,13,4,71,62,105,255
Georgia,Rayle,215,11,6,17,14,6,54
Georgia,Alston,152,0,2,8,5,5,20
Georgia,Ambrose,410,9,33,31,24,10,107
Georgia,Greensboro,3405,86,35,179,156,217,673
Georgia,Greenville,925,41,20,54,23,23,161
Georgia,Gresham Park,7607,92,112,325,206,294,1029
Georgia,Griffin,23312,561,356,1160,1603,1464,5144
Georgia,Grovetown,12521,119,178,809,1125,831,3062
Georgia,Gumbranch,194,4,0,5,11,4,24
Georgia,Gumlog,2463,41,19,172,103,107,442
Georgia,Guyton,1963,41,14,140,137,120,452
Georgia,Hagan,968,22,19,67,77,50,235
Georgia,Hahira,2843,131,57,170,178,163,699
Georgia,Hamilton,1013,15,10,94,48,79,246
Georgia,Alto,1165,11,0,86,113,58,268
Georgia,Hampton,7188,226,11,531,548,759,2075
Georgia,Hapeville,6649,10,71,478,374,317,1250
Georgia,Haralson,126,0,1,0,7,1,9
Georgia,Hardwick,3539,56,106,127,111,166,566
Georgia,Harlem,2872,41,35,113,122,111,422
Georgia,Harrison,525,14,6,21,31,38,110
Georgia,Hartwell,4504,201,22,189,327,153,892
Georgia,Aragon,977,0,16,54,80,56,206
Georgia,Arabi,552,5,9,31,32,20,97
Georgia,Appling,656,42,16,36,0,51,145
Georgia,Andersonville,295,2,15,13,1,4,35
Georgia,Americus,16345,297,327,1334,720,1131,3809
Georgia,Hannahs Mill,3949,84,84,134,257,275,834
Georgia,Grayson,2778,61,37,148,115,202,563
Georgia,Ray City,1236,22,18,57,45,74,216
Georgia,Ranger,169,0,1,0,19,35,55
Georgia,Parrott,173,0,0,6,14,9,29
Georgia,Panthersville,9367,229,98,570,377,456,1730
Georgia,Palmetto,4928,131,122,427,208,500,1388
Georgia,Oxford,2265,23,22,85,107,103,340
Georgia,Orchard Hill,222,0,0,6,24,14,44
Georgia,Omega,1299,9,11,77,63,82,242
Georgia,Oliver,221,0,0,7,8,7,22
Georgia,Oglethorpe,1307,36,20,17,66,48,187
Georgia,Offerman,433,15,20,16,9,3,63
Georgia,Odum,586,8,11,45,36,52,152
Georgia,Oconee,413,1,23,42,8,15,89
Georgia,Patterson,720,3,3,65,22,66,159
Georgia,Ocilla,3445,126,24,199,216,158,723
Georgia,Oakwood,4123,28,54,117,197,206,602
Georgia,Oak Park,843,5,21,73,29,66,194
Georgia,Nunez,80,0,0,1,6,12,19
Georgia,Norwood,272,2,0,4,0,7,13
Georgia,North High Shoals,767,13,23,35,60,59,190
Georgia,North Druid Hills,18385,387,117,612,457,552,2125
Georgia,North Decatur,17040,241,149,591,451,773,2205
Georgia,Norristown,82,0,0,0,0,7,7
Georgia,Norman Park,1220,29,20,69,93,85,296
Georgia,Norcross,16103,297,220,1456,1114,723,3810
Georgia,Nicholson,1587,28,17,92,88,98,323
Georgia,Ochlocknee,665,29,10,48,27,17,131
Georgia,Raoul,2982,32,5,84,62,195,378
Georgia,Pavo,580,6,0,12,39,21,78
Georgia,Peachtree City,34868,489,496,1972,2576,2780,8313
Georgia,Quitman,3804,119,44,196,286,181,826
Georgia,Putney,2519,61,37,56,47,66,267
Georgia,Pulaski,310,7,4,18,18,13,60
Georgia,Powder Springs,14462,326,43,655,959,1345,3328
Georgia,Poulan,1031,15,1,27,55,68,166
Georgia,Port Wentworth,6619,399,32,417,305,104,1257
Georgia,Porterdale,1890,31,56,151,39,117,394
Georgia,Portal,639,11,18,21,48,37,135
Georgia,Crooked Creek,927,7,10,14,32,13,76
Georgia,Plainville,335,2,2,27,19,30,80
Georgia,Plains,733,0,0,36,6,65,107
Georgia,Payne,208,0,10,27,23,9,69
Georgia,Pitts,463,4,0,35,67,47,153
Georgia,Pine Mountain,1419,15,13,61,34,66,189
Georgia,Pine Lake,648,0,3,18,17,18,56
Georgia,Pinehurst,405,2,7,7,27,1,44
Georgia,Phillipsburg,459,0,25,113,41,11,190
Georgia,Perry,14991,284,292,511,968,679,2734
Georgia,Perkins,243,0,0,0,0,74,74
Georgia,Pendergrass,464,2,7,18,20,21,68
Georgia,Pembroke,3036,116,42,306,182,256,902
Georgia,Pelham,3828,109,71,352,230,121,883
Georgia,Pearson,1935,24,40,113,111,124,412
Georgia,Peachtree Corners,39910,572,621,2244,2394,2454,8285
Georgia,Pineview,485,12,12,7,23,31,85
Georgia,Gray,3287,134,21,243,131,136,665
Georgia,Grantville,3124,37,62,352,232,172,855
Georgia,Graham,284,2,2,24,18,26,72
Georgia,Dawson,4388,59,106,311,294,324,1094
Georgia,Dawsonville,2416,67,36,180,150,158,591
Georgia,Dearing,552,3,9,43,37,24,116
Georgia,Decatur,20605,701,355,1306,1382,693,4437
Georgia,Deenwood,1845,11,74,194,53,56,388
Georgia,Deepstep,156,2,1,5,6,1,15
Georgia,Demorest,1842,12,12,47,40,75,186
Georgia,Denton,241,5,0,5,5,34,49
Georgia,De Soto,309,0,7,57,16,15,95
Georgia,Dewy Rose,230,0,17,15,0,23,55
Georgia,Dexter,571,13,0,29,34,43,119
Georgia,Davisboro,1776,6,10,9,17,67,109
Georgia,Dillard,401,0,0,8,14,44,66
Georgia,Doerun,790,15,12,74,46,42,189
Georgia,Donalsonville,2716,24,33,217,154,126,554
Georgia,Dooling,322,23,11,48,22,26,130
Georgia,Doraville,10650,129,139,578,457,565,1868
Georgia,Douglas,11750,246,161,852,767,756,2782
Georgia,Ball Ground,1869,31,22,99,82,106,340
Georgia,Baldwin,3467,91,57,225,232,138,743
Georgia,Bainbridge,12576,317,110,718,684,430,2259
Georgia,Baconton,794,31,6,79,77,89,282
Georgia,Avondale Estates,3066,53,58,184,147,89,531
Georgia,Avera,282,19,3,20,15,14,71
Georgia,Dock Junction,7272,92,54,286,433,443,1308
Georgia,Avalon,266,0,14,16,3,7,40
Georgia,Dasher,881,10,8,42,43,76,179
Georgia,Danville,201,0,2,4,4,15,25
Georgia,Crawfordville,626,14,5,6,21,22,68
Georgia,Crawford,948,0,16,48,30,55,149
Georgia,Covington,13507,206,214,685,765,647,2517
Georgia,Country Club Estates,8568,186,187,433,381,435,1622
Georgia,Cornelia,4199,109,84,337,356,356,1242
Georgia,Cordele,11140,230,272,818,558,807,2685
Georgia,Coolidge,598,18,0,28,30,42,118
Georgia,Conyers,15577,230,250,1117,1034,1436,4067
Georgia,Conley,5125,113,131,465,320,450,1479
Georgia,Concord,372,6,4,28,24,20,82
Georgia,Commerce,6575,167,269,317,224,296,1273
Georgia,Darien,2844,47,14,163,172,112,508
Georgia,Comer,1280,21,5,57,71,76,230
Georgia,Colquitt,2268,45,60,129,191,66,491
Georgia,Cumming,5588,170,99,271,221,215,976
Georgia,Cusseta-Chattahoochee County unified governme,11914,242,213,514,599,614,2182
Georgia,Cuthbert,3697,42,74,229,170,96,611
Georgia,Dacula,4831,155,95,288,479,390,1407
Georgia,Dahlonega,6052,39,31,40,42,334,486
Georgia,Daisy,146,0,0,12,12,22,46
Georgia,Dallas,12363,245,315,1125,782,510,2977
Georgia,Dalton,33496,463,625,2420,2222,1899,7629
Georgia,Damascus,332,0,0,26,16,43,85
Georgia,Danielsville,912,8,15,63,82,70,238
Georgia,Columbus,200285,3756,3039,10054,10814,10950,38613
Georgia,Austell,6994,90,238,398,475,476,1677
Georgia,Douglasville,31917,662,374,1739,2234,2513,7522
Georgia,Augusta-Richmond County consolidated government (balance),196635,2883,2574,9972,10213,10439,36081
Georgia,Flowery Branch,6216,136,180,591,292,217,1416
Georgia,Folkston,5313,5,74,212,70,199,560
Georgia,Forest Park,18953,386,327,1473,1154,966,4306
Georgia,Forsyth,3993,83,18,334,227,169,831
Georgia,Fort Gaines,1087,3,31,80,62,47,223
Georgia,Fort Oglethorpe,9547,149,150,353,642,530,1824
Georgia,Fort Stewart,4977,22,23,263,336,303,947
Georgia,Fort Valley,9192,195,80,440,476,361,1552
Georgia,Franklin,890,14,8,18,30,40,110
Georgia,Funston,790,29,49,44,76,53,251
Georgia,Gainesville,37115,672,737,2109,2432,2505,8455
Georgia,Flovilla,500,5,7,21,12,36,81
Georgia,Garden City,8966,215,114,568,447,319,1663
Georgia,Gay,100,0,2,6,11,6,25
Georgia,Geneva,106,0,0,6,0,1,7
Georgia,Georgetown,12600,236,218,427,625,709,2215
Georgia,Georgetown-Quitman County unified governme,2326,29,42,68,137,123,399
Georgia,Gibson,695,0,13,40,34,43,130
Georgia,Gillsville,287,2,9,26,27,10,74
Georgia,Girard,154,2,2,7,9,6,26
Georgia,Glennville,5150,63,22,224,291,210,810
Georgia,Glenwood,683,14,2,44,50,19,129
Georgia,Good Hope,236,6,0,4,5,7,22
Georgia,Gordon,2328,60,45,166,139,81,491
Georgia,Garfield,191,0,3,29,1,11,44
Georgia,Flemington,877,6,1,49,71,77,204
Georgia,Fitzgerald,9032,96,85,453,733,360,1727
Georgia,Fayetteville,16500,245,241,833,1046,1221,3586
Georgia,Auburn,7409,80,141,358,358,396,1333
Georgia,Attapulgus,585,8,10,42,30,8,98
Georgia,Atlanta,448901,8681,4579,17798,18225,16048,65331
Georgia,Athens-Clarke County unified government (balance),119684,1722,1407,4263,4126,4286,15804
Georgia,Ashburn,3875,71,27,298,237,273,906
Georgia,Arnoldsville,451,7,3,16,18,47,91
Georgia,Arlington,1242,40,21,162,32,35,290
Georgia,Argyle,143,0,0,5,1,7,13
Georgia,Arcade,1471,14,25,74,35,51,199
Georgia,Ellenton,108,0,0,0,4,3,7
Georgia,Ellijay,1952,42,22,128,72,87,351
Georgia,Emerson,1461,3,9,64,71,62,209
Georgia,Empire,421,0,0,15,0,52,67
Georgia,Enigma,903,12,3,19,96,42,172
Georgia,Ephesus,423,12,17,8,27,8,72
Georgia,Epworth,340,0,24,20,0,0,44
Georgia,Eton,1122,18,37,82,60,57,254
Georgia,Euharlee,4182,36,4,304,431,330,1105
Georgia,Evans,33730,516,640,2013,2452,2103,7724
Georgia,Experiment,2557,19,0,156,126,99,400
Georgia,Fairburn,13697,471,118,799,1167,897,3452
Georgia,Fairmount,841,9,15,27,45,41,137
Georgia,Fair Oaks,9109,157,253,515,563,470,1958
Georgia,Fairview,8026,102,307,430,206,513,1558
Georgia,Fargo,339,3,6,13,16,33,71
Georgia,Nicholls,4067,26,28,58,46,84,242
Georgia,Newton,699,4,5,20,53,28,110
Georgia,Pooler,21400,376,134,1168,1565,938,4181
Georgia,Irwinton,703,3,12,23,33,64,135
Georgia,Jenkinsburg,342,4,16,14,41,29,104
Georgia,Jersey,126,2,0,2,0,0,4
Georgia,Jesup,10163,129,57,681,684,578,2129
Georgia,Johns Creek,82203,2087,1176,5482,6074,6801,21620
Georgia,Jonesboro,4669,107,26,265,121,194,713
Georgia,Junction City,152,0,0,3,19,18,40
Georgia,Kennesaw,32186,846,475,1823,1642,1590,6376
Georgia,Keysville,245,6,9,13,7,16,51
Georgia,Kings Bay Base,1701,19,44,125,67,50,305
Georgia,Jeffersonville,1111,10,2,38,42,42,134
Georgia,Kingsland,16239,258,390,973,873,895,3389
Georgia,Kite,289,8,4,9,27,20,68
Georgia,Knoxville,60,0,0,0,0,0,0
Georgia,LaFayette,7107,55,131,444,326,350,1306
Georgia,LaGrange,30356,728,481,1772,1746,1670,6397
Georgia,Lake City,2650,26,52,126,76,109,389
Georgia,Lakeland,3378,72,49,238,240,144,743
Georgia,Lake Park,1070,9,4,76,85,106,280
Georgia,Lakeview,5878,38,110,296,471,230,1145
Georgia,Lakeview Estates,2789,19,154,262,197,166,798
Georgia,Kingston,766,12,9,64,55,65,205
Georgia,Lavonia,1842,6,60,81,39,74,260
Georgia,Jefferson,9771,176,137,585,665,840,2403
Georgia,Jakin,205,5,6,31,17,6,65
Georgia,Hinesville,34287,732,664,1897,1776,1681,6750
Georgia,Hiram,3681,54,59,83,230,166,592
Georgia,Hoboken,657,27,14,72,45,21,179
Georgia,Hogansville,3078,91,115,164,182,156,708
Georgia,Holly Springs,9979,270,210,852,845,575,2752
Georgia,Homeland,1028,13,26,78,48,83,248
Georgia,Homer,1343,29,3,78,97,91,298
Georgia,Homerville,2494,73,70,187,167,58,555
Georgia,Hoschton,1781,37,21,72,158,231,519
Georgia,Jasper,3715,27,52,157,221,258,715
Georgia,Howard,0,0,0,0,0,0,0
Georgia,Ideal,468,8,9,28,24,4,73
Georgia,Ila,428,18,3,38,26,30,115
Georgia,Indian Springs,2739,76,25,82,49,220,452
Georgia,Iron City,228,1,0,13,11,20,45
Georgia,Irondale,8488,57,308,543,669,534,2111
Georgia,Isle of Hope,2581,25,6,140,135,88,394
Georgia,Ivey,930,37,13,60,37,34,181
Georgia,Jackson,4949,110,77,476,211,253,1127
Georgia,Jacksonville,96,0,0,5,2,0,7
Georgia,Hull,239,9,2,17,7,5,40
Georgia,Lawrenceville,29738,461,458,1670,1876,2039,6504
Georgia,Leary,519,4,6,18,28,57,113
Georgia,Leesburg,2965,78,41,213,252,290,874
Georgia,Blue Ridge,1492,36,0,53,31,81,201
Georgia,Bluffton,73,3,2,1,1,1,8
Georgia,Ellaville,2022,31,40,198,146,153,568
Georgia,Elberton,4474,57,96,276,207,244,880
Georgia,Edison,1054,46,12,104,48,35,245
Georgia,Edge Hill,23,0,0,0,0,0,0
Georgia,Eatonton,6486,215,152,147,237,362,1113
Georgia,East Point,35357,722,385,1939,1665,1963,6674
Georgia,East Newnan,1495,0,57,116,40,10,223
Georgia,Bloomingdale,2746,26,35,104,147,57,369
Georgia,Eastman,5375,134,130,295,421,197,1177
Georgia,East Ellijay,993,46,29,92,85,61,313
Georgia,East Dublin,2470,69,26,162,147,161,565
Georgia,Eagle Grove,0,0,0,0,0,0,0
Georgia,Dutch Island,923,36,34,57,53,39,219
Georgia,Du Pont,177,0,5,7,4,2,18
Georgia,Dunwoody,47727,1143,1011,3118,2499,1869,9640
Georgia,Duluth,28294,553,417,1307,1438,1290,5005
Georgia,Dudley,773,4,14,40,28,36,122
Georgia,Dublin,16181,361,233,1019,860,839,3312
Georgia,East Griffin,1416,59,28,55,59,53,254
Georgia,Blakely,4854,71,165,341,261,301,1139
Georgia,Blairsville,731,13,0,69,0,43,125
Georgia,Blackshear,3522,106,74,166,52,201,599
Georgia,Lenox,832,25,3,59,47,33,167
Georgia,Leslie,365,5,2,15,39,25,86
Georgia,Lexington,266,0,0,18,21,12,51
Georgia,Lilburn,12372,277,169,674,863,717,2700
Georgia,Lilly,228,9,2,30,16,17,74
Georgia,Lincoln Park,500,0,0,0,0,17,17
Georgia,Lincolnton,1518,43,8,65,55,59,230
Georgia,Lindale,4041,42,54,180,266,215,757
Georgia,Lithia Springs,17246,556,250,1145,955,1096,4002
Georgia,Lithonia,1961,86,36,140,140,90,492
Georgia,Barnesville,6609,161,79,234,450,508,1432
Georgia,Bartow,310,0,4,21,12,4,41
Georgia,Barwick,443,3,17,16,22,49,107
Georgia,Baxley,4428,86,31,270,256,67,710
Georgia,Bellville,123,0,3,2,2,8,15
Georgia,Belvedere Park,16214,289,205,935,705,778,2912
Georgia,Berkeley Lake,1796,21,9,55,93,147,325
Georgia,Berlin,554,5,9,43,32,26,115
Georgia,Bethlehem,700,0,15,49,65,58,187
Georgia,Between,331,14,9,18,36,25,102
Georgia,Bishop,296,11,4,52,15,28,110
Georgia,Hiltonia,469,0,0,9,19,77,105
Georgia,Hilltop,293,0,0,33,62,14,109
Georgia,Culloden,254,5,13,11,16,19,64
Georgia,Hazlehurst,4217,64,22,225,311,437,1059
Georgia,Henderson,1886,13,0,28,36,28,105
Georgia,Hephzibah,3950,16,54,160,224,360,814
Georgia,Heron Bay,3539,53,83,322,330,199,987
Georgia,Hiawassee,982,0,0,8,3,0,11
Georgia,Higgston,429,10,10,37,30,30,117
Georgia,Hawkinsville,5546,39,81,160,166,275,721
Georgia,Helen,296,0,0,11,1,4,16
Hawaii,Holualoa,8390,136,125,402,274,320,1257
Hawaii,Kaanapali,1202,14,15,41,39,54,163
Hawaii,Kaaawa,1139,17,27,47,43,49,183
Hawaii,Iroquois Point,3935,96,45,362,217,67,787
Hawaii,Honomu,364,0,0,11,6,22,39
Hawaii,Hauula,3755,114,71,236,254,289,964
Hawaii,Honokaa,2359,13,10,103,66,160,352
Hawaii,Honalo,2571,57,4,112,179,79,431
Hawaii,Hawaiian Acres,2516,66,30,153,101,215,565
Hawaii,Hawaiian Ocean View,4276,0,79,228,268,185,760
Hawaii,Hawaiian Paradise Park,11684,141,18,444,365,762,1730
Hawaii,Honaunau-Napoopoo,2813,52,47,83,107,16,305
Hawaii,Heeia,4481,95,13,217,160,71,556
Hawaii,Hickam Housing,9243,395,220,879,573,405,2472
Hawaii,Hilo,45380,548,630,2017,1898,2453,7546
Hawaii,Hawaiian Beaches,4453,97,17,463,210,206,993
Hawaii,Hawi,1345,4,11,85,64,67,231
Hawaii,Waimalu,13333,139,140,390,722,486,1877
Hawaii,Hanapepe,2630,18,12,86,63,104,283
Hawaii,Ainaloa,3596,68,34,131,232,324,789
Hawaii,Anahola,1951,20,42,100,96,101,359
Hawaii,Captain Cook,4594,97,21,321,169,215,823
Hawaii,Discovery Harbour,1107,13,6,28,66,49,162
Hawaii,East Honolulu,48092,734,538,2082,2280,2414,8048
Hawaii,Eden Roc,687,0,15,18,46,28,107
Hawaii,Eleele,2604,40,33,141,96,194,504
Hawaii,Ewa Beach,14287,165,243,723,517,661,2309
Hawaii,Ewa Gentry,22676,442,222,1430,1260,1067,4421
Hawaii,Ewa Villages,7356,36,90,452,562,438,1578
Hawaii,Fern Acres,1426,0,0,38,100,81,219
Hawaii,Fern Forest,669,0,8,36,11,4,59
Hawaii,Haena,280,2,2,2,17,12,35
Hawaii,Wailuku,16064,369,308,699,788,461,2625
Hawaii,Halaula,530,0,17,10,19,35,81
Hawaii,Halawa,14812,211,179,649,717,733,2489
Hawaii,Haleiwa,3576,22,42,165,262,196,687
Hawaii,Haliimaile,1190,2,18,52,45,46,163
Hawaii,Hana,1258,22,5,84,92,63,266
Hawaii,Hanalei,210,0,0,19,8,6,33
Hawaii,Hanamaulu,4946,20,50,253,370,232,925
Hawaii,Kahaluu,4565,117,55,287,187,395,1041
Hawaii,Kahaluu-Keauhou,3783,0,47,80,214,219,560
Hawaii,Kahuku,2513,51,42,134,200,235,662
Hawaii,Kahului,28476,408,341,1384,1401,1678,5212
Hawaii,Naalehu,847,9,8,36,77,50,180
Hawaii,Nanakuli,12405,186,148,801,899,1036,3070
Hawaii,Nanawale Estates,1714,13,38,111,149,84,395
Hawaii,Napili-Honokowai,6723,187,83,263,195,335,1063
Hawaii,Ocean Pointe,11336,310,129,711,644,485,2279
Hawaii,Olinda,1161,12,11,31,30,67,151
Hawaii,Olowalu,92,0,0,1,4,0,5
Hawaii,Omao,1270,21,28,46,22,18,135
Hawaii,Orchidlands Estates,3305,18,91,121,163,226,619
Hawaii,Paauilo,633,16,6,22,26,50,120
Hawaii,Mountain View,3088,125,0,131,133,257,646
Hawaii,Pahala,1405,11,54,73,123,34,295
Hawaii,Paia,2561,76,43,75,102,124,420
Hawaii,Punaluu,1064,14,12,37,33,17,113
Hawaii,Pukalani,8072,151,56,405,673,322,1607
Hawaii,Puhi,3435,36,43,143,230,258,710
Hawaii,Puako,741,7,0,12,20,22,61
Hawaii,Princeville,2400,61,0,104,114,39,318
Hawaii,Poipu,1042,11,0,31,20,21,83
Hawaii,Pepeekeo,1681,3,33,50,70,100,256
Hawaii,Pearl City,47021,589,724,1907,1867,2113,7200
Hawaii,Paukaa,520,2,0,6,7,16,31
Hawaii,Pahoa,826,0,7,37,57,10,111
Hawaii,Aiea,9262,180,106,470,548,332,1636
Hawaii,Mokuleia,1653,19,9,46,29,74,177
Hawaii,Mililani Mauka,21055,470,159,1112,1267,1628,4636
Hawaii,Kailua CDP (Hawaii County),12652,134,138,611,615,450,1948
Hawaii,Kailua CDP (Honolulu County),38722,472,393,1650,1821,1975,6311
Hawaii,Kalaeloa,9,0,0,0,0,0,0
Hawaii,Lahaina,12118,260,138,683,363,527,1971
Hawaii,Laie,5644,141,41,300,261,268,1011
Hawaii,Lanai City,3519,68,45,229,93,261,696
Hawaii,Launiupoko,505,0,6,29,20,22,77
Hawaii,Laupahoehoe,533,12,21,70,19,14,136
Hawaii,Lawai,2253,12,34,101,109,61,317
Hawaii,Leilani Estates,1557,22,16,56,23,65,182
Hawaii,Mililani Town,28021,229,442,1275,1535,1518,4999
Hawaii,Lihue,7360,109,154,696,270,241,1470
Hawaii,Mahinahina,1016,26,30,32,29,30,147
Hawaii,Maili,8910,241,149,764,631,366,2151
Hawaii,Makaha,8813,187,168,447,286,606,1694
Hawaii,Makaha Valley,1284,20,18,96,64,100,298
Hawaii,Makakilo,20631,205,206,1334,1179,1637,4561
Hawaii,Makawao,6523,119,69,384,469,481,1522
Hawaii,Makena,132,0,0,3,11,14,28
Hawaii,Manele,20,0,0,0,0,0,0
Hawaii,Maunaloa,431,13,13,52,23,43,144
Hawaii,Maunawili,2149,32,7,93,121,81,334
Hawaii,Maalaea,298,1,1,2,2,3,9
Hawaii,Ahuimanu,8354,161,76,565,397,355,1554
Hawaii,Haiku-Pauwela,7846,143,59,298,459,448,1407
Hawaii,Kula,7478,60,101,335,331,342,1169
Hawaii,Volcano,2430,76,0,133,14,76,299
Hawaii,Wahiawa,17484,198,277,821,933,833,3062
Hawaii,Waialua,3690,50,17,216,128,137,548
Hawaii,Waianae,13632,307,229,940,808,951,3235
Hawaii,Waihee-Waiehu,9159,91,79,359,504,494,1527
Hawaii,Waikane,771,16,2,33,30,43,124
Hawaii,Waikapu,3561,58,72,244,176,165,715
Hawaii,Waikele,7786,125,92,400,391,268,1276
Hawaii,Waikoloa Village,6350,170,102,268,291,439,1270
Hawaii,Wailea,5656,0,46,183,81,243,553
Hawaii,Wailua,2584,20,27,165,74,117,403
Hawaii,Wailua Homesteads,5645,37,19,241,98,281,676
Hawaii,Urban Honolulu,347973,4208,3168,12387,13438,13490,46691
Hawaii,Kurtistown,1070,26,0,7,9,70,112
Hawaii,Wheeler AFB,2712,18,76,142,253,104,593
Hawaii,West Loch Estate,5364,28,91,165,291,346,921
Hawaii,Waipio Acres,4961,18,75,202,264,267,826
Hawaii,Waipio,11261,160,166,392,414,313,1445
Hawaii,Waipahu,41165,514,473,1824,2272,2380,7463
Hawaii,Waiohinu,112,2,0,2,6,14,24
Hawaii,Wainiha,168,0,0,13,0,0,13
Hawaii,Wainaku,1388,29,18,56,18,38,159
Hawaii,Waimea CDP (Kauai County),1690,21,7,59,27,40,154
Hawaii,Waimea CDP (Hawaii County),10817,338,364,850,769,664,2985
Hawaii,Waimanalo Beach,4255,56,65,211,184,230,746
Hawaii,Waimanalo,6164,113,127,431,525,500,1696
Hawaii,Whitmore Village,4919,109,43,236,221,296,905
Hawaii,Ualapue,372,2,10,23,18,25,78
Hawaii,Papaikou,1234,0,16,66,46,74,202
Hawaii,Royal Kunia,14198,99,178,518,873,947,2615
Hawaii,Schofield Barracks,20858,558,527,1397,1271,548,4301
Hawaii,Kaumakani,940,9,19,58,50,52,188
Hawaii,Kaunakakai,3544,87,50,203,182,156,678
Hawaii,Kawela Bay,248,1,4,8,2,8,23
Hawaii,Keaau,2415,58,13,141,99,92,403
Hawaii,Kealakekua,1894,14,30,82,96,124,346
Hawaii,Kekaha,2915,46,50,99,126,112,433
Hawaii,Keokea,1951,40,21,99,133,161,454
Hawaii,Kihei,22401,368,547,1291,1278,1032,4516
Hawaii,Kilauea,3208,72,67,140,157,145,581
Hawaii,Ko Olina,1872,40,16,62,29,73,220
Hawaii,Kualapuu,1998,24,17,130,199,121,491
Hawaii,Koloa,2623,38,43,146,176,122,525
Hawaii,Kapalua,322,0,5,12,5,6,28
Hawaii,Pupukea,5705,62,93,570,382,138,1245
Hawaii,Pakala Village,317,3,2,4,4,6,19
Hawaii,Kukuihaele,436,3,6,27,46,39,121
Hawaii,Kalaheo,4358,25,37,201,125,82,470
Hawaii,Kapolei,18737,593,386,1336,1244,1013,4572
Hawaii,Kalihiwai,271,6,0,11,17,8,42
Hawaii,Kalaoa,12214,349,158,316,417,520,1760
Hawaii,Kaneohe,33654,480,382,1227,1316,1420,4825
Hawaii,Kaneohe Station,11285,209,321,636,423,92,1681
Hawaii,Kapaa,10794,213,78,555,459,532,1837
Hawaii,Kapaau,1851,12,12,107,69,171,371
Idaho,Groveland,834,11,0,30,17,32,90
Idaho,Greenleaf,1000,16,11,60,130,92,309
Idaho,Grand View,469,3,13,23,35,26,100
Idaho,Grangeville,3160,38,18,128,41,85,310
Idaho,Hagerman,1186,13,1,222,97,74,407
Idaho,Kimberly,3444,52,64,306,213,307,942
Idaho,Island Park,184,3,0,4,8,5,20
Idaho,Kendrick,456,6,7,8,8,31,60
Idaho,Kellogg,2192,16,51,73,179,157,476
Idaho,Kamiah,1329,20,20,78,74,54,246
Idaho,Juliaetta,635,17,10,36,18,15,96
Idaho,Jerome,11100,239,162,990,825,661,2877
Idaho,Hailey,8002,44,152,475,345,420,1436
Idaho,Ketchum,2706,23,15,79,68,35,220
Idaho,Hamer,71,0,0,5,6,15,26
Idaho,Hope,54,0,0,1,1,1,3
Idaho,Harrison,168,0,0,3,6,5,14
Idaho,Elk River,119,4,0,6,3,0,13
Idaho,Idaho Falls,58374,1003,1105,3722,3484,3676,12990
Idaho,Idaho City,485,5,0,32,47,35,119
Idaho,Huetter,78,0,0,6,10,0,16
Idaho,Horseshoe Bend,775,3,11,13,52,55,134
Idaho,Irwin,235,2,3,3,5,9,22
Idaho,Hansen,1448,13,33,138,73,80,337
Idaho,Homedale,2590,63,29,107,266,262,727
Idaho,Hidden Springs,2336,48,36,341,228,179,832
Idaho,Heyburn,3163,54,47,130,209,244,684
Idaho,Hazelton,742,21,20,36,26,41,144
Idaho,Hayden Lake,680,14,6,20,35,25,100
Idaho,Hayden,13749,105,48,656,677,931,2417
Idaho,Hauser,694,6,8,31,23,29,97
Idaho,Hollister,168,0,1,2,5,11,19
Idaho,Iona,1980,13,38,150,140,124,465
Idaho,Lapwai,1286,69,21,80,100,79,349
Idaho,Lincoln,2986,62,61,287,345,129,884
Idaho,East Hope,170,0,0,0,14,10,24
Idaho,Eden,398,4,3,27,14,34,82
Idaho,Elk City,174,22,0,26,0,0,48
Idaho,Gooding,3498,0,94,183,279,281,837
Idaho,Glenns Ferry,1137,17,34,55,109,82,297
Idaho,Georgetown,440,11,1,18,13,29,72
Idaho,Genesee,910,20,19,46,47,53,185
Idaho,Garden Valley,211,0,0,0,9,48,57
Idaho,Garden City,11313,126,176,415,434,429,1580
Idaho,Fruitland,4842,30,135,477,245,327,1214
Idaho,Franklin,654,15,7,68,73,50,213
Idaho,Fort Hall,3336,75,34,202,234,187,732
Idaho,Firth,462,8,13,19,27,31,98
Idaho,Filer,2625,65,86,239,157,82,629
Idaho,Fernan Lake Village,143,5,0,1,16,2,24
Idaho,Ferdinand,154,0,0,5,7,12,24
Idaho,Fairfield,536,10,5,37,29,56,137
Idaho,Emmett,6548,85,58,405,404,413,1365
Idaho,Inkom,894,8,17,86,62,52,225
Idaho,Eagle,21863,180,291,1335,1740,1813,5359
Idaho,Dubois,615,0,13,21,41,46,121
Idaho,Drummond,1,0,0,0,0,0,0
Idaho,Driggs,1936,30,41,166,97,158,492
Idaho,Lewisville,488,1,2,11,27,30,71
Idaho,Lewiston,32284,558,481,1490,1379,1474,5382
Idaho,Leadore,131,0,7,2,3,5,17
Idaho,Lava Hot Springs,333,2,13,4,7,9,35
Idaho,Kuna,16557,578,237,1820,928,798,4361
Idaho,Kootenai,913,16,32,67,60,65,240
Idaho,Kooskia,602,13,7,25,30,32,107
Idaho,Cottonwood,1019,13,2,52,61,138,266
Idaho,Council,962,0,18,57,64,31,170
Idaho,Grace,855,12,21,42,43,34,152
Idaho,Craigmont,472,4,2,15,23,12,56
Idaho,Culdesac,330,2,5,8,18,6,39
Idaho,Dalton Gardens,2331,18,18,96,113,174,419
Idaho,Dayton,526,18,27,67,39,43,194
Idaho,Deary,462,21,10,23,27,10,91
Idaho,Declo,563,5,5,67,19,78,174
Idaho,De Smet,174,0,0,18,7,10,35
Idaho,Dietrich,323,7,13,51,15,19,105
Idaho,Dover,798,10,9,50,74,37,180
Idaho,Downey,640,20,6,53,31,30,140
Idaho,Crouch,119,6,0,1,4,10,21
Idaho,Donnelly,77,0,0,9,0,14,23
Idaho,Worley,267,4,0,11,7,15,37
Idaho,Lowman,23,0,0,0,0,0,0
Idaho,Bliss,346,2,0,26,32,12,72
Idaho,Blanchard,160,0,0,0,0,0,0
Idaho,Blackfoot,11843,212,239,871,811,639,2772
Idaho,Bennington,286,6,0,19,27,0,52
Idaho,Bellevue,2514,27,58,164,202,187,638
Idaho,Basalt,344,4,3,22,13,27,69
Idaho,Banks,9,0,0,0,0,0,0
Idaho,Bancroft,308,0,4,7,17,26,54
Idaho,Bloomington,188,0,1,7,12,26,46
Idaho,Atomic City,21,0,0,4,0,0,4
Idaho,Ashton,968,24,6,63,41,53,187
Idaho,Arimo,344,3,8,34,26,21,92
Idaho,Arco,955,0,6,93,38,56,193
Idaho,Arbon Valley,715,2,20,25,79,89,215
Idaho,Ammon,14469,269,207,1172,1392,1164,4204
Idaho,American Falls,4380,89,39,144,419,321,1012
Idaho,Albion,254,0,6,12,23,25,66
Idaho,Acequia,140,0,0,8,12,15,35
Idaho,Athol,798,7,6,63,27,38,141
Idaho,Boise City,214196,2495,2190,9921,11172,11045,36823
Idaho,Bonners Ferry,2496,11,20,153,105,131,420
Idaho,Bovill,243,5,9,8,8,7,37
Idaho,Rigby,4011,260,199,203,260,156,1078
Idaho,Riggins,267,0,0,0,0,3,3
Idaho,Ririe,790,22,13,16,62,75,188
Idaho,Yellow Pine,82,0,0,0,0,0,0
Idaho,Conkling Park,60,0,0,0,0,0,0
Idaho,Coeur d'Alene,46796,547,592,2028,2247,2339,7753
Idaho,Clifton,374,8,3,26,42,42,121
Idaho,Clayton,0,0,0,0,0,0,0
Idaho,Clark Fork,423,0,4,13,9,24,50
Idaho,Chubbuck,14224,293,218,1020,1001,947,3479
Idaho,Challis,883,28,11,26,40,65,170
Idaho,Castleford,147,0,1,13,15,3,32
Idaho,Cascade,1056,0,15,34,40,42,131
Idaho,Carey,539,1,10,15,39,54,119
Idaho,Cambridge,251,6,0,5,5,6,22
Idaho,Caldwell,49149,495,1328,3961,2861,2549,11194
Idaho,Butte City,81,0,0,8,0,0,8
Idaho,Burley,10245,183,132,726,671,615,2327
Idaho,Buhl,4205,71,65,253,245,132,766
Idaho,Aberdeen,2046,43,45,182,84,127,481
Idaho,Riverside,1037,0,25,77,70,60,232
Idaho,Roberts,578,7,8,20,38,75,148
Idaho,Robie Creek,1487,35,10,95,61,20,221
Idaho,Sweetwater,200,0,3,7,4,18,32
Idaho,Tensed,136,2,0,2,18,4,26
Idaho,Teton,1046,17,13,95,80,28,233
Idaho,Tetonia,347,5,0,19,14,26,64
Idaho,Troy,884,6,10,57,80,64,217
Idaho,Twin Falls,45984,597,751,2986,2483,2314,9131
Idaho,Tyhee,1165,9,10,79,76,78,252
Idaho,Ucon,1397,15,22,102,93,85,317
Idaho,Victor,2244,66,95,145,98,32,436
Idaho,Wallace,781,0,2,45,4,33,84
Idaho,Wardner,196,0,0,4,9,33,46
Idaho,Warm River,0,0,0,0,0,0,0
Idaho,Weippe,540,8,7,23,25,27,90
Idaho,Weiser,5362,58,46,363,325,278,1070
Idaho,Wendell,2734,51,67,232,188,160,698
Idaho,Weston,528,19,9,38,34,60,160
Idaho,White Bird,64,0,0,0,0,8,8
Idaho,Wilder,1452,12,33,125,83,205,458
Idaho,Winchester,304,4,9,11,19,9,52
Idaho,Swan Valley,126,1,0,13,8,0,22
Idaho,Richfield,429,2,3,19,10,71,105
Idaho,Sun Valley,1408,13,17,26,11,33,100
Idaho,Stites,228,4,4,5,13,12,38
Idaho,Rockford,414,0,17,10,33,45,105
Idaho,Rockford Bay,213,3,3,0,6,4,16
Idaho,Rockland,358,0,6,24,41,70,141
Idaho,Rupert,5601,88,101,368,344,449,1350
Idaho,St. Anthony,3476,48,44,204,146,227,669
Idaho,St. Charles,110,2,2,3,2,11,20
Idaho,St. Maries,2208,10,28,85,75,116,314
Idaho,Salmon,3052,17,26,166,102,205,516
Idaho,Sandpoint,7571,57,185,359,366,451,1418
Idaho,Shelley,4404,163,77,395,216,453,1304
Idaho,Shoshone,1542,8,21,79,117,144,369
Idaho,Smelterville,679,6,13,24,28,14,85
Idaho,Smiths Ferry,162,0,0,0,0,0,0
Idaho,Soda Springs,2974,89,127,187,154,153,710
Idaho,Spencer,20,0,0,0,0,1,1
Idaho,Lost River,9,0,0,0,0,0,0
Idaho,Stanley,161,0,0,3,0,0,3
Idaho,Star,6768,81,153,494,514,318,1560
Idaho,State Line,20,2,0,0,0,3,5
Idaho,Sugar City,1301,13,71,77,101,103,365
Idaho,Rexburg,26723,394,453,1073,900,1039,3859
Idaho,Spirit Lake,2193,24,40,160,125,123,472
Idaho,Rathdrum,7174,172,162,350,724,527,1935
Idaho,Marsing,1397,28,12,142,120,94,396
Idaho,Nampa,86203,772,1557,5859,6399,5913,20500
Idaho,Newdale,341,3,8,22,30,32,95
Idaho,New Meadows,522,0,13,58,36,33,140
Idaho,New Plymouth,1952,11,30,138,104,78,361
Idaho,Nezperce,487,5,6,20,14,33,78
Idaho,Notus,532,0,3,28,48,50,129
Idaho,Oakley,779,4,13,38,63,85,203
Idaho,Oldtown,235,3,1,9,7,29,49
Idaho,Onaway,190,0,4,3,0,4,11
Idaho,Orofino,3088,18,41,133,89,169,450
Idaho,Osburn,1429,0,20,54,53,71,198
Idaho,Oxford,54,0,0,7,12,7,26
Idaho,Paris,462,0,9,13,22,25,69
Idaho,Parker,340,5,6,19,35,37,102
Idaho,Parkline,69,0,0,10,3,0,13
Idaho,Parma,2266,18,29,212,125,222,606
Idaho,Murphy,95,0,0,0,0,13,13
Idaho,Paul,1299,4,11,90,80,99,284
Idaho,Mullan,717,6,20,35,30,37,128
Idaho,Moyie Springs,730,21,3,38,22,33,117
Idaho,Melba,501,2,5,47,52,55,161
Idaho,Menan,808,10,13,58,42,66,189
Idaho,Meridian,84018,1542,1660,7125,5943,4455,20725
Idaho,Middleton,6145,87,83,480,527,447,1624
Idaho,Midvale,161,9,2,4,0,3,18
Idaho,Minidoka,66,0,3,15,4,9,31
Idaho,Montpelier,2545,49,16,120,182,172,539
Idaho,Moore,150,0,0,11,8,0,19
Idaho,Moreland,1295,0,17,114,109,112,352
Idaho,Moscow,24688,296,82,1018,650,617,2663
Idaho,Mountain Home,13804,154,267,838,853,559,2671
Idaho,Mountain Home AFB,3190,59,57,208,56,87,467
Idaho,Malad City,2017,42,6,136,90,104,378
Idaho,Mackay,434,0,2,9,19,19,49
Idaho,McCammon,630,19,4,45,23,33,124
Idaho,McCall,2955,85,52,93,166,158,554
Idaho,Reubens,68,1,5,15,0,1,22
Idaho,Mud Lake,421,2,6,44,20,49,121
Idaho,Payette,7428,23,74,299,385,290,1071
Idaho,Murtaugh,92,4,2,8,5,0,19
Idaho,Malta,237,4,0,14,7,11,36
Idaho,Peck,163,0,0,3,9,13,25
Idaho,Pierce,681,4,16,65,14,17,116
Idaho,Pinehurst,1686,19,2,112,55,76,264
Idaho,Plummer,1145,30,25,81,90,73,299
Idaho,Pocatello,54549,709,821,3169,2856,2851,10406
Idaho,Placerville,28,0,0,0,0,0,0
Idaho,Post Falls,29320,445,486,2066,1655,1493,6145
Idaho,Potlatch,792,14,27,51,23,25,140
Idaho,Preston,5190,88,7,367,404,321,1187
Idaho,Priest River,1659,33,10,59,45,92,239
Idaho,Princeton,76,0,10,10,10,0,30
Idaho,Ponderay,947,28,23,16,9,47,123
Illinois,Iroquois village,160,4,5,4,3,6,22
Illinois,Ingalls Park,3047,78,20,185,177,133,593
Illinois,Inverness village,7431,81,43,275,445,586,1430
Illinois,Iola village,107,0,0,16,9,8,33
Illinois,Ipava village,560,7,12,19,55,21,114
Illinois,Irving village,445,6,1,34,28,66,135
Illinois,Jacksonville,19241,420,222,586,1057,1029,3314
Illinois,Irwin village,82,4,2,10,7,5,28
Illinois,Island Lake village,8041,171,81,453,406,540,1651
Illinois,Itasca village,8574,219,175,424,295,458,1571
Illinois,Iuka village,472,1,8,10,30,44,93
Illinois,Ivesdale village,281,2,1,9,22,17,51
Illinois,Industry village,396,10,4,31,23,9,77
Illinois,Irvington village,848,4,15,23,60,40,142
Illinois,Indianola village,368,4,0,21,35,29,89
Illinois,Hutsonville village,567,23,14,19,29,23,108
Illinois,Indian Creek village,569,11,9,46,65,18,149
Illinois,Ina village,2342,6,8,32,56,105,207
Illinois,Illiopolis village,943,10,23,55,77,54,219
Illinois,Sailor Springs village,90,5,3,0,2,2,12
Illinois,Jeffersonville village,497,7,4,37,38,30,116
Illinois,Hurst,780,10,9,6,45,19,89
Illinois,Huntley village,25412,498,407,1429,1437,1164,4935
Illinois,Hume village,366,5,1,25,14,24,69
Illinois,Humboldt village,448,2,8,23,20,10,63
Illinois,Hull village,499,10,0,39,37,31,117
Illinois,Sadorus village,394,10,5,16,18,12,61
Illinois,Rutland village,256,2,2,4,7,7,22
Illinois,Russellville village,61,0,0,13,4,0,17
Illinois,Rushville,3159,95,28,172,142,152,589
Illinois,Indian Head Park village,3827,25,18,294,164,127,628
Illinois,Saybrook village,785,3,18,21,78,64,184
Illinois,Scales Mound village,518,3,8,41,20,30,102
Illinois,Jerseyville,8583,145,113,341,338,494,1431
Illinois,St. Joseph village,4302,94,71,319,301,350,1135
Illinois,St. Libory village,625,24,10,15,13,13,75
Illinois,St. Peter village,303,0,2,12,12,7,33
Illinois,Salem,7054,165,102,401,294,403,1365
Illinois,Sammons Point village,379,2,3,26,22,24,77
Illinois,Sandoval village,1196,67,13,68,85,66,299
Illinois,Sandwich,7540,115,73,294,337,443,1262
Illinois,San Jose village,601,23,4,29,30,38,124
Illinois,Sauget village,219,0,1,13,0,7,21
Illinois,Sauk Village village,10540,235,180,621,764,1018,2818
Illinois,Saunemin village,348,4,4,22,32,31,93
Illinois,Savanna,2980,39,23,131,243,183,619
Illinois,Savoy village,8066,123,90,299,252,311,1075
Illinois,Sawyerville village,264,1,2,23,20,8,54
Illinois,Scott AFB,2982,189,41,279,106,46,661
Illinois,Sciota village,86,2,0,10,13,1,26
Illinois,Schram City village,473,10,4,37,31,29,111
Illinois,Schiller Park village,11834,287,139,529,613,532,2100
Illinois,Schaumburg village,74559,1611,1044,3112,3112,2782,11661
Illinois,St. Johns village,224,13,2,28,14,11,68
Illinois,Jerome village,1579,8,38,47,36,39,168
Illinois,St. Jacob village,1226,61,24,53,77,61,276
Illinois,Ste. Marie village,275,2,0,5,25,15,47
Illinois,Jewett village,276,6,4,4,16,29,59
Illinois,Johnsburg village,6321,107,93,339,369,357,1265
Illinois,Shelbyville,4964,56,54,382,214,175,881
Illinois,Sheffield village,760,14,6,33,44,39,136
Illinois,Shawneetown,1330,49,21,106,56,61,293
Illinois,Shannon village,625,6,17,15,20,32,90
Illinois,Shabbona village,936,23,6,23,38,62,152
Illinois,Seymour,373,7,19,0,8,0,34
Illinois,Sesser,1959,31,53,72,52,66,274
Illinois,Seneca village,2521,45,12,125,168,242,592
Illinois,Secor village,355,6,1,23,21,26,77
Illinois,Seatonville village,311,3,6,15,15,14,53
Illinois,Seaton village,236,2,0,8,16,17,43
Illinois,Scottville village,68,0,0,0,0,1,1
Illinois,St. Anne village,1422,23,2,86,96,96,303
Illinois,St. Augustine village,120,0,0,0,15,1,16
Illinois,St. Charles,33685,685,405,1829,2024,1972,6915
Illinois,St. David village,609,16,5,10,25,30,86
Illinois,St. Elmo,1340,27,19,75,57,83,261
Illinois,St. Francisville,440,4,14,33,11,16,78
Illinois,Jeisyville village,111,2,3,7,14,0,26
Illinois,Bowen village,458,13,2,19,31,46,111
Illinois,Brimfield village,901,33,12,65,62,70,242
Illinois,Hillview village,182,13,7,9,11,20,60
Illinois,Hillside village,8190,55,108,552,288,618,1621
Illinois,Hillsdale village,547,6,8,34,44,33,125
Illinois,Hillsboro,8545,96,74,336,209,344,1059
Illinois,Hillcrest village,1167,15,8,77,104,124,328
Illinois,Highwood,5391,117,12,345,386,325,1185
Illinois,Highland Park,29789,895,374,1566,2091,1989,6915
Illinois,Highland,9848,151,153,462,423,493,1682
Illinois,Hidalgo village,108,1,3,8,11,3,26
Illinois,Ruma village,293,5,14,16,12,19,66
Illinois,Hickory Hills,13933,287,258,576,722,531,2374
Illinois,Heyworth village,2937,34,75,200,212,190,711
Illinois,Hettick village,176,0,1,2,4,8,15
Illinois,Herscher village,1548,37,25,100,94,92,348
Illinois,Belleville,42898,774,561,1947,2209,2415,7906
Illinois,Bellevue village,1566,17,20,65,83,56,241
Illinois,Bellflower village,330,3,5,10,18,13,49
Illinois,Hinckley village,2035,42,12,136,108,119,417
Illinois,Bellmont village,204,7,0,6,2,12,27
Illinois,Hindsboro village,330,5,3,13,7,12,40
Illinois,Hodgkins village,2097,50,23,106,123,95,397
Illinois,Huey village,199,0,0,16,11,7,34
Illinois,Hudson village,1931,32,36,124,122,118,432
Illinois,Hoyleton village,661,12,11,36,44,64,167
Illinois,Hopkins Park village,409,3,4,12,14,19,52
Illinois,Hopewell village,451,3,3,20,40,25,91
Illinois,Hopedale village,1013,5,27,50,67,43,192
Illinois,Hooppole village,337,7,6,60,32,10,115
Illinois,Hoopeston,5420,83,86,313,193,167,842
Illinois,Homewood village,19375,412,146,1046,1156,1448,4208
Illinois,Hometown,4356,150,22,149,135,227,683
Illinois,Homer Glen village,24358,483,240,1241,1257,1643,4864
Illinois,Homer village,1246,21,5,61,143,47,277
Illinois,Hollowayville village,68,0,0,0,1,5,6
Illinois,Holiday Shores,2913,59,24,196,102,143,524
Illinois,Holiday Hills village,658,11,7,33,41,31,123
Illinois,Hoffman Estates village,52271,1098,551,3012,2680,2867,10208
Illinois,Hoffman village,474,10,0,43,22,31,106
Illinois,Hinsdale village,17308,538,303,1308,1456,1554,5159
Illinois,Broadlands village,380,4,6,15,21,23,69
Illinois,Bellwood village,19190,238,299,970,1075,1240,3822
Illinois,Bement village,1744,29,19,94,109,93,344
Illinois,Bluford village,617,9,9,36,21,34,109
Illinois,Bolingbrook village,74371,1380,1642,4817,4510,4967,17316
Illinois,Bondville village,476,8,0,20,14,32,74
Illinois,Bone Gap village,201,6,0,16,18,15,55
Illinois,Bonfield village,319,4,5,17,27,19,72
Illinois,Bonnie village,403,7,4,15,24,9,59
Illinois,Boody,232,4,0,11,13,14,42
Illinois,Boulder Hill,8584,206,149,477,529,629,1990
Illinois,Bourbonnais village,18656,208,58,1159,985,918,3328
Illinois,Braceville village,757,25,12,56,27,35,155
Illinois,Bradford village,707,13,4,38,32,58,145
Illinois,Bradley village,15763,326,181,755,686,802,2750
Illinois,Braidwood,6049,19,78,274,309,375,1055
Illinois,Breese,4539,186,0,203,259,242,890
Illinois,Bridgeport,1196,25,34,105,88,69,321
Illinois,Bridgeview village,16359,212,278,1001,958,809,3258
Illinois,Brighton village,2109,38,69,85,116,126,434
Illinois,Bluffs village,795,21,12,35,41,54,163
Illinois,Belvidere,25741,227,536,1741,1776,1887,6167
Illinois,Blue Mound village,1055,10,16,84,82,55,247
Illinois,Bloomington,78206,1519,1019,4434,4169,3648,14789
Illinois,Benld,1657,41,24,91,120,95,371
Illinois,Bensenville village,18485,304,228,900,1006,1052,3490
Illinois,Benson village,427,14,2,15,31,11,73
Illinois,Bentley,37,0,0,0,0,2,2
Illinois,Benton,7319,110,40,411,331,338,1230
Illinois,Berkeley village,5217,110,55,237,316,435,1153
Illinois,Berlin village,144,0,0,0,5,4,9
Illinois,Berwyn,56706,997,768,3239,3231,3466,11701
Illinois,Bethalto village,9406,234,208,587,461,585,2075
Illinois,Bethany village,1308,22,15,114,101,87,339
Illinois,Biggsville village,298,0,0,7,11,32,50
Illinois,Big Rock village,1128,18,10,77,53,53,211
Illinois,Bingham village,45,0,0,2,0,0,2
Illinois,Bishop Hill village,136,0,1,0,0,1,2
Illinois,Bismarck village,598,2,10,42,27,37,118
Illinois,Blandinsville village,693,13,9,24,15,15,76
Illinois,Bloomingdale village,22261,326,315,779,890,695,3005
Illinois,Blue Island,23096,534,315,1504,1513,1402,5268
Illinois,Royalton village,1177,13,14,40,57,46,170
Illinois,Princeville village,2024,56,27,169,124,95,471
Illinois,Royal village,231,0,1,21,11,12,45
Illinois,Mitchell,1161,19,0,49,0,24,92
Illinois,Minooka village,11505,377,117,1031,885,865,3275
Illinois,Minonk,2087,20,33,128,124,178,483
Illinois,Minier village,1346,19,20,75,92,115,321
Illinois,Mineral village,248,9,0,6,18,18,51
Illinois,Milton village,287,19,6,15,17,3,60
Illinois,Pittsburg village,559,0,7,23,13,16,59
Illinois,Pittsfield,4611,82,27,264,205,292,870
Illinois,Plainfield village,40855,1281,575,3367,3644,2796,11663
Illinois,Plainville village,417,11,2,16,41,23,93
Illinois,Plano,11920,245,254,689,828,672,2688
Illinois,Plattville village,274,11,2,15,14,13,55
Illinois,Pleasant Hill village,1110,27,14,111,42,44,238
Illinois,Pleasant Plains village,904,20,13,71,59,55,218
Illinois,Plymouth village,429,1,0,10,7,13,31
Illinois,Pocahontas village,631,0,13,17,36,25,91
Illinois,Polo,2172,9,41,156,115,119,440
Illinois,Metropolis,6417,116,91,291,387,289,1174
Illinois,Mettawa village,430,2,3,26,17,20,68
Illinois,Middletown village,280,5,11,16,9,9,50
Illinois,Midlothian village,14906,268,190,774,509,1103,2844
Illinois,Milan village,5137,14,24,165,207,174,584
Illinois,Milford village,1289,32,11,91,60,57,251
Illinois,Modesto village,174,1,0,2,13,8,24
Illinois,Millbrook village,342,0,0,9,15,12,36
Illinois,Milledgeville village,1061,53,11,56,27,40,187
Illinois,Millington village,643,13,4,38,36,30,121
Illinois,Mill Shoals village,204,3,3,6,11,13,36
Illinois,Millstadt village,3930,124,40,222,144,195,725
Illinois,Pontoon Beach village,5840,145,33,336,363,111,988
Illinois,Pontiac,12085,217,98,569,604,705,2193
Illinois,Mill Creek village,36,0,0,0,0,0,0
Illinois,Metcalf village,204,0,1,10,19,26,56
Illinois,Mokena village,19369,317,253,922,1154,1438,4084
Illinois,Momence,2845,47,54,63,148,218,530
Illinois,Muncie village,193,2,0,9,18,12,41
Illinois,Mulkeytown,151,0,0,10,0,0,10
Illinois,Mulberry Grove village,662,35,6,38,51,20,150
Illinois,Muddy village,39,0,0,2,1,2,5
Illinois,Moweaqua village,1776,18,16,111,102,138,385
Illinois,Mount Zion village,6118,117,82,456,266,327,1248
Illinois,Mount Vernon,15136,242,307,639,645,849,2682
Illinois,Mount Sterling,2080,48,15,138,97,67,365
Illinois,Mount Pulaski,1336,20,22,97,94,74,307
Illinois,Mount Prospect village,54710,976,657,2976,2790,2667,10066
Illinois,Mount Olive,2090,62,63,98,119,128,470
Illinois,Mount Morris village,2997,57,25,182,240,180,684
Illinois,Mount Erie village,87,2,0,5,6,8,21
Illinois,Mount Clare village,206,2,0,3,8,7,20
Illinois,Mount Carroll,1685,45,15,46,82,77,265
Illinois,Mount Carmel,7098,176,6,358,346,363,1249
Illinois,Mount Auburn village,535,9,13,28,35,12,97
Illinois,Monee village,5114,72,61,245,429,299,1106
Illinois,Monmouth,9302,240,130,397,529,519,1815
Illinois,Monroe Center village,477,6,2,17,52,23,100
Illinois,Montgomery village,19196,393,348,1329,1506,1158,4734
Illinois,Monticello,5493,142,152,306,230,285,1115
Illinois,Montrose village,280,8,6,17,33,21,85
Illinois,Moline,43062,770,403,2212,2214,2382,7981
Illinois,Morris,14402,441,177,881,569,703,2771
Illinois,Morrisonville village,903,26,12,31,83,54,206
Illinois,Morton village,16534,330,249,984,825,856,3244
Illinois,Morton Grove village,23472,309,236,1079,919,1068,3611
Illinois,Mound City,634,18,0,63,82,27,190
Illinois,Mounds,1131,24,48,70,105,82,329
Illinois,Mound Station village,165,0,3,11,6,9,29
Illinois,Morrison,4225,147,48,202,259,236,892
Illinois,Mundelein village,31624,769,327,1649,1586,1869,6200
Illinois,Metamora village,3454,63,19,240,348,230,900
Illinois,Meredosia village,1043,15,22,67,43,44,191
Illinois,Mansfield village,896,16,2,37,56,48,159
Illinois,Manlius village,423,14,4,43,20,18,99
Illinois,Manito village,1689,21,20,77,91,102,311
Illinois,Manhattan village,7161,164,128,674,425,424,1815
Illinois,Manchester village,327,3,4,12,14,19,52
Illinois,Malta village,1118,25,18,104,78,57,282
Illinois,Malden village,375,6,3,35,16,29,89
Illinois,Makanda village,588,8,0,30,35,34,107
Illinois,Mahomet village,7762,155,118,586,454,513,1826
Illinois,Magnolia village,386,5,7,22,41,45,120
Illinois,Maeystown village,123,6,3,12,2,10,33
Illinois,Madison,4063,75,37,126,309,249,796
Illinois,Macon,1229,34,12,79,34,49,208
Illinois,Macomb,18944,186,156,536,494,529,1901
Illinois,McNabb village,360,6,4,28,45,18,101
Illinois,Abingdon,3105,37,64,229,230,89,649
Illinois,Adair,150,10,0,0,6,10,26
Illinois,Alma village,371,5,11,29,35,20,100
Illinois,Allerton village,231,3,2,7,9,11,32
Illinois,Allenville village,170,0,0,8,5,4,17
Illinois,Allendale village,717,20,25,39,62,46,192
Illinois,Alhambra village,633,14,8,24,24,17,87
Illinois,Algonquin village,30278,532,423,1385,2254,2285,6879
Illinois,Manteno village,9251,278,199,485,708,484,2154
Illinois,Alexis village,967,15,11,44,56,78,204
Illinois,Albion,2154,19,37,115,113,94,378
Illinois,Albers village,1134,12,15,61,96,65,249
Illinois,Albany village,1039,19,8,58,49,63,197
Illinois,Adeline village,83,0,0,3,1,1,5
Illinois,Addison village,37270,329,494,2724,1709,2273,7529
Illinois,Addieville village,311,3,1,10,7,26,47
Illinois,Aledo,3590,66,67,164,136,224,657
Illinois,Merrionette Park village,1812,49,21,45,32,94,241
Illinois,Maple Park village,1316,49,4,97,86,107,343
Illinois,Maquon village,340,5,8,16,22,12,63
Illinois,Menominee village,264,1,10,19,39,2,71
Illinois,Mendota,7321,102,82,372,373,381,1310
Illinois,Mendon village,912,12,16,56,37,65,186
Illinois,Melvin village,509,3,13,47,45,17,125
Illinois,Melrose Park village,25491,478,388,1728,1887,1573,6054
Illinois,Medora village,408,18,11,15,24,10,78
Illinois,Media village,148,5,0,4,5,0,14
Illinois,Mechanicsburg village,560,11,21,19,56,31,138
Illinois,Mazon village,1024,14,10,71,83,92,270
Illinois,Maywood village,24138,355,491,1358,1341,1244,4789
Illinois,Maunie village,122,0,0,3,5,3,11
Illinois,Mattoon,17646,269,221,882,666,823,2861
Illinois,Matteson village,19159,253,250,1284,1227,1083,4097
Illinois,Matherville village,960,29,8,77,62,34,210
Illinois,Mason City,2305,67,30,85,146,149,477
Illinois,Mason,463,7,15,9,51,27,109
Illinois,Mascoutah,7801,160,125,605,598,617,2105
Illinois,Marengo,7714,109,65,478,551,482,1685
Illinois,Marietta village,218,0,0,6,2,4,12
Illinois,Marine village,1107,15,3,21,23,59,121
Illinois,Marion,17588,97,229,779,912,770,2787
Illinois,Marissa village,2011,45,29,73,123,91,361
Illinois,Mark village,599,12,4,19,14,35,84
Illinois,Mapleton village,329,4,6,27,25,17,79
Illinois,Markham,12685,185,263,828,710,875,2861
Illinois,Marquette Heights,2851,67,70,184,125,151,597
Illinois,Marseilles,4757,109,45,245,322,286,1007
Illinois,Marshall,3895,91,54,224,281,146,796
Illinois,Martinsville,1219,18,8,36,28,67,157
Illinois,Martinton village,304,2,4,21,9,32,68
Illinois,Maryville village,7791,111,200,341,365,450,1467
Illinois,Maroa,1724,35,32,109,95,74,345
Illinois,Murphysboro,8055,143,45,374,242,507,1311
Illinois,Murrayville village,472,2,9,20,26,15,72
Illinois,Naperville,145058,2788,2148,8364,9364,10494,33158
Illinois,Oak Brook village,7977,42,77,317,371,451,1258
Illinois,Norwood village,491,13,13,22,10,21,79
Illinois,North Utica village,1401,28,10,81,41,57,217
Illinois,North Riverside village,6991,149,61,280,341,505,1336
Illinois,North Pekin village,1480,12,41,113,84,58,308
Illinois,Northlake,12353,167,192,608,685,892,2544
Illinois,North Henderson village,184,5,2,5,7,15,34
Illinois,Northfield village,5305,70,41,201,338,501,1151
Illinois,North City village,834,7,20,75,56,40,198
Illinois,North Chicago,29925,481,345,1563,1310,1096,4795
Illinois,Northbrook village,33572,916,381,1992,1780,2141,7210
Illinois,North Barrington village,3032,34,35,152,171,219,611
Illinois,North Aurora village,17154,337,313,977,765,1011,3403
Illinois,Norris City village,1358,6,25,42,104,68,245
Illinois,Norris village,172,3,0,6,16,11,36
Illinois,Norridge village,14856,171,164,565,445,673,2018
Illinois,Normal,54488,913,604,2134,2223,2015,7889
Illinois,Oreana village,885,9,15,64,64,47,199
Illinois,New Holland village,179,0,1,8,9,4,22
Illinois,New Lenox village,25024,443,366,1676,1733,1817,6035
Illinois,Newman,916,17,4,44,93,20,178
Illinois,New Milford village,791,0,5,35,66,32,138
Illinois,New Minden village,233,6,1,9,20,4,40
Illinois,Oakbrook Terrace,2252,42,31,31,43,72,219
Illinois,New Salem village,129,0,2,2,5,4,13
Illinois,Niantic village,628,15,2,30,26,30,103
Illinois,Niles village,29955,338,183,1043,1178,959,3701
Illinois,Nilwood,223,3,5,6,9,2,25
Illinois,Noble village,574,18,6,44,31,31,130
Illinois,Nokomis,2294,77,45,178,159,67,526
Illinois,Nora village,113,1,0,2,3,13,19
Illinois,Newton,2818,28,39,113,154,152,486
Illinois,Oregon,3715,67,51,77,143,212,550
Illinois,Oakdale village,189,7,2,9,14,10,42
Illinois,Oak Forest,28134,548,240,1074,1212,1668,4742
Illinois,Orangeville village,929,28,6,65,61,48,208
Illinois,Oquawka village,1367,16,17,70,52,84,239
Illinois,Opdyke,339,0,0,41,36,7,84
Illinois,Oneida,776,7,9,67,55,52,190
Illinois,Onarga village,1381,5,15,111,91,141,363
Illinois,Omaha village,308,4,1,23,20,13,61
Illinois,Olympia Fields village,4916,55,14,149,135,197,550
Illinois,Olney,9085,143,51,569,533,454,1750
Illinois,Olmsted village,422,5,2,47,34,20,108
Illinois,Olivet,319,0,0,0,9,16,25
Illinois,Olive Branch,698,0,12,56,46,16,130
Illinois,Old Shawneetown village,174,1,0,23,1,12,37
Illinois,Old Ripley village,100,0,0,1,4,4,9
Illinois,Old Mill Creek village,152,0,0,5,5,6,16
Illinois,Okawville village,1460,35,8,75,84,92,294
Illinois,Ohlman village,110,4,1,7,9,4,25
Illinois,Ohio village,424,2,5,21,20,26,74
Illinois,Oak Grove village,762,10,0,91,28,55,184
Illinois,Oakland,910,7,13,32,51,57,160
Illinois,Oak Lawn village,56980,1128,567,2625,2696,2639,9655
Illinois,Oak Park village,52080,1163,775,2882,2769,2847,10436
Illinois,Oak Run,499,20,0,14,5,6,45
Illinois,Oakwood village,1650,13,27,103,100,66,309
Illinois,Oakford village,335,6,0,33,9,23,71
Illinois,Oakwood Hills village,2152,14,15,59,152,131,371
Illinois,Oconee village,199,5,0,9,14,25,53
Illinois,Odell village,1000,27,7,71,51,109,265
Illinois,Odin village,1052,11,10,65,53,26,165
Illinois,O'Fallon,29144,757,301,1764,1726,2021,6569
Illinois,Ogden village,740,2,11,40,41,29,123
Illinois,Oglesby,3880,147,33,254,210,145,789
Illinois,Oblong village,1472,31,51,60,64,76,282
Illinois,Orient,358,4,8,4,21,23,60
Illinois,Orion village,2011,46,39,123,97,132,437
Illinois,Orland Hills village,7259,10,71,453,481,682,1697
Illinois,Peru,10019,237,78,434,442,512,1703
Illinois,Pesotum village,520,11,5,17,37,10,80
Illinois,Petersburg,2357,69,64,146,186,136,601
Illinois,Phillipstown village,30,2,0,2,0,1,5
Illinois,Philo village,1737,45,42,157,118,127,489
Illinois,Phoenix village,2088,18,24,105,159,184,490
Illinois,Pierron village,460,20,5,25,33,10,93
Illinois,Pinckneyville,5450,106,109,181,255,332,983
Illinois,Pingree Grove village,5460,0,0,335,671,59,1065
Illinois,Piper City village,825,8,7,16,51,35,117
Illinois,Pistakee Highlands,3212,21,73,111,159,252,616
Illinois,New Haven village,373,4,6,13,36,6,65
Illinois,New Grand Chain village,173,4,0,12,16,5,37
Illinois,New Douglas village,355,9,7,20,19,18,73
Illinois,New Canton,364,4,10,11,21,15,61
Illinois,New Burnside village,205,2,2,10,3,3,20
Illinois,New Boston,698,18,20,47,23,20,128
Illinois,Naplate village,438,5,7,21,21,23,77
Illinois,Naples,48,0,0,2,0,0,2
Illinois,Nashville,3265,94,42,205,155,123,619
Illinois,Nason,241,1,0,7,9,11,28
Illinois,Nauvoo,1362,10,29,83,45,73,240
Illinois,Nebo village,310,9,2,10,7,35,63
Illinois,Perry village,329,0,2,4,13,12,31
Illinois,Nelson village,153,4,3,21,12,5,45
Illinois,Neponset village,603,12,2,32,44,24,114
Illinois,Newark village,1131,9,10,83,91,63,256
Illinois,New Athens village,2072,64,13,115,130,119,441
Illinois,New Baden village,3432,55,101,237,131,123,647
Illinois,New Bedford village,67,1,2,1,0,2,6
Illinois,New Berlin village,1501,27,16,139,118,111,411
Illinois,Neoga,1602,3,21,131,104,102,361
Illinois,Percy village,854,28,0,43,41,30,142
Illinois,Peotone village,3990,108,49,195,227,397,976
Illinois,Peoria Heights village,6046,75,50,142,239,189,695
Illinois,Panama village,262,13,0,21,14,10,58
Illinois,Pana,5684,129,83,367,233,206,1018
Illinois,Palos Park village,4944,43,105,161,275,187,771
Illinois,Palos Hills,17596,486,108,514,670,1129,2907
Illinois,Palos Heights,12566,137,104,478,598,635,1952
Illinois,Palmyra village,584,11,2,28,23,43,107
Illinois,Panola village,53,2,2,2,1,2,9
Illinois,Palmer village,135,1,1,5,3,5,15
Illinois,Palatine village,69188,1203,1004,3743,3566,4531,14047
Illinois,Paderborn,36,0,0,0,0,0,0
Illinois,Owaneco village,183,4,2,2,6,10,24
Illinois,Ottawa,18565,466,244,902,1168,932,3712
Illinois,Oswego village,32468,905,332,2905,2031,2456,8629
Illinois,Orland Park village,58273,709,388,2473,2989,3407,9966
Illinois,Palestine village,1375,28,11,68,49,62,218
Illinois,Alorton village,1867,59,42,149,85,188,523
Illinois,Papineau village,306,4,4,42,2,7,59
Illinois,Park City,7432,233,197,668,421,494,2013
Illinois,Peoria,115847,2319,1854,6513,6110,5539,22335
Illinois,Penfield,159,0,0,2,5,12,19
Illinois,Pekin,33905,568,561,1620,1573,1331,5653
Illinois,Pecatonica village,2234,57,63,158,136,172,586
Illinois,Pearl City village,884,32,11,55,57,52,207
Illinois,Pearl village,250,4,7,14,35,6,66
Illinois,Paris,8517,201,165,326,428,369,1489
Illinois,Payson village,1261,12,15,49,54,31,161
Illinois,Paw Paw village,797,1,2,29,37,42,111
Illinois,Pawnee village,2730,45,46,181,230,179,681
Illinois,Patoka village,529,5,3,22,30,25,85
Illinois,Park Ridge,37608,768,425,2005,2630,2181,8009
Illinois,Park Forest village,21928,442,264,1418,1508,1567,5199
Illinois,Parkersburg village,147,2,0,4,9,7,22
Illinois,Paxton,4252,33,79,202,166,227,707
Illinois,Alpha village,558,6,5,22,21,22,76
Illinois,Alsey village,233,18,3,21,16,9,67
Illinois,Alsip village,19396,440,330,943,1035,1055,3803
Illinois,Kempton village,150,0,1,5,9,13,28
Illinois,Kell village,196,6,2,8,1,13,30
Illinois,Keithsburg,609,9,6,15,24,16,70
Illinois,Keensburg village,138,0,0,11,11,2,24
Illinois,Keenes village,71,0,0,2,5,4,11
Illinois,Kaskaskia village,20,0,0,0,0,0,0
Illinois,Karnak village,605,18,0,28,48,53,147
Illinois,Kappa village,313,6,7,27,5,9,54
Illinois,Kansas village,655,7,18,36,46,37,144
Illinois,Kankakee,26821,624,396,2150,1494,1331,5995
Illinois,Kangley village,337,6,6,11,29,23,75
Illinois,Kaneville village,432,11,6,24,33,22,96
Illinois,Kane village,383,8,17,4,36,21,86
Illinois,Kampsville village,304,2,2,10,15,15,44
Illinois,Justice village,13015,322,246,889,830,554,2841
Illinois,Junction City village,513,10,0,31,27,35,103
Illinois,Junction village,113,0,0,7,13,13,33
Illinois,Annapolis,40,0,0,0,0,0,0
Illinois,Anna,4360,91,27,267,254,169,808
Illinois,Andover village,554,10,6,25,30,24,95
Illinois,Andalusia village,1384,11,21,24,77,157,290
Illinois,Anchor village,145,4,2,15,7,4,32
Illinois,Amboy,2535,28,58,58,124,197,465
Illinois,Kenilworth village,2653,51,57,208,280,291,887
Illinois,Alvan village,286,2,1,10,21,12,46
Illinois,Johnsonville village,57,0,0,0,12,0,12
Illinois,Johnston City,3531,67,40,232,189,184,712
Illinois,Joliet,147918,3005,2343,10087,9700,9971,35106
Illinois,Jonesboro,2059,35,8,121,121,80,365
Illinois,Joppa village,342,0,10,24,31,21,86
Illinois,Joy village,378,8,1,23,17,28,77
Illinois,Alto Pass village,402,4,0,38,40,39,121
Illinois,Annawan,900,23,4,68,55,55,205
Illinois,Kenney village,330,8,2,9,10,20,49
Illinois,Keyesport village,542,31,9,11,42,13,106
Illinois,Lake Villa village,8878,209,73,642,804,648,2376
Illinois,Lake Summerset,1999,14,44,75,153,69,355
Illinois,Lake Petersburg,628,0,0,0,0,21,21
Illinois,Lake of the Woods,2941,77,72,225,114,270,758
Illinois,Lakemoor village,6535,217,59,448,377,484,1585
Illinois,Lake Ka-Ho village,232,0,1,12,10,5,28
Illinois,Lake in the Hills village,28968,589,490,2210,1894,1840,7023
Illinois,Lake Holiday,4852,199,38,166,311,265,979
Illinois,Lake Forest,18951,370,240,1061,1237,1222,4130
Illinois,Lake Catherine,1712,23,21,76,53,58,231
Illinois,Lake Camelot,1986,75,33,129,125,93,455
Illinois,Lake Bluff village,5813,55,83,227,463,550,1378
Illinois,Lake Barrington village,4934,29,19,88,195,247,578
Illinois,La Harpe,1414,9,19,56,91,81,256
Illinois,La Grange Park village,13649,300,139,923,806,611,2779
Illinois,La Grange village,15709,522,178,1104,1179,1146,4129
Illinois,La Fayette village,252,0,4,7,26,24,61
Illinois,Kilbourne village,284,4,5,15,6,17,47
Illinois,Kildeer village,3938,46,43,229,211,446,975
Illinois,Kincaid village,1653,57,16,113,106,85,377
Illinois,Kinderhook village,269,11,6,10,28,19,74
Illinois,Kingston village,1066,4,5,47,111,66,233
Illinois,Kingston Mines village,288,3,0,17,17,7,44
Illinois,Kewanee,12736,320,164,451,706,783,2424
Illinois,Kinmundy,1015,28,5,116,50,70,269
Illinois,Kirkland village,1655,54,22,114,100,123,413
Illinois,Kirkwood village,773,12,8,46,62,51,179
Illinois,Knollwood,1613,17,9,26,88,108,248
Illinois,Knoxville,2827,32,4,145,152,160,493
Illinois,Lacon,1996,56,11,103,107,118,395
Illinois,Ladd village,1212,5,5,60,61,43,174
Illinois,Kinsman village,118,5,0,3,8,6,22
Illinois,Antioch village,14386,362,275,710,1311,718,3376
Illinois,Apple Canyon Lake,304,0,0,0,0,0,0
Illinois,Apple River village,456,12,4,41,23,24,104
Illinois,Basco village,78,2,0,4,0,9,15
Illinois,Batavia,26105,522,360,1530,1408,1887,5707
Illinois,Batchtown village,189,1,0,0,6,3,10
Illinois,Bath village,267,1,3,9,21,20,54
Illinois,Baylis village,195,4,0,3,0,5,12
Illinois,Bay View Gardens village,336,2,0,16,11,35,64
Illinois,Beach Park village,13833,171,174,705,868,833,2751
Illinois,Beardstown,6217,225,84,328,430,353,1420
Illinois,Beason,70,0,0,7,6,7,20
Illinois,Beaverville village,285,4,5,23,18,32,82
Illinois,Beckemeyer village,948,14,3,26,27,32,102
Illinois,Bedford Park village,646,2,33,33,26,28,122
Illinois,Beecher village,4532,13,45,215,356,270,899
Illinois,Beecher City village,454,7,3,38,25,38,111
Illinois,Belgium village,325,1,4,14,11,22,52
Illinois,Belknap village,54,0,0,0,0,2,2
Illinois,Belle Prairie City,60,1,0,5,4,2,12
Illinois,Roxana village,1653,64,34,58,102,88,346
Illinois,Round Lake Park village,7957,130,212,500,376,450,1668
Illinois,Round Lake Heights village,2908,60,59,210,282,240,851
Illinois,Round Lake Beach village,27966,427,558,1760,1815,2050,6610
Illinois,Round Lake village,18446,615,215,1462,1332,1257,4881
Illinois,Rossville village,1675,24,37,72,59,105,297
Illinois,Bartonville village,6438,77,25,422,346,201,1071
Illinois,Rosiclare,950,11,13,49,71,38,182
Illinois,Roseville village,1135,35,7,77,34,44,197
Illinois,Rosemont village,4305,83,51,238,253,172,797
Illinois,Roselle village,22979,357,284,1155,1349,1694,4839
Illinois,Rose Hill village,50,2,1,0,2,0,5
Illinois,Roscoe village,10536,210,195,651,798,694,2548
Illinois,Belle Rive village,301,0,3,10,29,8,50
Illinois,Rosewood Heights,4051,39,0,90,155,260,544
Illinois,Bartlett village,41552,830,804,2358,2185,2459,8636
Illinois,Bartelso village,608,12,19,20,30,50,131
Illinois,Barry,1300,24,22,76,74,76,272
Illinois,Ashton village,958,14,18,71,27,72,202
Illinois,Ashmore village,828,5,17,60,31,50,163
Illinois,Ashley,563,19,7,20,29,41,116
Illinois,Ashland village,1318,19,25,56,59,44,203
Illinois,Ashkum village,795,13,16,38,57,65,189
Illinois,Arthur village,2563,72,6,107,145,180,510
Illinois,Assumption,1315,5,22,122,94,69,312
Illinois,Arrowsmith village,316,10,14,12,21,21,78
Illinois,Armington village,360,10,15,29,18,21,93
Illinois,Arlington Heights village,75802,1442,907,3266,3734,3812,13161
Illinois,Arlington village,166,1,1,6,7,7,22
Illinois,Argenta village,958,22,2,59,78,54,215
Illinois,Arenzville village,364,7,0,10,46,23,86
Illinois,Arcola,2961,83,34,185,118,98,518
Illinois,Aroma Park village,659,7,4,37,35,17,100
Illinois,Lakewood village,4258,94,22,159,256,509,1040
Illinois,Astoria,1198,19,19,68,76,74,256
Illinois,Atkinson,1006,13,0,87,34,42,176
Illinois,Barrington Hills village,3370,0,20,83,172,290,565
Illinois,Barrington village,10576,220,158,710,634,839,2561
Illinois,Bardolph village,268,13,1,3,16,15,48
Illinois,Bannockburn village,1390,16,7,28,25,38,114
Illinois,Banner village,207,1,4,7,11,19,42
Illinois,Baldwin village,409,6,8,9,14,16,53
Illinois,Athens,1776,50,19,113,109,87,378
Illinois,Avon village,686,11,5,44,23,49,132
Illinois,Ava,661,13,19,41,38,47,158
Illinois,Aurora,200614,3609,4191,15059,13606,12984,49449
Illinois,Augusta village,573,4,0,18,9,57,88
Illinois,Auburn,4870,116,83,371,271,332,1173
Illinois,Atwood village,1115,3,0,66,38,48,155
Illinois,Atlanta,1321,37,14,92,73,39,255
Illinois,Aviston village,2228,33,36,153,116,111,449
Illinois,Royal Lakes village,155,3,1,5,11,6,26
Illinois,Lakewood Shores,1385,14,7,63,64,117,265
Illinois,La Moille village,793,6,14,39,35,51,145
Illinois,Richton Park village,13744,271,89,612,568,1246,2786
Illinois,Richview village,203,2,0,17,13,12,44
Illinois,Ridge Farm village,838,3,4,31,22,48,108
Illinois,Ridgway village,804,5,11,23,9,26,74
Illinois,Ridott village,155,2,0,8,8,11,29
Illinois,Ringwood village,791,15,5,28,102,81,231
Illinois,Rio village,204,6,1,6,9,13,35
Illinois,Ripley village,94,0,0,1,12,4,17
Illinois,Riverdale village,13106,289,181,687,833,983,2973
Illinois,River Forest village,11233,195,213,545,730,793,2476
Illinois,River Grove village,10260,165,152,327,461,528,1633
Illinois,Riverside village,8859,149,104,537,536,803,2129
Illinois,Riverton village,3478,12,41,253,310,251,867
Illinois,Riverwoods village,3811,81,46,211,322,250,910
Illinois,Roanoke village,2189,45,42,74,83,122,366
Illinois,Robbins village,5157,124,20,271,256,459,1130
Illinois,Roberts village,311,0,4,19,21,22,66
Illinois,Rome,1831,18,36,121,70,50,295
Illinois,Rolling Meadows,23401,392,240,1274,1149,1052,4107
Illinois,Rockwood village,63,0,0,2,2,17,21
Illinois,Rockton village,7567,143,123,447,436,486,1635
Illinois,Rock Island Arsenal,131,0,0,0,28,12,40
Illinois,Rock Island,38946,541,576,2029,1781,2004,6931
Illinois,Richmond village,1989,15,8,98,152,102,375
Illinois,Rockford,150283,2943,2302,8689,8229,8290,30453
Illinois,Rockdale village,2061,29,19,107,79,78,312
Illinois,Rock City village,288,12,0,30,24,10,76
Illinois,Rockbridge village,180,6,0,0,6,6,18
Illinois,Rochester village,3883,130,57,275,297,291,1050
Illinois,Rochelle,9440,169,172,512,632,445,1930
Illinois,Robinson,7506,150,36,376,227,358,1147
Illinois,Rock Falls,9178,291,61,366,499,444,1661
Illinois,Romeoville village,39774,900,472,2406,3031,2804,9613
Illinois,Reynolds village,451,11,4,23,33,28,99
Illinois,Redmon village,124,0,0,5,3,2,10
Illinois,Altamont,2399,30,35,141,129,128,463
Illinois,Alton,27335,604,405,1446,1494,1285,5234
Illinois,Altona village,494,21,7,33,30,33,124
Illinois,Pontoosuc village,94,0,0,3,3,2,8
Illinois,Poplar Grove village,5258,68,51,370,407,158,1054
Illinois,Port Barrington village,1451,46,25,69,104,103,347
Illinois,Port Byron village,1708,30,13,104,79,111,337
Illinois,Posen village,6319,95,176,271,489,546,1577
Illinois,Potomac village,700,8,15,44,55,51,173
Illinois,Prairie City village,508,12,5,26,45,28,116
Illinois,Prairie du Rocher village,694,4,26,50,37,27,144
Illinois,Prairie Grove village,1685,13,10,79,131,178,411
Illinois,Prestbury,1580,70,0,85,58,69,282
Illinois,Preston Heights,2907,0,26,266,124,164,580
Illinois,Princeton,7719,150,82,336,312,431,1311
Illinois,Broadview village,7957,70,61,323,352,349,1155
Illinois,Prophetstown,2150,46,33,42,150,169,440
Illinois,Reddick village,353,7,0,12,26,26,71
Illinois,Red Bud,3623,44,52,154,279,179,708
Illinois,Raymond village,781,12,2,59,38,28,139
Illinois,Raritan village,93,0,0,7,3,0,10
Illinois,Rapids City village,1047,3,8,45,73,70,199
Illinois,Rantoul village,13256,232,340,1012,673,1200,3457
Illinois,Rentchler,0,0,0,0,0,0,0
Illinois,Ransom village,354,3,1,9,16,21,50
Illinois,Ramsey village,1274,9,32,93,95,64,293
Illinois,Raleigh village,306,1,4,9,17,5,36
Illinois,Radom village,163,0,2,4,4,10,20
Illinois,Quincy,40763,642,550,2196,2239,1489,7116
Illinois,Pulaski village,182,0,0,7,20,2,29
Illinois,Prospect Heights,16370,389,268,1059,708,572,2996
Illinois,Rankin village,393,0,3,23,17,22,65
Illinois,Roodhouse,1788,38,18,89,131,100,376
Illinois,McLeansboro,2894,47,60,119,203,132,561
Illinois,McLean village,821,3,13,46,28,44,134
Illinois,Lindenhurst village,14414,209,254,819,1036,1207,3525
Illinois,Lincolnwood village,12666,225,205,556,648,670,2304
Illinois,Lincolnshire village,7271,143,72,419,352,370,1356
Illinois,Lincoln,14285,170,156,834,662,579,2401
Illinois,Limestone village,1435,7,10,90,109,77,293
Illinois,Lima village,175,0,6,13,16,2,37
Illinois,Lily Lake village,1113,10,19,68,74,74,245
Illinois,Libertyville village,20395,460,228,1020,1515,1430,4653
Illinois,Liberty village,512,2,3,43,34,31,113
Illinois,Lexington,2153,39,22,121,168,84,434
Illinois,Lewistown,2395,13,63,116,101,117,410
Illinois,Le Roy,3584,124,58,184,166,384,916
Illinois,Lerna village,324,0,4,21,17,23,65
Illinois,Leonore village,75,1,1,4,1,2,9
Illinois,Lenzburg village,509,17,19,32,27,31,126
Illinois,Lena village,2935,56,16,166,242,88,568
Illinois,Lemont village,16513,363,217,762,1179,1186,3707
Illinois,Lanark,1625,47,5,96,104,117,369
Illinois,Langleyville,348,9,0,17,9,18,53
Illinois,Lansing village,28445,201,166,1276,1453,2075,5171
Illinois,LaPlace,157,6,0,0,8,8,22
Illinois,La Prairie village,84,0,0,4,3,8,15
Illinois,La Rose village,113,1,2,2,6,4,15
Illinois,Lisbon village,368,8,2,21,24,31,86
Illinois,LaSalle,9510,126,50,513,536,345,1570
Illinois,Lawrenceville,4486,125,121,246,316,290,1098
Illinois,Leaf River village,585,2,17,42,48,48,157
Illinois,Lebanon,4259,27,112,210,106,85,540
Illinois,Lee village,352,3,10,14,36,25,88
Illinois,Leland village,978,9,16,53,50,40,168
Illinois,Leland Grove,1617,23,2,62,96,37,220
Illinois,Latham village,277,3,1,16,13,14,47
Illinois,Lisle village,22747,579,282,1005,945,940,3751
Illinois,Litchfield,7004,181,13,347,380,690,1611
Illinois,Littleton village,175,0,4,6,17,7,34
Illinois,Loves Park,24494,408,437,1391,1539,1556,5331
Illinois,Lovington village,1042,10,8,55,63,26,162
Illinois,Ludlow village,393,4,7,21,24,13,69
Illinois,Lyndon village,682,15,25,28,48,37,153
Illinois,Lynnville village,62,0,0,4,8,1,13
Illinois,Lynwood village,9297,78,54,407,575,555,1669
Illinois,Louisville village,1038,6,38,56,61,45,206
Illinois,Lyons village,10668,92,25,596,403,576,1692
Illinois,McCook village,208,7,6,8,0,2,23
Illinois,McCullom Lake village,913,18,3,57,40,43,161
Illinois,Macedonia village,59,0,0,0,0,0,0
Illinois,McHenry,26739,566,395,1309,1586,1831,5687
Illinois,Machesney Park village,23037,449,153,908,1345,1486,4341
Illinois,Mackinaw village,2357,75,18,132,138,109,472
Illinois,McClure village,376,3,9,25,29,28,94
Illinois,Lake Zurich village,19923,317,295,1093,1339,1444,4488
Illinois,Lost Nation,650,0,0,0,41,38,79
Illinois,Loraine village,301,3,2,25,20,9,59
Illinois,Little York village,288,3,0,31,16,6,56
Illinois,Liverpool village,144,7,0,5,6,18,36
Illinois,Livingston village,809,19,23,24,41,15,122
Illinois,Loami village,932,17,23,69,88,87,284
Illinois,Lockport,25088,796,488,1679,1442,1375,5780
Illinois,Loda village,323,0,2,11,10,21,44
Illinois,Lostant village,396,1,6,21,20,18,66
Illinois,Lomax village,358,4,0,6,16,20,46
Illinois,London Mills village,375,12,0,20,11,44,87
Illinois,Long Creek village,1528,11,51,78,73,75,288
Illinois,Long Grove village,8086,158,55,438,565,795,2011
Illinois,Long Lake,3715,49,33,115,303,345,845
Illinois,Long Point village,204,4,4,16,11,1,36
Illinois,Longview village,146,11,6,1,5,9,32
Illinois,Lombard village,43957,540,377,2107,2116,2137,7277
Illinois,Broadwell village,117,0,0,1,5,20,26
Illinois,Otterville,99,2,5,2,1,4,14
Illinois,Winfield village,9492,276,127,398,497,587,1885
Illinois,Smithboro village,169,0,0,11,6,4,21
Illinois,Smithfield village,187,0,4,17,17,10,48
Illinois,Smithton village,3827,100,69,113,207,192,681
Illinois,Somonauk village,2128,51,41,125,124,155,496
Illinois,Sorento village,527,12,5,43,52,46,158
Illinois,South Barrington village,4835,61,98,350,224,306,1039
Illinois,South Beloit,8131,258,164,692,489,332,1935
Illinois,South Chicago Heights village,4152,49,71,155,139,239,653
Illinois,South Elgin village,22227,424,344,1893,1730,1606,5997
Illinois,Southern View village,2010,32,24,87,137,81,361
Illinois,South Holland village,22124,395,328,1017,1259,1581,4580
Illinois,South Jacksonville village,3299,145,14,152,81,84,476
Illinois,Darmstadt,0,0,0,0,0,0,0
Illinois,South Pekin village,1175,17,27,66,114,72,296
Illinois,South Roxana village,2362,49,66,179,101,142,537
Illinois,South Wilmington village,770,16,5,41,34,24,120
Illinois,Sparland village,395,9,8,18,11,5,51
Illinois,Sleepy Hollow village,3337,28,72,160,242,281,783
Illinois,Skokie village,65061,1302,754,2910,2590,3629,11185
Illinois,Sims village,313,9,9,22,18,5,63
Illinois,Simpson village,103,7,0,14,9,10,40
Illinois,Bryant village,200,5,0,2,9,14,30
Illinois,Buckingham village,304,3,2,21,26,46,98
Illinois,Buckley village,578,5,4,13,25,49,96
Illinois,Buckner village,428,11,8,16,12,18,65
Illinois,Buda village,644,4,11,36,37,41,129
Illinois,Sheldon village,1222,19,14,66,73,93,265
Illinois,Sheridan village,2320,21,6,43,59,251,380
Illinois,Sherman village,4565,109,101,181,298,348,1037
Illinois,Sparta,4371,54,58,98,131,221,562
Illinois,Sherrard village,759,17,3,43,56,32,151
Illinois,Shipman,679,4,14,39,40,27,124
Illinois,Shorewood village,16354,347,226,949,840,958,3320
Illinois,Shumway village,188,0,1,6,10,10,27
Illinois,Sibley village,355,7,2,25,24,18,76
Illinois,Sidell village,598,27,2,9,39,44,121
Illinois,Sidney village,1300,10,6,59,79,63,217
Illinois,Sigel,394,9,6,34,20,21,90
Illinois,Silvis,7522,251,149,356,518,248,1522
Illinois,Shiloh village,12902,351,146,700,779,562,2538
Illinois,Brussels village,132,5,0,4,4,10,23
Illinois,Spaulding village,773,7,12,20,48,65,152
Illinois,Spring Bay village,502,19,8,31,20,43,121
Illinois,Streamwood village,40865,618,566,2429,2066,2234,7913
Illinois,Streator,12990,159,160,648,780,759,2506
Illinois,Stronghurst village,811,7,9,49,16,33,114
Illinois,Sublette village,413,7,2,8,8,20,45
Illinois,Sugar Grove village,9195,118,65,725,674,505,2087
Illinois,Davis village,790,33,20,29,76,55,213
Illinois,Davis Junction village,2532,46,47,228,291,177,789
Illinois,Dawson village,545,10,3,17,19,43,92
Illinois,Dayton,491,5,5,4,11,25,50
Illinois,Decatur,74654,1333,1173,3517,3409,3503,12935
Illinois,Deer Creek village,731,8,7,38,47,45,145
Illinois,Deerfield village,18588,557,154,1210,1523,1506,4950
Illinois,Deer Grove village,38,1,0,4,2,3,10
Illinois,Deer Park village,3323,37,36,216,271,192,752
Illinois,DeKalb,43483,620,686,1888,1808,1868,6870
Illinois,De Land village,430,2,3,12,49,25,91
Illinois,Delavan,1625,17,30,99,67,108,321
Illinois,Strawn village,109,1,1,9,9,2,22
Illinois,Strasburg village,550,6,9,17,27,12,71
Illinois,Stoy village,164,0,6,0,8,0,14
Illinois,Stonington village,957,25,18,59,77,67,246
Illinois,Springerton village,120,0,0,7,8,0,15
Illinois,Springfield,117061,2277,1350,5943,5872,5540,20982
Illinois,Spring Grove village,5510,118,42,389,336,623,1508
Illinois,Spring Valley,5405,78,134,246,277,123,858
Illinois,Standard village,235,9,0,12,22,18,61
Illinois,Standard City village,214,9,10,10,17,13,59
Illinois,Stanford village,688,29,4,53,36,48,170
Illinois,Staunton,4965,41,26,164,204,411,846
Illinois,Spillertown village,250,5,0,21,16,21,63
Illinois,Steeleville village,2171,65,7,74,159,98,403
Illinois,Sterling,15170,238,122,941,1024,740,3065
Illinois,Steward village,338,2,5,8,18,27,60
Illinois,Stewardson village,757,15,12,22,46,57,152
Illinois,Stickney village,6804,164,27,432,470,428,1521
Illinois,Stillman Valley village,1048,30,23,46,65,71,235
Illinois,Stockton village,1931,39,5,35,145,144,368
Illinois,Stonefort village,404,11,5,43,32,23,114
Illinois,Stone Park village,4947,83,107,359,156,350,1055
Illinois,Steger village,9563,165,163,520,373,500,1721
Illinois,De Pue village,1852,50,16,136,119,141,462
Illinois,Brownstown village,777,10,8,57,37,64,176
Illinois,Browning village,103,0,2,18,0,2,22
Illinois,Campbell Hill village,304,5,2,28,6,14,55
Illinois,Camden village,114,3,0,0,8,6,17
Illinois,Timberlane village,937,17,13,73,86,47,236
Illinois,Time village,21,0,0,0,0,0,0
Illinois,Tinley Park village,57176,1168,748,2859,2963,3276,11014
Illinois,Tiskilwa village,898,10,21,89,32,83,235
Illinois,Toledo village,1309,9,19,59,121,89,297
Illinois,Tolono village,3066,81,119,167,164,94,625
Illinois,Toluca,1332,45,9,66,17,39,176
Illinois,Tonica village,771,7,3,48,69,41,168
Illinois,Topeka village,82,0,0,0,10,12,22
Illinois,Toulon,1336,20,20,71,92,48,251
Illinois,Tovey village,483,18,0,27,27,14,86
Illinois,Towanda village,561,13,14,18,29,20,94
Illinois,Tower Hill village,508,16,1,22,26,53,118
Illinois,Tower Lakes village,1158,35,14,79,98,77,303
Illinois,Tremont village,2170,33,24,100,70,157,384
Illinois,Camp Point village,1150,22,14,73,59,45,213
Illinois,Campton Hills village,11012,181,204,654,961,955,2955
Illinois,Campus village,158,0,2,7,9,4,22
Illinois,Candlewick Lake,4486,26,94,148,176,419,863
Illinois,Thornton village,2615,66,30,116,154,117,483
Illinois,Tilden village,687,0,10,17,18,50,95
Illinois,Tilton village,2669,9,31,153,100,135,428
Illinois,Carterville,5691,72,48,452,311,258,1141
Illinois,Carrollton,2478,41,43,147,92,98,421
Illinois,Carrier Mills village,2081,36,3,89,135,110,373
Illinois,Carpentersville village,38264,881,1093,2798,2826,2686,10284
Illinois,Carol Stream village,40253,755,457,2219,2206,2390,8027
Illinois,Trenton,2698,57,16,99,99,189,460
Illinois,Carmi,5107,81,13,357,264,125,840
Illinois,Carlock village,613,4,10,50,41,35,140
Illinois,Carlinville,5452,177,59,328,178,291,1033
Illinois,Carbon Hill village,328,1,0,26,26,17,70
Illinois,Carbondale,26192,470,148,689,683,591,2581
Illinois,Carbon Cliff village,2076,52,50,149,85,126,462
Illinois,Capron village,1846,16,28,138,198,161,541
Illinois,Cantrall village,233,0,0,28,34,30,92
Illinois,Canton,14539,281,154,630,525,633,2223
Illinois,Carlyle,3299,24,46,204,191,159,624
Illinois,Browns village,127,0,1,3,3,3,10
Illinois,Trout Valley village,557,5,5,21,30,58,119
Illinois,Troy Grove village,240,5,0,28,12,3,48
Illinois,Dalton City village,434,7,12,26,14,30,89
Illinois,Dalzell village,725,12,5,37,44,30,128
Illinois,Damiansville village,522,11,10,24,16,25,86
Illinois,Dana village,126,3,1,4,0,13,21
Illinois,Danforth village,577,4,7,24,10,45,90
Illinois,Danvers village,1204,22,23,68,78,64,255
Illinois,Danville,32337,469,532,1679,1980,1751,6411
Illinois,Darien,22263,320,195,993,1068,1260,3836
Illinois,Goodfield village,884,12,11,44,67,84,218
Illinois,Golf village,474,12,9,40,41,24,126
Illinois,Golden Gate village,66,0,0,0,8,4,12
Illinois,Golden village,681,2,2,43,64,44,155
Illinois,Brocton village,357,6,5,30,24,19,84
Illinois,Brookfield village,18964,338,296,835,898,1156,3523
Illinois,Brooklyn village,836,41,44,50,43,56,234
Illinois,Brookport,883,2,14,25,10,27,78
Illinois,Broughton village,218,1,2,19,26,12,60
Illinois,Dallas City,1254,27,13,60,71,86,257
Illinois,Dakota village,511,4,12,21,37,32,106
Illinois,Dahlgren village,375,0,0,13,12,4,29
Illinois,Cypress village,247,8,4,6,9,18,45
Illinois,Tuscola,4405,15,35,207,300,376,933
Illinois,Twin Grove,1789,22,0,97,31,110,260
Illinois,Ullin village,406,6,8,4,8,14,40
Illinois,Union village,535,13,6,29,48,32,128
Illinois,Union Hill village,85,0,1,17,9,2,29
Illinois,University Park village,6963,117,41,534,431,651,1774
Illinois,Urbana,41988,581,222,852,1006,1115,3776
Illinois,Ursa village,639,4,8,35,32,24,103
Illinois,Troy,9939,258,100,436,635,692,2121
Illinois,Valier village,599,6,0,5,33,26,70
Illinois,Valmeyer village,1434,30,4,122,134,147,437
Illinois,Crossville village,691,10,22,43,25,49,149
Illinois,Crystal Lake,40635,724,542,2187,2510,2806,8769
Illinois,Crystal Lawns,2122,0,0,142,212,101,455
Illinois,Cuba,1561,38,12,119,114,156,439
Illinois,Cullom village,607,22,9,44,25,46,146
Illinois,Curran village,190,2,6,9,7,5,29
Illinois,Cutler village,389,2,2,18,18,20,60
Illinois,Valley City village,3,0,0,0,0,0,0
Illinois,Carthage,2580,10,31,151,107,150,449
Illinois,De Soto village,1567,56,20,117,76,83,352
Illinois,Varna village,420,14,8,25,14,34,95
Illinois,Winnetka village,12407,382,181,917,1035,1169,3684
Illinois,Winslow village,245,8,0,7,16,11,42
Illinois,Winthrop Harbor village,6849,101,22,282,529,413,1347
Illinois,Witt,774,25,12,35,81,22,175
Illinois,Wonder Lake village,3966,78,73,336,156,167,810
Illinois,Wood Dale,13923,177,285,506,688,741,2397
Illinois,Woodhull village,945,14,5,55,60,61,195
Illinois,Woodland village,328,1,5,21,27,28,82
Illinois,Woodlawn village,676,12,16,63,21,36,148
Illinois,Woodridge village,33321,618,613,1707,1296,1686,5920
Illinois,Wood River,10417,244,150,521,628,434,1977
Illinois,Woodson village,417,7,0,10,26,17,60
Illinois,Woodstock,25247,663,249,1389,1538,1828,5667
Illinois,Worden village,1250,18,41,89,29,26,203
Illinois,Worth village,10829,151,161,399,535,704,1950
Illinois,Wyanet village,1122,14,33,105,61,73,286
Illinois,Wyoming,1599,27,14,113,82,91,327
Illinois,Winnebago village,3027,44,2,217,255,197,715
Illinois,Forest View village,703,9,20,31,34,13,107
Illinois,Windsor,1445,12,61,168,92,54,387
Illinois,Windsor village,988,17,23,41,81,86,248
Illinois,East Cape Girardeau village,619,2,9,58,36,20,125
Illinois,East Carondelet village,587,15,0,31,38,60,144
Illinois,East Dubuque,1812,26,9,83,156,112,386
Illinois,White Hall,2569,57,27,102,212,116,514
Illinois,White Heath,234,0,0,0,0,10,10
Illinois,Williamsfield village,540,8,2,29,22,34,95
Illinois,Williamson village,212,1,7,4,10,7,29
Illinois,Williamsville village,1526,41,18,95,91,136,381
Illinois,Xenia village,493,3,5,18,28,39,93
Illinois,Willisville village,448,4,0,19,24,19,66
Illinois,Willowbrook,2044,22,20,57,60,76,235
Illinois,Willow Hill village,233,0,2,9,15,15,41
Illinois,Willow Springs village,5676,117,105,125,291,301,939
Illinois,Wilmette village,27420,642,604,1612,2404,2000,7262
Illinois,Wilmington village,128,2,3,13,3,9,30
Illinois,Wilmington,5776,169,121,272,262,339,1163
Illinois,Wilsonville village,563,4,4,40,24,15,87
Illinois,Winchester,1569,41,34,58,80,97,310
Illinois,Willowbrook village,8629,81,77,309,415,512,1394
Illinois,East Brooklyn village,142,0,0,5,6,4,15
Illinois,Yale village,80,5,3,5,2,6,21
Illinois,Yorkville,18222,278,317,1575,1386,1230,4786
Illinois,Burnham village,4224,54,69,239,166,290,818
Illinois,Burnt Prairie village,66,0,0,1,1,4,6
Illinois,Burr Ridge village,10753,222,104,545,453,507,1831
Illinois,Bush village,265,0,7,16,9,4,36
Illinois,Bushnell,3022,73,50,122,124,171,540
Illinois,Butler village,130,2,1,11,5,2,21
Illinois,Byron,3672,111,60,283,168,202,824
Illinois,Cabery village,326,4,1,16,22,19,62
Illinois,Cahokia village,14740,258,230,935,1231,780,3434
Illinois,Cairo,2758,89,18,172,168,126,573
Illinois,Caledonia village,219,2,1,11,28,10,52
Illinois,Calhoun village,204,2,2,5,4,6,19
Illinois,Calumet City,37184,642,413,1762,2603,3090,8510
Illinois,Calumet Park village,8367,147,75,317,509,535,1583
Illinois,Camargo village,550,20,13,36,33,37,139
Illinois,Cambria village,1380,3,33,51,102,51,240
Illinois,Cambridge village,2126,35,21,117,152,83,408
Illinois,Burlington village,659,11,4,38,50,61,164
Illinois,Bureau Junction village,242,0,3,10,14,11,38
Illinois,Burbank,29157,451,341,1752,1831,1593,5968
Illinois,Bunker Hill,1719,22,3,61,87,111,284
Illinois,Zeigler,1804,13,34,85,105,118,355
Illinois,Zion,24251,300,415,1628,1792,1970,6105
Illinois,Forest Park village,14194,175,116,264,459,598,1612
Illinois,Forest Lake,1719,27,18,48,89,83,265
Illinois,Forest City village,222,4,1,11,15,15,46
Illinois,Ford Heights village,2780,68,24,96,238,275,701
Illinois,Foosland village,115,7,4,9,14,0,34
Illinois,Flossmoor village,9492,129,52,637,470,713,2001
Illinois,Yates City village,813,5,16,48,38,51,158
Illinois,Florence village,40,4,0,0,0,0,4
Illinois,Flora,5027,150,114,348,265,272,1149
Illinois,Flat Rock village,347,4,2,21,17,22,66
Illinois,Flanagan village,1138,32,15,62,66,65,240
Illinois,Fithian village,504,0,5,7,29,24,65
Illinois,Buffalo Grove village,41591,827,492,2367,2055,2372,8113
Illinois,Bull Valley village,1085,21,6,67,85,48,227
Illinois,Bulpitt village,262,14,14,29,12,10,79
Illinois,Buncombe village,203,4,12,13,8,6,43
Illinois,Floraville,0,0,0,0,0,0,0
Illinois,Vandalia,6550,57,58,144,269,423,951
Illinois,East Alton village,6215,63,0,157,208,354,782
Illinois,Eagarville village,169,10,11,10,6,9,46
Illinois,Gifford village,861,16,5,60,37,38,156
Illinois,Gibson City,3542,140,82,282,157,237,898
Illinois,German Valley village,440,7,0,22,22,10,61
Illinois,Germantown Hills village,3480,95,39,251,212,298,895
Illinois,Germantown village,1112,7,8,85,84,54,238
Illinois,Georgetown,3413,46,10,173,175,151,555
Illinois,Georgetown,477,4,7,6,33,9,59
Illinois,Genoa,5233,39,53,398,447,291,1228
Illinois,Geneva,21704,423,265,1071,1399,1643,4801
Illinois,Geneseo,6523,128,109,328,456,358,1379
Illinois,Gays village,288,5,0,4,27,23,59
Illinois,Garrett village,108,0,1,5,1,3,10
Illinois,Gardner village,1211,14,25,52,74,47,212
Illinois,Garden Prairie,198,2,1,6,3,18,30
Illinois,Galva,2543,25,32,126,138,153,474
Illinois,Galesburg,31696,576,313,1376,1449,1093,4807
Illinois,Galena,3345,45,51,125,35,109,365
Illinois,Gilberts village,7338,289,160,658,364,395,1866
Illinois,Gillespie,3310,42,82,163,114,123,524
Illinois,Gilman,1680,53,36,66,83,81,319
Illinois,Gilson,132,0,0,8,0,0,8
Illinois,Venedy village,125,2,6,12,0,0,20
Illinois,Venetian Village,2709,59,37,68,87,121,372
Illinois,Venice,1963,30,16,93,144,152,435
Illinois,Vergennes village,269,0,11,6,29,20,66
Illinois,Vermilion village,235,0,4,26,28,4,62
Illinois,Golconda,770,4,7,15,50,43,119
Illinois,Godley village,752,14,8,76,48,53,199
Illinois,Godfrey village,17868,429,254,786,724,1003,3196
Illinois,Galatia village,941,7,22,44,46,35,154
Illinois,Glenwood village,8923,242,94,354,519,479,1688
Illinois,Glen Ellyn village,27890,575,384,1796,1483,1764,6002
Illinois,Glendale Heights village,34497,552,440,2121,1684,1747,6544
Illinois,Glencoe village,8881,240,167,795,728,625,2555
Illinois,Glen Carbon village,12882,327,196,791,730,540,2584
Illinois,Glasgow village,126,0,0,0,7,10,17
Illinois,Glasford village,1201,11,27,41,44,107,230
Illinois,Gladstone village,221,1,5,10,11,17,44
Illinois,Girard,1805,36,45,136,87,80,384
Illinois,Glenview village,45969,859,563,2682,2535,2793,9432
Illinois,Earlville,1847,15,7,67,111,102,302
Illinois,Gages Lake,10025,244,99,639,469,480,1931
Illinois,Fulton,3467,83,24,157,126,164,554
Illinois,Dixon,15196,107,182,638,652,654,2233
Illinois,Dolton village,23283,446,184,1373,1529,1226,4758
Illinois,Dongola village,913,31,6,51,70,74,232
Illinois,Donnellson village,140,3,0,2,6,5,16
Illinois,Donovan village,281,5,4,14,24,16,63
Illinois,Dorchester village,157,0,0,9,11,5,25
Illinois,Dover village,146,6,0,17,11,2,36
Illinois,Dowell village,328,2,1,32,27,4,66
Illinois,Downers Grove village,49504,1068,659,2782,2328,2769,9606
Illinois,Downs village,972,23,15,73,88,41,240
Illinois,Du Bois village,150,0,3,3,3,8,17
Illinois,Dunfermline village,273,3,10,18,18,14,63
Illinois,Dunlap village,1478,19,32,105,113,125,394
Illinois,Dupo village,4006,81,36,235,202,172,726
Illinois,Du Quoin,6002,123,29,327,270,191,940
Illinois,Durand village,1201,10,12,44,46,59,171
Illinois,Dwight village,4192,59,27,147,342,180,755
Illinois,Dixmoor village,3626,75,16,252,217,275,835
Illinois,Dix village,464,8,6,22,10,9,55
Illinois,Divernon village,1292,23,16,114,62,71,286
Illinois,Dieterich village,679,20,13,55,47,25,160
Illinois,Freeport,24973,786,287,1092,1374,1395,4934
Illinois,Freeman Spur village,200,0,0,14,7,7,28
Illinois,Freeburg village,4226,120,40,176,179,247,762
Illinois,Franklin Park village,18410,290,198,616,799,1281,3184
Illinois,Franklin Grove village,1185,16,13,55,114,88,286
Illinois,Franklin village,505,8,19,20,23,23,93
Illinois,Frankfort Square,9258,158,130,444,462,814,2008
Illinois,Frankfort village,18295,452,316,1326,1186,1300,4580
Illinois,Fults village,18,0,0,0,1,1,2
Illinois,Fox River Grove village,4739,183,33,199,213,370,998
Illinois,Fox Lake village,10539,156,135,385,372,482,1530
Illinois,Forsyth village,3493,44,50,178,179,222,673
Illinois,Forreston village,1707,36,19,116,99,101,371
Illinois,Forrest village,1193,16,15,100,81,51,263
Illinois,Des Plaines,58930,1181,782,2746,2407,2510,9626
Illinois,Detroit village,110,1,5,7,5,17,35
Illinois,De Witt village,224,1,0,7,9,14,31
Illinois,Diamond village,2612,67,51,179,226,221,744
Illinois,Fox Lake Hills,2190,60,42,61,84,82,329
Illinois,Cary village,18038,330,257,949,1249,1197,3982
Illinois,Buffalo village,537,22,17,21,23,24,107
Illinois,Caseyville village,4103,121,63,104,160,252,700
Illinois,Ferris village,143,2,2,9,0,9,22
Illinois,Fidelity village,133,4,0,4,9,1,18
Illinois,Fieldon village,198,2,1,7,9,10,29
Illinois,Fillmore village,262,7,2,22,15,8,54
Illinois,Findlay village,718,7,0,35,54,31,127
Illinois,Fisher village,1860,24,43,74,86,81,308
Illinois,Fayetteville village,408,2,8,24,12,8,54
Illinois,Casey,2546,46,34,81,150,116,427
Illinois,Waggoner village,166,8,8,2,15,5,38
Illinois,Walnut village,1554,34,21,133,89,77,354
Illinois,Walnut Hill village,91,2,2,0,4,2,10
Illinois,Walshville village,41,0,0,0,0,0,0
Illinois,Waltonville village,434,4,11,33,37,12,97
Illinois,Wamac,1351,11,22,55,95,53,236
Illinois,Wadsworth village,3700,0,40,58,110,233,441
Illinois,Farmington,2455,24,56,137,195,130,542
Illinois,Farmersville village,569,10,3,16,36,29,94
Illinois,Farmer City,1947,30,25,40,99,111,305
Illinois,Villa Grove,2166,43,25,82,75,78,303
Illinois,Villa Park village,21800,414,219,1496,1095,1195,4419
Illinois,Viola village,897,15,16,45,40,41,157
Illinois,Virden,3539,92,76,302,139,211,820
Illinois,Virgil village,339,0,12,26,32,21,91
Illinois,Virginia,1322,3,17,63,83,76,242
Illinois,Volo village,3757,149,87,226,173,87,722
Illinois,Fairbury,3722,33,40,162,303,203,741
Illinois,Fairfield,4882,70,60,184,220,267,801
Illinois,Fairmont,2322,47,29,113,170,85,444
Illinois,Fairmont City village,2498,69,29,192,204,190,684
Illinois,Fairmount village,671,2,5,37,29,66,139
Illinois,Fairview village,515,31,9,33,25,37,135
Illinois,Fairview Heights,17014,355,121,644,568,683,2371
Illinois,Farina village,576,11,11,20,47,17,106
Illinois,Wapella village,565,10,1,19,10,28,68
Illinois,Warren village,1510,38,36,65,42,52,233
Illinois,Warrensburg village,1217,30,16,114,37,130,327
Illinois,Warrenville,13373,138,189,655,683,854,2519
Illinois,Wenona,1165,21,28,53,49,63,214
Illinois,Wenonah village,45,0,0,0,5,0,5
Illinois,West Brooklyn village,124,5,3,3,3,12,26
Illinois,Westchester village,16783,228,187,796,655,821,2687
Illinois,West Chicago,27461,318,490,1858,1782,2285,6733
Illinois,West City village,709,17,14,51,19,16,117
Illinois,West Dundee village,7391,105,64,448,273,252,1142
Illinois,Western Springs village,13125,386,130,1026,1013,1054,3609
Illinois,Westervelt,107,0,9,16,0,0,25
Illinois,Westfield village,742,19,0,23,55,75,172
Illinois,West Frankfort,7720,152,93,525,349,315,1434
Illinois,Westmont village,25389,398,358,958,1201,940,3855
Illinois,West Peoria,4445,22,4,176,140,125,467
Illinois,West Point village,224,4,0,20,21,8,53
Illinois,West Salem village,923,10,18,33,61,39,161
Illinois,Wellington village,268,0,3,20,15,8,46
Illinois,Vienna,1450,47,5,56,51,48,207
Illinois,Weldon village,461,2,14,28,34,27,105
Illinois,Wayne City village,1138,19,20,15,96,110,260
Illinois,Warsaw,1538,23,10,84,61,81,259
Illinois,Washburn village,1028,15,8,71,87,67,248
Illinois,Washington,15824,428,223,1173,953,919,3696
Illinois,Washington Park village,4072,24,0,227,305,272,828
Illinois,Chapin village,479,10,8,28,19,12,77
Illinois,Ewing village,265,7,1,16,18,16,58
Illinois,Wataga village,725,2,8,33,48,34,125
Illinois,Waterloo,10151,135,197,419,628,521,1900
Illinois,Waterman village,1539,19,15,91,87,162,374
Illinois,Watseka,5426,65,56,229,257,317,924
Illinois,Watson village,714,8,19,23,17,57,124
Illinois,Wauconda village,13140,252,271,842,841,662,2868
Illinois,Waukegan,88570,1322,1296,6147,5396,6371,20532
Illinois,Waverly,1201,21,0,43,93,65,222
Illinois,Wayne village,2318,0,18,55,114,164,351
Illinois,Waynesville village,544,12,15,14,16,15,72
Illinois,West Union,354,17,0,21,26,14,78
Illinois,Victoria village,311,3,1,11,19,46,80
Illinois,Verona village,240,10,0,9,24,43,86
Illinois,Cicero,84361,1344,1592,6685,5865,5754,21240
Illinois,Cisco village,251,9,7,17,10,5,48
Illinois,Cisne village,646,11,23,32,13,22,101
Illinois,Cissna Park village,834,16,8,37,36,26,123
Illinois,Claremont village,244,5,1,24,16,7,53
Illinois,Clarendon Hills village,8609,361,146,536,715,862,2620
Illinois,Christopher,2876,47,49,119,144,202,561
Illinois,Clay City village,898,29,7,33,48,31,148
Illinois,Clear Lake village,240,0,0,9,24,10,43
Illinois,Cleveland village,175,4,6,6,14,11,41
Illinois,Clifton village,1581,48,18,113,86,97,362
Illinois,Clinton,6987,161,116,325,349,377,1328
Illinois,Coal City village,5724,124,82,325,435,392,1358
Illinois,Coalton village,283,3,7,11,7,5,33
Illinois,Clayton village,613,7,4,29,25,20,85
Illinois,Chrisman,1346,21,11,63,55,73,223
Illinois,Chillicothe,6092,158,32,380,233,225,1028
Illinois,Chicago Ridge village,14407,230,149,1262,632,520,2793
Illinois,Evergreen Park village,19934,433,148,914,1208,1292,3995
Illinois,Evansville village,671,15,3,56,45,36,155
Illinois,Evanston,75603,1433,820,3648,3185,3018,12104
Illinois,Chatham village,12341,329,248,810,726,705,2818
Illinois,Chatsworth,1012,27,11,64,44,64,210
Illinois,Chebanse village,1129,23,18,83,71,79,274
Illinois,Chemung,294,9,0,0,58,0,67
Illinois,Chenoa,1763,8,41,72,107,71,299
Illinois,Cherry village,446,11,6,29,3,17,66
Illinois,Cherry Valley village,2913,20,22,120,110,95,367
Illinois,Chester,8592,78,61,438,321,266,1164
Illinois,Chesterfield village,238,2,0,9,8,8,27
Illinois,Chestnut,169,0,14,0,0,0,14
Illinois,Chicago,2717534,51134,33537,130733,127863,134449,477716
Illinois,Chicago Heights,30428,631,288,1816,1587,2283,6605
Illinois,Coal Valley village,3784,51,44,121,277,206,699
Illinois,Coatsburg village,164,3,1,6,2,4,16
Illinois,Cobden village,1425,0,4,91,86,99,280
Illinois,Coffeen,405,7,6,19,33,26,91
Illinois,Countryside,5984,97,100,291,334,278,1100
Illinois,Cowden village,547,0,10,14,26,42,92
Illinois,Coyne Center,953,0,8,80,30,32,150
Illinois,Crab Orchard,293,3,0,16,30,24,73
Illinois,Crainville village,1287,29,22,56,33,36,176
Illinois,Creal Springs,446,8,7,17,18,12,62
Illinois,Crescent City village,728,10,0,37,36,80,163
Illinois,Crest Hill,20479,230,253,999,1076,884,3442
Illinois,Creston village,740,11,4,33,31,51,130
Illinois,Crestwood village,11027,49,196,487,394,439,1565
Illinois,Crete village,8246,119,68,430,430,549,1596
Illinois,Creve Coeur village,5652,61,58,166,369,263,917
Illinois,Vermont village,674,11,10,46,25,50,142
Illinois,Vernon village,104,0,4,14,7,1,26
Illinois,Vernon Hills village,25768,526,363,1362,1625,1569,5445
Illinois,Country Club Hills,16806,324,82,777,955,1181,3319
Illinois,Versailles village,489,6,2,17,12,13,50
Illinois,Coulterville village,969,13,14,44,62,80,213
Illinois,Cornland,50,0,0,0,0,0,0
Illinois,Colchester,1539,27,32,83,83,56,281
Illinois,Coleta village,212,7,2,34,27,5,75
Illinois,Colfax village,1101,32,7,42,87,81,249
Illinois,Collinsville,25025,220,261,1120,1289,1156,4046
Illinois,Colona,4918,76,57,355,225,339,1052
Illinois,Colp village,253,0,5,20,24,16,65
Illinois,Columbia,10029,127,139,505,542,656,1969
Illinois,Columbus village,80,0,0,2,6,10,18
Illinois,Como,405,12,0,12,10,32,66
Illinois,Compton village,266,6,13,6,12,10,47
Illinois,Concord village,186,5,0,12,17,5,39
Illinois,Congerville village,483,6,15,30,26,24,101
Illinois,Cooksville village,194,7,4,7,4,14,36
Illinois,Cordova village,624,0,4,15,24,37,80
Illinois,Cornell village,353,2,1,12,24,25,64
Illinois,Cortland,4323,108,53,308,376,414,1259
Illinois,Westville village,3355,33,58,135,336,243,805
Illinois,Exeter village,105,0,0,15,5,6,26
Illinois,Wheaton,53585,1073,729,2612,2703,3476,10593
Illinois,Edinburg village,1097,15,0,45,47,48,155
Illinois,Edgewood village,507,0,14,15,35,34,98
Illinois,Eddyville village,63,1,0,7,0,5,13
Illinois,East St. Louis,26689,686,425,2158,1304,1619,6192
Illinois,East Peoria,23137,448,210,925,1180,1347,4110
Illinois,Easton village,347,1,4,17,20,22,64
Illinois,Edwardsville,24896,485,333,1292,1453,928,4491
Illinois,East Moline,21422,463,361,1054,1021,1049,3948
Illinois,Harvey,25773,691,275,1416,1474,1967,5823
Illinois,Harwood Heights village,8649,37,122,257,333,289,1038
Illinois,Havana,3395,18,11,216,229,156,630
Illinois,Hawthorn Woods village,7634,163,55,623,476,604,1921
Illinois,Hazel Crest village,14195,289,126,920,863,1141,3339
Illinois,Hebron village,1237,7,25,71,42,86,231
Illinois,Harvel village,182,0,1,4,5,22,32
Illinois,Effingham,12513,321,153,692,641,692,2499
Illinois,Elburn village,5785,173,77,429,553,460,1692
Illinois,El Dara village,123,0,0,5,1,0,6
Illinois,Hanna City village,1361,46,20,62,95,51,274
Illinois,Hanover village,711,0,4,15,22,49,90
Illinois,Hanover Park village,38373,613,721,2394,2472,2513,8713
Illinois,Hardin village,944,16,10,41,58,43,168
Illinois,Harmon village,122,6,5,0,2,5,18
Illinois,Harrisburg,9247,67,77,527,467,619,1757
Illinois,Harrison,957,0,21,79,88,40,228
Illinois,Harristown village,1330,19,18,40,62,83,222
Illinois,Hartford village,1654,19,10,91,120,25,265
Illinois,Hartsburg village,243,3,0,8,15,18,44
Illinois,Harvard,9802,170,58,893,820,639,2580
Illinois,Elizabeth village,744,4,12,36,20,38,110
Illinois,Elgin,112105,2369,1985,6210,6790,6958,24312
Illinois,Eldred village,207,4,4,4,11,11,34
Illinois,Eldorado,4103,97,73,174,115,191,650
Illinois,Hecker village,467,1,15,39,54,10,119
Illinois,Henderson village,237,4,1,9,7,8,29
Illinois,Hennepin village,905,29,5,58,45,38,175
Illinois,Henning village,354,2,7,19,5,42,75
Illinois,Tamms village,827,22,0,39,19,12,92
Illinois,Tamaroa village,494,3,2,34,49,27,115
Illinois,Tallula village,445,11,1,27,32,27,98
Illinois,Table Grove village,365,8,11,16,16,17,68
Illinois,Symerton village,107,2,0,9,12,6,29
Illinois,Sycamore,17572,303,136,850,957,856,3102
Illinois,Swansea village,13869,201,232,843,736,635,2647
Illinois,Sun River Terrace village,450,15,6,22,52,17,112
Illinois,Sumner,5988,9,15,46,65,344,479
Illinois,Summit village,11447,207,265,858,679,584,2593
Illinois,Summerfield village,581,2,2,26,26,43,99
Illinois,Sullivan,4600,27,51,206,220,254,758
Illinois,Charleston,21552,234,158,537,715,755,2399
Illinois,East Dundee village,3074,18,12,104,142,175,451
Illinois,East Galesburg village,801,13,6,47,43,40,149
Illinois,Tampico village,684,20,5,38,41,48,152
Illinois,Hanaford village,297,2,7,6,7,9,31
Illinois,Taylor Springs village,556,2,0,20,27,10,59
Illinois,Tennessee village,131,1,1,3,2,4,11
Illinois,Henry,2343,36,30,91,107,130,394
Illinois,Heritage Lake,1354,0,18,78,115,137,348
Illinois,East Hazel Crest village,1611,34,22,70,90,107,323
Illinois,Herrick village,440,3,16,26,43,29,117
Illinois,Herrin,12797,217,150,604,769,599,2339
Illinois,Thomson village,736,32,1,33,11,39,116
Illinois,Thompsonville village,735,41,23,49,48,48,209
Illinois,Thomasboro village,1230,13,4,76,71,35,199
Illinois,Third Lake village,1246,29,0,83,59,59,230
Illinois,The Galena Territory,996,0,0,12,0,23,35
Illinois,Thebes village,372,17,5,43,45,12,122
Illinois,Thayer village,726,5,6,15,22,47,95
Illinois,Thawville village,192,3,8,8,17,9,45
Illinois,West York,152,0,0,12,25,0,37
Illinois,Teutopolis village,1793,26,14,91,117,95,343
Illinois,Taylorville,11068,67,69,496,653,594,1879
Illinois,East Gillespie village,256,3,1,17,11,10,42
Illinois,Hampton village,1942,28,10,106,121,124,389
Illinois,Elizabethtown village,256,0,0,10,14,30,54
Illinois,El Paso,2694,39,48,94,158,190,529
Illinois,Elmwood Park village,24971,211,361,1225,1119,1006,3922
Illinois,Elmwood,2253,65,22,101,210,148,546
Illinois,Elmhurst,45469,1120,886,2626,2909,2797,10338
Illinois,Ellsworth village,259,9,2,2,1,23,37
Illinois,Ellisville village,106,2,5,2,4,14,27
Illinois,Elsah village,739,8,8,2,0,0,18
Illinois,Ellis Grove village,439,13,9,15,13,4,54
Illinois,Elkville village,1047,30,24,27,54,51,186
Illinois,Elkhart village,346,11,10,20,19,4,64
Illinois,Catlin village,1981,58,41,130,72,158,459
Illinois,Cave-In-Rock village,365,8,18,19,20,27,92
Illinois,Cedar Point village,322,7,6,23,13,13,62
Illinois,Cedarville village,633,7,6,30,25,37,105
Illinois,Elliott village,239,3,3,8,10,14,38
Illinois,Elvaston village,119,0,6,4,5,8,23
Illinois,Elwood village,2130,31,42,104,99,122,398
Illinois,Emden village,348,10,0,33,15,17,75
Illinois,Wheeler village,118,0,1,9,8,6,24
Illinois,Wheeling village,37982,697,672,1808,1703,1467,6347
Illinois,Whiteash,341,11,0,10,22,10,53
Illinois,White City village,189,2,4,7,3,5,21
Illinois,Channel Lake,1505,0,5,26,81,98,210
Illinois,Channahon village,12845,242,130,770,928,809,2879
Illinois,Chandlerville village,621,33,5,50,46,35,169
Illinois,Champaign,84008,1268,886,2975,3096,2941,11166
Illinois,Eureka,5704,80,153,214,305,244,996
Illinois,Essex village,858,41,12,82,35,60,230
Illinois,Erie village,1507,25,5,76,120,98,324
Illinois,Equality village,551,8,12,25,12,28,85
Illinois,Enfield village,628,5,10,13,31,31,90
Illinois,Energy village,1215,37,2,71,49,35,194
Illinois,Emington village,87,7,0,6,2,3,18
Illinois,Central City village,1047,47,52,62,43,24,228
Illinois,Hampshire village,5851,113,50,450,620,340,1573
Illinois,Centralia,12798,336,156,617,535,496,2140
Illinois,Cerro Gordo village,1348,27,10,93,60,90,280
Illinois,Green Oaks village,3850,40,79,300,309,315,1043
Illinois,Greenup village,1769,7,45,43,100,73,268
Illinois,Green Valley village,733,5,10,11,27,27,80
Illinois,Greenview village,860,12,15,45,36,49,157
Illinois,Greenville,6842,190,95,331,216,264,1096
Illinois,Greenwood village,400,3,0,31,25,17,76
Illinois,Gridley village,1356,8,18,55,99,91,271
Illinois,Griggsville,1161,18,28,128,101,38,313
Illinois,Gulf Port village,19,0,0,0,0,0,0
Illinois,Gurnee village,31136,393,478,1778,2093,2331,7073
Illinois,Hainesville village,3690,152,132,174,284,224,966
Illinois,Hamburg village,77,0,0,2,0,0,2
Illinois,Hamel village,886,16,9,51,43,30,149
Illinois,Hamilton,2918,43,17,248,195,65,568
Illinois,Hammond village,446,3,6,28,25,19,81
Illinois,Greenfield,1412,20,22,87,79,56,264
Illinois,Centreville,5142,149,124,287,297,359,1216
Illinois,Grayville,1630,25,28,70,68,57,248
Illinois,Granville village,1380,52,72,38,62,103,327
Illinois,Chadwick village,481,13,0,12,22,27,74
Illinois,Good Hope village,387,7,2,9,15,33,66
Illinois,Goofy Ridge,167,0,0,6,7,23,36
Illinois,Goreville village,1206,18,11,93,71,72,265
Illinois,Gorham village,173,2,1,4,2,19,28
Illinois,Grafton,616,7,13,32,23,8,83
Illinois,Grayslake village,21117,489,248,918,1446,1388,4489
Illinois,Grand Detour,548,0,0,0,11,64,75
Illinois,Grand Tower,451,6,2,3,24,9,44
Illinois,Grandview village,1406,33,22,90,80,60,285
Illinois,Grandwood Park,5757,94,148,416,443,489,1590
Illinois,Granite City,29421,495,342,1580,1326,1289,5032
Illinois,Grantfork village,337,17,8,22,6,11,64
Illinois,Elk Grove Village village,33333,612,380,1359,1360,1679,5390
Illinois,Grant Park village,1270,15,19,58,68,71,231
Illinois,Grand Ridge village,538,11,6,32,39,35,123
Indiana,Westphalia,79,0,0,0,0,8,8
Indiana,Austin,4235,10,32,159,240,359,800
Indiana,Leo-Cedarville,3785,94,72,302,286,416,1170
Indiana,Avoca,710,28,0,0,49,41,118
Indiana,Wynnedale,162,0,0,4,6,9,19
Indiana,Yeoman,137,1,6,7,10,17,41
Indiana,Yorktown,11268,165,217,605,757,795,2539
Indiana,Zanesville,639,12,2,46,49,44,153
Indiana,Zionsville,25072,660,578,2009,1691,1620,6558
Indiana,Marion,29075,359,308,1651,865,916,4099
Indiana,Marengo,852,8,17,30,37,47,139
Indiana,Manilla,240,0,0,0,0,10,10
Indiana,Madison,12054,95,76,375,484,622,1652
Indiana,Macy,269,0,0,15,33,26,74
Indiana,Worthington,1214,17,2,61,67,117,264
Indiana,Mackey,92,0,2,1,7,9,19
Indiana,Lyons,784,0,8,20,64,42,134
Indiana,Lynnville,936,16,5,98,77,76,272
Indiana,Lynn,1113,7,7,77,65,51,207
Indiana,Crawfordsville,15982,340,85,729,907,796,2857
Indiana,Cromwell,478,5,14,13,20,10,62
Indiana,Crothersville,1574,14,25,43,75,70,227
Indiana,Crown Point,28444,408,275,1285,1443,1592,5003
Indiana,Crows Nest,113,6,4,0,0,12,22
Indiana,Culver,1444,13,17,48,81,109,268
Indiana,Cumberland,5316,85,24,349,280,342,1080
Indiana,McCordsville,5224,36,8,208,448,542,1242
Indiana,Cynthiana,561,14,4,17,22,24,81
Indiana,Woodlawn Heights,63,1,2,4,0,0,7
Indiana,Wolcottville,1009,15,2,105,75,34,231
Indiana,West Point,566,0,42,13,77,67,199
Indiana,Westport,1403,33,27,131,51,59,301
Indiana,West Terre Haute,2505,56,61,166,133,165,581
Indiana,Westville,7065,42,29,181,150,625,1027
Indiana,Wheatfield,990,10,10,69,55,58,202
Indiana,Wheatland,455,9,10,34,27,25,105
Indiana,Wheeler,347,0,0,25,18,7,50
Indiana,Whiteland,4732,58,34,276,319,232,919
Indiana,Whitestown,4864,132,51,338,395,283,1199
Indiana,Whitewater,80,2,3,12,5,3,25
Indiana,Woodburn,1549,28,35,83,75,95,316
Indiana,Whiting,4905,163,54,255,242,276,990
Indiana,Williams,322,0,0,0,0,25,25
Indiana,Williams Creek,396,10,10,28,36,29,113
Indiana,Williamsport,1842,45,2,40,51,97,235
Indiana,Winamac,2623,23,12,120,194,232,581
Indiana,Winchester,4822,31,17,196,257,329,830
Indiana,Windfall City,856,18,21,59,51,59,208
Indiana,Winfield,5054,44,84,487,353,291,1259
Indiana,Wingate,257,7,1,14,16,12,50
Indiana,Winona Lake,4935,41,65,149,179,171,605
Indiana,Wolcott,1055,20,11,71,61,77,240
Indiana,Wilkinson,474,0,0,19,46,50,115
Indiana,Avilla,2193,40,28,96,125,188,477
Indiana,Dale,1789,12,19,81,64,111,287
Indiana,Dana,546,8,4,11,24,26,73
Indiana,Leesburg,589,6,7,46,35,29,123
Indiana,Lebanon,15762,131,324,502,1000,707,2664
Indiana,Leavenworth,283,0,0,2,7,3,12
Indiana,Lawrenceburg,4996,0,14,234,262,279,789
Indiana,Dublin,752,13,12,34,11,33,103
Indiana,Dubois,409,0,41,34,0,18,93
Indiana,Dugger,799,4,0,27,51,29,111
Indiana,Dune Acres,188,0,2,3,4,6,15
Indiana,Dunkirk,2446,6,34,95,146,189,470
Indiana,Dunlap,6220,36,65,349,397,625,1472
Indiana,Lewisville,382,13,4,16,9,20,62
Indiana,Dunreith,208,2,10,9,9,9,39
Indiana,Dyer,16257,191,275,611,675,822,2574
Indiana,Earl Park,407,0,7,12,26,15,60
Indiana,East Chicago,29178,640,478,2364,1820,1909,7211
Indiana,Bedford,13371,169,222,705,621,566,2283
Indiana,Battle Ground,1085,17,2,45,63,56,183
Indiana,Batesville,6398,187,91,296,337,402,1313
Indiana,Bass Lake,1330,42,25,45,83,56,251
Indiana,Bargersville,6492,119,100,543,559,194,1515
Indiana,Bainbridge,841,10,5,38,57,70,180
Indiana,Avon,15145,272,137,1112,1226,1195,3942
Indiana,Dupont,276,2,7,15,14,5,43
Indiana,Daleville,1588,9,5,84,126,94,318
Indiana,Liberty,2074,26,26,157,98,141,448
Indiana,Linden,783,21,25,56,59,33,194
Indiana,Danville,9379,101,173,687,632,800,2393
Indiana,Darlington,750,14,15,34,53,51,167
Indiana,Darmstadt,1471,19,9,73,79,52,232
Indiana,Dayton,1500,31,3,101,135,80,350
Indiana,Decatur,9084,123,148,558,450,422,1701
Indiana,Decker,257,0,3,14,11,13,41
Indiana,Delphi,2874,51,7,143,162,193,556
Indiana,De Motte,3944,45,112,135,117,356,765
Indiana,Denver,506,9,7,19,33,32,100
Indiana,Deputy,17,0,0,0,0,0,0
Indiana,Ligonier,4361,34,60,241,254,407,996
Indiana,Dillsboro,1634,22,32,122,111,100,387
Indiana,Dresser,24,0,0,0,0,6,6
Indiana,Lowell,9400,144,109,356,467,731,1807
Indiana,Losantville,223,0,4,7,2,10,23
Indiana,Loogootee,2701,24,7,162,176,165,534
Indiana,Long Beach,1127,3,0,23,42,45,113
Indiana,Logansport,17716,221,175,894,1130,955,3375
Indiana,Lizton,519,2,2,32,31,54,121
Indiana,Livonia,132,0,2,12,6,2,22
Indiana,Little York,159,1,4,14,5,10,34
Indiana,Linton,5340,7,47,249,276,174,753
Indiana,Dover Hill,141,0,0,12,0,0,12
Indiana,Winslow,1087,58,20,48,104,67,297
Indiana,Norway,492,0,0,38,31,21,90
Indiana,Reynolds,562,14,19,27,28,41,129
Indiana,Laconia,77,0,1,1,0,0,2
Indiana,La Crosse,582,9,15,53,34,11,122
Indiana,Ladoga,1057,4,26,71,87,53,241
Indiana,Lafayette,70661,926,943,3986,2793,3041,11689
Indiana,La Fontaine,727,13,2,16,30,39,100
Indiana,Lagrange,2723,27,21,169,185,122,524
Indiana,Lagro,548,3,9,39,37,27,115
Indiana,Lake Dalecarlia,1373,52,14,55,49,114,284
Indiana,Lake Holiday,879,30,9,24,45,71,179
Indiana,Lake Santee,858,8,14,17,84,64,187
Indiana,Lakes of the Four Seasons,6692,182,23,167,389,357,1118
Indiana,Lake Station,12268,115,242,989,812,506,2664
Indiana,Laketon,444,14,0,59,25,14,112
Indiana,Lake Village,667,0,0,6,16,11,33
Indiana,Lakeville,831,12,13,45,46,37,153
Indiana,Landess,299,10,0,21,10,39,80
Indiana,Lanesville,604,11,13,26,21,32,103
Indiana,La Paz,639,30,9,51,39,33,162
Indiana,Lapel,1833,10,13,42,83,67,215
Indiana,La Porte,22242,230,351,1281,1249,1129,4240
Indiana,Larwill,333,2,8,39,24,21,94
Indiana,Laurel,547,13,22,40,37,30,142
Indiana,Lawrence,47120,912,918,2951,3266,2941,10988
Indiana,Chrisney,446,8,8,19,24,29,88
Indiana,Chesterton,14124,295,170,729,1070,980,3244
Indiana,Chesterfield,2590,46,42,94,115,110,407
Indiana,Newtown,294,5,0,10,23,17,55
Indiana,Kouts,1899,24,22,104,112,151,413
Indiana,Koontz Lake,1431,0,14,62,52,74,202
Indiana,Kokomo,58054,853,860,2810,2838,3021,10382
Indiana,Churubusco,1953,26,38,150,85,124,423
Indiana,West Lebanon,818,0,4,68,54,51,177
Indiana,Covington,2553,20,18,187,137,101,463
Indiana,Country Squire Lakes,3155,43,54,276,107,116,596
Indiana,Country Club Heights,114,0,0,1,10,22,33
Indiana,Corydon,3121,0,15,183,189,91,478
Indiana,Corunna,245,4,0,18,16,27,65
Indiana,Cordry Sweetwater Lakes,1024,0,8,0,21,45,74
Indiana,Converse,1455,19,34,82,100,75,310
Indiana,Connersville,13241,136,188,682,700,623,2329
Indiana,Columbus,45868,747,781,2688,2390,2383,8989
Indiana,Columbia City,9070,254,158,382,511,576,1881
Indiana,Collegeville,614,0,0,0,0,0,0
Indiana,Colfax,820,17,20,44,67,36,184
Indiana,New Trenton,354,0,15,0,0,0,15
Indiana,Colburn,349,0,0,21,0,0,21
Indiana,Coalmont,336,0,0,31,32,23,86
Indiana,Cloverdale,1794,16,34,86,87,52,275
Indiana,Clinton,4812,19,80,313,218,263,893
Indiana,Clifford,218,2,0,13,14,7,36
Indiana,Clermont,1352,31,14,29,62,65,201
Indiana,Clear Lake,500,1,8,10,18,19,56
Indiana,Clayton,957,6,15,70,69,43,203
Indiana,Claypool,361,2,0,28,4,37,71
Indiana,Clay City,789,7,22,34,27,22,112
Indiana,Clarksville,21627,323,277,1028,1030,1112,3770
Indiana,Clarks Hill,583,11,9,55,25,23,123
Indiana,Clarksburg,323,0,22,0,23,20,65
Indiana,Cicero,4894,12,38,171,379,410,1010
Indiana,Coatesville,618,11,14,26,16,53,120
Indiana,New Washington,538,0,9,39,10,30,88
Indiana,New Whiteland,5725,77,70,405,298,218,1068
Indiana,Noblesville,58013,1378,1040,3644,3931,3338,13331
Indiana,Parkers Settlement,799,7,0,65,20,17,109
Indiana,Patoka,1061,50,16,72,81,39,258
Indiana,Patriot,339,0,7,47,34,37,125
Indiana,Pendleton,4224,45,55,227,169,212,708
Indiana,Pennville,769,13,38,50,26,20,147
Indiana,Perrysville,502,4,7,34,31,23,99
Indiana,Peru,11197,137,182,607,633,699,2258
Indiana,Petersburg,2592,43,25,71,146,119,404
Indiana,Pierceton,1074,30,2,77,92,87,288
Indiana,Pine Village,193,1,2,8,8,5,24
Indiana,Pittsboro,3116,133,80,246,233,185,877
Indiana,Plainfield,29710,526,459,1321,1429,1821,5556
Indiana,Plainville,637,5,10,54,28,38,135
Indiana,Parker City,1411,11,17,41,83,107,259
Indiana,Plymouth,10031,186,131,767,687,760,2531
Indiana,Poneto,138,1,1,2,6,9,19
Indiana,Portage,37197,583,402,1874,2189,1947,6995
Indiana,Porter,4887,25,78,214,239,368,924
Indiana,Portland,6201,200,103,205,314,293,1115
Indiana,Poseyville,1311,34,14,88,62,65,263
Indiana,Pottawattamie Park,266,16,11,9,17,5,58
Indiana,Princes Lakes,1433,9,15,50,80,85,239
Indiana,Princeton,8618,203,151,504,457,403,1718
Indiana,Raglesville,53,0,0,0,0,0,0
Indiana,Ragsdale,157,0,0,8,7,14,29
Indiana,Redkey,1456,46,7,125,105,100,383
Indiana,Remington,1165,31,9,63,43,21,167
Indiana,Rensselaer,5495,51,45,313,242,250,901
Indiana,Point Isabel,136,0,8,7,0,8,23
Indiana,Richland,453,4,2,27,54,19,106
Indiana,Paragon,791,12,2,73,32,37,156
Indiana,Palmyra,1290,31,51,76,68,48,274
Indiana,North Crows Nest,54,5,0,6,7,0,18
Indiana,North Judson,1867,15,3,73,155,92,338
Indiana,North Liberty,1883,58,64,160,164,108,554
Indiana,North Manchester,6303,178,125,281,335,228,1147
Indiana,North Salem,528,2,10,11,27,31,81
Indiana,North Terre Haute,4505,61,73,264,220,117,735
Indiana,North Vernon,6895,197,112,263,412,349,1333
Indiana,North Webster,1196,8,26,87,50,34,205
Indiana,Notre Dame,6446,0,0,0,0,0,0
Indiana,Oakland City,2601,42,17,56,166,82,363
Indiana,Oaktown,708,22,3,31,15,14,85
Indiana,Odon,1477,29,26,99,115,89,358
Indiana,Ogden Dunes,1203,16,14,32,39,40,141
Indiana,Paoli,3852,33,8,198,247,176,662
Indiana,Oldenburg,670,7,16,40,32,27,122
Indiana,Oolitic,1091,0,10,57,53,73,193
Indiana,Orestes,436,0,5,22,19,11,57
Indiana,Orland,391,2,3,12,27,29,73
Indiana,Orleans,2212,25,61,143,126,123,478
Indiana,Osceola,2711,37,39,118,201,128,523
Indiana,Osgood,1806,25,22,107,154,122,430
Indiana,Ossian,3658,37,18,212,234,343,844
Indiana,Otterbein,1404,25,11,119,71,56,282
Indiana,Otwell,428,0,0,23,24,0,47
Indiana,Owensburg,797,14,0,66,31,29,140
Indiana,Owensville,1233,2,10,90,68,76,246
Indiana,Oxford,1171,23,15,92,49,58,237
Indiana,Painted Hills,849,0,16,0,9,131,156
Indiana,Onward,133,0,0,5,5,12,22
Indiana,West Lafayette,43999,404,211,1073,1087,970,3745
Indiana,Jamestown,1038,11,0,39,31,59,140
Indiana,Westfield,33744,989,713,2419,2387,2299,8807
Indiana,Center Point,229,6,0,15,13,7,41
Indiana,Cedar Lake,11757,228,120,726,774,891,2739
Indiana,Cedar Grove,246,0,8,18,10,9,45
Indiana,Cayuga,1000,3,0,38,77,72,190
Indiana,Carthage,794,7,12,49,55,52,175
Indiana,Merrillville,35322,421,709,2093,1941,2098,7262
Indiana,Metamora,84,0,0,0,0,0,0
Indiana,Mexico,790,0,17,18,23,40,98
Indiana,Michiana Shores,277,0,0,4,6,5,15
Indiana,Michigan City,31412,461,289,1417,1486,1520,5173
Indiana,Michigantown,434,12,8,38,36,18,112
Indiana,Middlebury,3494,37,0,142,174,219,572
Indiana,Middletown,2272,17,26,115,164,120,442
Indiana,Mier,136,0,0,0,0,0,0
Indiana,Milan,2088,42,16,118,136,66,378
Indiana,Milford,1683,20,34,144,78,64,340
Indiana,Millersburg,1016,19,24,55,78,60,236
Indiana,Millhousen,155,0,0,15,15,4,34
Indiana,Milltown,912,11,19,51,40,50,171
Indiana,Milroy,709,7,0,80,61,16,164
Indiana,Milton,492,5,6,32,35,32,110
Indiana,Mishawaka,48121,695,558,2573,2150,2310,8286
Indiana,Mitchell,4291,8,64,223,178,165,638
Indiana,Centerville,2609,17,36,220,193,216,682
Indiana,Chalmers,450,2,26,26,18,19,91
Indiana,Chandler,3355,77,90,249,225,239,880
Indiana,Charlestown,7906,88,94,483,590,682,1937
Indiana,Ferdinand,2092,17,47,107,90,87,348
Indiana,Farmland,1392,23,11,74,104,100,312
Indiana,Farmersburg,1257,2,9,39,109,93,252
Indiana,Fairview Park,1191,8,3,39,49,75,174
Indiana,Fairmount,3002,63,12,282,206,260,823
Indiana,Fairland,663,10,6,23,42,40,121
Indiana,Evansville,120212,1576,1577,5686,5236,4671,18746
Indiana,Etna Green,751,30,2,36,12,67,147
Indiana,English,860,7,4,63,42,60,176
Indiana,Emison,157,16,12,0,0,0,28
Indiana,Elwood,8484,118,109,351,456,467,1501
Indiana,Modoc,206,2,14,14,8,5,43
Indiana,Elnora,585,0,0,39,44,14,97
Indiana,Elkhart,52354,758,856,3881,3034,2650,11179
Indiana,Elizabethtown,487,10,9,35,31,36,121
Indiana,Elizabeth,214,6,6,9,15,5,41
Indiana,Elberfeld,699,21,16,37,25,39,138
Indiana,Edwardsport,338,9,1,12,12,23,57
Indiana,Edinburgh,4346,90,135,156,254,228,863
Indiana,Edgewood,1872,34,21,132,104,104,395
Indiana,Economy,163,2,0,3,12,9,26
Indiana,Eaton,1671,19,25,88,135,68,335
Indiana,East Germantown,262,0,1,6,5,10,22
Indiana,East Enterprise,413,0,0,77,74,38,189
Indiana,Ellettsville,6434,172,89,302,365,171,1099
Indiana,Monon,1910,30,67,107,161,125,490
Indiana,Monroe,646,10,13,33,48,53,157
Indiana,Monroe City,598,18,9,56,67,12,162
Indiana,Newberry,161,9,0,0,0,3,12
Indiana,Newburgh,3306,32,37,175,127,216,587
Indiana,New Carlisle,2028,47,31,150,104,129,461
Indiana,New Castle,17755,249,314,825,1035,976,3399
Indiana,New Chicago,2081,16,3,131,120,126,396
Indiana,New Goshen,476,0,18,18,37,26,99
Indiana,New Harmony,715,0,6,9,18,32,65
Indiana,New Haven,15832,179,234,917,741,744,2815
Indiana,New Market,546,5,13,16,39,45,118
Indiana,New Middletown,27,0,0,1,0,7,8
Indiana,Southport,2288,16,19,155,258,132,580
Indiana,New Amsterdam,15,0,0,2,0,0,2
Indiana,South Haven,5145,33,92,280,310,218,933
Indiana,Somerville,213,0,0,20,29,11,60
Indiana,Somerset,502,31,0,30,0,10,71
Indiana,Smithville-Sanders,3440,122,12,166,158,165,623
Indiana,Sims,180,0,0,0,0,0,0
Indiana,Simonton Lake,4446,58,11,241,185,278,773
Indiana,Silver Lake,1002,11,35,56,52,64,218
Indiana,Sidney,81,0,0,5,7,9,21
Indiana,West Harrison,417,4,3,11,15,13,46
Indiana,Shoals,789,7,0,58,21,46,132
Indiana,Shirley,874,22,19,57,67,78,243
Indiana,Shipshewana,688,9,4,38,24,21,96
Indiana,South Bend,100590,1699,1633,5462,6161,5678,20633
Indiana,Fillmore,659,0,3,37,28,78,146
Indiana,New Albany,36582,426,493,1630,1733,1545,5827
Indiana,Nappanee,6650,113,129,522,408,332,1504
Indiana,Monroeville,1188,12,12,74,13,76,187
Indiana,Monrovia,1725,2,5,146,139,191,483
Indiana,Monterey,310,3,7,28,14,32,84
Indiana,Montezuma,1021,29,29,67,83,52,260
Indiana,Montgomery,335,3,0,18,17,28,66
Indiana,Monticello,5332,12,148,202,367,343,1072
Indiana,Montmorenci,184,0,0,11,0,0,11
Indiana,Montpelier,1704,26,14,153,120,84,397
Indiana,Mooreland,294,2,5,16,24,19,66
Indiana,Moores Hill,696,23,3,47,81,62,216
Indiana,Mooresville,9508,173,29,657,348,513,1720
Indiana,Nashville,1255,0,20,73,62,65,220
Indiana,Morgantown,889,15,14,33,99,71,232
Indiana,Morristown,1264,14,14,36,46,66,176
Indiana,Mount Auburn,120,0,0,4,14,1,19
Indiana,Mount Ayr,116,0,0,6,7,2,15
Indiana,Mount Carmel,58,2,0,6,3,5,16
Indiana,Mount Etna,97,0,2,1,5,3,11
Indiana,Mount Summit,537,13,2,12,29,74,130
Indiana,Mount Vernon,6610,95,77,223,340,468,1203
Indiana,Mulberry,1362,13,25,63,54,45,200
Indiana,Muncie,70173,759,697,2305,2375,2862,8998
Indiana,Munster,23250,447,251,1402,1196,1379,4675
Indiana,Napoleon,189,7,3,0,9,5,24
Indiana,Morocco,1111,5,16,43,65,57,186
Indiana,Fishers,83177,2238,1527,5680,6015,5895,21355
Indiana,Fish Lake,915,16,0,53,78,59,206
Indiana,Flora,2148,24,29,178,93,120,444
Indiana,Union City,3486,0,36,179,319,230,764
Indiana,Ulen,125,0,0,10,7,3,20
Indiana,Troy,287,1,5,19,2,10,37
Indiana,Tri-Lakes,1241,0,0,64,32,66,162
Indiana,Trail Creek,2006,46,12,112,164,118,452
Indiana,Trafalgar,1161,29,12,86,85,98,310
Indiana,Town of Pines,734,12,11,27,25,32,107
Indiana,Topeka,1060,6,19,127,98,63,313
Indiana,Toad Hop,52,0,0,0,0,0,0
Indiana,Tipton,5252,15,81,365,253,417,1131
Indiana,Thorntown,1648,33,22,90,64,92,301
Indiana,Uniondale,303,10,2,24,21,8,65
Indiana,Terre Haute,61061,790,619,2525,2468,2613,9015
Indiana,Tell City,7234,69,60,480,332,418,1359
Indiana,Tecumseh,734,14,10,79,95,13,211
Indiana,Taylorsville,1080,0,0,90,101,89,280
Indiana,Syracuse,2864,49,23,246,152,171,641
Indiana,Switz City,288,7,0,10,11,16,44
Indiana,Sweetser,1242,40,9,102,81,82,314
Indiana,Swayzee,1025,38,8,75,65,49,235
Indiana,Sunman,919,10,37,60,48,33,188
Indiana,Summitville,1026,11,20,50,34,39,154
Indiana,Sulphur Springs,390,2,4,19,25,30,80
Indiana,Sullivan,4184,44,56,260,120,81,561
Indiana,Tennyson,335,13,5,12,17,9,56
Indiana,Straughn,253,7,3,21,18,6,55
Indiana,Universal,295,0,5,26,28,12,71
Indiana,Utica,711,12,1,66,42,60,181
Indiana,Waynetown,1237,67,39,72,71,66,315
Indiana,Waveland,351,3,3,28,22,15,71
Indiana,Waterloo,2210,106,60,191,162,156,675
Indiana,Washington,11874,232,83,860,625,616,2416
Indiana,Warsaw,14385,279,87,782,783,620,2551
Indiana,Warren Park,1697,25,22,84,40,134,305
Indiana,Warren,1511,16,35,72,76,66,265
Indiana,Wanatah,1158,12,12,77,59,73,233
Indiana,Walton,1102,9,18,91,43,55,216
Indiana,Wallace,122,6,2,17,3,2,30
Indiana,Walkerton,1874,27,31,73,82,84,297
Indiana,Upland,3883,58,30,69,201,137,495
Indiana,Waldron,603,0,0,70,35,30,135
Indiana,Wabash,10469,168,129,516,485,500,1798
Indiana,Vincennes,18135,235,221,880,906,721,2963
Indiana,Vevay,1471,9,13,50,63,87,222
Indiana,Versailles,2126,21,48,90,135,83,377
Indiana,Vernon,382,14,10,16,26,15,81
Indiana,Vera Cruz,116,0,0,21,1,10,32
Indiana,Veedersburg,2237,21,34,129,113,105,402
Indiana,Van Buren,867,7,12,29,35,49,132
Indiana,Van Bibber Lake,276,0,0,14,0,0,14
Indiana,Valparaiso,32123,456,235,1458,1564,1620,5333
Indiana,Vallonia,274,0,7,0,6,25,38
Indiana,Wakarusa,2024,35,21,115,118,117,406
Indiana,Sheridan,2841,28,35,157,178,159,557
Indiana,Stockwell,594,0,0,29,75,39,143
Indiana,Stilesville,206,0,0,2,6,14,22
Indiana,Gas City,6046,85,68,287,345,379,1164
Indiana,Gary,78483,1254,1052,4919,4631,4524,16380
Indiana,Garrett,6552,167,131,526,360,449,1633
Indiana,Galveston,1068,8,9,46,54,70,187
Indiana,Galena,1803,30,82,93,196,183,584
Indiana,Fulton,516,13,0,46,46,40,145
Indiana,French Lick,1989,26,46,136,147,64,419
Indiana,Fremont,2255,72,14,49,122,181,438
Indiana,Freetown,265,0,0,0,22,24,46
Indiana,Freelandville,617,34,0,7,31,0,72
Indiana,Fredericksburg,110,0,0,2,0,4,6
Indiana,Gaston,945,20,30,59,74,52,235
Indiana,Frankton,1878,26,52,115,121,156,470
Indiana,Frankfort,16467,297,332,977,1083,717,3406
Indiana,Francisco,703,11,7,65,54,75,212
Indiana,Francesville,867,3,6,18,52,41,120
Indiana,Fowlerton,276,0,4,19,26,18,67
Indiana,Fowler,2269,46,45,77,76,142,386
Indiana,Fountain City,732,6,23,45,27,54,155
Indiana,Fort Wayne,257059,4413,3460,14733,15058,14441,52105
Indiana,Fortville,4095,63,46,193,228,115,645
Indiana,Fort Branch,2971,48,53,133,148,157,539
Indiana,Fontanet,334,0,0,23,0,10,33
Indiana,Florence,78,0,0,0,0,0,0
Indiana,Franklin,24090,294,320,1334,1608,1331,4887
Indiana,Stinesville,183,4,2,1,1,8,16
Indiana,Geneva,1407,31,28,61,35,46,201
Indiana,Georgetown,3084,79,23,199,155,154,610
Indiana,Staunton,562,18,3,26,30,39,116
Indiana,State Line City,165,5,0,9,8,6,28
Indiana,Star City,194,13,0,24,6,0,43
Indiana,Spurgeon,171,0,0,2,0,9,11
Indiana,Springport,173,2,0,15,19,1,37
Indiana,Spring Lake,304,1,0,11,14,30,56
Indiana,Spring Hill,87,0,0,0,0,1,1
Indiana,Spring Grove,384,1,0,17,23,23,64
Indiana,Spiceland,917,38,10,54,56,79,237
Indiana,Spencer,2374,8,27,144,55,173,407
Indiana,Speedway,12100,165,135,560,427,337,1624
Indiana,Gentryville,344,3,8,11,18,18,58
Indiana,South Whitley,1903,6,16,151,155,110,438
Indiana,Greensboro,139,1,3,25,2,5,36
Indiana,Greenfield,21179,261,439,1402,856,1024,3982
Indiana,Greendale,4554,16,63,199,357,279,914
Indiana,Greencastle,10314,212,117,576,406,268,1579
Indiana,Granger,30690,603,380,1907,2097,2539,7526
Indiana,Grandview,700,24,3,51,64,50,192
Indiana,Grabill,1454,32,30,144,92,44,342
Indiana,Gosport,740,8,10,30,35,53,136
Indiana,Goshen,32946,681,695,1937,1825,1868,7006
Indiana,Goodland,1003,0,0,40,35,69,144
Indiana,Glenwood,309,8,4,20,16,21,69
Indiana,Greensburg,12054,160,295,664,710,525,2354
Indiana,Shepardsville,380,0,0,8,63,83,154
Indiana,Shorewood Forest,2494,47,50,74,185,167,523
Indiana,Shelby,612,0,0,24,41,134,199
Indiana,Andrews,1090,30,4,90,34,50,208
Indiana,Angola,8615,178,171,439,422,323,1533
Indiana,Arcadia,1248,19,16,68,132,37,272
Indiana,Argos,1944,29,40,158,148,91,466
Indiana,Arlington,518,0,0,37,75,36,148
Indiana,Ashley,1080,21,36,52,72,60,241
Indiana,Atlanta,702,9,1,54,39,31,134
Indiana,Attica,3352,34,49,113,139,219,554
Indiana,Auburn,12979,223,168,488,752,771,2402
Indiana,Aurora,3744,47,54,204,130,182,617
Indiana,New Palestine,2169,36,36,116,169,152,509
Indiana,New Paris,1160,34,13,59,101,121,328
Indiana,New Pekin,1497,13,27,45,108,153,346
Indiana,New Point,315,0,7,31,11,15,64
Indiana,Newport,500,3,0,24,18,19,64
Indiana,New Richmond,351,10,5,22,22,22,81
Indiana,New Ross,342,5,7,28,35,16,91
Indiana,New Salisbury,495,14,0,0,78,0,92
Indiana,Carlisle,594,20,2,20,47,47,136
Indiana,Carbon,463,3,11,47,17,34,112
Indiana,Cannelton,1520,36,31,47,130,72,316
Indiana,Cannelburg,193,0,2,19,8,7,36
Indiana,Canaan,52,0,0,0,0,0,0
Indiana,Campbellsburg,609,3,16,53,56,36,164
Indiana,Camden,684,15,7,62,56,28,168
Indiana,Anderson,55630,664,813,2957,2429,2867,9730
Indiana,Cambridge City,1773,29,11,44,111,110,305
Indiana,Amo,508,2,9,24,43,53,131
Indiana,Amboy,323,4,5,12,23,9,53
Indiana,Rolling Prairie,712,17,34,27,40,46,164
Indiana,Rocky Ripple,693,13,8,49,7,47,124
Indiana,Rockville,2577,64,64,54,57,68,307
Indiana,Rockport,2467,62,32,250,85,113,542
Indiana,Rochester,6123,86,112,151,233,272,854
Indiana,Roanoke,1784,21,18,112,126,120,397
Indiana,Roann,492,7,0,39,24,27,97
Indiana,Roachdale,949,4,7,92,43,67,213
Indiana,River Forest,24,0,0,0,1,1,2
Indiana,Rising Sun,2456,34,12,87,141,88,362
Indiana,Riley,171,0,4,11,10,12,37
Indiana,Ridgeville,590,6,1,42,37,29,115
Indiana,Richmond,36291,411,449,1804,1697,1566,5927
Indiana,Carmel,85367,2096,1435,5886,5554,6112,21083
Indiana,Aberdeen,1756,0,10,145,131,68,354
Indiana,Advance,464,7,2,33,12,41,95
Indiana,Akron,1488,33,32,86,110,96,357
Indiana,Alamo,53,0,0,2,0,2,4
Indiana,Albany,2076,32,31,86,92,107,348
Indiana,Albion,2468,18,96,132,117,114,477
Indiana,Alexandria,5074,104,174,280,309,190,1057
Indiana,Alfordsville,86,0,0,3,0,8,11
Indiana,Alton,52,0,0,0,0,7,7
Indiana,Altona,228,4,0,5,15,15,39
Indiana,Ambia,205,3,4,12,13,15,47
Indiana,Americus,409,12,0,37,12,41,102
Indiana,Cadiz,178,4,0,7,17,34,62
Indiana,Butlerville,136,0,0,0,0,0,0
Indiana,Butler,2870,47,45,151,171,213,627
Indiana,Bloomfield,2507,39,30,134,148,205,556
Indiana,Blanford,264,0,0,10,12,29,51
Indiana,Birdseye,420,3,8,22,25,14,72
Indiana,Bicknell,3080,10,16,214,180,136,556
Indiana,Beverly Shores,547,0,0,17,21,0,38
Indiana,Bethany,94,0,5,0,2,0,7
Indiana,Berne,3863,63,68,195,201,205,732
Indiana,Beech Grove,14000,94,166,891,1031,827,3009
Indiana,Merom,184,0,3,13,11,8,35
Indiana,Meridian Hills,1660,34,21,88,138,99,380
Indiana,Mentone,937,12,5,55,68,50,190
Indiana,Memphis,732,21,28,35,48,43,175
Indiana,Melody Hill,3866,52,109,107,187,260,715
Indiana,Mellott,203,5,3,10,12,9,39
Indiana,Medora,548,8,7,48,33,28,124
Indiana,Medaryville,554,22,6,34,50,19,131
Indiana,Mecca,422,2,19,40,36,35,132
Indiana,Mauckport,59,0,0,1,1,10,12
Indiana,Matthews,593,0,7,16,14,36,73
Indiana,Martinsville,11739,69,136,557,552,556,1870
Indiana,Marshall,277,1,0,13,15,1,30
Indiana,Markleville,514,3,13,38,27,35,116
Indiana,Markle,1164,7,6,46,56,62,177
Indiana,West Baden Springs,530,0,6,18,24,25,73
Indiana,West College Corner,782,6,18,48,59,106,237
Indiana,Bloomingdale,313,2,4,7,32,13,58
Indiana,Bloomington,82813,978,599,1998,1875,1987,7437
Indiana,Blountsville,122,4,1,8,6,6,25
Indiana,Bluffton,9536,82,132,440,558,596,1808
Indiana,Burns Harbor,1326,19,17,47,87,63,233
Indiana,Burns City,145,0,0,0,0,0,0
Indiana,Burnettsville,343,13,10,20,23,7,73
Indiana,Burlington,594,11,10,37,32,37,127
Indiana,Burket,148,0,0,8,13,8,29
Indiana,Bunker Hill,603,3,4,17,35,38,97
Indiana,Buffalo,1041,0,27,34,32,35,128
Indiana,Buck Creek,157,0,0,0,0,0,0
Indiana,Bryant,252,13,6,15,17,7,58
Indiana,Bruceville,525,10,2,28,53,33,126
Indiana,Brownstown,2958,46,37,139,216,172,610
Indiana,Brownsburg,23484,504,414,957,1198,1285,4358
Indiana,Rome City,1159,3,0,45,28,54,130
Indiana,Brookville,2573,4,50,179,180,159,572
Indiana,Brooksburg,77,0,0,8,4,3,15
Indiana,Brooklyn,1635,10,41,65,122,125,363
Indiana,Brook,1012,19,24,62,79,70,254
Indiana,Bristol,1809,25,43,84,39,61,252
Indiana,Bright,4946,74,102,202,358,291,1027
Indiana,Bremen,4588,96,109,242,231,285,963
Indiana,Brazil,8028,35,116,711,375,593,1830
Indiana,Bourbon,1697,29,8,86,112,125,360
Indiana,Boswell,733,0,3,33,53,55,144
Indiana,Boston,150,6,1,4,11,4,26
Indiana,Borden,755,15,17,50,38,26,146
Indiana,Boonville,6213,95,66,509,408,101,1179
Indiana,Brookston,1526,20,60,93,98,48,319
Indiana,Shelbyville,19250,259,326,1245,1015,1000,3845
Indiana,Rosedale,656,35,9,25,39,50,158
Indiana,Knox,3723,0,25,183,285,170,663
Indiana,Russellville,383,0,6,11,19,32,68
Indiana,Rushville,6192,43,105,401,321,329,1199
Indiana,Royal Center,919,13,31,67,39,59,209
Indiana,Rossville,1623,17,25,121,127,113,403
Indiana,Roselawn,4087,39,52,259,359,233,942
Indiana,Greens Fork,482,15,2,20,11,12,60
Indiana,Greentown,2710,41,63,150,138,169,561
Indiana,Greenville,666,5,3,27,39,57,131
Indiana,Greenwood,53828,976,752,2694,2840,3432,10694
Indiana,Griffin,164,3,5,11,9,1,29
Indiana,Griffith,16643,237,228,795,917,849,3026
Indiana,Grissom AFB,2779,18,64,158,215,178,633
Indiana,Hagerstown,1584,46,14,109,78,97,344
Indiana,Hamilton,1665,40,0,82,74,117,313
Indiana,Hamlet,890,16,24,109,18,74,241
Indiana,Hammond,78983,1406,1482,4467,4453,5005,16813
Indiana,Hanna,311,0,0,4,0,11,15
Indiana,Hanover,3495,26,66,138,100,172,502
Indiana,Hardinsburg,185,0,1,11,9,9,30
Indiana,Harlan,1669,18,30,70,41,148,307
Indiana,Harmony,719,22,2,14,29,26,93
Indiana,Harrodsburg,769,9,14,83,63,50,219
Indiana,Hartford City,6156,106,147,272,250,264,1039
Indiana,Hartsville,363,2,8,23,16,15,64
Indiana,Hatfield,788,10,31,0,55,50,146
Indiana,Russiaville,1104,20,15,76,75,72,258
Indiana,Haubstadt,1587,27,4,97,89,99,316
Indiana,St. Bernice,432,0,24,26,27,20,97
Indiana,St. John,15789,529,193,943,960,1133,3758
Indiana,Shelburn,1200,9,7,76,68,56,216
Indiana,Sharpsville,695,2,4,44,50,62,162
Indiana,Shamrock Lakes,261,0,0,14,18,17,49
Indiana,Shadeland,1746,2,4,44,84,116,250
Indiana,Seymour,18861,246,401,899,870,885,3301
Indiana,Selma,735,11,11,24,31,13,90
Indiana,Sellersburg,8675,174,93,661,494,746,2168
Indiana,Seelyville,919,28,14,47,2,11,102
Indiana,Scottsburg,6677,53,60,342,386,302,1143
Indiana,Scotland,149,0,0,0,23,42,65
Indiana,Scipio,63,0,0,0,0,0,0
Indiana,Schneider,278,1,1,16,11,15,44
Indiana,Schererville,28987,531,314,1468,1282,1396,4991
Indiana,Saratoga,197,0,6,8,12,0,26
Indiana,Santa Claus,2671,41,27,231,260,190,749
Indiana,San Pierre,96,0,0,0,0,0,0
Indiana,Sandborn,385,2,7,14,20,6,49
Indiana,Saltillo,100,0,0,0,4,7,11
Indiana,Salt Creek Commons,2380,0,157,246,69,120,592
Indiana,Salem,6256,45,57,326,326,296,1050
Indiana,Salamonia,232,2,3,22,17,18,62
Indiana,St. Paul,1112,19,12,54,52,59,196
Indiana,St. Meinrad,550,0,0,0,30,35,65
Indiana,St. Mary of the Woods,781,0,0,15,0,15,30
Indiana,St. Leon,666,2,10,17,29,14,72
Indiana,St. Joe,511,13,16,44,40,48,161
Indiana,Hayden,1299,0,0,15,223,273,511
Indiana,Hazleton,291,0,7,24,23,8,62
Indiana,Hebron,3723,89,9,255,202,295,850
Indiana,Roseland,561,10,4,25,18,28,85
Indiana,Crane,215,9,1,12,14,9,45
Indiana,Jasonville,2370,31,41,89,104,116,381
Indiana,Jasper,15538,95,167,901,912,924,2999
Indiana,Jeffersonville,46259,827,659,2062,2258,2319,8125
Indiana,Jonesboro,1621,10,12,80,155,97,354
Indiana,Jonesville,158,2,1,7,8,10,28
Indiana,Kempton,368,8,5,9,23,14,59
Indiana,Kendallville,9870,163,67,512,763,530,2035
Indiana,Jalapa,204,0,0,0,0,0,0
Indiana,Kennard,435,0,5,25,30,33,93
Indiana,Kentland,1886,22,12,129,52,119,334
Indiana,Kewanna,797,12,10,34,24,62,142
Indiana,Kimmell,528,28,4,7,17,59,115
Indiana,Kingman,517,5,4,27,36,48,120
Indiana,Kingsbury,309,3,12,17,16,22,70
Indiana,Kingsford Heights,1477,25,31,110,104,31,301
Indiana,Kirklin,791,18,38,49,39,58,202
Indiana,Knightstown,2123,18,17,77,124,144,380
Indiana,Knightsville,805,3,20,33,44,29,129
Indiana,Kent,110,0,0,27,0,0,27
Indiana,Ingalls,2123,37,65,145,146,93,486
Indiana,Crandall,171,11,5,4,23,5,48
Indiana,Indianapolis city (balance),841449,13475,10598,47066,44968,44120,160227
Indiana,Henryville,1837,12,11,68,203,48,342
Indiana,Herbst,47,0,0,0,0,0,0
Indiana,Heritage Lake,2885,34,0,71,149,216,470
Indiana,Hidden Valley,5138,87,27,329,326,560,1329
Indiana,Highland,23285,326,234,1226,1187,1259,4232
Indiana,Highland,4226,121,20,222,248,142,753
Indiana,Hillsboro,668,11,2,45,50,54,162
Indiana,Hoagland,887,15,5,60,22,46,148
Indiana,Hobart,28943,589,433,1408,1208,1215,4853
Indiana,Holland,738,6,22,50,48,41,167
Indiana,Holton,610,16,6,33,48,39,142
Indiana,Homecroft,685,15,3,19,34,33,104
Indiana,Hope,2306,67,19,104,131,88,409
Indiana,Howe,716,0,0,0,33,101,134
Indiana,Hudson,594,6,13,65,48,51,183
Indiana,Hudson Lake,1424,41,23,89,90,42,285
Indiana,Huntertown,5260,98,74,416,352,244,1184
Indiana,Huntingburg,6446,68,86,421,536,404,1515
Indiana,Huntington,17231,288,336,588,1009,799,3020
Indiana,Idaville,686,30,0,79,26,30,165
Indiana,Hymera,680,11,7,38,28,35,119
Indiana,Indian Village,118,1,1,4,2,4,12
Iowa,La Motte,239,4,5,10,13,8,40
Iowa,Lamont,378,3,8,28,21,17,77
Iowa,Lambs Grove,196,11,2,7,9,2,31
Iowa,Lake View,1124,12,6,46,53,50,167
Iowa,Lakeside,662,17,3,15,34,18,87
Iowa,Lake Park,1112,6,8,69,83,86,252
Iowa,Lake Panorama,1097,9,8,40,31,49,137
Iowa,Lake Mills,2010,25,16,79,86,84,290
Iowa,Lake City,1766,34,38,45,73,111,301
Iowa,Lakota,235,5,4,5,7,11,32
Iowa,Lamoni,2559,21,5,141,97,81,345
Iowa,Nichols,392,4,3,15,25,29,76
Iowa,Lansing,953,10,6,10,60,67,153
Iowa,South Amana,124,0,0,0,0,10,10
Iowa,Somers,129,3,4,0,4,6,17
Iowa,Solon,2302,51,51,162,160,166,590
Iowa,Soldier,154,5,0,5,12,7,29
Iowa,Smithland,160,0,0,4,3,4,11
Iowa,Sloan,1067,23,19,37,53,56,188
Iowa,Slater,1612,39,44,88,139,101,411
Iowa,Sioux Rapids,663,15,0,60,26,40,141
Iowa,Sioux City,82792,1607,1702,4564,4326,4170,16369
Iowa,Sioux Center,7312,272,90,371,566,180,1479
Iowa,Silver City,177,2,2,3,4,5,16
Iowa,Sigourney,2071,31,25,131,82,82,351
Iowa,Sidney,1001,36,4,43,63,73,219
Iowa,Sibley,2687,76,40,122,150,176,564
Iowa,Shueyville,594,16,7,54,42,18,137
Iowa,Sherrill,202,2,2,16,10,7,37
Iowa,Shenandoah,5062,238,94,177,215,200,924
Iowa,South English,269,11,0,25,11,29,76
Iowa,Shellsburg,1143,5,22,90,56,61,234
Iowa,Spencer,11186,227,144,658,576,432,2037
Iowa,Spirit Lake,4948,168,88,167,249,117,789
Iowa,Stout,191,4,9,5,17,2,37
Iowa,Story City,3435,57,64,160,147,197,625
Iowa,Storm Lake,10814,398,169,574,603,633,2377
Iowa,Stone City,298,0,0,0,16,17,33
Iowa,Stockton,209,2,4,18,13,9,46
Iowa,Stockport,254,12,4,16,9,14,55
Iowa,Steamboat Rock,292,8,1,11,4,10,34
Iowa,State Center,1355,31,30,61,57,77,256
Iowa,Stanwood,572,0,2,29,38,33,102
Iowa,Stanton,694,9,7,39,32,28,115
Iowa,Stanley,114,10,0,8,7,8,33
Iowa,Stanhope,401,2,0,25,9,23,59
Iowa,Stacyville,545,4,2,20,10,28,64
Iowa,Springville,1034,15,3,67,51,59,195
Iowa,Spring Hill,63,0,4,16,3,0,23
Iowa,Springbrook,175,8,0,8,7,2,25
Iowa,Spragueville,93,0,1,5,5,5,16
Iowa,Spillville,409,1,13,24,21,15,74
Iowa,Stratford,632,0,16,32,33,24,105
Iowa,Shell Rock,1188,9,11,69,49,49,187
Iowa,Sheldahl,266,3,3,6,15,24,51
Iowa,Lincoln,128,9,4,7,3,2,25
Iowa,Linden,186,1,0,8,4,3,16
Iowa,Lineville,197,3,2,5,8,6,24
Iowa,Linn Grove,137,1,1,14,2,0,18
Iowa,Lisbon,1990,43,42,123,157,114,479
Iowa,Liscomb,317,2,6,26,23,20,77
Iowa,Little Cedar,45,0,0,0,0,0,0
Iowa,Little Rock,492,9,10,13,15,30,77
Iowa,Little Sioux,140,0,0,0,5,13,18
Iowa,Livermore,451,6,14,17,15,30,82
Iowa,Lockridge,272,7,1,8,5,18,39
Iowa,Logan,1627,51,33,114,62,116,376
Iowa,Lohrville,371,14,9,13,15,18,69
Iowa,Lone Rock,136,0,0,7,2,0,9
Iowa,Lone Tree,1374,11,10,67,117,109,314
Iowa,Long Grove,894,40,12,64,63,54,233
Iowa,Lorimor,378,0,22,13,5,23,63
Iowa,Lime Springs,429,10,0,30,20,19,79
Iowa,Sheldon,5024,28,9,181,198,381,797
Iowa,Lidderdale,139,1,3,1,3,9,17
Iowa,Ladora,320,2,4,22,24,26,78
Iowa,Shelby,578,4,9,27,21,32,93
Iowa,Sheffield,1146,27,7,90,70,82,276
Iowa,Sharpsburg,76,0,0,8,1,5,14
Iowa,Shannon City,73,10,1,6,7,0,24
Iowa,Shambaugh,189,1,0,3,9,31,44
Iowa,Seymour,664,18,18,38,44,17,135
Iowa,Sexton,41,0,0,8,0,0,8
Iowa,Sergeant Bluff,4356,132,83,425,449,487,1576
Iowa,Searsboro,161,6,0,4,1,13,24
Iowa,Scranton,563,1,11,42,51,18,123
Iowa,Schleswig,808,6,0,61,30,41,138
Iowa,Schaller,802,32,11,36,69,52,200
Iowa,Scarville,63,0,0,0,9,2,11
Iowa,Saylorville,3485,15,0,130,316,360,821
Iowa,Sandyville,82,3,2,1,6,5,17
Iowa,Sanborn,1306,64,16,73,57,62,272
Iowa,Salix,372,7,6,23,28,10,74
Iowa,Libertyville,335,7,1,9,13,10,40
Iowa,Strawberry Point,1407,33,20,79,104,90,326
Iowa,Struble,86,0,0,2,5,6,13
Iowa,Stuart,1593,5,17,79,118,95,314
Iowa,Lewis,470,13,2,35,18,23,91
Iowa,Anthon,728,17,5,47,51,47,167
Iowa,Aplington,1152,41,12,78,59,52,242
Iowa,Arcadia,512,11,17,35,33,23,119
Iowa,Archer,167,4,5,15,5,1,30
Iowa,Aredale,53,0,0,0,4,1,5
Iowa,Arion,185,12,7,5,15,5,44
Iowa,Arispe,63,0,0,9,2,2,13
Iowa,Arlington,520,2,7,24,23,39,95
Iowa,Armstrong,918,34,12,39,39,53,177
Iowa,Arnolds Park,1128,8,8,11,49,40,116
Iowa,Arthur,210,1,0,14,24,4,43
Iowa,Asbury,5014,99,80,399,417,266,1261
Iowa,Ashton,435,1,8,28,9,17,63
Iowa,Aspinwall,18,0,0,1,2,0,3
Iowa,Atalissa,327,4,3,20,21,19,67
Iowa,Athelstan,49,0,0,14,6,0,20
Iowa,Letts,407,6,7,21,29,32,95
Iowa,Atkins,1839,39,23,124,127,95,408
Iowa,Lester,268,3,6,20,16,4,49
Iowa,Leon,1999,27,59,118,51,105,360
Iowa,La Porte City,2315,78,29,151,245,106,609
Iowa,Larchwood,952,9,25,83,42,68,227
Iowa,Larrabee,187,2,0,17,7,12,38
Iowa,Latimer,463,8,2,19,16,16,61
Iowa,Laurel,316,1,1,21,15,42,80
Iowa,Laurens,1271,22,27,36,63,76,224
Iowa,Lawler,331,9,5,2,16,1,33
Iowa,Lawton,851,19,15,48,58,59,199
Iowa,Leando,64,0,0,0,0,0,0
Iowa,Le Claire,3888,70,80,206,231,157,744
Iowa,Ledyard,117,2,2,0,1,13,18
Iowa,Le Grand,1041,15,35,90,65,53,258
Iowa,Lehigh,407,2,0,10,14,15,41
Iowa,Leighton,168,2,3,15,1,7,28
Iowa,Leland,275,0,13,27,13,7,60
Iowa,Le Mars,9757,266,154,528,323,568,1839
Iowa,Lenox,1433,21,17,95,93,69,295
Iowa,Le Roy,6,0,0,0,0,0,0
Iowa,Atlantic,6929,119,45,469,234,345,1212
Iowa,Auburn,278,13,4,4,3,25,49
Iowa,Audubon,2054,50,39,81,100,114,384
Iowa,Beaverdale,1435,69,27,74,147,26,343
Iowa,Bedford,1491,19,35,126,64,63,307
Iowa,Belle Plaine,2528,71,78,104,203,152,608
Iowa,Bellevue,2134,51,16,91,135,63,356
Iowa,Belmond,2438,36,55,140,157,59,447
Iowa,Bennett,384,16,4,14,18,18,70
Iowa,Bentley,136,0,0,0,17,6,23
Iowa,Benton,43,0,0,0,0,1,1
Iowa,Berkley,22,0,0,0,0,2,2
Iowa,Bernard,123,0,0,1,7,9,17
Iowa,Swan,78,2,4,3,5,10,24
Iowa,Swaledale,187,6,9,22,3,11,51
Iowa,Sutherland,582,3,9,6,30,18,66
Iowa,Superior,184,2,10,10,6,13,41
Iowa,Sun Valley Lake,223,0,0,0,0,5,5
Iowa,Sumner,2114,65,32,167,90,69,423
Iowa,Sully,812,12,9,55,51,53,180
Iowa,Beaver,125,0,2,5,25,22,54
Iowa,Beaman,234,1,2,21,20,13,57
Iowa,Beaconsfield,25,0,0,0,0,0,0
Iowa,Beacon,573,28,4,29,18,44,123
Iowa,Aurelia,1002,23,12,41,62,29,167
Iowa,Aurora,233,3,5,14,17,27,66
Iowa,Avoca,1378,26,59,53,62,50,250
Iowa,Ayrshire,152,0,3,7,3,14,27
Iowa,Badger,572,6,2,40,42,41,131
Iowa,Bagley,330,12,1,4,12,28,57
Iowa,Baldwin,110,3,2,2,0,7,14
Iowa,Balltown,68,0,1,5,1,0,7
Iowa,Lanesboro,114,0,0,2,4,16,22
Iowa,Bancroft,747,19,25,52,33,32,161
Iowa,Barnes City,286,2,15,10,30,13,70
Iowa,Barnum,271,2,36,14,15,26,93
Iowa,Bartlett,0,0,0,0,0,0,0
Iowa,Bassett,69,0,0,0,0,4,4
Iowa,Batavia,669,33,3,25,46,23,130
Iowa,Battle Creek,701,16,18,34,21,26,115
Iowa,Baxter,929,3,27,41,42,36,149
Iowa,Bayard,470,2,5,19,33,31,90
Iowa,Bankston,79,2,0,0,2,0,4
Iowa,Lacona,446,10,1,19,31,20,81
Iowa,Ankeny,51489,1230,881,3127,3227,2383,10848
Iowa,Knierim,81,2,1,15,4,6,28
Iowa,Hardy,98,7,0,8,17,2,34
Iowa,Harlan,5029,80,28,220,235,326,889
Iowa,Harper,93,4,1,4,4,6,19
Iowa,Harpers Ferry,291,0,0,10,1,7,18
Iowa,Harris,155,0,2,3,2,4,11
Iowa,Hartford,847,13,10,81,63,79,246
Iowa,Hartley,1695,25,60,82,97,92,356
Iowa,Hartwick,99,5,1,6,0,5,17
Iowa,Harvey,269,0,2,34,7,5,48
Iowa,Hastings,172,3,2,14,10,5,34
Iowa,Havelock,152,0,6,11,10,3,30
Iowa,Haverhill,204,2,0,6,5,8,21
Iowa,Hawarden,2551,117,31,173,147,99,567
Iowa,Hawkeye,549,5,1,29,70,40,145
Iowa,Hayesville,40,0,0,0,2,0,2
Iowa,Hayfield,7,0,0,0,0,0,0
Iowa,Hazleton,902,12,18,62,63,73,228
Iowa,Hedrick,849,13,12,38,34,66,163
Iowa,Henderson,165,7,7,15,23,1,53
Iowa,Wellman,1395,10,16,82,69,59,236
Iowa,Wellsburg,939,29,12,31,86,46,204
Iowa,Welton,127,0,0,2,15,4,21
Iowa,Wesley,354,9,8,22,14,12,65
Iowa,Whittemore,474,12,10,25,12,28,87
Iowa,Whiting,874,31,9,48,42,38,168
Iowa,Wheatland,685,16,12,29,34,67,158
Iowa,What Cheer,701,4,2,72,24,60,162
Iowa,Westwood,146,6,1,12,7,9,35
Iowa,West Union,2692,81,60,125,135,150,551
Iowa,Westside,333,0,14,5,15,9,43
Iowa,West Point,1113,0,0,72,28,47,147
Iowa,Westphalia,126,5,0,5,6,4,20
Iowa,Hepburn,56,0,5,0,11,8,24
Iowa,Weston,96,0,0,0,10,9,19
Iowa,West Liberty,3737,45,95,289,160,197,786
Iowa,Westgate,187,4,2,6,6,6,24
Iowa,Westfield,172,9,7,21,20,9,66
Iowa,West Des Moines,61266,1240,961,2860,2893,2979,10933
Iowa,West Chester,106,1,0,5,3,4,13
Iowa,West Burlington,3021,21,64,115,117,159,476
Iowa,West Branch,2716,54,44,149,162,177,586
Iowa,West Bend,890,22,29,57,27,23,158
Iowa,West Amana,243,0,0,0,0,0,0
Iowa,West Okoboji,290,3,2,2,7,19,33
Iowa,Hiawatha,7150,172,131,302,315,291,1211
Iowa,High Amana,111,16,0,20,0,0,36
Iowa,Hills,810,18,10,37,38,44,147
Iowa,Iowa City,71832,1089,661,2288,2359,2260,8657
Iowa,Iowa Falls,5198,79,31,300,294,227,931
Iowa,Ireton,667,14,6,28,35,35,118
Iowa,Irvington,26,0,0,6,7,0,13
Iowa,Irwin,380,3,1,5,14,30,53
Iowa,Jackson Junction,46,0,0,0,4,5,9
Iowa,Jacksonville,31,0,0,0,0,0,0
Iowa,Jamaica,215,2,3,7,5,21,38
Iowa,Janesville,880,8,6,81,30,67,192
Iowa,Ionia,351,15,8,25,18,17,83
Iowa,Jefferson,4272,15,50,213,277,240,795
Iowa,Jewell Junction,1281,7,33,90,90,80,300
Iowa,Johnston,19550,369,235,1396,1218,1286,4504
Iowa,Joice,190,0,3,8,10,17,38
Iowa,Jolley,37,0,0,3,3,0,6
Iowa,Kalona,2447,65,51,171,109,57,453
Iowa,Kamrar,184,5,0,15,6,3,29
Iowa,Kanawha,690,21,2,24,24,28,99
Iowa,Kellerton,278,6,2,18,24,13,63
Iowa,Kelley,323,2,2,15,20,15,54
Iowa,Jesup,2691,59,42,207,138,152,598
Iowa,Whitten,153,1,3,12,16,14,46
Iowa,Inwood,817,10,16,47,20,26,119
Iowa,Independence,5986,60,52,263,523,263,1161
Iowa,Hillsboro,228,1,0,11,9,21,42
Iowa,Hinton,864,12,12,63,65,68,220
Iowa,Holiday Lake,340,0,5,8,0,0,13
Iowa,Holland,235,8,0,9,18,12,47
Iowa,Holstein,1454,29,10,47,64,88,238
Iowa,Holy Cross,376,4,7,21,26,23,81
Iowa,Homestead,201,0,27,41,18,0,86
Iowa,Hopkinton,567,10,4,12,22,33,81
Iowa,Hornick,273,4,5,13,12,13,47
Iowa,Indianola,15165,251,162,849,865,590,2717
Iowa,Hospers,793,36,20,52,25,14,147
Iowa,Hubbard,961,14,18,32,70,63,197
Iowa,Hudson,2391,90,49,157,77,187,560
Iowa,Hull,2317,57,40,114,144,100,455
Iowa,Humboldt,4635,115,95,325,234,164,933
Iowa,Humeston,493,10,0,14,49,36,109
Iowa,Hutchins,11,0,0,0,0,0,0
Iowa,Huxley,3430,94,125,190,197,126,732
Iowa,Ida Grove,2199,21,72,96,113,83,385
Iowa,Imogene,34,0,0,1,2,3,6
Iowa,Houghton,151,1,0,16,6,4,27
Iowa,Kellogg,746,5,13,62,43,32,155
Iowa,Willey,108,4,1,9,9,7,30
Iowa,Williamsburg,3128,91,78,103,120,189,581
Iowa,Geneva,142,5,0,4,4,13,26
Iowa,George,1065,2,9,63,56,28,158
Iowa,Gibson,57,1,0,2,2,4,9
Iowa,Gilbert,1237,46,17,111,98,69,341
Iowa,Gilbertville,700,7,8,2,2,37,56
Iowa,Gillett Grove,56,0,0,0,8,11,19
Iowa,Gilman,696,5,37,48,73,30,193
Iowa,Gilmore City,417,3,2,20,16,16,57
Iowa,Gladbrook,839,22,2,28,29,56,137
Iowa,Glenwood,5243,86,45,68,252,441,892
Iowa,Glidden,1336,40,13,77,70,96,296
Iowa,Goldfield,658,6,17,31,30,32,116
Iowa,Goodell,129,5,7,11,1,1,25
Iowa,Goose Lake,263,10,8,15,23,21,77
Iowa,Gowrie,1093,4,19,37,105,43,208
Iowa,Graettinger,702,9,9,38,28,44,128
Iowa,Graf,77,4,0,7,6,3,20
Iowa,Grafton,326,9,1,17,7,28,62
Iowa,Grand Junction,854,9,8,47,64,73,201
Iowa,Garwin,464,3,15,24,22,56,120
Iowa,Garrison,384,5,4,30,10,21,70
Iowa,Garner,3100,44,82,108,202,285,721
Iowa,Garnavillo,855,19,2,59,45,49,174
Iowa,New Virginia,472,16,6,25,32,40,119
Iowa,Fontanelle,667,0,11,33,35,32,111
Iowa,Forest City,4110,67,30,217,235,324,873
Iowa,Fort Atkinson,267,3,1,6,14,21,45
Iowa,Fort Dodge,24789,444,306,1169,1171,1377,4467
Iowa,Fort Madison,10832,327,169,455,466,586,2003
Iowa,Fostoria,163,5,0,13,8,10,36
Iowa,Franklin,114,2,0,4,6,8,20
Iowa,Fraser,165,0,10,5,14,13,42
Iowa,Grand Mound,507,5,1,11,28,42,87
Iowa,Fredericksburg,1123,22,11,50,53,62,198
Iowa,Fredonia,388,0,4,41,41,25,111
Iowa,Fremont,691,27,8,44,27,38,144
Iowa,Fruitland,1281,38,31,106,87,70,332
Iowa,Frytown,79,0,0,0,0,16,16
Iowa,Galt,80,0,0,1,1,1,3
Iowa,Galva,519,30,5,49,29,18,131
Iowa,Garber,141,1,0,12,16,9,38
Iowa,Garden City,64,0,0,0,4,4,8
Iowa,Garden Grove,228,6,7,19,13,9,54
Iowa,Frederika,192,1,0,6,9,7,23
Iowa,Grand River,247,4,13,12,11,2,42
Iowa,Grandview,512,13,14,30,29,13,99
Iowa,Granger,1587,41,40,87,107,75,350
Iowa,Harcourt,246,4,1,13,12,9,39
Iowa,Zwingle,125,0,0,8,8,5,21
Iowa,Zearing,591,2,7,46,26,22,103
Iowa,Yorktown,78,0,2,5,2,0,9
Iowa,Yetter,25,0,0,1,0,4,5
Iowa,Yale,289,2,3,11,15,26,57
Iowa,Wyoming,442,10,2,11,12,40,75
Iowa,Worthington,406,8,7,18,27,10,70
Iowa,Woolstock,195,3,3,5,9,8,28
Iowa,Hansell,86,1,0,5,0,4,10
Iowa,Woodward,1623,40,19,29,75,296,459
Iowa,Woodbine,1660,30,24,115,87,92,348
Iowa,Woden,257,1,4,22,13,11,51
Iowa,Wiota,92,0,0,0,1,4,5
Iowa,Winthrop,922,18,7,71,80,47,223
Iowa,Winterset,5159,84,129,255,299,290,1057
Iowa,Winfield,1001,16,14,62,82,56,230
Iowa,Windsor Heights,4888,139,48,312,175,193,867
Iowa,Wilton,2791,41,35,148,93,206,523
Iowa,Williamson,108,5,5,7,1,0,18
Iowa,Woodburn,273,4,4,5,15,11,39
Iowa,Williams,506,10,5,48,32,55,150
Iowa,Hanlontown,215,1,2,5,9,10,27
Iowa,Hampton,4371,90,68,336,210,209,913
Iowa,Grant,90,2,1,6,11,9,29
Iowa,Granville,384,15,3,23,18,9,68
Iowa,Gravity,162,0,0,3,0,10,13
Iowa,Gray,155,6,0,0,17,13,36
Iowa,Greeley,263,8,1,21,14,7,51
Iowa,Greene,1194,35,24,56,48,72,235
Iowa,Greenfield,2007,41,20,99,118,107,385
Iowa,Green Mountain,113,6,0,5,0,0,11
Iowa,Greenville,89,4,0,5,6,6,21
Iowa,Hancock,169,0,4,7,8,2,21
Iowa,Grimes,9509,192,155,671,499,484,2001
Iowa,Griswold,1111,19,16,77,48,84,244
Iowa,Grundy Center,2706,47,70,124,145,122,508
Iowa,Gruver,98,3,6,6,2,0,17
Iowa,Guernsey,68,0,1,1,4,8,14
Iowa,Guthrie Center,1715,54,18,88,109,126,395
Iowa,Guttenberg,1823,13,52,61,48,88,262
Iowa,Halbur,262,13,4,29,21,16,83
Iowa,Hamburg,1111,24,8,63,83,82,260
Iowa,Hamilton,183,2,5,26,3,44,80
Iowa,Grinnell,9132,172,84,357,387,442,1442
Iowa,Kensett,274,5,1,7,8,17,38
Iowa,Kent,52,0,0,0,7,10,17
Iowa,Keokuk,10705,157,206,682,384,421,1850
Iowa,Exira,871,9,6,34,22,31,102
Iowa,Everly,564,19,4,21,44,52,140
Iowa,Evansdale,4777,61,20,217,190,304,792
Iowa,Estherville,6091,63,59,368,381,238,1109
Iowa,Essex,924,9,28,53,62,52,204
Iowa,Epworth,2057,43,19,99,143,114,418
Iowa,Emmetsburg,3817,77,39,206,138,103,563
Iowa,Emerson,478,19,0,42,32,32,125
Iowa,Ely,1994,57,34,137,124,138,490
Iowa,Elma,654,7,24,16,26,9,82
Iowa,Ellsworth,596,22,17,8,89,46,182
Iowa,Ellston,23,0,0,0,2,4,6
Iowa,Elliott,417,5,5,25,29,40,104
Iowa,Elk Run Heights,942,9,9,15,44,23,100
Iowa,Elkport,30,0,0,0,0,0,0
Iowa,Elk Horn,543,9,6,19,11,31,76
Iowa,Elkhart,653,13,7,47,42,22,131
Iowa,Elkader,1252,13,15,30,57,58,173
Iowa,Elgin,785,18,3,37,43,34,135
Iowa,Exline,135,1,0,4,5,4,14
Iowa,Fairbank,1109,19,10,89,54,17,189
Iowa,Fairfax,2300,56,70,166,158,74,524
Iowa,Fairfield,9739,88,29,359,530,404,1410
Iowa,Thayer,52,0,1,4,3,4,12
Iowa,Terril,399,14,2,9,13,17,55
Iowa,Tennant,60,0,0,4,0,4,8
Iowa,Templeton,368,5,4,15,32,31,87
Iowa,Tama,2830,18,30,260,244,133,685
Iowa,Tabor,1237,11,20,75,61,86,253
Iowa,Swisher,838,25,10,57,59,41,192
Iowa,Swea City,525,20,5,29,11,37,102
Iowa,Fonda,575,12,9,20,44,31,116
Iowa,Eldridge,6017,58,103,389,420,359,1329
Iowa,Floyd,403,6,5,8,25,29,73
Iowa,Fertile,336,1,7,11,15,17,51
Iowa,Ferguson,133,4,0,7,1,0,12
Iowa,Fenton,325,7,3,31,18,19,78
Iowa,Fayette,1137,4,4,20,22,29,79
Iowa,Farragut,461,9,5,17,16,28,75
Iowa,Farnhamville,337,7,1,11,9,9,37
Iowa,Farmington,783,7,2,48,35,23,115
Iowa,Farmersburg,264,7,5,21,14,21,68
Iowa,Farley,1590,48,29,83,69,123,352
Iowa,Floris,177,4,2,7,24,7,44
Iowa,Eldora,2717,22,19,76,157,313,587
Iowa,Eldon,999,20,4,45,38,47,154
Iowa,Elberon,156,8,0,7,8,11,34
Iowa,Douds,52,0,0,0,0,0,0
Iowa,Doon,538,11,13,40,24,29,117
Iowa,Donnellson,856,10,10,37,32,64,153
Iowa,Donahue,366,6,6,20,21,21,74
Iowa,Dolliver,64,0,0,1,5,4,10
Iowa,Dixon,225,2,7,8,9,16,42
Iowa,Dike,1376,47,20,70,73,113,323
Iowa,Dickens,188,3,0,5,5,26,39
Iowa,Diamondhead Lake,359,8,0,7,32,24,71
Iowa,Dougherty,91,8,0,0,10,5,23
Iowa,Keosauqua,1059,15,3,43,30,31,122
Iowa,Keswick,252,3,8,19,17,19,66
Iowa,Keystone,656,13,20,21,47,29,130
Iowa,Kimballton,296,14,4,14,11,15,58
Iowa,Kingsley,1456,25,37,77,123,129,391
Iowa,Kinross,42,0,0,0,2,2,4
Iowa,Kirkman,72,0,0,0,0,1,1
Iowa,Kirkville,177,0,0,8,5,7,20
Iowa,Kiron,229,6,0,12,4,3,25
Iowa,Klemme,498,12,2,18,46,37,115
Iowa,Keota,954,29,38,68,58,29,222
Iowa,Thompson,463,9,2,32,12,17,72
Iowa,Dow City,514,8,18,45,31,25,127
Iowa,Drakesville,177,4,0,0,4,1,9
Iowa,Edgewood,818,21,6,19,34,35,115
Iowa,Eddyville,1333,5,17,90,111,134,357
Iowa,East Peru,93,2,0,2,5,4,13
Iowa,East Amana,38,0,0,0,0,0,0
Iowa,Early,683,24,15,31,28,28,126
Iowa,Earlville,805,3,7,40,60,35,145
Iowa,Earling,476,19,12,21,18,13,83
Iowa,Earlham,1752,35,41,123,190,115,504
Iowa,Eagle Grove,3483,65,8,209,193,194,669
Iowa,Dows,453,0,2,13,10,21,46
Iowa,Dysart,1609,23,34,74,88,98,317
Iowa,Durant,1983,61,14,127,49,146,397
Iowa,Durango,14,0,0,0,0,0,0
Iowa,Dunlap,1252,19,15,79,78,60,251
Iowa,Dunkerton,879,18,19,61,60,75,233
Iowa,Dundee,165,2,4,12,5,8,31
Iowa,Duncombe,363,5,10,7,26,14,62
Iowa,Duncan,95,0,0,0,0,0,0
Iowa,Dumont,734,20,6,43,31,43,143
Iowa,Dubuque,58409,1106,699,2510,2399,2698,9412
Iowa,Dyersville,4214,121,75,215,191,158,760
Iowa,Thor,163,1,2,9,8,13,33
Iowa,Thornburg,95,4,0,1,4,6,15
Iowa,Thornton,494,6,0,22,45,14,87
Iowa,Ames,62815,611,755,1432,1511,1508,5817
Iowa,Anamosa,5518,135,17,276,285,261,974
Iowa,Anderson,0,0,0,0,0,0,0
Iowa,Andover,88,6,0,3,5,6,20
Iowa,Andrew,441,12,3,27,34,29,105
Iowa,Anita,954,21,13,61,40,27,162
Iowa,Lost Nation,506,0,12,27,29,52,120
Iowa,Weldon,156,4,10,5,1,13,33
Iowa,Webster City,7869,189,127,428,440,464,1648
Iowa,Amana,404,0,0,9,9,49,67
Iowa,Webster,127,5,0,3,3,3,14
Iowa,Wayland,1133,21,11,43,89,60,224
Iowa,Waverly,10013,176,132,542,350,500,1700
Iowa,Waukon,3818,55,58,202,177,161,653
Iowa,Waukee,16956,486,523,1198,1153,932,4292
Iowa,Waucoma,281,4,1,21,9,16,51
Iowa,Watkins,93,0,6,0,0,0,6
Iowa,Waterville,137,2,0,6,2,17,27
Iowa,Waterloo,68432,1034,975,3887,3541,3376,12813
Iowa,Washta,196,5,0,2,13,13,33
Iowa,Webb,158,2,0,14,10,9,35
Iowa,Washington,7348,69,145,295,441,530,1480
Iowa,Alvord,231,8,1,15,9,8,41
Iowa,Alton,1285,41,15,75,32,75,238
Iowa,Keomah Village,64,0,1,0,1,1,3
Iowa,Ackley,1706,64,11,79,50,93,297
Iowa,Ackworth,40,0,0,0,3,4,7
Iowa,Adair,854,10,12,40,50,36,148
Iowa,Adel,4055,43,101,213,330,167,854
Iowa,Afton,970,10,8,20,46,81,165
Iowa,Agency,655,5,2,31,22,43,103
Iowa,Ainsworth,568,12,4,43,47,47,153
Iowa,Albert City,631,12,19,25,18,19,93
Iowa,Altoona,15808,278,333,894,968,882,3355
Iowa,Albia,3799,49,122,264,181,221,837
Iowa,Alburnett,607,2,11,21,45,51,130
Iowa,Alden,803,12,11,22,47,39,131
Iowa,Alexander,157,0,3,12,13,7,35
Iowa,Algona,5494,108,54,332,277,205,976
Iowa,Alleman,524,2,6,23,44,42,117
Iowa,Allerton,536,10,7,36,30,33,116
Iowa,Allison,1160,12,30,50,49,86,227
Iowa,Alta,2056,47,23,133,80,90,373
Iowa,Alta Vista,288,2,8,18,35,6,69
Iowa,Albion,468,0,0,26,16,51,93
Iowa,Knoxville,7245,190,155,332,478,421,1576
Iowa,Washburn,997,25,10,75,23,70,203
Iowa,Walnut,688,24,6,20,26,39,115
Iowa,University Heights,1222,19,20,34,65,18,156
Iowa,Unionville,64,0,0,2,0,0,2
Iowa,Union,517,5,8,32,43,42,130
Iowa,Underwood,884,18,9,76,67,42,212
Iowa,Udell,37,0,1,1,0,0,2
Iowa,Twin Lakes,247,0,0,0,0,0,0
Iowa,Turin,111,2,3,14,12,3,34
Iowa,Truro,512,10,7,34,43,39,133
Iowa,Truesdale,139,0,0,1,0,10,11
Iowa,University Park,594,10,21,52,30,35,148
Iowa,Tripoli,1350,18,11,94,47,114,284
Iowa,Traer,1726,42,40,66,76,97,321
Iowa,Toronto,136,5,4,8,1,6,24
Iowa,Toledo,2146,57,16,73,135,214,495
Iowa,Toeterville,40,0,0,0,0,4,4
Iowa,Titonka,500,8,0,17,21,20,66
Iowa,Tipton,3202,18,77,211,144,119,569
Iowa,Tingley,178,2,0,18,11,0,31
Iowa,Tiffin,2358,55,50,80,80,91,356
Iowa,Thurman,209,5,5,16,9,29,64
Iowa,Treynor,1013,20,38,88,43,50,239
Iowa,Wapello,2017,19,6,69,137,115,346
Iowa,Urbana,1402,40,24,122,80,66,332
Iowa,Ute,411,11,1,17,14,19,62
Iowa,Wall Lake,664,5,7,27,30,41,110
Iowa,Wallingford,128,4,0,3,3,11,21
Iowa,Walker,775,9,19,25,47,27,127
Iowa,Walford,1563,50,19,110,126,102,407
Iowa,Walcott,1575,20,23,86,75,107,311
Iowa,Wahpeton,323,0,2,8,6,5,21
Iowa,Wadena,325,19,7,40,17,18,101
Iowa,Volga,204,1,2,11,7,24,45
Iowa,Vinton,5197,39,38,200,411,358,1046
Iowa,Urbandale,42099,601,493,2669,2234,2392,8389
Iowa,Vining,69,0,5,1,1,1,8
Iowa,Villisca,1249,25,3,71,69,96,264
Iowa,Victor,1087,25,41,55,79,57,257
Iowa,Ventura,738,14,2,36,25,24,101
Iowa,Varina,79,0,0,13,12,2,27
Iowa,Van Wert,178,5,0,5,15,17,42
Iowa,Van Meter,1549,49,15,90,113,168,435
Iowa,Van Horne,717,18,16,49,31,50,164
Iowa,Valeria,52,0,0,2,4,10,16
Iowa,Vail,470,13,5,22,24,9,73
Iowa,Vincent,165,0,1,7,9,1,18
Iowa,Loveland,40,0,0,0,0,0,0
Iowa,Akron,1454,58,27,75,77,100,337
Iowa,New Vienna,393,6,9,6,12,31,64
Iowa,Norwalk,9671,261,148,503,700,517,2129
Iowa,Northwood,2028,42,22,82,84,122,352
Iowa,North Washington,143,2,2,8,18,6,36
Iowa,North Liberty,14972,482,294,991,656,651,3074
Iowa,North English,1232,51,27,106,114,70,368
Iowa,North Buena Vista,73,0,0,0,0,3,3
Iowa,Northboro,40,1,0,1,0,2,4
Iowa,Nora Springs,1553,43,59,95,55,79,331
Iowa,Milton,576,6,17,45,36,29,133
Iowa,Minburn,330,2,2,28,26,27,85
Iowa,Minden,629,18,5,41,61,32,157
Iowa,Mineola,118,11,0,11,0,0,22
Iowa,Mingo,216,0,3,16,13,3,35
Iowa,Missouri Valley,2723,32,32,119,106,164,453
Iowa,Mitchell,128,0,5,11,7,0,23
Iowa,Mitchellville,2303,39,20,103,118,81,361
Iowa,Modale,283,10,5,19,24,19,77
Iowa,Mona,115,0,0,0,9,8,17
Iowa,Mondamin,348,1,1,8,16,22,48
Iowa,Monmouth,144,4,0,8,0,8,20
Iowa,Monona,1632,21,11,55,46,103,236
Iowa,Monroe,1805,31,47,91,128,86,383
Iowa,Montezuma,1576,41,18,118,75,58,310
Iowa,Monticello,3800,104,39,170,268,187,768
Iowa,Montour,238,5,0,15,2,12,34
Iowa,Norway,613,2,4,36,57,61,160
Iowa,Numa,68,0,2,1,2,1,6
Iowa,Oakland,1585,38,8,108,85,80,319
Iowa,Oakland Acres,111,0,0,2,6,13,21
Iowa,Maxwell,919,11,4,69,56,25,165
Iowa,Maynard,563,15,6,17,49,36,123
Iowa,Maysville,139,3,2,8,3,4,20
Iowa,Mechanicsville,1082,10,32,29,82,66,219
Iowa,Mediapolis,1342,18,14,52,67,53,204
Iowa,Melbourne,891,23,21,63,59,28,194
Iowa,Melcher-Dallas,1203,21,18,32,63,36,170
Iowa,Melrose,133,3,2,3,5,3,16
Iowa,Melvin,237,5,1,12,22,5,45
Iowa,Menlo,410,0,5,32,34,32,103
Iowa,Meriden,206,2,0,26,9,14,51
Iowa,Merrill,845,16,20,51,59,35,181
Iowa,Montrose,925,0,5,52,85,60,202
Iowa,Meservey,226,8,0,4,7,4,23
Iowa,Middle Amana,495,5,0,0,49,46,100
Iowa,Middletown,313,12,2,27,10,19,70
Iowa,Miles,454,3,5,39,19,49,115
Iowa,Milford,2971,16,55,176,167,43,457
Iowa,Miller,0,0,0,0,0,0,0
Iowa,Millersburg,198,2,0,5,21,5,33
Iowa,Millerton,14,2,0,0,1,0,3
Iowa,Milo,829,16,17,28,83,29,173
Iowa,Newton,15147,259,166,768,959,864,3016
Iowa,Odebolt,1090,13,16,40,48,100,217
Iowa,Ocheyedan,504,11,9,30,15,18,83
Iowa,Oakville,131,0,2,10,10,12,34
Iowa,Meyer,0,0,0,0,0,0,0
Iowa,Moorhead,248,0,0,8,6,10,24
Iowa,Moorland,205,10,9,5,13,15,52
Iowa,Moravia,814,20,21,43,46,50,180
Iowa,Pleasant Hill,9099,203,94,533,371,371,1572
Iowa,Plano,60,4,1,0,0,3,8
Iowa,Plainfield,428,8,6,24,16,17,71
Iowa,Pisgah,240,3,1,16,9,11,40
Iowa,Pioneer,7,0,0,0,0,4,4
Iowa,Pilot Mound,174,0,0,3,5,8,16
Iowa,Pierson,426,8,7,45,11,23,94
Iowa,Peterson,300,4,2,9,8,15,38
Iowa,Persia,266,3,6,21,6,10,46
Iowa,Perry,8086,151,115,425,606,445,1742
Iowa,Percival,24,0,0,0,0,0,0
Iowa,Peosta,1747,85,26,187,226,105,629
Iowa,Pleasanton,18,0,0,1,0,0,1
Iowa,Pella,10316,230,143,599,349,552,1873
Iowa,Patterson,150,0,5,9,7,7,28
Iowa,Paton,268,5,8,26,20,17,76
Iowa,Parnell,213,2,1,4,15,6,28
Iowa,Park View,2438,90,17,67,148,259,581
Iowa,Parkersburg,1877,42,27,126,134,91,420
Iowa,Panorama Park,102,0,0,3,1,0,4
Iowa,Panora,1117,23,16,71,43,80,233
Iowa,Panama,199,5,4,16,10,9,44
Iowa,Palo,1050,23,14,101,67,65,270
Iowa,Palmer,149,0,6,8,9,7,30
Iowa,Packwood,286,20,2,26,15,14,77
Iowa,Pacific Junction,350,10,2,10,11,17,50
Iowa,Paullina,982,18,7,91,71,52,239
Iowa,Maurice,286,7,9,18,18,18,70
Iowa,Pleasant Plain,47,0,0,1,5,1,7
Iowa,Plover,41,0,0,0,4,3,7
Iowa,Morley,107,0,2,2,3,2,9
Iowa,Morning Sun,877,11,7,53,42,36,149
Iowa,Morrison,97,2,5,7,2,4,20
Iowa,Moulton,608,12,19,66,15,35,147
Iowa,Mount Auburn,100,0,3,1,5,1,10
Iowa,Mount Ayr,1799,42,26,65,66,64,263
Iowa,Mount Pleasant,8575,149,46,384,259,540,1378
Iowa,Mount Sterling,36,0,0,0,0,0,0
Iowa,Climbing Hill,166,7,0,0,13,15,35
Iowa,Clermont,653,18,6,36,33,55,148
Iowa,Protivin,284,3,6,6,0,2,17
Iowa,Promise City,203,0,7,7,0,6,20
Iowa,Pleasantville,1819,40,14,73,68,168,363
Iowa,Princeton,1106,9,4,63,73,47,196
Iowa,Marquette,399,3,10,5,5,22,45
Iowa,Prescott,292,6,2,10,10,31,59
Iowa,Prairie City,1848,39,44,145,140,101,469
Iowa,Prairieburg,156,0,0,0,2,16,18
Iowa,Postville,2281,80,88,198,115,84,565
Iowa,Portsmouth,154,3,1,1,2,7,14
Iowa,Portland,12,0,0,0,0,0,0
Iowa,Popejoy,56,0,0,10,16,0,26
Iowa,Pomeroy,835,13,4,37,49,82,185
Iowa,Polk City,3953,135,75,285,225,230,950
Iowa,Pocahontas,1717,31,24,71,60,51,237
Iowa,Plymouth,352,5,9,19,10,12,55
Iowa,Primghar,995,32,13,102,54,82,283
Iowa,Oyens,87,6,0,0,9,5,20
Iowa,Matlock,85,0,0,2,2,9,13
Iowa,Masonville,92,0,0,3,3,4,10
Iowa,Luxemburg,189,0,0,2,7,5,14
Iowa,Lu Verne,336,7,3,20,3,18,51
Iowa,Luther,161,0,0,0,8,20,28
Iowa,Lucas,196,0,0,3,8,17,28
Iowa,Luana,317,9,0,16,11,7,43
Iowa,Low Moor,195,6,4,12,13,11,46
Iowa,Lowden,823,2,5,59,48,52,166
Iowa,Lovilia,608,30,7,32,28,38,135
Iowa,Pulaski,258,5,6,10,11,8,40
Iowa,Quasqueton,511,12,6,24,10,13,65
Iowa,Quimby,376,6,7,27,15,20,75
Iowa,Radcliffe,560,2,9,30,40,36,117
Iowa,Rake,172,14,0,16,7,3,40
Iowa,Ralston,81,0,2,12,6,2,22
Iowa,Randalia,61,2,0,4,2,1,9
Iowa,Randall,174,8,0,12,6,4,30
Iowa,Randolph,188,5,0,17,6,2,30
Iowa,Rathbun,87,3,0,3,0,0,6
Iowa,Raymond,824,19,10,19,53,33,134
Iowa,Readlyn,885,19,31,57,36,66,209
Iowa,Reasnor,185,7,0,3,6,9,25
Iowa,Redding,61,0,0,10,0,1,11
Iowa,Redfield,782,16,15,35,28,32,126
Iowa,Red Oak,5588,82,90,332,253,241,998
Iowa,Reinbeck,1750,29,32,54,103,80,298
Iowa,Luzerne,102,1,1,9,5,3,19
Iowa,Lynnville,482,2,8,14,16,23,63
Iowa,Lytton,315,4,5,11,10,13,43
Iowa,McCallsburg,329,17,13,20,19,9,78
Iowa,Marne,131,1,14,0,4,16,35
Iowa,Marion,36311,944,472,2360,2271,1844,7891
Iowa,Marengo,2518,68,70,178,108,222,646
Iowa,Marcus,1309,26,10,64,66,66,232
Iowa,Marble Rock,304,12,4,12,9,11,48
Iowa,Marathon,276,3,7,15,9,14,48
Iowa,Maquoketa,6029,135,115,211,389,513,1363
Iowa,Mapleton,1430,30,7,85,94,102,318
Iowa,Manson,1843,46,31,102,87,109,375
Iowa,Manning,1558,29,28,49,64,96,266
Iowa,Manly,1464,42,37,62,152,97,390
Iowa,Manilla,979,33,11,43,77,32,196
Iowa,Rembrandt,146,0,4,5,3,14,26
Iowa,Manchester,5106,166,70,299,251,319,1105
Iowa,Maloy,24,1,1,2,0,0,4
Iowa,Mallard,308,0,5,9,16,2,32
Iowa,Malcom,282,0,2,12,13,12,39
Iowa,Maharishi Vedic City,738,0,0,0,0,15,15
Iowa,Magnolia,157,0,0,0,2,10,12
Iowa,Madrid,2554,33,17,169,166,213,598
Iowa,Macksburg,130,9,3,10,6,3,31
Iowa,McIntire,117,0,0,0,3,2,5
Iowa,McGregor,776,16,13,15,54,44,142
Iowa,Macedonia,254,3,0,8,9,20,40
Iowa,McClelland,129,2,2,10,8,7,29
Iowa,McCausland,338,10,1,15,15,5,46
Iowa,Malvern,1063,27,22,84,39,41,213
Iowa,Remsen,1878,56,46,125,128,159,514
Iowa,Renwick,291,5,0,21,12,12,50
Iowa,Rhodes,283,3,0,8,22,19,52
Iowa,Royal,429,15,9,17,22,31,94
Iowa,Rudd,373,11,5,8,8,26,58
Iowa,Runnells,541,10,9,28,48,33,128
Iowa,Russell,552,12,3,30,30,60,135
Iowa,Ruthven,721,40,12,40,45,23,160
Iowa,Rutland,115,2,2,6,12,7,29
Iowa,Ryan,355,7,0,18,9,20,54
Iowa,Sabula,496,4,0,20,6,16,46
Iowa,Sac City,2232,30,56,82,89,79,336
Iowa,Sageville,82,0,0,1,2,5,8
Iowa,St. Ansgar,1057,13,22,61,55,32,183
Iowa,St. Anthony,115,6,1,7,7,6,27
Iowa,Rowley,316,6,2,7,21,11,47
Iowa,St. Benedict,24,0,0,3,3,2,8
Iowa,St. Donatus,132,0,3,3,7,4,17
Iowa,St. Joseph,78,7,7,12,9,8,43
Iowa,St. Lucas,164,0,2,0,13,4,19
Iowa,St. Marys,138,0,0,2,17,4,23
Iowa,St. Olaf,140,1,3,5,17,10,36
Iowa,St. Paul,89,2,2,0,2,2,8
Iowa,Salem,478,5,3,17,27,41,93
Iowa,Martelle,255,6,3,7,6,7,29
Iowa,Martensdale,463,4,14,33,18,44,113
Iowa,Martinsburg,148,0,5,1,10,11,27
Iowa,Marysville,64,3,1,0,2,16,22
Iowa,Mason City,27643,372,226,1341,1325,1518,4782
Iowa,St. Charles,659,12,0,28,32,36,108
Iowa,Massena,342,8,2,29,19,18,76
Iowa,Rowan,178,2,5,14,2,12,35
Iowa,Roseville,0,0,0,0,0,0,0
Iowa,Riceville,811,4,15,23,43,57,142
Iowa,Richland,665,12,4,20,53,67,156
Iowa,Rickardsville,166,1,2,6,7,12,28
Iowa,Ricketts,178,8,2,11,7,6,34
Iowa,Ridgeway,283,6,0,4,7,15,32
Iowa,Rinard,65,0,0,0,3,8,11
Iowa,Ringsted,432,11,4,22,21,14,72
Iowa,Rippey,210,4,0,8,11,10,33
Iowa,Riverdale,476,4,12,20,19,27,82
Iowa,Riverside,1060,13,9,47,66,87,222
Iowa,River Sioux,119,0,0,0,35,0,35
Iowa,Riverton,331,10,1,27,25,15,78
Iowa,Rossie,54,1,1,5,0,0,7
Iowa,Robins,3357,61,48,187,250,276,822
Iowa,Rock Falls,168,4,0,15,14,4,37
Iowa,Rockford,824,15,14,44,60,50,183
Iowa,Rock Rapids,2592,39,14,235,159,102,549
Iowa,Rock Valley,3553,95,137,182,249,258,921
Iowa,Rockwell,1130,43,17,30,42,65,197
Iowa,Rockwell City,2155,30,30,99,113,109,381
Iowa,Rodman,47,0,0,0,2,8,10
Iowa,Rodney,63,0,1,1,1,8,11
Iowa,Roland,1398,17,59,124,104,81,385
Iowa,Rolfe,568,8,3,36,31,13,91
Iowa,Rome,165,0,0,29,2,16,47
Iowa,Rose Hill,145,0,0,6,3,1,10
Iowa,Rochester,40,0,0,0,0,0,0
Iowa,Oxford Junction,516,19,8,32,9,30,98
Iowa,Preston,1079,19,3,54,48,74,198
Iowa,Owasa,53,0,0,2,2,13,17
Iowa,Dakota City,781,5,7,37,42,50,141
Iowa,Cylinder,72,4,0,6,6,2,18
Iowa,Cushing,195,5,5,10,8,11,39
Iowa,Curlew,71,0,3,6,4,3,16
Iowa,Cumming,435,10,5,35,22,23,95
Iowa,Cumberland,330,0,18,21,24,12,75
Iowa,Crystal Lake,185,2,3,3,1,3,12
Iowa,Cromwell,93,2,0,1,5,7,15
Iowa,Creston,7886,175,101,534,360,387,1557
Iowa,Cresco,3865,105,80,208,289,166,848
Iowa,Crescent,542,13,15,21,24,18,91
Iowa,Crawfordsville,287,2,2,14,30,13,61
Iowa,Craig,118,0,2,13,12,6,33
Iowa,Dallas Center,1734,39,43,117,83,93,375
Iowa,Council Bluffs,62309,1017,925,3315,2984,3218,11459
Iowa,Cotter,48,2,0,0,3,2,7
Iowa,Corydon,1431,19,4,42,54,58,177
Iowa,Corwith,234,2,2,0,10,9,23
Iowa,Correctionville,806,25,5,53,50,37,170
Iowa,Corning,1570,54,15,42,28,78,217
Iowa,Corley,43,0,0,0,0,0,0
Iowa,Coralville,20038,559,301,1159,874,856,3749
Iowa,Coppock,69,10,0,0,0,0,10
Iowa,Coon Rapids,1395,21,25,75,108,88,317
Iowa,Conway,16,0,0,0,0,2,2
Iowa,Conroy,304,0,0,0,0,29,29
Iowa,Conrad,1099,16,30,74,58,76,254
Iowa,Conesville,534,12,1,37,31,66,147
Iowa,Coulter,276,3,0,8,15,26,52
Iowa,Dana,69,0,0,0,0,2,2
Iowa,Danbury,357,3,7,13,11,16,50
Iowa,Danville,1062,36,17,101,79,58,291
Iowa,Boone,12631,112,275,523,548,732,2190
Iowa,Bondurant,4555,123,192,481,371,193,1360
Iowa,Bonaparte,398,14,1,35,20,16,86
Iowa,Bolan,37,0,0,7,8,0,15
Iowa,Bode,285,3,4,12,6,5,30
Iowa,Blue Grass,1439,31,20,132,86,50,319
Iowa,Bloomfield,2615,42,37,108,108,128,423
Iowa,Blockton,157,0,1,7,9,7,24
Iowa,Blencoe,239,9,2,1,24,17,53
Iowa,Blanchard,36,0,1,2,2,1,6
Iowa,Blakesburg,291,0,9,13,14,4,40
Iowa,Blairstown,757,22,11,72,65,25,195
Iowa,Blairsburg,112,0,0,1,7,5,13
Iowa,Oxford,895,15,11,41,47,62,176
Iowa,Birmingham,545,7,7,24,36,29,103
Iowa,Bevington,43,0,0,2,2,7,11
Iowa,Bettendorf,34663,668,400,2170,2008,2080,7326
Iowa,Bertram,394,2,5,15,36,40,98
Iowa,Delhi,412,3,5,12,16,20,56
Iowa,Delaware,138,2,1,4,5,10,22
Iowa,Defiance,228,4,0,9,12,5,30
Iowa,Deep River,302,8,5,29,27,13,82
Iowa,Dedham,242,3,2,21,12,17,55
Iowa,Decorah,8009,62,47,236,250,160,755
Iowa,Decatur City,202,2,0,14,16,5,37
Iowa,Dayton,785,10,9,39,36,55,149
Iowa,Dawson,197,2,1,7,24,17,51
Iowa,Davis City,252,9,2,32,12,14,69
Iowa,Davenport,101863,1585,1546,5443,4600,5081,18255
Iowa,Colwell,83,0,0,3,4,17,24
Iowa,Columbus Junction,2120,27,83,131,77,148,466
Iowa,Camanche,4387,100,51,253,248,260,912
Iowa,Calumet,208,0,7,18,10,13,48
Iowa,Clive,16634,326,203,1018,1120,1252,3919
Iowa,Clio,114,9,0,13,4,3,29
Iowa,Clinton,26413,535,278,1049,1432,1333,4627
Iowa,Brandon,312,13,2,28,11,8,62
Iowa,Bradgate,67,6,0,1,0,2,9
Iowa,Bradford,78,0,0,0,0,0,0
Iowa,Braddyville,154,0,0,1,6,3,10
Iowa,Mount Union,99,5,3,8,4,2,22
Iowa,Mount Vernon,4523,95,83,184,357,317,1036
Iowa,Moville,1481,31,14,79,86,92,302
Iowa,Murray,590,7,20,49,41,11,128
Iowa,Muscatine,23888,655,421,1206,1429,1365,5076
Iowa,Mystic,410,9,1,33,21,15,79
Iowa,Nashua,1614,42,14,99,98,68,321
Iowa,Nemaha,78,0,0,3,7,6,16
Iowa,Neola,909,34,19,62,62,42,219
Iowa,Nevada,6799,131,86,314,467,279,1277
Iowa,New Albin,646,15,2,66,62,44,189
Iowa,Newell,1174,25,27,103,108,69,332
Iowa,Newhall,944,19,7,70,55,72,223
Iowa,New Hampton,3510,81,32,302,179,197,791
Iowa,New Hartford,586,19,28,32,24,23,126
Iowa,New Haven,51,0,0,0,0,0,0
Iowa,New Liberty,148,2,0,11,6,10,29
Iowa,New London,1819,48,16,61,84,92,301
Iowa,New Market,382,0,4,9,27,20,60
Iowa,New Providence,226,4,4,11,1,13,33
Iowa,New Sharon,1298,30,28,87,84,87,316
Iowa,Nodaway,122,4,0,8,5,7,24
Iowa,Clutier,205,1,0,3,6,12,22
Iowa,Bouton,190,6,3,4,18,14,45
Iowa,Coalville,542,0,7,58,11,5,81
Iowa,Coggon,730,2,8,35,59,67,171
Iowa,Calmar,1049,35,0,69,71,30,205
Iowa,Callender,425,17,17,30,27,14,105
Iowa,California Junction,117,0,0,0,5,8,13
Iowa,Calamus,422,5,2,15,36,26,84
Iowa,Bussey,482,4,5,18,35,50,112
Iowa,Burt,550,8,11,11,31,66,127
Iowa,Burr Oak,306,0,0,20,0,19,39
Iowa,Burlington,25537,324,463,1179,1403,1436,4805
Iowa,Burchinal,67,7,0,16,0,0,23
Iowa,Buffalo Center,886,24,16,38,46,43,167
Iowa,Buffalo,1217,6,15,26,35,69,151
Iowa,Buck Grove,21,0,0,0,0,0,0
Iowa,Buckeye,88,1,0,15,8,4,28
Iowa,Brunsville,93,0,0,0,1,5,6
Iowa,Brooklyn,1476,5,40,56,88,55,244
Iowa,Bronson,339,10,8,24,16,13,71
Iowa,Britt,1966,47,24,120,109,61,361
Iowa,Bristow,183,7,3,11,18,8,47
Iowa,Brighton,606,2,8,35,20,39,104
Iowa,Bridgewater,141,5,0,6,5,1,17
Iowa,Breda,478,6,6,33,21,27,93
Iowa,Brayton,132,2,1,9,0,4,16
Iowa,Columbus City,405,12,3,14,23,14,66
Iowa,Colo,884,23,20,43,77,54,217
Iowa,Collins,462,4,10,20,40,31,105
Iowa,College Springs,223,3,2,13,18,20,56
Iowa,Colfax,1848,34,33,123,115,162,467
Iowa,Colesburg,402,4,2,15,13,15,49
Iowa,Coin,213,5,5,7,2,9,28
Iowa,Coburg,47,0,0,2,11,8,21
Iowa,Boxholm,230,3,12,22,9,4,50
Iowa,Marshalltown,27770,508,540,1772,1336,1353,5509
Iowa,Dexter,911,39,19,53,49,69,229
Iowa,Charles City,7500,111,55,326,396,364,1252
Iowa,Charlotte,398,12,6,24,20,14,76
Iowa,Charter Oak,601,8,6,50,22,35,121
Iowa,Chatsworth,69,1,0,0,1,11,13
Iowa,Chelsea,204,9,2,14,14,8,47
Iowa,Cherokee,5147,134,38,214,316,196,898
Iowa,Chester,241,7,14,4,12,23,60
Iowa,Chillicothe,102,2,0,6,3,7,18
Iowa,Churdan,370,10,5,30,20,20,85
Iowa,Cincinnati,329,2,4,8,12,10,36
Iowa,Chariton,4240,73,62,196,220,299,850
Iowa,Clare,232,7,0,7,41,9,64
Iowa,Clarinda,5476,128,28,191,198,454,999
Iowa,Clarion,2788,69,25,153,129,210,586
Iowa,Clarksville,1335,39,28,84,73,48,272
Iowa,Delta,260,4,4,13,17,13,51
Iowa,Delphos,20,0,0,0,0,0,0
Iowa,Deloit,395,16,25,31,17,8,97
Iowa,Delmar,497,15,7,29,24,26,101
Iowa,Boyden,752,14,8,26,38,34,120
Iowa,Clayton,42,0,0,0,0,0,0
Iowa,Clearfield,378,5,1,17,20,19,62
Iowa,Clarence,945,29,0,51,53,55,188
Iowa,Chapin,153,4,0,0,0,0,4
Iowa,Centralia,133,4,0,3,2,14,23
Iowa,Central City,1373,14,11,109,114,70,318
Iowa,Carson,845,14,15,34,71,28,162
Iowa,Carroll,10020,246,106,733,365,537,1987
Iowa,Carpenter,117,0,0,0,10,15,25
Iowa,Carlisle,4120,180,124,333,237,209,1083
Iowa,Carbon,27,0,0,0,0,0,0
Iowa,Cantril,227,1,5,7,7,4,24
Iowa,Cambridge,806,19,21,67,59,37,203
Iowa,Diagonal,332,3,3,16,7,27,56
Iowa,Casey,394,3,6,12,22,30,73
Iowa,De Witt,5283,61,82,252,397,331,1123
Iowa,De Soto,1159,6,10,89,70,89,264
Iowa,Des Moines,208020,3114,3237,11576,11055,9874,38856
Iowa,Derby,132,0,0,4,11,9,24
Iowa,Denver,1789,39,17,109,105,121,391
Iowa,Denmark,350,4,0,6,16,24,50
Iowa,Denison,8383,243,80,571,468,747,2109
Iowa,Castalia,170,0,0,2,9,12,23
Iowa,Castana,105,2,2,10,0,0,14
Iowa,Cedar Falls,40439,514,394,1561,1300,1503,5272
Iowa,Cedar Rapids,128829,2475,1605,6097,6615,6373,23165
Iowa,Center Junction,93,1,0,0,2,3,6
Iowa,Center Point,2478,87,32,143,149,206,617
Iowa,Centerville,5431,161,86,208,147,301,903
Iowa,Clear Lake,7675,201,45,361,335,348,1290
Iowa,Carter Lake,3771,16,80,184,326,151,757
Iowa,Cleghorn,218,2,8,15,8,8,41
Iowa,Cascade,1984,60,35,102,127,71,395
Iowa,Oelwein,6275,143,75,286,231,338,1073
Iowa,Ogden,2114,10,10,113,110,151,394
Iowa,Okoboji,833,32,10,5,15,30,92
Iowa,Olds,200,3,4,11,18,10,46
Iowa,Olin,718,12,14,46,32,35,139
Iowa,Ollie,225,3,4,6,9,5,27
Iowa,Onawa,2921,43,32,208,155,115,553
Iowa,Onslow,201,1,1,5,4,11,22
Iowa,Orange City,6147,53,47,253,368,362,1083
Iowa,Orient,369,7,2,16,13,25,63
Iowa,Orchard,34,1,0,1,0,0,2
Iowa,Osage,3640,46,12,126,247,177,608
Iowa,Osceola,4985,138,95,232,271,180,916
Iowa,Oskaloosa,11558,195,187,593,530,448,1953
Iowa,Ossian,979,22,12,50,63,85,232
Iowa,Osterdock,68,0,0,6,1,0,7
Iowa,Otho,505,16,4,20,20,12,72
Iowa,Oto,106,0,2,12,11,8,33
Iowa,Otranto,7,0,0,0,0,0,0
Iowa,Ottosen,56,0,3,2,3,4,12
Iowa,Ottumwa,24758,400,307,1362,1330,1147,4546
Iowa,Orleans,465,3,0,6,2,14,25
Iowa,Clemons,125,5,0,0,5,9,19
Kansas,Lyndon,1068,23,21,67,62,58,231
Kansas,Great Bend,15850,278,255,1032,934,1038,3537
Kansas,Lyons,3731,31,49,206,232,158,676
Kansas,Leonardville,410,8,2,12,30,21,73
Kansas,Lowell,344,28,0,35,0,0,63
Kansas,Leoti,1502,32,48,102,108,67,357
Kansas,LeRoy,612,12,3,16,19,53,103
Kansas,Levant,71,0,0,0,0,0,0
Kansas,Lewis,396,7,0,8,16,10,41
Kansas,Liberal,20819,370,421,1544,1224,1366,4925
Kansas,Liberty,225,0,2,3,0,51,56
Kansas,Liebenthal,117,0,0,5,1,1,7
Kansas,Lincoln Center,1312,12,23,59,77,98,269
Kansas,Protection,502,12,9,13,21,25,80
Kansas,Lindsborg,3441,70,4,157,179,148,558
Kansas,Linn,471,13,3,28,22,30,96
Kansas,Linn Valley,811,0,22,26,33,36,117
Kansas,Linwood,407,0,11,20,30,25,86
Kansas,Little River,553,20,6,23,21,38,108
Kansas,Logan,498,6,8,18,11,29,72
Kansas,Lone Elm,23,0,0,0,0,0,0
Kansas,Longford,222,6,0,3,4,15,28
Kansas,Long Island,177,1,0,7,2,20,30
Kansas,Longton,340,1,0,31,16,21,69
Kansas,Lorraine,187,6,2,11,2,3,24
Kansas,Lost Springs,86,2,0,6,3,4,15
Kansas,Louisburg,4294,109,50,293,298,235,985
Kansas,Louisville,287,23,15,20,5,15,78
Kansas,Lucas,444,16,0,30,16,31,93
Kansas,Luray,276,12,1,11,3,0,27
Kansas,Deerfield,742,10,12,64,61,73,220
Kansas,Sterling,2313,36,25,89,48,104,302
Kansas,Cottonwood Falls,939,11,12,43,57,74,197
Kansas,Corning,151,13,8,8,11,6,46
Kansas,Copeland,294,2,5,16,9,17,49
Kansas,Coolidge,122,3,2,4,5,9,23
Kansas,Conway Springs,1551,22,18,70,164,135,409
Kansas,Concordia,5289,113,35,243,167,355,913
Kansas,Colwich,1385,33,62,72,101,102,370
Kansas,Dresden,66,0,9,3,1,6,19
Kansas,Colony,408,3,8,15,14,18,58
Kansas,Collyer,83,0,0,2,1,14,17
Kansas,Coldwater,824,11,17,32,26,69,155
Kansas,Colby,5450,0,99,260,133,234,726
Kansas,Coffeyville,9921,268,124,437,383,478,1690
Kansas,Coats,169,2,0,4,13,33,52
Kansas,Clyde,782,18,9,56,43,18,144
Kansas,Climax,38,0,2,1,1,2,6
Kansas,Clifton,574,8,12,43,15,45,123
Kansas,Council Grove,2319,36,25,131,97,122,411
Kansas,Courtland,371,12,14,19,25,14,84
Kansas,Coyville,37,0,0,0,1,3,4
Kansas,Cuba,192,2,3,14,20,4,43
Kansas,Delia,149,7,0,5,4,12,28
Kansas,Delphos,437,15,14,22,10,14,75
Kansas,Denison,183,2,1,9,12,6,30
Kansas,Denton,162,1,1,5,0,7,14
Kansas,Derby,23731,447,294,1497,1818,1329,5385
Kansas,De Soto,5941,89,95,244,446,402,1276
Kansas,Detroit,388,0,0,72,0,51,123
Kansas,Dexter,370,15,7,13,24,6,65
Kansas,Clearwater,2566,34,79,125,130,170,538
Kansas,Dighton,961,2,9,24,43,74,152
Kansas,Dorrance,184,0,0,10,22,1,33
Kansas,Douglass,1895,24,64,129,132,178,527
Kansas,Downs,974,3,18,13,38,14,86
Kansas,Danville,50,0,2,1,0,0,3
Kansas,Damar,158,5,1,5,3,13,27
Kansas,Cunningham,416,15,13,14,29,10,81
Kansas,Culver,100,0,3,1,7,5,16
Kansas,Cullison,44,6,0,1,0,0,7
Kansas,Dodge City,28045,423,484,1798,1925,1746,6376
Kansas,Dearing,523,8,11,23,21,41,104
Kansas,Clayton,88,4,0,0,3,0,7
Kansas,Claflin,606,0,2,29,43,39,113
Kansas,Sharon,147,3,0,2,2,8,15
Kansas,Sharon Springs,701,19,5,49,32,35,140
Kansas,Shawnee,64125,1245,806,4061,4083,3838,14033
Kansas,Silver Lake,1780,67,44,172,112,114,509
Kansas,Simpson,59,0,0,0,0,1,1
Kansas,Smith Center,1558,36,30,85,59,66,276
Kansas,Smolan,185,4,5,11,9,8,37
Kansas,Soldier,115,2,1,6,7,8,24
Kansas,Solomon,1173,13,38,70,76,84,281
Kansas,South Haven,287,11,4,13,16,14,58
Kansas,South Hutchinson,2392,24,11,66,76,127,304
Kansas,Spearville,733,0,6,47,21,51,125
Kansas,Speed,49,6,3,0,0,0,9
Kansas,Spivey,45,2,0,0,0,2,4
Kansas,Spring Hill,5739,107,182,392,447,362,1490
Kansas,Stafford,1130,19,18,65,36,93,231
Kansas,Stark,81,0,1,5,1,10,17
Kansas,Seward,38,0,0,1,1,2,4
Kansas,Severy,286,4,0,5,7,11,27
Kansas,Severance,91,3,4,3,6,9,25
Kansas,Seneca,2006,28,24,67,118,42,279
Kansas,Circleville,160,4,0,11,12,0,27
Kansas,Cimarron,2093,42,20,204,184,158,608
Kansas,Dunlap,15,0,0,0,0,0,0
Kansas,Chicopee,551,10,0,77,27,30,144
Kansas,Chetopa,1275,10,16,89,122,57,294
Kansas,Durham,118,1,2,1,6,1,11
Kansas,Dwight,232,0,4,27,21,18,70
Kansas,Earlton,48,0,2,1,3,1,7
Kansas,Clay Center,4240,132,30,243,241,182,828
Kansas,Eastborough,736,14,6,28,91,33,172
Kansas,Edgerton,1706,61,38,122,97,100,418
Kansas,Edmond,55,0,0,2,8,3,13
Kansas,Edna,435,4,3,26,15,20,68
Kansas,Scranton,637,7,2,30,23,48,110
Kansas,Sedan,1129,23,4,51,57,45,180
Kansas,Sedgwick,1867,49,25,155,142,116,487
Kansas,Cherryvale,2221,34,20,115,145,145,459
Kansas,Selden,321,5,15,18,12,8,58
Kansas,Easton,352,0,0,15,20,36,71
Kansas,Columbus,3207,52,30,0,136,194,412
Kansas,Lincolnville,244,4,3,8,21,13,49
Kansas,Cheney,1929,42,12,120,127,86,387
Kansas,La Crosse,1295,16,20,58,65,40,199
Kansas,Labette,44,0,0,0,0,2,2
Kansas,Kismet,297,12,3,9,28,19,71
Kansas,Kirwin,182,6,2,16,13,3,40
Kansas,Kipp,151,0,0,23,47,24,94
Kansas,Kiowa,998,38,10,39,48,22,157
Kansas,Kinsley,1402,9,26,19,89,81,224
Kansas,Kingman,3128,55,25,218,137,146,581
Kansas,Kincaid,174,0,12,30,17,5,64
Kansas,Kickapoo Tribal Center,201,2,4,20,16,13,55
Kansas,Kickapoo Site 7,43,2,0,2,2,0,6
Kansas,Kickapoo Site 6,20,0,0,3,0,0,3
Kansas,Kickapoo Site 5,67,0,0,0,9,9,18
Kansas,Kickapoo Site 2,44,1,0,7,2,4,14
Kansas,Kickapoo Site 1,93,0,5,13,11,2,31
Kansas,Kensington,468,13,8,24,15,34,94
Kansas,Kechi,2180,41,32,120,149,127,469
Kansas,Kansas City,148855,2653,2708,9391,8643,8331,31726
Kansas,Kanorado,141,2,0,11,2,3,18
Kansas,Abbyville,92,2,1,3,2,14,22
Kansas,Abilene,6671,133,145,320,268,286,1152
Kansas,Ada,53,0,0,0,0,0,0
Kansas,Admire,128,2,2,10,7,2,23
Kansas,Agenda,75,2,2,8,12,1,25
Kansas,Agra,255,3,5,13,13,22,56
Kansas,Albert,166,5,0,4,2,6,17
Kansas,Alden,96,0,1,6,1,1,9
Kansas,Alexander,31,0,0,0,0,0,0
Kansas,Allen,286,0,3,27,12,9,51
Kansas,La Cygne,1284,21,48,115,49,87,320
Kansas,La Harpe,542,17,5,10,28,31,91
Kansas,Lake Quivira,911,12,0,66,44,62,184
Kansas,Lakin,2028,60,45,104,110,118,437
Kansas,Palco,169,0,3,19,9,10,41
Kansas,Palmer,179,10,6,16,0,5,37
Kansas,Paola,5570,96,71,359,495,320,1341
Kansas,Paradise,37,0,0,0,0,2,2
Kansas,Park,99,0,1,14,5,2,22
Kansas,Park City,7290,91,172,490,480,560,1793
Kansas,Parker,435,16,5,25,32,18,96
Kansas,Parkerfield,339,3,5,2,16,14,40
Kansas,Parkerville,70,3,0,3,5,5,16
Kansas,Parsons,10223,112,114,528,391,604,1749
Kansas,Partridge,265,0,0,5,13,12,30
Kansas,Pawnee Rock,221,1,7,7,12,21,48
Kansas,Leona,51,2,2,0,1,0,5
Kansas,Leon,678,12,2,78,22,57,171
Kansas,Alma,837,9,22,37,31,44,143
Kansas,Lenora,238,9,0,9,10,4,32
Kansas,Lehigh,182,0,0,20,18,12,50
Kansas,Lecompton,598,3,7,27,40,30,107
Kansas,Lebo,886,13,12,41,62,54,182
Kansas,Lebanon,309,0,7,26,26,9,68
Kansas,Leawood,33339,788,438,2240,2532,2065,8063
Kansas,Leavenworth,35861,716,519,2268,1946,1832,7281
Kansas,Lawrence,91305,1222,1070,3617,3368,2883,12160
Kansas,Latimer,42,2,0,2,0,3,7
Kansas,Latham,128,1,0,4,5,4,14
Kansas,Larned,4011,85,48,197,127,287,744
Kansas,Lansing,11623,180,184,418,763,764,2309
Kansas,Langdon,30,0,0,2,0,0,2
Kansas,Lane,218,0,6,3,0,6,15
Kansas,Lancaster,315,11,0,22,17,18,68
Kansas,Lenexa,50412,1095,673,2676,2449,2450,9343
Kansas,Almena,493,1,1,30,15,68,115
Kansas,Altamont,1206,21,7,82,125,105,340
Kansas,Alta Vista,473,10,5,16,20,21,72
Kansas,Neodesha,2245,7,13,167,167,85,439
Kansas,Neosho Falls,132,12,0,6,4,8,30
Kansas,Neosho Rapids,195,3,0,6,11,15,35
Kansas,Ness City,1520,27,29,73,70,50,249
Kansas,Netawaka,176,4,0,6,13,17,40
Kansas,New Albany,32,0,0,0,0,2,2
Kansas,New Cambria,145,0,7,9,7,4,27
Kansas,New Strawn,388,7,1,12,12,21,53
Kansas,Peabody,1262,30,31,69,44,82,256
Kansas,Penalosa,15,0,0,0,0,0,0
Kansas,Perry,916,14,16,30,66,57,183
Kansas,Peru,161,8,1,2,10,1,22
Kansas,Phillipsburg,2525,60,38,228,82,146,554
Kansas,Piqua,186,7,0,0,14,32,53
Kansas,Natoma,310,6,5,11,8,18,48
Kansas,Pittsburg,20382,318,336,828,870,775,3127
Kansas,Plainville,1930,24,18,109,100,104,355
Kansas,Pleasanton,1206,19,6,54,115,59,253
Kansas,Plevna,90,1,0,1,6,6,14
Kansas,Pomona,824,11,9,53,20,47,140
Kansas,Portis,101,2,3,5,6,10,26
Kansas,Potwin,458,6,9,30,36,41,122
Kansas,Powhattan,81,1,2,9,5,6,23
Kansas,Prairie View,183,6,0,16,14,7,43
Kansas,Prairie Village,21814,575,300,1029,1101,977,3982
Kansas,Pratt,6887,176,113,252,293,254,1088
Kansas,Prescott,238,0,0,14,10,8,32
Kansas,Preston,175,0,2,14,5,5,26
Kansas,Pretty Prairie,715,32,8,37,41,38,156
Kansas,Princeton,281,5,6,8,17,25,61
Kansas,Plains,1099,8,27,46,56,83,220
Kansas,Ozawkie,757,20,4,48,62,61,195
Kansas,Nashville,67,0,4,4,0,1,9
Kansas,Muscotah,201,2,0,23,16,17,58
Kansas,Alton,141,0,0,7,12,5,24
Kansas,Altoona,418,19,0,27,22,9,77
Kansas,Americus,841,12,4,55,60,37,168
Kansas,Andale,830,13,19,48,78,48,206
Kansas,Andover,12293,315,217,569,1051,1062,3214
Kansas,Anthony,2340,35,24,80,169,68,376
Kansas,Arcadia,454,22,11,20,42,49,144
Kansas,Argonia,697,62,13,37,65,52,229
Kansas,Arkansas City,12253,270,166,730,619,513,2298
Kansas,Arlington,524,9,5,22,22,14,72
Kansas,Paxico,309,15,2,31,28,27,103
Kansas,Hugoton,3864,83,51,340,217,316,1007
Kansas,Humboldt,1826,5,25,56,64,104,254
Kansas,Hunnewell,74,4,0,3,0,2,9
Kansas,Narka,113,0,0,3,6,15,24
Kansas,Hunter,68,0,0,0,3,3,6
Kansas,Hutchinson,41808,1041,577,2064,1958,2260,7900
Kansas,Independence,9179,129,100,545,638,509,1921
Kansas,Ingalls,311,7,10,28,15,10,70
Kansas,Inman,1303,10,7,33,91,64,205
Kansas,Iola,5602,84,82,370,317,189,1042
Kansas,Isabel,98,0,5,4,0,0,9
Kansas,Iuka,207,7,0,15,20,9,51
Kansas,Jamestown,353,6,13,18,19,29,85
Kansas,Jennings,130,0,0,3,2,0,5
Kansas,Jetmore,879,26,11,20,43,56,156
Kansas,Jewell,434,13,6,32,17,23,91
Kansas,Johnson City,1339,40,14,83,129,53,319
Kansas,Junction City,24823,646,392,1463,1225,988,4714
Kansas,Kanopolis,415,7,0,13,14,18,52
Kansas,Huron,76,0,0,0,12,13,25
Kansas,Cherokee,846,3,0,37,97,62,199
Kansas,Oxford,1135,12,21,34,121,54,242
Kansas,Overbrook,977,8,16,44,44,73,185
Kansas,Healy,265,5,2,11,22,25,65
Kansas,Hepler,137,2,4,4,3,5,18
Kansas,Herington,2241,30,39,80,145,104,398
Kansas,Herndon,133,1,0,1,3,15,20
Kansas,Hesston,3566,74,27,147,235,136,619
Kansas,Hiawatha,3132,0,90,128,199,95,512
Kansas,Highland,1053,4,10,26,4,18,62
Kansas,Hill City,1464,4,12,38,93,63,210
Kansas,Hillsboro,2916,48,26,105,136,100,415
Kansas,Hillsdale,270,9,12,12,0,19,52
Kansas,Hoisington,2666,96,28,214,168,122,628
Kansas,Holcomb,2434,84,88,201,205,255,833
Kansas,Hollenberg,21,0,0,0,0,0,0
Kansas,Holton,3284,24,30,202,174,189,619
Kansas,Holyrood,400,8,2,31,11,14,66
Kansas,Home,164,4,0,0,0,13,17
Kansas,Hope,488,8,8,31,20,40,107
Kansas,Horace,152,0,2,12,11,8,33
Kansas,Horton,1746,25,35,103,79,114,356
Kansas,Howard,741,1,7,37,54,44,143
Kansas,Hoxie,1251,31,14,89,24,44,202
Kansas,Hoyt,639,2,4,37,33,29,105
Kansas,Hudson,137,0,4,0,12,6,22
Kansas,Scottsville,10,0,0,0,0,0,0
Kansas,Scott City,3930,88,19,198,265,222,792
Kansas,Schoenchen,193,9,0,11,6,2,28
Kansas,Scandia,430,3,2,29,10,45,89
Kansas,Scammon,454,3,4,13,32,20,72
Kansas,Sawyer,92,5,0,4,3,4,16
Kansas,Hazelton,144,0,1,7,7,10,25
Kansas,Haysville,11234,185,273,664,778,895,2795
Kansas,Haviland,797,15,9,30,36,36,126
Kansas,Havensville,148,0,0,6,4,10,20
Kansas,Chautauqua,68,3,0,2,0,0,5
Kansas,Chase,565,9,10,41,32,36,128
Kansas,Chapman,1441,17,16,86,135,75,329
Kansas,Chanute,9217,87,280,546,447,492,1852
Kansas,Centralia,550,16,10,17,64,39,146
Kansas,Cedar Vale,527,21,21,30,23,17,112
Kansas,Cedar Point,27,0,2,0,0,0,2
Kansas,Cedar,6,0,0,0,0,0,0
Kansas,Greeley,282,1,4,13,19,17,54
Kansas,Greeley County unified government (balance),388,9,13,3,0,3,28
Kansas,Green,125,1,2,5,2,9,19
Kansas,Greenleaf,390,2,2,22,14,10,50
Kansas,Greensburg,896,12,11,29,34,57,143
Kansas,Grenola,164,5,3,4,9,1,22
Kansas,Savonburg,139,1,3,9,9,9,31
Kansas,Gridley,294,0,2,11,16,32,61
Kansas,Gypsum,378,6,3,15,18,11,53
Kansas,Haddam,64,0,0,0,2,2,4
Kansas,Halstead,2305,51,59,109,226,263,708
Kansas,Hamilton,239,1,0,20,13,16,50
Kansas,Hamlin,48,1,0,0,0,8,9
Kansas,Hanover,586,12,5,25,46,20,108
Kansas,Hanston,265,2,0,10,15,20,47
Kansas,Hardtner,147,2,0,7,5,9,23
Kansas,Harper,1309,16,13,36,66,107,238
Kansas,Harris,11,0,0,0,0,0,0
Kansas,Hartford,384,4,6,21,6,27,64
Kansas,Harveyville,212,5,1,10,5,10,31
Kansas,Havana,144,3,4,12,4,2,25
Kansas,Haven,1243,16,17,90,82,62,267
Kansas,Grinnell,276,3,3,7,11,13,37
Kansas,Satanta,1019,20,4,65,112,48,249
Kansas,Salina,47840,763,566,2727,2369,2701,9126
Kansas,St. Paul,689,2,0,48,45,83,178
Kansas,Newton,19139,401,206,1152,1095,1085,3939
Kansas,Nickerson,1181,36,9,59,100,71,275
Kansas,Niotaze,105,1,0,6,3,0,10
Kansas,Norcatur,185,3,2,5,0,9,19
Kansas,North Newton,1782,23,11,63,49,66,212
Kansas,Norton,2856,58,84,181,113,166,602
Kansas,Nortonville,529,14,23,47,28,20,132
Kansas,Norwich,489,16,11,44,17,41,129
Kansas,Oak Hill,51,0,0,0,0,1,1
Kansas,Oaklawn-Sunview,2906,47,62,290,221,102,722
Kansas,Oakley,1914,6,9,100,99,129,343
Kansas,Oberlin,1890,41,8,75,63,74,261
Kansas,Odin,78,4,0,0,0,4,8
Kansas,Offerle,255,0,9,23,15,24,71
Kansas,Quinter,1007,15,11,71,53,46,196
Kansas,Ogden,2010,52,13,34,131,162,392
Kansas,Olathe,131508,3168,2223,9072,8605,8422,31490
Kansas,Olivet,84,0,0,14,1,4,19
Kansas,Olmitz,138,5,0,6,12,4,27
Kansas,Olpe,595,4,13,48,55,25,145
Kansas,Olsburg,238,4,5,15,11,19,54
Kansas,Onaga,746,5,4,46,45,38,138
Kansas,Oneida,59,0,0,2,3,6,11
Kansas,Osage City,2885,81,89,141,140,132,583
Kansas,Osawatomie,4373,123,60,483,202,264,1132
Kansas,Osborne,1463,27,21,89,84,83,304
Kansas,Oskaloosa,1338,23,16,46,80,109,274
Kansas,Oswego,1847,29,44,113,101,69,356
Kansas,Otis,334,0,3,16,18,17,54
Kansas,Ottawa,12487,127,186,765,514,784,2376
Kansas,Oketo,69,0,0,2,6,5,13
Kansas,Overland Park,181464,3532,2666,9559,9545,10032,35334
Kansas,Radium,35,0,0,5,0,3,8
Kansas,Randall,90,0,0,2,2,0,4
Kansas,St. Marys,2797,68,64,245,173,170,720
Kansas,St. John,1414,36,30,119,108,82,375
Kansas,St. George,852,25,9,90,102,60,286
Kansas,St. Francis,1239,0,7,49,75,58,189
Kansas,Sabetha,2557,35,29,131,133,90,418
Kansas,Russell Springs,34,0,0,10,0,0,10
Kansas,Russell,4499,36,30,196,289,242,793
Kansas,Rush Center,137,0,8,1,7,3,19
Kansas,Rozel,171,0,2,20,10,4,36
Kansas,Roxbury,57,0,0,0,0,0,0
Kansas,Rossville,1177,33,31,88,55,73,280
Kansas,Roseland,64,0,0,1,4,7,12
Kansas,Rose Hill,3961,28,131,178,374,288,999
Kansas,Rosalia,86,0,4,4,3,7,18
Kansas,Ramona,116,3,5,15,10,8,41
Kansas,Rolla,463,3,17,41,32,69,162
Kansas,Robinson,234,3,2,30,4,6,45
Kansas,Riverton,934,19,0,71,65,45,200
Kansas,Riley,971,22,10,51,73,56,212
Kansas,Richmond,540,6,3,27,34,60,130
Kansas,Richfield,34,0,0,0,1,5,6
Kansas,Rexford,235,0,9,14,42,22,87
Kansas,Reserve,68,0,0,3,0,0,3
Kansas,Republic,86,3,0,2,4,2,11
Kansas,Redfield,81,0,0,8,4,9,21
Kansas,Reading,298,3,5,30,28,26,92
Kansas,Raymond,65,0,0,0,0,0,0
Kansas,Rantoul,121,0,0,1,2,2,5
Kansas,Ransom,295,8,3,16,14,12,53
Kansas,Randolph,166,1,4,9,6,4,24
Kansas,Roeland Park,6819,148,54,232,141,266,841
Kansas,Hays,20992,420,282,883,803,847,3235
Kansas,Quenemo,424,11,5,34,5,41,96
Kansas,Atchison,10858,115,84,672,556,649,2076
Kansas,Wilroads Gardens,388,0,6,18,18,72,114
Kansas,Wilmore,26,0,0,0,1,3,4
Kansas,Stockton,1334,29,11,100,52,63,255
Kansas,Strong City,495,10,20,22,8,17,77
Kansas,Sublette,1540,25,13,93,92,112,335
Kansas,Summerfield,138,3,0,7,8,5,23
Kansas,Sun City,38,0,0,0,0,0,0
Kansas,Susank,32,0,0,0,0,0,0
Kansas,Sylvan Grove,297,4,5,22,19,3,53
Kansas,Sylvia,256,5,11,22,29,13,80
Kansas,Syracuse,1791,73,24,146,117,111,471
Kansas,Talmage,90,0,0,0,0,0,0
Kansas,Tampa,107,1,2,6,4,13,26
Kansas,Tescott,298,7,4,12,19,29,71
Kansas,Thayer,577,8,17,31,45,18,119
Kansas,Timken,87,0,9,3,8,15,35
Kansas,Tipton,210,1,0,21,7,6,35
Kansas,Tonganoxie,4681,79,38,286,240,331,974
Kansas,Topeka,127672,2188,1645,6246,6591,6494,23164
Kansas,Wilsey,164,1,0,6,2,6,15
Kansas,Wilson,750,29,15,24,8,28,104
Kansas,Winchester,565,7,5,7,24,18,61
Kansas,Edwardsville,4372,65,49,309,289,279,991
Kansas,Esbon,147,4,4,12,2,19,41
Kansas,Erie,1092,31,11,55,40,54,191
Kansas,Enterprise,975,16,4,57,46,49,172
Kansas,Ensign,218,3,4,14,24,14,59
Kansas,Englewood,84,0,0,0,4,7,11
Kansas,Emporia,24739,611,356,1132,972,1351,4422
Kansas,Emmett,128,8,7,16,0,7,38
Kansas,Elwood,1027,25,11,70,50,78,234
Kansas,Elsmore,93,0,3,3,6,5,17
Kansas,Toronto,273,5,8,20,2,12,47
Kansas,Elmdale,49,0,0,0,0,0,0
Kansas,Ellis,2120,72,59,141,75,114,461
Kansas,Ellinwood,2520,74,76,83,63,120,416
Kansas,Elkhart,2159,0,88,130,62,64,344
Kansas,Elk Falls,57,0,0,5,2,0,7
Kansas,Elk City,285,7,1,5,7,13,33
Kansas,Elgin,98,0,0,3,1,6,10
Kansas,El Dorado,12910,289,224,956,690,612,2771
Kansas,Elbing,285,2,7,12,16,21,58
Kansas,Effingham,621,17,14,66,20,38,155
Kansas,Ellsworth,3075,18,17,100,109,102,346
Kansas,Towanda,1625,19,31,146,144,180,520
Kansas,Tribune,684,8,12,25,69,50,164
Kansas,Troy,991,10,0,77,58,25,170
Kansas,Waterville,674,12,17,43,35,14,121
Kansas,Wathena,1312,32,0,30,67,84,213
Kansas,Waverly,607,3,13,50,41,47,154
Kansas,Webber,20,0,0,0,0,0,0
Kansas,Weir,585,7,9,56,28,20,120
Kansas,Welda,73,0,0,0,0,0,0
Kansas,Wellington,7997,174,73,366,457,460,1530
Kansas,Wellsville,1880,55,19,132,155,87,448
Kansas,Weskan,207,0,0,17,8,24,49
Kansas,Washington,1166,40,2,66,63,73,244
Kansas,West Mineral,239,1,6,16,13,7,43
Kansas,Westphalia,173,4,0,10,7,19,40
Kansas,Westwood,1795,48,29,101,98,74,350
Kansas,Westwood Hills,446,10,2,19,29,15,75
Kansas,Wetmore,345,7,0,19,36,26,88
Kansas,Wheaton,156,25,1,11,20,3,60
Kansas,White City,524,10,8,22,13,25,78
Kansas,White Cloud,242,18,0,27,10,15,70
Kansas,Whitewater,700,3,11,56,50,59,179
Kansas,Bentley,542,15,13,30,21,20,99
Kansas,Westmoreland,868,7,11,46,39,52,155
Kansas,Eskridge,531,5,5,28,21,21,80
Kansas,Wamego,4349,88,42,243,361,334,1068
Kansas,Walnut,301,3,9,17,15,21,65
Kansas,Turon,313,5,10,17,6,11,49
Kansas,Tyro,258,15,1,5,9,17,47
Kansas,Udall,738,14,17,23,27,51,132
Kansas,Ulysses,6022,139,267,299,360,413,1478
Kansas,Uniontown,441,1,9,47,25,36,118
Kansas,Utica,137,0,0,2,6,16,24
Kansas,Valley Center,6586,96,85,330,374,444,1329
Kansas,Valley Falls,1060,5,5,41,40,87,178
Kansas,Vassar,723,23,7,36,10,38,114
Kansas,Walton,255,1,2,1,14,10,28
Kansas,Vermillion,127,4,2,9,10,0,25
Kansas,Vining,45,0,4,7,6,3,20
Kansas,Viola,131,3,0,2,3,3,11
Kansas,Virgil,28,0,0,0,1,1,2
Kansas,Wakarusa,323,7,0,13,12,0,32
Kansas,WaKeeney,1889,30,40,81,70,99,320
Kansas,Wakefield,1000,9,7,30,123,75,244
Kansas,Waldo,45,0,2,2,1,1,6
Kansas,Waldron,16,0,0,0,0,0,0
Kansas,Wallace,52,0,0,3,8,7,18
Kansas,Victoria,1357,26,15,70,65,48,224
Kansas,Eudora,6276,135,102,355,462,656,1710
Kansas,Eureka,2419,34,38,153,124,83,432
Kansas,Everest,296,1,6,7,12,28,54
Kansas,Buffalo,312,4,1,26,25,26,82
Kansas,Buhler,1400,15,26,69,116,93,319
Kansas,Bunker Hill,113,7,0,3,10,1,21
Kansas,Burden,533,10,7,19,61,38,135
Kansas,Burdett,304,5,1,18,31,26,81
Kansas,Burlingame,886,15,5,48,52,51,171
Kansas,Burlington,2629,103,33,102,105,133,476
Kansas,Burns,366,6,6,5,37,20,74
Kansas,Burr Oak,166,0,0,4,0,8,12
Kansas,Bucyrus,264,0,0,28,0,0,28
Kansas,Burrton,1046,16,13,66,95,95,285
Kansas,Bushton,264,4,0,19,13,19,55
Kansas,Byers,38,4,0,0,2,3,9
Kansas,Caldwell,1085,35,27,25,44,39,170
Kansas,Cambridge,118,0,0,11,5,1,17
Kansas,Caney,2052,16,65,74,120,137,412
Kansas,Canton,827,17,0,33,49,71,170
Kansas,Carbondale,1409,50,14,124,59,64,311
Kansas,Carlton,14,0,0,0,0,0,0
Kansas,Cassoday,103,2,1,4,7,12,26
Kansas,Bushong,42,0,0,0,12,8,20
Kansas,Catharine,53,0,0,0,0,13,13
Kansas,Bucklin,894,18,3,73,52,30,176
Kansas,Brookville,311,1,4,17,28,44,94
Kansas,Winona,240,3,0,25,17,12,57
Kansas,Woodbine,188,10,12,3,1,12,38
Kansas,Woodston,140,1,0,7,7,8,23
Kansas,Wright,102,0,0,3,0,0,3
Kansas,Yates Center,1284,9,19,40,78,46,192
Kansas,Yoder,242,0,0,0,47,44,91
Kansas,Zenda,97,7,1,3,1,1,13
Kansas,Zurich,104,3,0,3,0,1,7
Kansas,Benton,949,3,15,58,64,98,238
Kansas,Brownell,46,0,0,2,5,2,9
Kansas,Bern,192,9,4,8,12,10,43
Kansas,Bird City,499,13,5,16,19,44,97
Kansas,Bison,196,0,5,3,14,18,40
Kansas,Blue Mound,262,0,2,15,12,18,47
Kansas,Blue Rapids,1018,22,8,54,109,87,280
Kansas,Bluff City,74,2,2,0,7,6,17
Kansas,Bogue,298,21,19,24,2,10,76
Kansas,Bonner Springs,7498,143,102,394,383,409,1431
Kansas,Brewster,250,3,1,9,7,16,36
Kansas,Bronson,378,8,8,42,19,30,107
Kansas,Beverly,160,0,6,5,17,3,31
Kansas,Bennington,772,55,7,64,39,54,219
Kansas,Grantville,48,0,0,0,0,0,0
Kansas,Grainfield,329,16,7,15,14,14,66
Kansas,Galatia,14,0,0,0,0,0,0
Kansas,Fulton,137,6,4,9,5,15,39
Kansas,Frontenac,3445,51,66,175,320,104,716
Kansas,Freeport,0,0,0,0,0,0,0
Kansas,Fredonia,2455,29,17,159,140,231,576
Kansas,Frederick,8,0,0,0,0,0,0
Kansas,Franklin,715,0,0,0,76,61,137
Kansas,Frankfort,746,18,11,27,35,28,119
Kansas,Fowler,441,5,12,23,19,25,84
Kansas,Galena,2988,65,192,131,161,149,698
Kansas,Fort Scott,7893,72,25,373,376,506,1352
Kansas,Fort Dodge,215,0,0,0,0,0,0
Kansas,Formoso,111,0,0,32,1,0,33
Kansas,Ford,281,1,4,7,13,16,41
Kansas,Fontana,145,0,1,6,7,7,21
Kansas,Florence,415,2,7,9,17,14,49
Kansas,Falun,109,0,0,0,0,0,0
Kansas,Fall River,179,0,0,12,3,2,17
Kansas,Fairway,3964,75,52,138,241,216,722
Kansas,Fairview,261,2,0,11,5,22,40
Kansas,Fort Riley,7015,152,317,640,113,112,1334
Kansas,Grandview Plaza,2110,4,30,87,84,64,269
Kansas,Galesburg,102,4,1,5,8,2,20
Kansas,Garden City,27007,387,468,1938,1789,1532,6114
Kansas,Gove City,96,0,0,5,8,2,15
Kansas,Gorham,351,16,7,16,12,11,62
Kansas,Goodland,4834,130,72,308,258,248,1016
Kansas,Goff,111,2,4,6,4,4,20
Kansas,Goessel,605,10,10,39,46,15,120
Kansas,Cawker City,511,8,2,20,16,34,80
Kansas,Goddard,4256,78,73,455,391,330,1327
Kansas,Glen Elder,507,22,31,40,17,22,132
Kansas,Glasco,460,5,9,23,23,16,76
Kansas,Galva,903,21,18,61,36,26,162
Kansas,Glade,65,0,0,0,2,5,7
Kansas,Geuda Springs,193,0,11,13,6,7,37
Kansas,Geneseo,282,1,1,12,11,19,44
Kansas,Gem,86,3,0,9,8,4,24
Kansas,Gaylord,136,12,0,6,1,20,39
Kansas,Gas,606,16,0,22,37,32,107
Kansas,Garnett,3306,26,59,202,279,50,616
Kansas,Garfield,243,4,4,1,4,32,45
Kansas,Gardner,20466,487,482,1488,1386,1359,5202
Kansas,Garden Plain,805,23,14,28,50,71,186
Kansas,Girard,2788,51,28,159,101,177,516
Kansas,Winfield,12286,114,207,583,656,647,2207
Kansas,Benedict,57,0,1,0,0,0,1
Kansas,Belvue,241,6,11,14,20,6,57
Kansas,Bendena,69,0,0,0,0,12,12
Kansas,Mayetta,337,4,6,11,19,38,78
Kansas,Mayfield,94,0,1,10,8,6,25
Kansas,Meade,1702,10,30,114,157,141,452
Kansas,Medicine Lodge,2056,11,29,103,88,84,315
Kansas,Melvern,510,10,3,42,46,38,139
Kansas,Marysville,3301,108,38,164,187,154,651
Kansas,Menlo,34,4,3,5,1,0,13
Kansas,Merriam,11232,159,105,371,503,533,1671
Kansas,Milan,72,2,5,3,0,5,15
Kansas,Mildred,26,0,2,4,2,0,8
Kansas,Milford,507,2,10,38,19,26,95
Kansas,Milton,46,0,0,0,0,0,0
Kansas,Miltonvale,449,0,0,18,27,21,66
Kansas,Meriden,899,13,7,53,27,81,181
Kansas,Marquette,747,10,6,38,36,56,146
Kansas,Marion,1857,12,3,81,133,100,329
Kansas,Marienthal,16,0,0,0,0,0,0
Kansas,McCune,510,7,4,20,21,31,83
Kansas,McDonald,163,0,4,6,0,4,14
Kansas,McFarland,364,10,24,26,14,14,88
Kansas,Macksville,492,19,7,30,49,49,154
Kansas,McLouth,1282,39,26,100,100,64,329
Kansas,McPherson,13212,181,261,620,667,716,2445
Kansas,Madison,917,16,28,99,97,44,284
Kansas,Mahaska,53,0,0,0,1,8,9
Kansas,Maize,4054,47,274,164,267,336,1088
Kansas,Manchester,162,0,7,11,9,11,38
Kansas,Manhattan,55769,668,341,1619,1377,1624,5629
Kansas,Mankato,812,16,15,39,39,34,143
Kansas,Manter,183,1,12,2,5,4,24
Kansas,Maple Hill,700,6,21,63,83,60,233
Kansas,Mapleton,99,3,0,11,16,5,35
Kansas,Minneapolis,2099,69,26,187,141,96,519
Kansas,McCracken,195,1,1,7,8,4,21
Kansas,Minneola,733,11,15,54,53,24,157
Kansas,Mission Hills,3572,46,36,211,271,379,943
Kansas,Baldwin City,4588,84,87,260,301,272,1004
Kansas,Baileyville,173,0,0,0,0,7,7
Kansas,Arma,1469,48,12,79,85,80,304
Kansas,Asherville,0,0,0,0,0,0,0
Kansas,Ashland,748,1,16,40,52,64,173
Kansas,Assaria,504,16,14,32,37,25,124
Kansas,Barnard,55,0,0,0,0,0,0
Kansas,Axtell,401,4,11,22,20,8,65
Kansas,Atlanta,225,5,0,13,17,16,51
Kansas,Aurora,52,8,0,0,5,1,14
Kansas,Augusta,9242,146,114,680,577,568,2085
Kansas,Auburn,1293,32,15,66,42,70,225
Kansas,Atwood,1021,13,8,66,46,65,198
Kansas,Attica,769,43,0,61,33,24,161
Kansas,Athol,50,0,0,0,1,0,1
Kansas,Munjor,198,0,0,28,0,0,28
Kansas,Munden,131,2,8,7,4,10,31
Kansas,Mulvane,5607,172,0,313,399,375,1259
Kansas,Mission Woods,183,4,6,5,2,8,25
Kansas,Moline,333,5,0,8,13,6,32
Kansas,Montezuma,978,7,7,55,36,10,115
Kansas,Moran,545,2,6,22,15,26,71
Kansas,Morganville,160,13,0,3,7,4,27
Kansas,Morland,103,2,0,4,4,9,19
Kansas,Morrill,310,3,5,24,34,13,79
Kansas,Morrowville,159,0,0,4,20,14,38
Kansas,Moscow,322,5,8,19,31,30,93
Kansas,Mound City,742,13,20,51,24,39,147
Kansas,Moundridge,1814,28,25,85,77,69,284
Kansas,Mound Valley,452,5,12,26,21,49,113
Kansas,Mount Hope,755,15,5,35,42,53,150
Kansas,Mulberry,485,4,3,22,16,16,61
Kansas,Mullinville,190,0,0,10,9,10,29
Kansas,Mission,9481,188,117,454,361,366,1486
Kansas,McConnell AFB,1360,49,18,44,32,58,201
Kansas,Matfield Green,50,1,1,0,2,1,5
Kansas,Windom,106,0,0,9,12,2,23
Kansas,Barnes,104,5,2,4,1,3,15
Kansas,Bassett,9,0,0,0,1,1,2
Kansas,Baxter Springs,4114,57,62,330,292,309,1050
Kansas,Bazine,389,6,2,23,23,59,113
Kansas,Beattie,223,2,0,7,12,8,29
Kansas,Bel Aire,7059,64,59,261,298,679,1361
Kansas,Belle Plaine,1706,41,14,99,138,135,427
Kansas,Belleville,1902,36,25,82,39,44,226
Kansas,Beloit,3780,87,55,216,157,241,756
Kansas,Whiting,217,6,2,18,18,15,59
Kansas,Wichita,387147,6718,6093,21899,21017,21275,77002
Kansas,Willard,90,1,0,4,13,1,19
Kansas,Williamsburg,318,12,0,30,25,9,76
Kansas,Willis,25,0,0,1,0,2,3
Kansas,Willowbrook,83,0,0,10,3,2,15
Kansas,Belpre,188,3,0,30,11,2,46
Kansas,Bartlett,90,1,3,0,2,7,13
Kansas,Basehor,4980,238,28,203,373,270,1112
Kentucky,Ironville,435,0,0,80,28,0,108
Kentucky,Crestwood,4705,84,114,329,423,328,1278
Kentucky,Irvine,2223,15,41,144,90,105,395
Kentucky,Crittenden,3833,57,84,317,261,153,872
Kentucky,Frankfort,27535,218,358,1318,1464,956,4314
Kentucky,Francisville,9315,293,254,672,920,583,2722
Kentucky,Fox Chase,458,1,11,15,9,13,49
Kentucky,Fountain Run,231,2,2,14,13,7,38
Kentucky,Fort Wright,5754,112,67,381,181,254,995
Kentucky,Fort Thomas,16326,228,282,1089,1166,801,3566
Kentucky,Fort Mitchell,8247,134,55,454,504,773,1920
Kentucky,Crestview Hills,3320,39,34,53,67,113,306
Kentucky,Irvington,1030,27,3,60,87,51,228
Kentucky,Jeff,281,0,8,7,60,8,83
Kentucky,Jackson,2079,32,32,83,40,110,297
Kentucky,Lewisburg,789,25,6,43,51,29,154
Kentucky,Leitchfield,6819,206,66,382,201,223,1078
Kentucky,Ledbetter,1704,0,57,91,57,164,369
Kentucky,Lebanon Junction,1861,18,10,90,73,74,265
Kentucky,Lebanon,5620,88,141,334,391,264,1218
Kentucky,Lawrenceburg,11038,105,121,625,685,553,2089
Kentucky,Langdon Place,913,9,18,50,53,56,186
Kentucky,Lancaster,3814,55,36,133,160,167,551
Kentucky,Lakeview Heights,309,8,15,8,30,6,67
Kentucky,Lakeside Park,2757,88,7,127,172,161,555
Kentucky,La Grange,8387,150,100,441,541,629,1861
Kentucky,Island,442,3,7,30,11,32,83
Kentucky,LaFayette,150,6,8,4,6,11,35
Kentucky,Kuttawa,698,6,4,18,15,12,55
Kentucky,Kingsley,381,5,2,22,14,12,55
Kentucky,Kevil,521,2,6,36,16,32,92
Kentucky,Kenvir,359,0,15,28,6,42,91
Kentucky,Kenton Vale,86,2,1,3,0,0,6
Kentucky,Junction City,2494,32,41,177,183,119,552
Kentucky,Jenkins,2330,43,32,107,119,98,399
Kentucky,Jeffersonville,1761,29,9,68,120,67,293
Kentucky,Jeffersontown,26953,418,377,1282,1366,1260,4703
Kentucky,Fort Knox,9449,278,200,806,776,502,2562
Kentucky,Jamestown,2075,11,23,120,41,108,303
Kentucky,La Center,1080,21,0,35,99,55,210
Kentucky,Fort Campbell North,13936,368,333,1078,672,342,2793
Kentucky,Flat Lick,936,0,0,10,25,66,101
Kentucky,Fordsville,536,4,6,38,21,25,94
Kentucky,Ekron,203,0,0,46,10,2,58
Kentucky,Elizabethtown,29657,353,348,1500,1654,1496,5351
Kentucky,Elizaville,223,0,8,10,0,10,28
Kentucky,Elk Creek,1603,0,45,76,96,172,389
Kentucky,Elkhorn City,898,7,3,6,28,41,85
Kentucky,Elkton,2081,53,9,99,82,159,402
Kentucky,Elsmere,8489,345,153,578,405,373,1854
Kentucky,Eminence,2515,31,58,148,216,130,583
Kentucky,Emlyn,349,0,0,28,0,54,82
Kentucky,Erlanger,18510,285,237,1156,1157,880,3715
Kentucky,Eubank,317,2,7,35,13,10,67
Kentucky,Edmonton,1656,10,9,54,138,8,219
Kentucky,Evarts,905,20,9,35,44,48,156
Kentucky,Ezel,225,0,4,7,14,22,47
Kentucky,Fairfield,125,2,0,3,6,6,17
Kentucky,Fairview,235,0,0,33,23,0,56
Kentucky,Fairview,183,8,0,12,7,0,27
Kentucky,Falmouth,2349,9,26,73,133,148,389
Kentucky,Fancy Farm,593,5,14,38,38,36,131
Kentucky,Farley,4588,27,79,262,194,190,752
Kentucky,Farmers,102,0,0,0,0,0,0
Kentucky,Farmington,106,0,0,7,0,12,19
Kentucky,Ferguson,1090,10,15,45,65,51,186
Kentucky,Fincastle,891,19,20,58,43,53,193
Kentucky,Ewing,259,7,3,20,24,13,67
Kentucky,Forest Hills,385,6,3,20,16,27,72
Kentucky,Edgewood,8699,124,56,473,531,569,1753
Kentucky,East Bernstadt,920,0,9,57,41,62,169
Kentucky,Florence,31428,625,277,1577,1751,1129,5359
Kentucky,Flatwoods,7407,102,41,378,333,309,1163
Kentucky,Fleming-Neon,926,10,8,50,36,32,136
Kentucky,Crofton,778,15,12,101,68,8,204
Kentucky,Crossgate,270,11,9,13,5,7,45
Kentucky,Cumberland,2245,28,49,109,159,126,471
Kentucky,Cunningham,200,6,0,8,19,0,33
Kentucky,Cynthiana,6380,12,11,351,498,292,1164
Kentucky,Danville,16542,197,106,549,791,768,2411
Kentucky,Dawson Springs,2737,18,26,145,178,138,505
Kentucky,Dayton,5381,74,100,333,292,318,1117
Kentucky,Eddyville,2603,18,40,101,55,114,328
Kentucky,Dexter,364,0,0,0,0,31,31
Kentucky,Dixon,1121,28,0,55,47,73,203
Kentucky,Doe Valley,1601,0,21,28,58,132,239
Kentucky,Douglass Hills,5592,74,98,291,300,144,907
Kentucky,Dover,232,5,4,19,10,3,41
Kentucky,Drakesboro,469,9,2,48,22,21,102
Kentucky,Druid Hills,335,23,9,28,8,12,80
Kentucky,Dry Ridge,2341,18,97,178,114,114,521
Kentucky,Dunmor,319,5,0,23,7,29,64
Kentucky,Dwale,279,0,0,0,0,0,0
Kentucky,Dycusburg,15,0,0,0,0,0,0
Kentucky,Earlington,1547,17,32,108,40,139,336
Kentucky,Diablock,334,0,0,0,15,14,29
Kentucky,Flemingsburg,2880,12,48,55,207,139,461
Kentucky,South Carrollton,120,0,1,6,2,6,15
Kentucky,Somerset,11358,152,201,646,350,720,2069
Kentucky,Union,5635,160,124,413,399,442,1538
Kentucky,Trenton,414,4,2,24,37,20,87
Kentucky,Tompkinsville,2061,3,31,95,82,71,282
Kentucky,Tolu,212,0,0,0,7,7,14
Kentucky,Thornhill,219,8,1,27,16,27,79
Kentucky,Ten Broeck,103,0,0,1,3,2,6
Kentucky,Taylorsville,1126,25,8,28,68,49,178
Kentucky,Taylor Mill,6701,181,200,176,321,395,1273
Kentucky,Symsonia,596,13,12,56,16,36,133
Kentucky,Sycamore,159,4,0,3,3,5,15
Kentucky,Summersville,539,11,0,36,13,14,74
Kentucky,Summer Shade,263,0,7,10,11,0,28
Kentucky,Sturgis,2098,62,52,69,154,55,392
Kentucky,Strathmoor Village,631,15,6,12,34,20,87
Kentucky,Uniontown,732,5,17,55,34,28,139
Kentucky,Strathmoor Manor,356,5,7,12,19,22,65
Kentucky,Stanton,2707,69,22,145,60,89,385
Kentucky,Stanford,3680,47,17,159,124,176,523
Kentucky,Stamping Ground,822,23,5,40,20,24,112
Kentucky,Spring Valley,782,24,11,52,74,82,243
Kentucky,Spring Mill,286,0,5,18,17,22,62
Kentucky,Springfield,2955,122,27,110,110,126,495
Kentucky,Spottsville,284,0,0,20,20,0,40
Kentucky,Sparta,284,3,0,17,29,31,80
Kentucky,South Williamson,628,0,8,40,0,30,78
Kentucky,South Wallins,632,0,14,43,8,18,83
Kentucky,South Shore,1196,2,24,56,52,24,158
Kentucky,South Park View,4,0,0,0,0,0,0
Kentucky,Smithland,354,2,5,16,29,34,86
Kentucky,Smithfield,79,4,0,0,0,3,7
Kentucky,Stearns,1335,54,28,121,13,23,239
Kentucky,Slaughters,252,0,10,0,12,13,35
Kentucky,Upton,751,0,12,28,7,50,97
Kentucky,Vanceburg,1491,28,16,21,61,123,249
Kentucky,Wildwood,277,7,3,23,5,3,41
Kentucky,Wilder,3063,33,0,107,115,121,376
Kentucky,Wickliffe,705,4,1,30,62,49,146
Kentucky,Whitley City,953,0,12,13,0,79,104
Kentucky,Whitesville,473,4,7,46,30,15,102
Kentucky,Whitesburg,2053,33,54,57,50,64,258
Kentucky,White Plains,944,20,16,51,38,44,169
Kentucky,Wheelwright,937,14,2,25,20,69,130
Kentucky,Wheatcroft,153,0,0,7,11,8,26
Kentucky,Westwood,611,16,0,31,55,22,124
Kentucky,Westwood,4783,37,0,406,132,210,785
Kentucky,Westport,202,0,0,0,5,31,36
Kentucky,West Point,955,12,22,65,83,33,215
Kentucky,West Liberty,3298,4,0,96,40,77,217
Kentucky,Utica,97,0,0,0,10,0,10
Kentucky,West Buechel,1196,23,42,40,52,46,203
Kentucky,Wayland,370,4,3,16,29,13,65
Kentucky,Waverly,296,3,7,15,21,12,58
Kentucky,Watterson Park,1409,19,45,109,58,81,312
Kentucky,Water Valley,328,5,4,12,9,21,51
Kentucky,Warsaw,2022,17,46,96,52,128,339
Kentucky,Warfield,318,4,4,9,16,12,45
Kentucky,Walton,4063,135,151,412,158,201,1057
Kentucky,Wallins Creek,142,0,0,1,2,9,12
Kentucky,Virgie,269,0,0,24,0,0,24
Kentucky,Vine Grove,5534,150,91,346,301,232,1120
Kentucky,Villa Hills,7399,177,37,214,307,579,1314
Kentucky,Vicco,326,11,6,20,21,10,68
Kentucky,Versailles,8985,75,122,465,623,476,1761
Kentucky,Verona,1141,0,7,35,33,67,142
Kentucky,Wellington,506,22,2,29,13,14,80
Kentucky,Smiths Grove,811,20,3,42,50,50,165
Kentucky,Simpsonville,2618,58,72,244,133,95,602
Kentucky,Shively,15570,129,80,888,693,1210,3000
Kentucky,Richmond,32574,405,281,1211,997,1161,4055
Kentucky,Richlawn,417,16,2,15,25,18,76
Kentucky,Reidland,4419,24,169,187,279,221,880
Kentucky,Raywick,137,1,0,3,4,14,22
Kentucky,Ravenna,473,0,7,27,24,14,72
Kentucky,Radcliff,22913,330,518,1148,1270,1296,4562
Kentucky,Raceland,2932,13,39,158,184,134,528
Kentucky,Rabbit Hash,426,0,0,0,97,55,152
Kentucky,Pryorsburg,207,0,0,0,12,27,39
Kentucky,Providence,3125,55,16,209,162,170,612
Kentucky,Prospect,4806,37,98,227,204,422,988
Kentucky,Princeton,6251,96,174,455,385,222,1332
Kentucky,Prestonville,107,0,4,6,1,4,15
Kentucky,Prestonsburg,3398,55,49,149,94,202,549
Kentucky,Rineyville,3399,76,48,111,349,191,775
Kentucky,Powderly,694,0,3,26,27,27,83
Kentucky,Poole,285,10,12,27,0,61,110
Kentucky,Plum Springs,472,6,6,26,16,15,69
Kentucky,Pleasureville,883,7,10,42,103,44,206
Kentucky,Pleasant View,395,5,0,14,0,25,44
Kentucky,Plantation,822,30,16,38,38,50,172
Kentucky,Plano,1194,18,16,30,59,70,193
Kentucky,Pippa Passes,527,3,0,1,10,4,18
Kentucky,Pioneer Village,2765,54,40,92,159,97,442
Kentucky,Pineville,1629,9,7,77,43,29,165
Kentucky,Pine Knot,1810,14,0,150,112,87,363
Kentucky,Pikeville,7038,44,63,320,409,207,1043
Kentucky,Southgate,3821,22,32,220,264,201,739
Kentucky,Lewisport,1522,4,22,118,96,51,291
Kentucky,Sonora,638,3,0,30,39,50,122
Kentucky,Poplar Hills,439,32,16,22,9,24,103
Kentucky,Silver Grove,1154,19,35,102,63,51,270
Kentucky,River Bluff,417,5,0,22,38,32,97
Kentucky,Robards,609,10,10,61,30,42,153
Kentucky,Shepherdsville,11695,124,265,824,756,715,2684
Kentucky,Shelbyville,14782,343,218,1068,646,921,3196
Kentucky,Sharpsburg,405,6,0,45,11,24,86
Kentucky,Seneca Gardens,621,10,9,32,27,25,103
Kentucky,Sedalia,352,0,0,0,29,35,64
Kentucky,Sebree,1556,41,42,84,67,58,292
Kentucky,Scottsville,4335,78,48,220,256,170,772
Kentucky,Science Hill,610,9,12,29,24,28,102
Kentucky,Sardis,120,0,4,10,1,4,19
Kentucky,Sandy Hook,548,4,5,36,31,23,99
Kentucky,Sanders,274,0,0,15,12,29,56
Kentucky,Salyersville,1754,45,13,127,99,114,398
Kentucky,Salvisa,562,0,0,4,21,96,121
Kentucky,Salt Lick,353,7,1,29,17,34,88
Kentucky,Riverwood,503,14,10,21,38,32,115
Kentucky,Salem,809,5,8,38,20,37,108
Kentucky,St. Matthews,17837,251,171,582,416,564,1984
Kentucky,St. Charles,293,0,0,26,14,27,67
Kentucky,Sadieville,294,1,6,23,21,24,75
Kentucky,Sacramento,406,4,10,13,17,27,71
Kentucky,Ryland Heights,1072,4,7,40,57,69,177
Kentucky,Russellville,7015,91,64,186,453,438,1232
Kentucky,Russell Springs,2491,40,8,132,62,91,333
Kentucky,Russell,3307,37,25,89,159,147,457
Kentucky,Rosine,40,0,0,0,0,0,0
Kentucky,Rolling Hills,832,5,25,39,25,65,159
Kentucky,Rolling Fields,743,20,13,38,43,59,173
Kentucky,Rockport,245,3,0,19,9,15,46
Kentucky,Rockholds,622,40,0,63,65,0,168
Kentucky,Rochester,275,6,11,32,20,12,81
Kentucky,St. Regis Park,1412,25,0,76,68,76,245
Kentucky,Lexington-Fayette urban,308306,4900,3482,14593,14318,12969,50262
Kentucky,Coldstream,1238,21,16,101,71,74,283
Kentucky,Lincolnshire,147,0,1,10,5,6,22
Kentucky,Cambridge,170,2,0,11,8,2,23
Kentucky,Camargo,1297,20,5,98,80,52,255
Kentucky,Calvert City,2543,42,52,192,238,134,658
Kentucky,California,121,0,0,13,2,17,32
Kentucky,Calhoun,894,3,20,38,66,48,175
Kentucky,Cadiz,2618,46,113,94,159,102,514
Kentucky,Butler,495,3,15,7,21,28,74
Kentucky,Campbellsburg,789,0,6,45,51,46,148
Kentucky,Burnside,888,9,14,32,69,29,153
Kentucky,Burlington,16892,369,207,945,1336,1020,3877
Kentucky,Burkesville,1414,74,15,40,52,69,250
Kentucky,Burgin,1238,17,8,87,41,46,199
Kentucky,Buffalo,482,0,0,10,16,7,33
Kentucky,Buckner,5693,124,60,252,303,381,1120
Kentucky,Buckhorn,125,0,0,3,20,21,44
Kentucky,Brownsville,857,16,0,7,16,50,89
Kentucky,Burna,351,0,0,0,11,18,29
Kentucky,Campbellsville,10983,110,184,447,454,460,1655
Kentucky,Campton,574,28,10,12,46,24,120
Kentucky,Caneyville,649,18,10,38,38,18,122
Kentucky,Clay City,1283,20,23,136,92,74,345
Kentucky,Clay,1048,17,15,55,52,78,217
Kentucky,Claryville,2446,98,10,110,189,194,601
Kentucky,Clarkson,1036,32,11,46,47,37,173
Kentucky,Chaplin,259,0,0,9,8,5,22
Kentucky,Cerulean,219,0,0,0,0,0,0
Kentucky,Central City,5918,29,33,549,212,280,1103
Kentucky,Centertown,367,2,3,12,3,18,38
Kentucky,Cecilia,429,37,0,21,0,0,58
Kentucky,Cayce,82,0,0,0,0,7,7
Kentucky,Cawood,703,0,0,39,45,24,108
Kentucky,Cave City,2210,41,49,21,106,98,315
Kentucky,Catlettsburg,1959,0,31,51,71,100,253
Kentucky,Carrsville,34,0,0,2,0,0,2
Kentucky,Carrollton,3933,45,74,207,302,122,750
Kentucky,Carlisle,2163,14,17,58,100,192,381
Kentucky,Cannonsburg,658,0,0,55,0,61,116
Kentucky,Brownsboro Village,314,7,0,1,12,1,21
Kentucky,Phelps,1068,38,8,46,82,46,220
Kentucky,Brownsboro Farm,674,9,24,50,91,36,210
Kentucky,Brooks,2505,45,0,108,148,114,415
Kentucky,Woodlawn Park,952,29,0,39,31,54,153
Kentucky,Woodlawn,252,0,4,11,23,9,47
Kentucky,Woodland Hills,774,18,12,65,53,30,178
Kentucky,Woodbury,102,0,0,4,5,8,17
Kentucky,Woodburn,304,3,0,5,3,13,24
Kentucky,Wingo,790,7,31,23,35,53,149
Kentucky,Windy Hills,2348,43,31,87,96,38,295
Kentucky,Worthington,1320,18,30,54,65,76,243
Kentucky,Winchester,18388,301,373,870,963,786,3293
Kentucky,Willisburg,360,14,3,25,11,13,66
Kentucky,Williamstown,3927,36,82,330,332,346,1126
Kentucky,Williamsburg,5250,31,0,199,121,207,558
Kentucky,Blaine,69,3,0,2,0,4,9
Kentucky,Blackey,233,3,14,17,14,49,97
Kentucky,Big Clifty,340,0,0,0,28,18,46
Kentucky,Betsy Layne,782,0,42,108,61,57,268
Kentucky,Wilmore,6057,114,53,247,250,286,950
Kentucky,Worthington Hills,1597,72,21,118,50,94,355
Kentucky,Worthville,227,8,2,7,14,31,62
Kentucky,Crab Orchard,1002,26,19,57,39,56,197
Kentucky,Bromley,790,6,5,30,46,48,135
Kentucky,Broeck Pointe,299,7,1,28,21,25,82
Kentucky,Brodhead,1324,10,0,38,50,61,159
Kentucky,Briarwood,608,14,0,44,29,10,97
Kentucky,Bremen,137,0,0,2,6,7,15
Kentucky,Brandenburg,2855,65,25,134,125,202,551
Kentucky,Bradfordsville,317,5,14,30,12,0,61
Kentucky,Bowling Green,61617,924,644,2737,3211,2358,9874
Kentucky,Boston,426,0,0,49,10,0,59
Kentucky,Booneville,82,0,0,6,3,0,9
Kentucky,Bonnieville,249,1,7,36,8,12,64
Kentucky,Blue Ridge Manor,827,11,0,35,22,43,111
Kentucky,Bloomfield,965,9,35,87,39,52,222
Kentucky,Blandville,56,0,0,0,10,8,18
Kentucky,Crescent Springs,3976,100,75,374,102,279,930
Kentucky,Crestview,378,6,8,21,23,24,82
Kentucky,Liberty,1862,11,30,73,43,95,252
Kentucky,Brooksville,536,14,1,19,12,45,91
Kentucky,Berry,280,1,3,11,15,12,42
Kentucky,Pewee Valley,1615,24,11,79,139,122,375
Kentucky,Perryville,1037,14,3,16,35,92,160
Kentucky,Meadowview Estates,340,6,0,9,2,17,34
Kentucky,Melbourne,408,8,3,11,15,10,47
Kentucky,Mentor,224,0,9,25,0,10,44
Kentucky,Middlesborough,9934,300,178,457,338,536,1809
Kentucky,Middletown,7788,108,82,419,334,420,1363
Kentucky,Midway,1733,16,6,108,96,58,284
Kentucky,Millersburg,911,21,12,48,46,39,166
Kentucky,Meadow Vale,721,21,2,44,12,27,106
Kentucky,Millstone,33,0,0,0,0,0,0
Kentucky,Mockingbird Valley,149,6,4,12,6,5,33
Kentucky,Monterey,84,0,0,4,9,0,13
Kentucky,Monticello,6141,95,70,173,201,176,715
Kentucky,Moorland,392,3,4,16,4,31,58
Kentucky,Morehead,6938,0,33,69,174,170,446
Kentucky,Morganfield,3572,36,33,103,179,164,515
Kentucky,Morgantown,2681,20,56,204,80,135,495
Kentucky,Milton,728,9,13,33,36,14,105
Kentucky,Meadowbrook Farm,99,5,2,6,13,2,28
Kentucky,Maytown,321,0,0,13,38,33,84
Kentucky,Maysville,8924,67,94,428,420,623,1632
Kentucky,Coxton,218,11,0,0,13,13,37
Kentucky,Covington,40845,686,463,2138,1881,1898,7066
Kentucky,Corydon,783,7,21,62,76,24,190
Kentucky,Corinth,231,0,0,6,3,23,32
Kentucky,Corbin,6923,142,109,411,580,332,1574
Kentucky,Concord,16,0,0,0,1,2,3
Kentucky,Combs,266,0,0,22,22,23,67
Kentucky,Columbus,156,0,0,3,2,11,16
Kentucky,Columbia,4561,0,31,52,91,248,422
Kentucky,Creekside,308,3,2,6,10,8,29
Kentucky,Cold Spring,6111,92,114,274,300,175,955
Kentucky,Coldiron,137,0,0,0,8,0,8
Kentucky,Coal Run Village,1761,50,5,99,95,60,309
Kentucky,Cloverport,1110,0,0,39,93,104,236
Kentucky,Clinton,1293,26,27,89,43,41,226
Kentucky,Cleaton,98,0,0,0,0,22,22
Kentucky,Mays Lick,157,0,0,0,5,13,18
Kentucky,Mortons Gap,1049,10,5,65,33,53,166
Kentucky,Petersburg,462,0,0,0,11,23,34
Kentucky,Mount Olivet,397,0,4,24,26,8,62
Kentucky,Mount Vernon,2814,46,73,219,146,159,643
Kentucky,Olive Hill,1863,46,20,57,152,68,343
Kentucky,Oneida,203,0,0,6,11,3,20
Kentucky,Onton,28,0,2,6,0,0,8
Kentucky,Orchard Grass Hills,1836,51,25,120,176,111,483
Kentucky,Owensboro,58350,1476,955,3111,2874,2795,11211
Kentucky,Owenton,1688,6,22,60,116,86,290
Kentucky,Owingsville,1776,11,13,142,176,107,449
Kentucky,Old Brownsboro Place,393,4,7,24,29,24,88
Kentucky,Paducah,25001,210,295,1001,1167,1123,3796
Kentucky,Paris,9831,147,96,455,636,675,2009
Kentucky,Park City,475,7,0,8,25,18,58
Kentucky,Park Hills,2990,96,25,103,109,77,410
Kentucky,Parkway Village,662,13,3,13,29,25,83
Kentucky,Pathfork,510,0,0,20,18,45,83
Kentucky,Payne Gap,347,0,4,0,15,5,24
Kentucky,Pembroke,852,27,36,48,25,40,176
Kentucky,Paintsville,4251,80,100,336,165,108,789
Kentucky,Oakland,204,3,6,13,14,15,51
Kentucky,Oak Grove,7496,141,264,749,409,376,1939
Kentucky,Oakbrook,8749,215,113,422,461,501,1712
Kentucky,Mount Washington,13736,275,228,661,793,987,2944
Kentucky,Muldraugh,1063,0,3,43,42,60,148
Kentucky,Munfordville,1723,28,17,79,77,75,276
Kentucky,Murray,18515,199,236,700,617,442,2194
Kentucky,Murray Hill,556,5,0,20,21,27,73
Kentucky,Nebo,191,6,0,3,13,4,26
Kentucky,New Castle,1071,23,23,82,55,48,231
Kentucky,New Haven,669,10,6,38,31,20,105
Kentucky,New Hope,207,0,0,0,0,47,47
Kentucky,Newport,15428,196,171,367,443,703,1880
Kentucky,Nicholasville,28843,352,507,1662,1781,1417,5719
Kentucky,Norbourne Estates,409,6,1,18,31,25,81
Kentucky,North Corbin,1735,29,46,10,95,81,261
Kentucky,Northfield,1008,27,15,52,82,58,234
Kentucky,North Middletown,921,19,10,51,69,30,179
Kentucky,Nortonville,1120,11,21,54,44,45,175
Kentucky,Norwood,340,11,6,19,18,19,73
Kentucky,Mount Sterling,7078,42,140,243,394,366,1185
Kentucky,Berea,14454,155,178,887,751,564,2535
Kentucky,Wurtland,1073,2,14,34,39,52,141
Kentucky,Benham,529,3,6,23,12,31,75
Kentucky,Hazard,5415,68,14,155,236,282,755
Kentucky,Hazel,505,5,2,26,33,33,99
Kentucky,Hazel Green,233,0,0,0,6,5,11
Kentucky,Hebron,6102,140,54,546,582,278,1600
Kentucky,Hebron Estates,1167,4,19,18,80,57,178
Kentucky,Henderson,28889,493,448,1299,1408,1499,5147
Kentucky,Hendron,4760,38,30,291,307,244,910
Kentucky,Heritage Creek,1026,5,15,30,50,37,137
Kentucky,Hickman,2385,75,9,86,94,119,383
Kentucky,Hickory,140,0,0,0,0,7,7
Kentucky,Hickory Hill,138,4,0,13,10,5,32
Kentucky,High Bridge,246,0,0,0,0,0,0
Kentucky,Highland Heights,7152,65,54,203,114,167,603
Kentucky,Hills and Dales,167,2,2,3,6,6,19
Kentucky,Hillview,7904,105,79,482,643,305,1614
Kentucky,Hindman,786,16,2,46,38,56,158
Kentucky,Hiseville,167,0,0,0,7,8,15
Kentucky,Hodgenville,3226,11,64,114,307,225,721
Kentucky,Hollow Creek,933,11,20,42,47,64,184
Kentucky,Hawesville,1033,38,19,47,59,49,212
Kentucky,Hollyvilla,424,4,4,16,29,14,67
Kentucky,Hartford,2709,28,52,140,140,130,490
Kentucky,Harlan,1607,51,14,89,69,93,316
Kentucky,Glenview,460,5,2,4,35,29,75
Kentucky,Glenview Hills,392,18,6,36,35,24,119
Kentucky,Glenview Manor,175,3,1,8,7,7,26
Kentucky,Goose Creek,301,2,3,16,16,24,61
Kentucky,Goshen,1054,18,15,78,71,101,283
Kentucky,Gracey,11,0,0,0,0,0,0
Kentucky,Grand Rivers,360,6,0,17,18,12,53
Kentucky,Gratz,64,1,0,5,7,1,14
Kentucky,Benton,4379,15,68,231,221,289,824
Kentucky,Grayson,4097,46,14,105,129,163,457
Kentucky,Greensburg,2298,39,27,114,123,56,359
Kentucky,Green Spring,659,22,12,36,41,31,142
Kentucky,Greenup,1180,10,3,66,34,82,195
Kentucky,Greenville,4416,107,48,104,227,209,695
Kentucky,Guthrie,1682,69,16,107,68,130,390
Kentucky,Hanson,826,25,10,50,21,35,141
Kentucky,Hardin,625,13,9,56,24,19,121
Kentucky,Hardinsburg,2225,19,30,91,112,125,377
Kentucky,Hardyville,391,0,0,8,35,64,107
Kentucky,Harrodsburg,8380,217,102,514,508,338,1679
Kentucky,Glencoe,471,8,9,44,38,18,117
Kentucky,Hopkinsville,32483,404,231,1644,1659,1701,5639
Kentucky,Houston Acres,475,1,14,11,29,28,83
Kentucky,McKinney,344,0,47,55,0,0,102
Kentucky,McKee,958,33,1,79,40,25,178
Kentucky,McHenry,418,1,3,49,12,15,80
Kentucky,Maceo,382,19,5,16,22,28,90
Kentucky,McDowell,824,5,0,26,20,35,86
Kentucky,McCarr,131,0,0,0,18,10,28
Kentucky,Lynnview,1055,9,32,68,52,17,178
Kentucky,Lyndon,11244,247,233,657,310,282,1729
Kentucky,Lynch,649,15,16,17,21,25,94
Kentucky,Ludlow,4547,75,30,124,316,340,885
Kentucky,Loyall,605,10,10,19,12,21,72
Kentucky,Lowes,115,0,0,0,0,0,0
Kentucky,Lovelaceville,141,0,12,34,0,0,46
Kentucky,Louisville/Jefferson County metro government (balance),608732,9361,8112,29507,31607,31500,110087
Kentucky,Louisa,2961,13,48,178,146,94,479
Kentucky,Loretto,734,3,10,48,43,40,144
Kentucky,London,8090,93,52,492,349,226,1212
Kentucky,Livingston,121,5,0,2,1,7,15
Kentucky,Livermore,1435,21,26,80,67,121,315
Kentucky,Mackville,246,3,0,22,12,5,42
Kentucky,Horse Cave,2238,50,23,144,74,163,454
Kentucky,McRoberts,847,0,0,14,28,55,97
Kentucky,Magnolia,392,0,0,29,6,41,76
Kentucky,Hunters Hollow,367,6,0,23,18,31,78
Kentucky,Hurstbourne,4302,143,25,100,288,171,727
Kentucky,Hurstbourne Acres,1799,43,18,72,7,36,176
Kentucky,Hustonville,602,5,11,41,72,45,174
Kentucky,Hyden,429,0,0,0,4,11,15
Kentucky,Independence,26062,594,486,1641,1459,1506,5686
Kentucky,Indian Hills,2930,111,21,150,168,191,641
Kentucky,Inez,657,2,6,22,17,29,76
Kentucky,Mayking,231,0,0,0,0,24,24
Kentucky,Mayfield,10101,165,213,746,500,508,2132
Kentucky,Massac,3938,104,39,211,224,323,901
Kentucky,Masonville,1075,11,9,48,84,83,235
Kentucky,Maryhill Estates,164,4,3,12,11,17,47
Kentucky,Martin,713,12,9,36,36,36,129
Kentucky,Marrowbone,52,0,0,0,9,0,9
Kentucky,Marion,3004,37,40,163,125,141,506
Kentucky,Manor Creek,304,10,15,25,25,3,78
Kentucky,Manitou,114,0,0,0,0,0,0
Kentucky,Manchester,1489,13,3,62,33,73,184
Kentucky,Madisonville,19687,309,387,1206,879,935,3716
Kentucky,Glasgow,14224,190,221,637,650,709,2407
Kentucky,Graymoor-Devondale,2922,84,57,65,79,103,388
Kentucky,Ghent,399,7,4,8,30,37,86
Kentucky,Augusta,1102,8,5,64,65,71,213
Kentucky,Gilbertsville,187,0,0,0,28,0,28
Kentucky,Auxier,472,0,7,0,13,37,57
Kentucky,Bancroft,451,7,2,15,26,36,86
Kentucky,Bandana,147,0,0,0,0,0,0
Kentucky,Barbourmeade,1372,45,42,54,85,95,321
Kentucky,Barbourville,3172,48,61,180,155,119,563
Kentucky,Bardstown,12930,356,173,727,879,810,2945
Kentucky,Bardwell,760,17,21,56,34,23,151
Kentucky,Barlow,675,9,7,37,45,24,122
Kentucky,Audubon Park,1445,37,6,52,43,54,192
Kentucky,Beattyville,1501,4,46,109,43,107,309
Kentucky,Bedford,747,13,18,66,54,25,176
Kentucky,Beech Grove,477,0,36,59,29,0,124
Kentucky,Beechmont,897,0,0,62,5,62,129
Kentucky,Beechwood Village,1302,21,25,42,56,58,202
Kentucky,Belfry,219,0,0,0,20,27,47
Kentucky,Bellefonte,883,26,9,13,22,31,101
Kentucky,Bellemeade,807,20,12,47,35,39,153
Kentucky,Belleview,530,8,0,34,15,0,57
Kentucky,Bellevue,5921,128,40,317,224,239,948
Kentucky,Bellewood,335,18,7,21,16,8,70
Kentucky,Beaver Dam,3557,0,80,265,268,246,859
Kentucky,Auburn,1491,2,17,33,98,67,217
Kentucky,Crayne,144,4,0,0,9,0,13
Kentucky,Artemus,583,14,0,29,0,30,73
Kentucky,Arlington,380,3,10,22,28,9,72
Kentucky,Anthoston,140,0,0,0,0,0,0
Kentucky,Annville,694,0,0,68,27,15,110
Kentucky,Anchorage,2172,46,64,158,199,181,648
Kentucky,Allensville,137,0,5,17,10,12,44
Kentucky,Allen,211,1,1,11,10,22,45
Kentucky,Alexandria,8735,176,112,500,520,524,1832
Kentucky,Albany,1874,67,18,68,47,56,256
Kentucky,Ages,289,32,0,0,6,6,44
Kentucky,Adairville,1048,12,19,93,78,42,244
Kentucky,Arjay,557,0,26,94,24,17,161
Kentucky,Franklin,8643,85,162,560,523,550,1880
Kentucky,Germantown,149,0,0,6,8,6,20
Kentucky,Breckinridge Center,2479,49,34,58,144,419,704
Kentucky,Georgetown,30968,642,703,1956,1749,1485,6535
Kentucky,Garrison,549,0,8,21,67,40,136
Kentucky,Gamaliel,406,4,8,28,30,24,94
Kentucky,Ashland,21391,343,350,1003,900,1042,3638
Kentucky,Fulton,2592,42,28,165,198,141,574
Kentucky,Frenchburg,517,17,3,30,36,10,96
Kentucky,Freeburn,380,0,21,53,50,17,141
Kentucky,Fredonia,494,9,2,22,11,21,65
Louisiana,Maurice village,1498,11,13,39,54,81,198
Louisiana,Melville,1383,0,66,137,124,94,421
Louisiana,Meraux,6397,127,78,287,304,550,1346
Louisiana,Mermentau village,696,30,12,63,65,43,213
Louisiana,Morse village,890,8,11,60,78,33,190
Louisiana,Mer Rouge village,602,19,20,23,32,34,128
Louisiana,Merrydale,9008,191,87,660,601,557,2096
Louisiana,Merryville,1069,0,12,53,69,70,204
Louisiana,Metairie,142715,2996,1519,5934,5891,5748,22088
Louisiana,Milton,2854,125,37,171,121,193,647
Louisiana,Morganza village,932,42,21,88,41,57,249
Louisiana,Minden,12887,158,111,884,616,855,2624
Louisiana,Minorca,1942,20,27,109,151,53,360
Louisiana,Montegut,1560,37,9,62,119,85,312
Louisiana,Monterey,693,0,30,55,43,76,204
Louisiana,Montgomery,631,5,14,32,29,10,90
Louisiana,Monticello,5260,61,85,310,319,465,1240
Louisiana,Montpelier village,299,14,2,22,30,19,87
Louisiana,Mathews,2387,100,25,149,120,47,441
Louisiana,Midway,1458,109,0,91,100,60,360
Louisiana,Monroe,49529,1071,677,2731,3383,2685,10547
Louisiana,Marrero,31738,635,365,1940,1683,1966,6589
Louisiana,Moss Bluff,12595,303,179,865,779,968,3094
Louisiana,Mansfield,4995,39,180,366,228,280,1093
Louisiana,Mangham,711,24,4,75,45,48,196
Louisiana,Mandeville,12187,203,116,500,834,812,2465
Louisiana,Mamou,3209,69,75,181,193,138,656
Louisiana,Madisonville,756,17,2,52,24,46,141
Louisiana,McNary village,181,0,0,8,4,10,22
Louisiana,Lydia,611,0,37,37,24,0,98
Louisiana,Lutcher,3415,23,26,79,121,225,474
Louisiana,Mansura,1702,19,31,107,167,50,374
Louisiana,Montz,2033,52,26,151,132,61,422
Louisiana,Lucky village,281,3,0,6,9,23,41
Louisiana,Loreauville village,722,7,7,51,14,49,128
Louisiana,Longville,663,25,0,89,70,0,184
Louisiana,Longstreet village,99,0,0,4,4,0,8
Louisiana,Logansport,1937,28,21,155,134,152,490
Louisiana,Lockport Heights,1386,19,27,43,126,72,287
Louisiana,Lockport,2556,33,47,98,112,192,482
Louisiana,Livonia,1619,13,10,66,133,121,343
Louisiana,Luling,12825,268,297,801,690,731,2787
Louisiana,Martin village,595,6,4,26,12,54,102
Louisiana,Many,2810,63,42,282,108,245,740
Louisiana,Marion,823,11,2,26,38,35,112
Louisiana,Mound village,14,3,0,0,3,0,6
Louisiana,Mount Lebanon,45,0,0,0,1,2,3
Louisiana,Napoleonville village,653,11,2,33,59,23,128
Louisiana,Natalbany,2587,87,0,113,29,62,291
Louisiana,Natchez village,486,0,11,33,27,19,90
Louisiana,Natchitoches,18460,305,254,1118,927,1113,3717
Louisiana,Newellton,1331,67,33,58,68,94,320
Louisiana,New Iberia,30782,705,726,1949,1871,1525,6776
Louisiana,Maringouin,871,19,4,0,23,38,84
Louisiana,New Llano,2443,65,27,162,166,121,541
Louisiana,New Roads,4754,11,56,178,300,264,809
Louisiana,Noble village,280,4,9,6,16,9,44
Louisiana,Norco,2994,46,13,123,192,142,516
Louisiana,North Hodge village,507,3,18,33,50,28,132
Louisiana,North Vacherie,2462,46,30,181,77,97,431
Louisiana,Mooringsport,740,8,18,47,37,28,138
Louisiana,Moonshine,130,29,0,0,13,11,53
Louisiana,Marksville,5594,43,73,387,286,228,1017
Louisiana,New Orleans,376738,7035,4093,17769,16364,16192,61453
Louisiana,New Sarpy,1453,22,0,95,66,84,267
Louisiana,Varnado village,355,7,13,11,21,26,78
Louisiana,Waggaman,9334,513,146,250,465,544,1918
Louisiana,Spokane,266,0,10,0,10,0,20
Louisiana,Spearsville village,122,0,1,8,7,2,18
Louisiana,South Vacherie,3577,37,51,119,137,163,507
Louisiana,South Mansfield village,371,11,9,25,12,20,77
Louisiana,Sorrento,1457,43,21,85,83,123,355
Louisiana,Sorrel,620,0,32,11,23,17,83
Louisiana,Slidell,27567,665,258,1796,1421,1529,5669
Louisiana,Slaughter,1297,43,32,98,59,45,277
Louisiana,Siracusaville,463,20,17,37,19,10,103
Louisiana,Singer,632,0,0,48,23,83,154
Louisiana,Simsboro village,1239,21,13,39,93,134,300
Louisiana,Simpson village,706,17,4,58,32,59,170
Louisiana,Simmesport,2003,63,70,142,118,80,473
Louisiana,Sikes village,146,0,0,4,8,13,25
Louisiana,Sicily Island village,470,0,16,32,35,66,149
Louisiana,Sibley,1358,21,50,54,70,82,277
Louisiana,Shreveport,200015,3756,2601,11016,10542,10384,38299
Louisiana,St. Francisville,1960,56,23,144,167,103,493
Louisiana,Moreauville village,927,22,8,45,46,80,201
Louisiana,St. Gabriel,6872,51,92,208,136,553,1040
Louisiana,St. James,877,43,3,80,58,26,210
Louisiana,St. Joseph,978,7,23,56,50,88,224
Louisiana,St. Martinville,6105,75,183,416,313,489,1476
Louisiana,Springfield,418,2,7,14,9,5,37
Louisiana,St. Maurice,439,8,9,24,35,21,97
Louisiana,Saline village,348,10,3,30,21,26,90
Louisiana,Sarepta,944,44,22,51,49,61,227
Louisiana,Schriever,7142,0,149,451,228,342,1170
Louisiana,Scott,8865,163,46,200,587,510,1506
Louisiana,Shenandoah,18874,470,240,1101,990,1244,4045
Louisiana,Shongaloo village,175,2,8,25,14,0,49
Louisiana,St. Rose,8868,308,226,756,631,329,2250
Louisiana,Gretna,17827,396,134,1011,815,832,3188
Louisiana,Springhill,5194,46,75,350,205,121,797
Louisiana,Starks,601,0,0,14,63,33,110
Louisiana,Vivian,3664,0,72,177,159,137,545
Louisiana,Violet,6119,66,89,320,450,363,1288
Louisiana,Vinton,3379,29,11,116,127,185,468
Louisiana,Ville Platte,7327,103,80,482,453,332,1450
Louisiana,Village St. George,7294,76,63,491,400,411,1441
Louisiana,Vienna Bend,1335,0,0,46,182,30,258
Louisiana,Vienna,480,10,3,54,21,13,101
Louisiana,Vidalia,4195,138,59,298,158,172,825
Louisiana,Ventress,1121,0,8,23,45,67,143
Louisiana,Venice,257,0,9,31,0,16,56
Louisiana,Urania,1130,7,8,43,25,44,127
Louisiana,Union,1051,57,9,150,70,67,353
Louisiana,Turkey Creek village,357,11,3,25,19,18,76
Louisiana,Tullos,435,3,0,18,49,42,112
Louisiana,Triumph,215,8,0,0,33,0,41
Louisiana,Timberlane,10996,145,223,615,810,611,2404
Louisiana,Tickfaw village,646,12,27,56,65,19,179
Louisiana,Start,1041,0,51,89,52,115,307
Louisiana,Sterlington,1873,5,29,98,150,156,438
Louisiana,Stonewall,2236,37,37,218,95,130,517
Louisiana,Sugartown,0,0,0,0,0,0,0
Louisiana,Sulphur,20199,360,255,1309,1125,1412,4461
Louisiana,Sun village,323,7,2,18,19,15,61
Louisiana,Stanley village,182,2,0,10,1,0,13
Louisiana,Sunset,2919,42,58,134,146,136,516
Louisiana,Swartz,4936,111,37,204,180,217,749
Louisiana,Taft,78,0,0,0,0,0,0
Louisiana,Tallulah,7187,167,55,466,379,308,1375
Louisiana,Tangipahoa village,607,21,0,28,12,32,93
Louisiana,Terrytown,24910,470,637,1719,1276,994,5096
Louisiana,Thibodaux,14579,203,82,625,624,514,2048
Louisiana,Supreme,1036,0,44,97,91,29,261
Louisiana,Morgan City,12019,291,293,546,659,532,2321
Louisiana,Greenwood,3223,51,94,260,229,33,667
Louisiana,Iota,1707,32,60,56,125,105,378
Louisiana,Amite City,4283,32,45,211,252,245,785
Louisiana,Amelia,2408,0,41,132,129,12,314
Louisiana,Ama,1241,38,7,60,45,96,246
Louisiana,Alexandria,47985,936,689,2878,3088,2748,10339
Louisiana,Albany village,1481,18,19,83,76,100,296
Louisiana,Addis,4194,124,68,371,237,176,976
Louisiana,Abita Springs,2529,25,23,109,147,148,452
Louisiana,Abbeville,12381,446,181,921,522,601,2671
Louisiana,Hackberry,1211,7,0,89,49,56,201
Louisiana,Ruston,22185,398,240,906,974,1101,3619
Louisiana,Rosepine,1979,33,37,106,64,128,368
Louisiana,Roseland,1027,40,18,54,76,62,250
Louisiana,Rosedale village,982,22,5,29,45,54,155
Louisiana,Romeville,257,0,0,0,0,12,12
Louisiana,Rodessa village,241,0,0,21,15,9,45
Louisiana,Rock Hill,216,0,0,0,0,0,0
Louisiana,Robeline village,100,0,1,3,4,1,9
Louisiana,Anacoco village,1046,10,6,63,49,46,174
Louisiana,Roanoke,441,0,0,0,23,13,36
Louisiana,Angie village,252,6,0,14,9,23,52
Louisiana,Arcadia,2897,10,68,78,182,114,452
Louisiana,Bayou Cane,21067,363,450,1003,1092,1062,3970
Louisiana,Bayou Blue,12574,310,288,1436,560,473,3067
Louisiana,Bawcomville,3404,67,17,132,287,99,602
Louisiana,Baton Rouge,229186,4320,2609,11346,10522,10039,38836
Louisiana,Bastrop,10949,189,108,677,502,678,2154
Louisiana,Baskin village,310,5,8,27,28,19,87
Louisiana,Basile,1852,20,32,88,86,61,287
Louisiana,Barataria,859,0,20,9,8,9,46
Louisiana,Banks Springs,1568,0,0,236,183,116,535
Louisiana,Ball,4000,59,30,256,227,208,780
Louisiana,Baldwin,2236,19,22,131,107,134,413
Louisiana,Baker,13800,262,177,838,746,565,2588
Louisiana,Avondale,5117,98,192,393,216,188,1087
Louisiana,Atlanta village,99,3,0,2,8,5,18
Louisiana,Athens village,298,0,7,17,16,14,54
Louisiana,Ashland village,245,8,1,12,29,5,55
Louisiana,Arnaudville,1267,15,27,48,58,89,237
Louisiana,Arabi,4544,110,88,243,256,164,861
Louisiana,River Ridge,13636,247,104,612,653,604,2220
Louisiana,Ringgold,1536,38,13,90,162,69,372
Louisiana,Ridgecrest,616,2,13,41,24,12,92
Louisiana,Cut Off,5857,115,95,334,492,156,1192
Louisiana,Cullen,873,0,7,31,89,55,182
Louisiana,Crowley,13193,272,203,747,652,710,2584
Louisiana,Raceland,10556,241,159,520,519,400,1839
Louisiana,Quitman village,156,6,1,5,14,7,33
Louisiana,Provencal village,632,7,9,42,37,49,144
Louisiana,Prospect,525,0,11,46,56,20,133
Louisiana,Prien,8114,189,94,385,430,537,1635
Louisiana,Presquille,1730,32,0,86,124,140,382
Louisiana,Prairieville,29721,437,333,1964,2542,2168,7444
Louisiana,Poydras,2271,68,28,97,109,188,490
Louisiana,Powhatan village,126,3,3,0,6,9,21
Louisiana,Port Vincent village,871,4,7,30,50,37,128
Louisiana,Port Sulphur,2053,70,70,260,126,146,672
Louisiana,Port Barre,1848,49,73,187,120,28,457
Louisiana,Port Allen,5137,75,63,193,77,176,584
Louisiana,Ponchatoula,6845,287,194,407,397,440,1725
Louisiana,Delcambre,2232,48,29,129,126,73,405
Louisiana,Delhi,2954,100,33,206,135,51,525
Louisiana,Delta village,191,0,1,12,10,2,25
Louisiana,Denham Springs,10126,166,99,577,694,530,2066
Louisiana,Richwood,5993,27,6,86,108,87,314
Louisiana,Richmond village,544,8,5,15,29,40,97
Louisiana,Reserve,9615,148,65,452,525,753,1943
Louisiana,Reeves village,266,7,0,30,22,34,93
Louisiana,Reddell,628,0,0,23,27,64,114
Louisiana,Red Chute,6206,125,39,277,326,463,1230
Louisiana,Rayville,3724,73,57,245,263,215,853
Louisiana,Rayne,7988,204,254,438,412,316,1624
Louisiana,Bayou Corne,132,8,0,0,7,11,26
Louisiana,Doyline village,894,17,8,24,44,77,170
Louisiana,Donaldsonville,7577,187,7,510,428,476,1608
Louisiana,Dodson village,403,0,11,44,48,20,123
Louisiana,Dixie Inn village,240,7,2,18,6,6,39
Louisiana,Deville,1577,50,0,148,83,87,368
Louisiana,Destrehan,10994,126,119,447,722,957,2371
Louisiana,Des Allemands,2054,0,18,44,33,65,160
Louisiana,DeRidder,10861,115,252,726,679,649,2421
Louisiana,DeQuincy,3179,16,96,157,51,206,526
Louisiana,Downsville village,131,0,0,5,4,4,13
Louisiana,Pollock,425,9,10,13,25,17,74
Louisiana,Bayou Country Club,1375,10,0,91,92,55,248
Louisiana,Bayou Goula,553,0,0,0,43,46,89
Louisiana,Kinder,2870,153,136,306,132,198,925
Louisiana,Killona,747,0,37,0,80,120,237
Louisiana,Killian,1030,20,16,71,74,27,208
Louisiana,Kilbourne village,427,6,5,14,30,18,73
Louisiana,Kentwood,2213,66,12,133,164,160,535
Louisiana,Kenner,66993,1085,893,3238,2986,3049,11251
Louisiana,Keachi,403,3,2,25,31,31,92
Louisiana,Kaplan,4599,56,23,143,178,382,782
Louisiana,Junction City village,409,8,6,14,7,40,75
Louisiana,Joyce,212,0,0,0,0,0,0
Louisiana,Jordan Hill,115,0,0,14,6,0,20
Louisiana,Jonesville,2342,66,47,163,143,111,530
Louisiana,Jonesboro,4653,76,95,235,245,180,831
Louisiana,Jennings,10226,292,119,475,575,684,2145
Louisiana,Jena,3401,19,0,112,175,94,400
Louisiana,Jefferson,11061,170,140,195,478,326,1309
Louisiana,Jean Lafitte,2055,18,6,138,169,136,467
Louisiana,Kraemer,954,6,34,40,57,24,161
Louisiana,Jeanerette,5549,85,163,289,221,363,1121
Louisiana,Krotz Springs,1028,0,34,61,35,34,164
Louisiana,Lacassine,431,0,0,0,33,68,101
Louisiana,Lillie village,165,0,14,1,0,15,30
Louisiana,Leonville,845,4,23,25,57,19,128
Louisiana,Lemannville,795,0,0,0,24,31,55
Louisiana,Leesville,6608,79,95,288,348,305,1115
Louisiana,Lecompte,972,3,5,71,38,93,210
Louisiana,Lawtell,1744,0,65,161,41,23,290
Louisiana,Larose,7217,186,112,414,307,445,1464
Louisiana,Laplace,28640,707,213,1994,1706,1922,6542
Louisiana,Lakeview,1072,28,0,55,31,17,131
Louisiana,Lakeshore,1717,15,22,127,89,44,297
Louisiana,Lake Providence,3830,0,44,451,235,255,985
Louisiana,Lake Charles,74190,1301,982,3804,4047,3504,13638
Louisiana,Lake Arthur,2732,75,61,224,141,29,530
Louisiana,Lafourche Crossing,2035,24,9,91,120,177,421
Louisiana,Lafitte,878,0,0,27,77,134,238
Louisiana,Lafayette,124982,2420,1729,6158,6051,5823,22181
Louisiana,Lacombe,8038,105,54,471,336,443,1409
Louisiana,Labadieville,2149,19,7,143,117,191,477
Louisiana,Jamestown village,218,0,1,3,15,20,39
Louisiana,Jackson,3794,26,9,72,126,264,497
Louisiana,Iowa,3110,75,73,133,155,149,585
Louisiana,Bourg,2444,75,22,300,245,11,653
Louisiana,Bossier City,66093,1223,1212,3619,3632,2897,12583
Louisiana,Bordelonville,711,0,19,81,65,36,201
Louisiana,Boothville,883,6,0,89,60,31,186
Louisiana,Bonita village,178,0,0,1,0,11,12
Louisiana,Bogalusa,12006,206,101,951,647,729,2634
Louisiana,Blanchard,2920,34,33,153,150,182,552
Louisiana,Bienville village,219,1,13,4,12,7,37
Louisiana,Berwick,4830,121,52,273,270,316,1032
Louisiana,Bernice,1270,15,30,87,69,56,257
Louisiana,Benton,1864,25,25,111,112,202,475
Louisiana,Belmont,489,0,0,15,34,30,79
Louisiana,Belle Rose,1722,6,14,36,155,109,320
Louisiana,Belle Chasse,13610,269,53,492,1131,777,2722
Louisiana,Belcher village,288,1,11,8,12,14,46
Louisiana,Bayou Vista,5103,61,40,402,361,388,1252
Louisiana,Bayou L'Ourse,1563,58,67,117,102,76,420
Louisiana,Boutte,2450,70,35,136,87,121,449
Louisiana,Hahnville,3540,66,59,100,234,184,643
Louisiana,Hall Summit village,377,0,3,37,39,31,110
Louisiana,Hammond,20272,368,238,832,780,647,2865
Louisiana,Inniswold,6583,102,23,289,505,301,1220
Louisiana,Independence,1613,23,52,109,83,72,339
Louisiana,Ida village,181,0,1,6,5,2,14
Louisiana,Houma,33982,669,566,1994,1855,1859,6943
Louisiana,Hosston village,310,0,12,14,18,7,51
Louisiana,Hornbeck,424,22,1,25,16,11,75
Louisiana,Homer,3092,32,40,131,196,228,627
Louisiana,Hodge village,352,0,5,9,17,20,51
Louisiana,Bayou Gauche,2154,29,53,117,270,86,555
Louisiana,Hester,308,0,20,9,18,10,57
Louisiana,Henderson,1877,22,20,85,98,54,279
Louisiana,Heflin village,220,5,10,19,6,18,58
Louisiana,Haynesville,2506,69,59,94,126,158,506
Louisiana,Hayes,886,43,45,49,49,89,275
Louisiana,Haughton,3439,0,21,193,236,294,744
Louisiana,Harvey,21085,549,214,1046,1091,1156,4056
Louisiana,Harrisonburg village,380,0,6,31,29,10,76
Louisiana,Harahan,9328,164,141,662,311,301,1579
Louisiana,Hessmer village,838,0,7,60,52,42,161
Louisiana,Lisbon village,194,0,0,3,8,21,32
Louisiana,Point Place,365,0,0,10,8,0,18
Louisiana,Pleasure Bend,376,5,0,12,54,7,78
Louisiana,Duson,1950,30,45,161,135,71,442
Louisiana,East Hodge village,322,6,11,38,9,6,70
Louisiana,Eastwood,4986,283,122,177,426,403,1411
Louisiana,Eden Isle,7183,108,78,456,392,196,1230
Louisiana,Edgard,2531,54,24,118,96,107,399
Louisiana,Edgefield village,191,0,0,23,14,29,66
Louisiana,Egan,559,11,0,12,5,23,51
Louisiana,Elizabeth,555,14,9,50,48,41,162
Louisiana,Elmwood,4552,112,14,165,190,89,570
Louisiana,Elton,1278,52,8,78,66,65,269
Louisiana,Empire,999,17,22,49,18,84,190
Louisiana,Epps village,1221,6,16,22,30,20,94
Louisiana,Erath,2144,16,20,100,103,142,381
Louisiana,Eros,173,0,0,21,8,14,43
Louisiana,Erwinville,2010,14,26,36,176,90,342
Louisiana,Estelle,15355,259,250,934,947,627,3017
Louisiana,Estherwood village,1025,17,11,106,79,71,284
Louisiana,Dulac,1088,0,13,13,11,0,37
Louisiana,Eunice,10252,120,150,643,510,486,1909
Louisiana,Dubberly village,209,0,2,1,12,9,24
Louisiana,Dry Prong village,520,0,9,37,45,29,120
Louisiana,Cameron,392,0,0,26,37,22,85
Louisiana,Calvin village,230,1,0,8,23,31,63
Louisiana,Calhoun,621,40,0,27,53,20,140
Louisiana,Cade,1428,36,20,53,78,34,221
Louisiana,Buras,1001,0,5,41,41,95,182
Louisiana,Bunkie,4099,95,0,259,281,161,796
Louisiana,Bryceland village,89,4,6,6,8,0,24
Louisiana,Brusly,2653,81,39,179,103,142,544
Louisiana,Brownsville,4193,101,100,348,214,91,854
Louisiana,Brownfields,5456,100,60,481,557,319,1517
Louisiana,Broussard,9637,204,91,491,583,302,1671
Louisiana,Bridge City,7027,177,75,517,477,563,1809
Louisiana,Breaux Bridge,8286,225,104,813,663,426,2231
Louisiana,Branch,255,0,0,0,18,0,18
Louisiana,Boyce,1441,10,34,90,88,59,281
Louisiana,Gueydan,1559,9,17,52,116,79,273
Louisiana,Grosse Tete village,738,33,19,23,51,11,137
Louisiana,Dubach,929,7,0,64,128,52,251
Louisiana,Campti,862,0,4,79,72,27,182
Louisiana,Evergreen,262,0,0,9,5,8,22
Louisiana,Fenton village,434,0,8,25,14,23,70
Louisiana,Gilliam village,119,0,0,6,7,5,18
Louisiana,Gillis,495,0,0,0,0,79,79
Louisiana,Glencoe,313,0,0,18,18,21,57
Louisiana,Glenmora,1272,65,11,108,83,67,334
Louisiana,Gloster,101,0,0,0,0,0,0
Louisiana,Golden Meadow,1783,7,18,133,89,65,312
Louisiana,Goldonna village,373,5,6,23,19,13,66
Louisiana,Gonzales,10319,198,72,375,526,587,1758
Louisiana,Grambling,5067,52,62,209,260,186,769
Louisiana,Gramercy,3493,45,66,111,306,263,791
Louisiana,Grand Cane village,273,0,3,5,10,19,37
Louisiana,Grand Coteau,889,10,16,58,35,51,170
Louisiana,Grand Isle,1002,38,0,80,45,34,197
Louisiana,Grand Point,2383,8,71,177,118,169,543
Louisiana,Gray,5515,107,66,425,346,291,1235
Louisiana,Grayson village,382,9,0,28,0,21,58
Louisiana,Greensburg,713,21,15,33,18,27,114
Louisiana,Gilbert village,427,13,12,40,45,9,119
Louisiana,Farmerville,3877,62,70,224,189,69,614
Louisiana,Gibsland,938,32,10,27,40,63,172
Louisiana,Garyville,2314,119,50,189,79,54,491
Louisiana,Ferriday,3438,297,39,303,191,155,985
Louisiana,Fifth Ward,735,0,0,11,23,18,52
Louisiana,Fisher village,248,6,5,7,4,22,44
Louisiana,Florien village,420,10,5,23,31,8,77
Louisiana,Folsom village,697,20,13,43,37,36,149
Louisiana,Fordoche,917,9,8,37,15,32,101
Louisiana,Forest village,301,1,4,27,11,26,69
Louisiana,Forest Hill village,713,7,9,75,65,44,200
Louisiana,Fort Jesup,291,0,8,0,29,0,37
Louisiana,Fort Polk North,2391,17,26,91,77,5,216
Louisiana,Fort Polk South,9684,365,213,809,529,315,2231
Louisiana,Franklin,7435,134,114,406,441,449,1544
Louisiana,Franklinton,3793,55,135,161,210,103,664
Louisiana,French Settlement village,1349,5,27,77,85,106,300
Louisiana,Frierson,530,26,0,52,73,0,151
Louisiana,Galliano,7510,222,38,716,336,381,1693
Louisiana,Gardere,10908,302,31,621,696,517,2167
Louisiana,Georgetown village,389,6,3,13,47,45,114
Louisiana,Pointe a la Hache,188,0,0,0,0,0,0
Louisiana,Cankton village,641,17,13,42,34,32,138
Louisiana,Carlyss,4896,8,138,542,323,368,1379
Louisiana,Oil City,958,0,15,47,69,46,177
Louisiana,Oberlin,1969,56,12,90,180,171,509
Louisiana,Oak Ridge village,118,0,0,17,6,0,23
Louisiana,Oak Hills Place,8487,180,47,322,552,488,1589
Louisiana,Oak Grove,1497,35,11,74,122,33,275
Louisiana,Oakdale,7722,99,104,221,246,181,851
Louisiana,Norwood village,285,1,9,8,6,9,33
Louisiana,Crescent,409,0,0,34,0,10,44
Louisiana,Walker,6205,83,106,178,401,307,1075
Louisiana,Wallace,662,21,0,31,74,42,168
Louisiana,Wallace Ridge,286,4,7,17,17,14,59
Louisiana,Washington,725,0,10,39,69,19,137
Louisiana,Waterproof,854,18,0,94,50,45,207
Louisiana,Watson,905,0,33,34,58,0,125
Louisiana,Welcome,971,15,9,86,132,34,276
Louisiana,Welsh,3223,85,53,197,308,118,761
Louisiana,Westlake,4606,130,66,221,271,208,896
Louisiana,Old Jefferson,6999,134,59,393,310,365,1261
Louisiana,Westminster,2996,96,33,142,120,62,453
Louisiana,Olla,1165,15,19,72,66,65,237
Louisiana,Oretta,542,0,0,41,48,6,95
Louisiana,Pleasant Hill village,704,0,6,34,25,36,101
Louisiana,Plaucheville village,178,0,4,13,5,0,22
Louisiana,Plaquemine,6993,134,164,523,413,201,1435
Louisiana,Plain Dealing,1009,35,4,35,100,63,237
Louisiana,Pitkin,493,0,0,49,28,22,99
Louisiana,Pioneer village,163,3,9,0,6,17,35
Louisiana,Pineville,14455,276,255,772,740,661,2704
Louisiana,Pine Prairie village,1319,11,2,65,46,67,191
Louisiana,Pierre Part,2555,33,50,153,77,56,369
Louisiana,Pearl River,2466,5,26,158,203,217,609
Louisiana,Paulina,1149,27,25,98,60,51,261
Louisiana,Patterson,6106,40,142,269,312,414,1177
Louisiana,Parks village,668,12,2,16,20,33,83
Louisiana,Paradis,1304,0,10,76,136,99,321
Louisiana,Palmetto village,152,1,0,8,3,0,12
Louisiana,Paincourtville,1017,21,28,3,101,138,291
Louisiana,Ossun,2528,125,25,332,184,76,742
Louisiana,Opelousas,16638,309,331,1340,1112,759,3851
Louisiana,Carencro,8269,185,163,426,335,457,1566
Louisiana,West Monroe,13032,291,234,658,568,644,2395
Louisiana,White Castle,2241,102,45,126,109,145,527
Louisiana,Clarence village,358,0,8,8,55,38,109
Louisiana,Claiborne,11760,222,61,614,568,492,1957
Louisiana,Church Point,4525,66,80,403,199,144,892
Louisiana,Choudrant village,1200,10,15,54,57,89,225
Louisiana,Choctaw,842,7,21,59,28,56,171
Louisiana,Cheneyville,492,16,5,28,14,12,75
Louisiana,Chauvin,2945,27,15,270,157,166,635
Louisiana,Chatham,671,10,3,43,7,26,89
Louisiana,Chataignier village,363,0,12,18,41,42,113
Louisiana,Charenton,1731,7,33,62,82,105,289
Louisiana,Chalmette,21311,519,375,1489,1180,943,4506
Louisiana,Chackbay,5162,114,67,382,501,219,1283
Louisiana,Central,27768,484,257,1284,1322,1711,5058
Louisiana,Center Point,332,0,0,14,35,0,49
Louisiana,Cecilia,1183,34,43,80,79,30,266
Louisiana,Catahoula,923,23,39,153,72,13,300
Louisiana,Castor village,299,0,5,71,22,13,111
Louisiana,Clarks village,995,7,18,74,58,56,213
Louisiana,Westwego,8564,220,144,373,463,257,1457
Louisiana,Clayton,571,13,3,29,48,38,131
Louisiana,Colfax,1706,26,18,80,100,82,306
Louisiana,Wilson village,548,7,10,31,11,14,73
Louisiana,Winnfield,4666,117,48,351,260,212,988
Louisiana,Winnsboro,4811,81,203,545,276,246,1351
Louisiana,Wisner,923,29,14,67,43,41,194
Louisiana,Woodmere,12161,142,219,704,807,1140,3012
Louisiana,Woodworth,1121,41,8,34,55,47,185
Louisiana,Youngsville,10109,234,204,881,700,493,2512
Louisiana,Zachary,15868,376,198,909,1383,1460,4326
Louisiana,Clinton,1401,34,23,71,82,68,278
Louisiana,Zwolle,2134,26,34,156,164,109,489
Louisiana,Covington,9350,110,163,335,371,329,1308
Louisiana,Coushatta,2539,62,68,132,161,173,596
Louisiana,Cotton Valley,1055,30,12,31,55,65,193
Louisiana,Cottonport,1997,47,41,191,197,129,605
Louisiana,Converse village,412,4,8,17,22,14,65
Louisiana,Convent,628,5,7,22,0,30,64
Louisiana,Columbia,432,3,4,24,18,18,67
Louisiana,Collinston village,216,6,0,4,2,4,16
Louisiana,Creola village,278,0,2,15,51,23,91
Louisiana,Livingston,2035,38,15,127,73,195,448
Maine,Ashland,606,12,3,40,24,23,102
Maine,Auburn,22916,379,219,952,1431,1328,4309
Maine,Blaine,438,0,0,26,32,38,96
Maine,Mechanic Falls,1649,19,22,174,81,18,314
Maine,Mexico,1574,54,0,54,24,48,180
Maine,Milford,2239,30,0,24,196,141,391
Maine,Millinocket,4419,14,49,100,201,233,597
Maine,Milo,1923,20,26,119,100,163,428
Maine,Naples,462,12,0,9,9,5,35
Maine,Newcastle,697,10,25,32,3,40,110
Maine,Newport,1616,6,27,61,142,103,339
Maine,Norridgewock,1198,0,0,64,32,43,139
Maine,North Berwick,1792,28,74,98,78,109,387
Maine,North Windham,4671,58,82,208,216,305,869
Maine,Mars Hill,956,7,0,33,34,45,119
Maine,Norway,2341,45,55,119,108,150,477
Maine,Old Orchard Beach,8697,161,0,292,321,80,854
Maine,Old Town,7726,168,29,303,205,126,831
Maine,Orono,9522,82,37,118,115,211,563
Maine,Oxford,1538,0,19,80,49,114,262
Maine,Pittsfield,3110,0,143,214,133,267,757
Maine,Portland,66490,853,595,2559,2372,2671,9050
Maine,Presque Isle,9378,93,110,311,375,539,1428
Maine,Randolph,1792,11,37,39,56,150,293
Maine,Richmond,1942,0,9,176,149,165,499
Maine,Rockland,7233,78,15,24,358,263,738
Maine,Rumford,4214,59,22,132,234,191,638
Maine,Oakland,2448,25,21,17,71,230,364
Maine,Mapleton,763,18,4,33,12,37,104
Maine,Madison,2372,53,48,92,28,35,256
Maine,Madawaska,2623,27,11,132,79,82,331
Maine,Anson,791,0,51,16,29,79,175
Maine,Fryeburg,1797,11,5,114,60,103,293
Maine,Gardiner,5697,50,44,316,216,286,912
Maine,Gorham,6445,58,26,264,290,306,944
Maine,Gray,1225,24,82,186,112,29,433
Maine,Greenville,1453,33,22,94,191,83,423
Maine,Guilford,1031,22,12,18,37,54,143
Maine,Hallowell,2514,31,10,56,61,164,322
Maine,Hartland,768,12,4,47,27,49,139
Maine,Houlton,4778,76,69,175,161,193,674
Maine,Howland,1193,16,13,67,80,42,218
Maine,Kennebunk,5621,31,23,184,234,287,759
Maine,Kennebunkport,1078,25,27,83,28,49,212
Maine,Kittery,4515,67,69,193,55,178,562
Maine,Kittery Point,1112,69,0,11,0,0,80
Maine,Lake Arrowhead,2477,19,9,101,213,187,529
Maine,Lewiston,36356,467,348,1666,1686,1437,5604
Maine,Limestone,1257,5,0,47,122,134,308
Maine,Lincoln,2688,12,40,225,54,96,427
Maine,Lisbon Falls,4128,30,53,217,260,313,873
Maine,Little Falls,382,0,0,12,33,11,56
Maine,Littlejohn Island,78,0,0,0,0,0,0
Maine,Livermore Falls,1366,20,9,81,66,40,216
Maine,Lubec,377,0,9,3,7,35,54
Maine,Machias,1206,16,28,68,71,58,241
Maine,Saco,18874,245,252,764,560,1177,2998
Maine,Alfred,658,0,0,0,35,21,56
Maine,Sanford,20864,272,367,1209,974,1248,4070
Maine,Searsport,1059,0,0,0,31,117,148
Maine,Cumberland Center,2664,91,56,138,250,293,828
Maine,Cousins Island,565,10,0,10,43,72,135
Maine,Clinton,1076,32,0,31,39,50,152
Maine,Chisholm,1209,49,0,98,21,35,203
Maine,Castine,959,0,0,0,14,10,24
Maine,Casco,646,0,24,9,2,38,73
Maine,Caribou,7960,74,51,351,438,426,1340
Maine,Cape Neddick,2780,46,49,108,60,141,404
Maine,Camden,3304,40,47,0,99,114,300
Maine,Calais,3038,38,0,130,206,114,488
Maine,Bucksport,2481,17,81,183,84,39,404
Maine,Damariscotta,1095,0,7,64,52,69,192
Maine,Brunswick Station,510,10,0,61,37,0,108
Maine,Bridgton,2214,0,27,89,83,117,316
Maine,Brewer,9341,81,98,473,385,382,1419
Maine,Bowdoinham,520,0,23,19,46,13,101
Maine,Boothbay Harbor,922,0,0,38,36,29,103
Maine,Blue Hill,1000,0,0,0,69,73,142
Maine,Bingham,605,11,16,27,11,6,71
Maine,Biddeford,21289,280,208,952,804,1048,3292
Maine,Berwick,2412,0,79,207,97,69,452
Maine,Belfast,6668,86,66,373,305,184,1014
Maine,Bath,8349,188,26,502,471,347,1534
Maine,Bar Harbor,2585,13,16,109,96,59,293
Maine,Brunswick,15453,187,201,606,544,579,2117
Maine,Dexter,2087,15,0,79,99,210,403
Maine,Dixfield,1039,25,14,110,38,62,249
Maine,Dover-Foxcroft,2445,0,0,65,80,137,282
Maine,Skowhegan,6260,19,135,299,247,318,1018
Maine,South Eliot,3740,20,33,173,238,258,722
Maine,South Paris,2854,42,10,141,14,142,349
Maine,South Portland,25304,304,186,1345,934,1460,4229
Maine,Southwest Harbor,753,0,0,16,30,33,79
Maine,South Windham,1140,0,0,9,7,11,27
Maine,Standish,393,0,0,0,0,47,47
Maine,Steep Falls,1227,18,76,89,58,60,301
Maine,Thomaston,2031,46,0,231,70,90,437
Maine,Topsham,6483,95,90,211,252,341,989
Maine,Unity,529,30,23,9,18,29,109
Maine,Van Buren,1877,34,9,58,60,37,198
Maine,Waldoboro,1135,0,49,0,37,99,185
Maine,Freeport,1507,26,24,104,101,76,331
Maine,Fort Kent,2345,17,15,43,68,107,250
Maine,Fort Fairfield,1763,0,56,104,66,79,305
Maine,Farmington,3795,48,33,86,35,27,229
Maine,Farmingdale,1969,57,0,100,145,43,345
Maine,Falmouth Foreside,1702,19,24,43,89,144,319
Maine,Falmouth,2051,35,38,54,95,107,329
Maine,Fairfield,3105,0,46,163,299,182,690
Maine,Ellsworth,7832,176,40,311,383,360,1270
Maine,Eastport,1365,13,0,41,37,30,121
Maine,East Millinocket,1717,22,34,81,59,77,273
Maine,Eagle Lake,530,3,4,32,19,0,58
Maine,Scarborough,4601,13,26,342,253,266,900
Maine,Washburn,948,3,15,34,40,63,155
Maine,Hampden,3468,31,46,116,105,239,537
Maine,Wiscasset,1193,10,0,67,15,50,142
Maine,Winthrop,2651,21,61,69,248,144,543
Maine,Winslow,7661,74,111,292,390,459,1326
Maine,Woodland,869,0,5,42,33,55,135
Maine,Wilton,2036,19,0,76,179,133,407
Maine,Yarmouth,5628,91,110,231,277,319,1028
Maine,York Harbor,3003,0,93,120,66,211,490
Maine,West Kennebunk,1062,47,11,25,63,67,213
Maine,Winterport,1110,24,0,55,11,24,114
Maine,Westbrook,17754,272,179,787,748,974,2960
Maine,Augusta,18772,292,227,674,829,797,2819
Maine,Waterville,15989,192,192,627,613,481,2105
Maine,Bangor,32695,442,407,1267,1339,1218,4673
Maine,Winter Harbor,398,8,7,19,10,13,57
Maryland,Peppermill Village,4785,128,112,347,163,353,1103
Maryland,Pecktonville,170,0,9,22,10,11,52
Maryland,Pasadena,25895,480,366,1239,1205,1536,4826
Maryland,Parsonsburg,309,0,0,0,44,16,60
Maryland,Martin's Additions village,976,12,15,89,80,99,295
Maryland,Easton,16599,182,143,996,718,626,2665
Maryland,Perry Hall,28633,429,314,1066,1127,1419,4355
Maryland,Perryman,2811,51,43,167,118,103,482
Maryland,Perryville,4427,14,86,154,287,175,716
Maryland,Pikesville,32149,600,353,1647,1216,1122,4938
Maryland,Pinesburg,365,0,0,6,34,13,53
Maryland,Piney Point,803,13,0,42,31,48,134
Maryland,Marlton,9391,207,54,578,532,556,1927
Maryland,Marlow Heights,5676,172,65,291,286,340,1154
Maryland,Marlboro Village,10457,97,200,390,893,657,2237
Maryland,Parole,16764,157,72,472,371,487,1559
Maryland,Parkville,32163,378,451,1876,1060,1711,5476
Maryland,Paramount-Long Meadow,2605,74,63,108,144,148,537
Maryland,Oxon Hill,18437,203,263,663,691,994,2814
Maryland,National Harbor,3837,0,97,172,105,265,639
Maryland,Naval Academy,5630,0,4,4,53,53,114
Maryland,Newark,329,0,32,19,0,0,51
Maryland,New Carrollton,12542,253,156,648,659,515,2231
Maryland,New Market,951,42,20,102,60,28,252
Maryland,New Windsor,1145,19,23,85,85,60,272
Maryland,Nikep,88,0,0,0,10,10,20
Maryland,North Beach,2311,16,28,98,167,105,414
Maryland,North Bethesda,48818,1067,448,2215,2197,2101,8028
Maryland,North Brentwood,518,6,2,16,14,14,52
Maryland,North Chevy Chase village,486,16,4,24,31,28,103
Maryland,North East,3700,90,0,269,119,146,624
Maryland,Marlboro Meadows,3657,55,20,149,188,194,606
Maryland,North Kensington,9768,148,123,425,405,396,1497
Maryland,North Potomac,24087,401,299,1454,1704,1962,5820
Maryland,Oakland,2102,19,0,65,65,66,215
Maryland,Ocean,10,0,0,0,0,0,0
Maryland,Ocean City,7074,9,30,172,162,143,516
Maryland,Ocean Pines,11025,121,44,385,309,205,1064
Maryland,Odenton,38374,677,706,1962,1748,2078,7171
Maryland,Oldtown,114,0,6,0,0,9,15
Maryland,Olney,35090,809,387,1566,1993,2963,7718
Maryland,Overlea,12206,132,153,415,563,714,1977
Maryland,Owings,2638,17,22,241,195,219,694
Maryland,Owings Mills,33732,760,456,1651,1547,1445,5859
Maryland,Oxford,545,11,2,21,23,10,67
Maryland,North Laurel,22217,282,393,1783,1019,1435,4912
Maryland,Mardela Springs,308,0,8,18,26,24,76
Maryland,Lutherville,6600,158,108,388,302,272,1228
Maryland,Manchester,4814,127,122,397,209,256,1111
Maryland,Langley Park,21049,208,356,1209,768,446,2987
Maryland,Landover Hills,1903,15,14,125,82,128,364
Maryland,Landover,23218,483,384,1403,1193,1382,4845
Maryland,Lake Shore,19375,300,245,909,849,944,3247
Maryland,Lake Arbor,10414,215,160,364,358,634,1731
Maryland,Konterra,2416,0,0,189,68,150,407
Maryland,Klondike,132,15,0,0,0,0,15
Maryland,Kitzmiller,275,4,0,9,8,18,39
Maryland,Kingsville,4387,76,46,207,193,243,765
Maryland,Kingstown,1923,0,22,235,34,56,347
Maryland,Kettering,13195,74,64,521,609,489,1757
Maryland,Kent Narrows,441,0,0,0,0,0,0
Maryland,Kensington,1990,37,50,172,90,74,423
Maryland,Kennedyville,177,0,9,56,0,0,65
Maryland,Kemps Mill,107,0,0,0,0,0,0
Maryland,Kemp Mill,12285,324,184,677,614,646,2445
Maryland,Keedysville,1185,15,15,86,128,70,314
Maryland,Jugtown,212,0,0,13,0,8,21
Maryland,Joppatowne,12684,139,82,699,542,697,2159
Maryland,Jesterville,323,0,0,0,0,0,0
Maryland,Jessup,7671,0,0,185,53,293,531
Maryland,Lanham,10967,230,96,709,754,711,2500
Maryland,Mapleville,229,0,11,11,12,0,34
Maryland,Lansdowne,8490,156,105,483,415,389,1548
Maryland,Largo,11015,99,118,423,374,596,1610
Maryland,Madison,204,0,0,9,0,23,32
Maryland,McCoole,355,0,17,17,16,0,50
Maryland,National,58,0,12,11,0,0,23
Maryland,Lusby,1632,14,0,122,123,123,382
Maryland,Luke,97,0,0,3,0,10,13
Maryland,Long Beach,2219,0,0,105,158,245,508
Maryland,Lonaconing,1088,4,17,55,44,59,179
Maryland,Loch Lynn Heights,681,8,8,31,34,53,134
Maryland,Lochearn,26070,396,293,1047,1281,1192,4209
Maryland,Little Orleans,28,0,0,0,0,0,0
Maryland,Linthicum,10699,136,205,570,427,518,1856
Maryland,Linganore,9082,195,220,603,494,648,2160
Maryland,Libertytown,1261,16,10,35,46,64,171
Maryland,Lexington Park,12642,333,389,938,521,703,2884
Maryland,Leonardtown,3392,115,46,185,165,144,655
Maryland,Leitersburg,621,12,0,0,21,50,83
Maryland,Leisure World,9227,0,6,83,71,104,264
Maryland,Laytonsville,337,4,2,12,24,12,54
Maryland,Layhill,5051,36,99,257,185,208,785
Maryland,La Vale,3265,36,39,208,87,153,523
Maryland,Laurel,25849,486,513,1270,1103,1119,4491
Maryland,La Plata,8994,199,126,408,660,420,1813
Maryland,Nanticoke Acres,228,0,21,0,0,0,21
Maryland,Mount Airy,9353,314,52,638,709,618,2331
Maryland,Myersville,1812,38,30,171,131,129,499
Maryland,Crofton,27934,548,617,1907,1626,1333,6031
Maryland,Crisfield,2685,135,32,260,99,114,640
Maryland,Cresaptown,6127,56,48,78,123,392,697
Maryland,Crellin,203,0,7,0,0,19,26
Maryland,Cottage City,1151,35,35,36,36,37,179
Maryland,Corriganville,424,14,0,4,32,20,70
Maryland,Cordova,682,10,0,54,46,13,123
Maryland,Coral Hills,9842,170,214,415,527,746,2072
Maryland,Mercersville,61,0,0,0,0,0,0
Maryland,Croom,3107,27,0,148,74,205,454
Maryland,Melwood,2763,70,0,96,78,86,330
Maryland,Mays Chapel,11774,219,138,549,713,544,2163
Maryland,Jennings,110,0,0,7,7,7,21
Maryland,East Riverdale,16242,102,395,975,928,799,3199
Maryland,Eckhart Mines,891,12,0,0,69,0,81
Maryland,Eden,670,7,0,22,53,15,97
Maryland,Edesville,182,0,0,0,0,30,30
Maryland,Edgemere,8443,111,97,302,259,482,1251
Maryland,Edgemont,178,0,0,0,0,0,0
Maryland,Edgewater,9583,339,113,362,404,422,1640
Maryland,Mechanicsville,1937,10,36,128,172,91,437
Maryland,Crownsville,1967,0,60,152,96,107,415
Maryland,Cumberland,20449,243,372,967,942,785,3309
Maryland,Damascus,15267,272,249,760,1007,1036,3324
Maryland,East New Market,458,14,2,18,28,23,85
Maryland,Eakles Mill,0,0,0,0,0,0,0
Maryland,Eagle Harbor,41,0,1,0,5,2,8
Maryland,Dunkirk,2303,34,33,82,169,185,503
Maryland,Dundalk,62349,765,876,3142,3205,2983,10971
Maryland,Drum Point,3149,63,54,71,225,249,662
Maryland,Downsville,347,8,0,24,32,23,87
Maryland,District Heights,6036,23,79,311,334,357,1104
Maryland,Detmold,36,0,0,0,0,0,0
Maryland,Derwood,2169,27,10,69,218,165,489
Maryland,Denton,4357,95,68,319,260,246,988
Maryland,Delmar,3026,51,36,146,166,157,556
Maryland,Deer Park,474,4,14,32,30,31,111
Maryland,Deal Island,353,0,0,9,10,9,28
Maryland,Deale,5095,127,94,204,305,196,926
Maryland,Dawson,143,0,0,0,0,24,24
Maryland,Darnestown,6784,129,74,314,389,494,1400
Maryland,Darlington,481,0,3,16,20,19,58
Maryland,Dargan,157,0,0,0,0,12,12
Maryland,Danville,364,0,0,0,0,23,23
Maryland,Dames Quarter,152,0,0,11,0,0,11
Maryland,Edgewood,26060,520,380,1213,1774,1490,5377
Maryland,Edmonston,1445,10,19,63,85,104,281
Maryland,Eldersburg,31494,452,369,1888,1930,1904,6543
Maryland,Eldorado,57,2,0,6,6,2,16
Maryland,Maugansville,3573,59,43,244,142,178,666
Maryland,Maryland City,17060,459,228,722,626,856,2891
Maryland,Marydel,204,0,7,14,11,7,39
Maryland,Middle River,25816,263,348,1554,1505,1247,4917
Maryland,Middletown,4432,107,46,240,282,395,1070
Maryland,Midland,651,3,19,10,34,23,89
Maryland,Midlothian,344,21,12,23,0,22,78
Maryland,Milford Mill,30085,722,327,1259,1472,1787,5567
Maryland,Millington,620,15,6,15,31,14,81
Maryland,Mitchellville,10475,59,82,376,619,512,1648
Maryland,Monrovia,285,0,0,21,0,40,61
Maryland,Montgomery Village,33337,531,437,1631,1493,1618,5710
Maryland,Morningside,1525,26,16,56,33,24,155
Maryland,Moscow,232,0,0,8,0,8,16
Maryland,Mount Aetna,650,0,0,55,36,32,123
Maryland,Mountain Lake Park,2641,57,55,175,140,167,594
Maryland,Mount Briar,234,0,0,17,16,36,69
Maryland,Mount Lena,523,19,0,37,36,21,113
Maryland,Mount Rainier,8329,140,87,454,298,353,1332
Maryland,Mount Savage,776,0,0,12,33,34,79
Maryland,Mount Vernon,810,0,15,64,82,0,161
Maryland,Mayo,8779,108,124,329,551,729,1841
Maryland,Nanticoke,302,0,0,0,49,38,87
Maryland,Middleburg,15,0,0,0,0,0,0
Maryland,Forest Glen,7374,171,75,319,281,297,1143
Maryland,Elkridge,17550,317,244,734,1164,1108,3567
Maryland,Elkton,15718,200,215,1139,559,946,3059
Maryland,Ellerslie,485,0,4,14,22,23,63
Maryland,Ellicott City,68513,1324,787,4090,4541,4899,15641
Maryland,Elliott,20,0,0,0,0,0,0
Maryland,Emmitsburg,2951,85,50,195,205,147,682
Maryland,Ernstville,14,0,0,0,0,0,0
Maryland,Essex,38256,734,552,2203,1595,1707,6791
Maryland,Fairland,23673,302,333,1170,1173,1008,3986
Maryland,Fairlee,338,0,0,7,11,61,79
Maryland,Fairmount,272,5,0,0,0,0,5
Maryland,Fairmount Heights,1602,50,47,61,48,78,284
Maryland,Fairplay,467,20,0,36,12,0,68
Maryland,Fairview,0,0,0,0,0,0,0
Maryland,Fairwood,5707,165,74,445,289,215,1188
Maryland,Fallston,9418,70,89,447,628,845,2079
Maryland,Federalsburg,2676,4,54,219,209,139,625
Maryland,Ferndale,18612,133,503,754,931,933,3254
Maryland,Finzel,699,11,0,14,21,59,105
Maryland,Fishing Creek,136,0,0,0,0,0,0
Maryland,Flintstone,83,0,0,6,0,0,6
Maryland,Forest Heights,2530,52,52,73,100,104,381
Maryland,Jefferson,2143,28,18,108,108,161,423
Maryland,Hillcrest Heights,15383,131,132,729,675,903,2570
Maryland,Indian Springs,49,0,0,0,0,0,0
Maryland,San Mar,219,0,0,0,4,22,26
Maryland,Savage,6058,219,82,309,275,347,1232
Maryland,Scaggsville,9348,162,84,509,641,599,1995
Maryland,Seabrook,17839,312,284,1197,881,1240,3914
Maryland,Seat Pleasant,4699,153,119,209,270,413,1164
Maryland,Secretary,759,29,9,54,41,36,169
Maryland,Severn,47432,797,529,2779,2157,2522,8784
Maryland,Severna Park,38364,897,665,2248,2626,2424,8860
Maryland,Shady Side,6440,191,68,344,525,366,1494
Maryland,Shaft,426,0,0,36,0,14,50
Maryland,Sharpsburg,811,2,8,66,65,16,157
Maryland,Sharptown,959,5,12,69,105,22,213
Maryland,Silver Hill,5182,73,58,252,360,234,977
Maryland,Silver Spring,77460,1108,1222,3471,2944,3463,12208
Maryland,Smith Island,180,0,0,17,0,0,17
Maryland,Smithsburg,3010,40,40,236,270,176,762
Maryland,Snow Hill,2343,31,76,112,62,114,395
Maryland,Solomons,1833,0,42,0,35,23,100
Maryland,Ilchester,26304,517,547,1602,1431,1717,5814
Maryland,Hyattsville,18225,234,318,799,809,739,2899
Maryland,Hutton,60,0,4,0,0,0,4
Maryland,Sandy Hook,205,18,0,32,13,17,80
Maryland,Hurlock,1958,59,55,120,128,82,444
Maryland,Salisbury,31883,800,650,1556,1632,1250,5888
Maryland,St. Leonard,458,0,15,0,6,11,32
Maryland,Reisterstown,27637,599,301,1618,1369,1464,5351
Maryland,Ridgely,1379,30,11,84,92,72,289
Maryland,Ringgold,165,0,9,0,0,0,9
Maryland,Rising Sun,2869,57,63,176,267,271,834
Maryland,Pittsville,1426,19,21,157,51,101,349
Maryland,Riva,3817,80,34,225,184,171,694
Maryland,Riverdale Park,7169,95,167,386,451,482,1581
Maryland,Riverside,6799,61,86,298,369,267,1081
Maryland,Riviera Beach,13466,339,239,539,654,522,2293
Maryland,Robinwood,7769,56,92,472,564,441,1625
Maryland,Rock Hall,1157,3,15,29,28,51,126
Maryland,Rock Point,127,0,0,0,0,9,9
Maryland,Rockville,64331,1179,776,2716,2675,2731,10077
Maryland,Rohrersville,18,0,0,0,0,0,0
Maryland,Rosaryville,11348,62,93,612,502,838,2107
Maryland,Rosedale,19029,396,173,731,868,985,3153
Maryland,Rosemont village,360,2,0,10,33,13,58
Maryland,Rossville,15368,134,179,528,537,688,2066
Maryland,Sabillasville,264,0,0,0,0,48,48
Maryland,St. George Island,297,13,0,0,0,12,25
Maryland,St. James,3160,14,41,165,97,225,542
Maryland,St. Michaels,1084,20,11,63,7,42,143
Maryland,Reid,60,7,0,0,0,0,7
Maryland,Huntingtown,4025,30,9,198,401,395,1033
Maryland,Friendship Heights Village,4872,74,31,51,52,74,282
Maryland,Goldsboro,221,7,5,11,12,16,51
Maryland,Gorman,31,0,0,0,0,0,0
Maryland,Grahamtown,388,0,0,0,14,23,37
Maryland,Grantsville,819,26,0,27,18,34,105
Maryland,Grasonville,3349,40,32,245,250,217,784
Maryland,Greenbelt,23827,312,196,1229,1481,1385,4603
Maryland,Greensboro,2020,73,46,109,150,124,502
Maryland,Greensburg,329,10,8,9,9,17,53
Maryland,Hagerstown,40210,612,669,2533,2579,1956,8349
Maryland,Halfway,10596,208,69,543,396,471,1687
Maryland,Hampstead,6351,183,87,474,366,429,1539
Maryland,Hampton,4897,50,70,217,243,275,855
Maryland,Hancock,1649,16,15,86,99,72,288
Maryland,Havre de Grace,13445,153,104,584,661,489,1991
Maryland,Hebron,1046,25,31,76,41,65,238
Maryland,Henderson,172,0,4,3,0,12,19
Maryland,Herald Harbor,2726,40,0,184,205,166,595
Maryland,Highfield-Cascade,897,6,9,59,39,49,162
Maryland,Highland,1113,19,0,74,50,138,281
Maryland,Highland Beach,110,2,2,0,2,0,6
Maryland,Hillandale,5936,86,66,270,239,281,942
Maryland,Golden Beach,3380,0,52,222,185,217,676
Maryland,Hughesville,2206,0,0,35,179,136,350
Maryland,Glenn Dale,13108,82,148,628,643,869,2370
Maryland,Glen Echo,286,23,9,7,15,19,73
Maryland,Friendsville,582,19,20,40,6,23,108
Maryland,Frostburg,8759,86,112,277,307,324,1106
Maryland,Fruitland,5110,113,28,166,386,233,926
Maryland,Fulton,2758,205,44,152,183,99,683
Maryland,Funkstown,863,3,14,0,23,95,135
Maryland,Gaithersburg,64945,1189,1301,3710,3147,2995,12342
Maryland,Galena,835,0,11,73,35,31,150
Maryland,Galestown,155,0,0,16,0,0,16
Maryland,Galesville,574,0,0,0,0,32,32
Maryland,Gambrills,2583,31,12,155,125,152,475
Maryland,Gapland,111,0,0,0,0,16,16
Maryland,Garrett Park,998,31,9,103,47,27,217
Maryland,Garretts Mill,460,0,35,19,14,0,68
Maryland,Garrison,8549,109,109,625,529,243,1615
Maryland,Georgetown,148,0,0,0,20,0,20
Maryland,Germantown,89826,1900,1674,5665,5447,5261,19947
Maryland,Gilmore,190,0,0,0,0,7,7
Maryland,Girdletree,142,8,0,25,8,10,51
Maryland,Glassmanor,17552,203,523,1111,1025,857,3719
Maryland,Glenarden,6212,109,33,398,252,541,1333
Maryland,Glen Burnie,68550,1075,975,2621,3166,2953,10790
Maryland,Glenmont,15716,124,241,827,524,888,2604
Maryland,Redland,17175,225,278,802,783,1017,3105
Maryland,Rawlings,605,0,0,43,31,12,86
Maryland,Randallstown,34088,675,507,1526,1949,2133,6790
Maryland,Waterview,14,0,0,0,0,0,0
Maryland,Washington Grove,636,13,4,25,30,22,94
Maryland,Walkersville,5965,129,47,374,244,425,1219
Maryland,Walker Mill,11293,134,79,493,602,678,1986
Maryland,Waldorf,71399,1257,933,3832,4433,4894,15349
Maryland,Vienna,284,3,6,10,11,3,33
Maryland,Vale Summit,74,6,0,9,0,0,15
Maryland,Urbana,10750,426,311,844,845,794,3220
Maryland,Upper Marlboro,699,3,17,41,18,19,98
Maryland,University Park,2624,65,48,88,118,48,367
Maryland,Union Bridge,894,7,20,53,70,27,177
Maryland,Tyaskin,244,0,0,0,0,0,0
Maryland,Trego-Rohrersville Station,116,0,0,0,0,0,0
Maryland,Travilah,12106,235,205,790,1061,785,3076
Maryland,Trappe,1228,35,22,33,58,75,223
Maryland,Towson,57725,858,564,2203,2086,2197,7908
Maryland,Tolchester,268,0,0,0,13,0,13
Maryland,Timonium,10436,160,87,375,451,550,1623
Maryland,Tilghmanton,683,13,0,40,27,13,93
Maryland,Tilghman Island,952,22,4,0,59,19,104
Maryland,Thurmont,6392,82,10,312,517,311,1232
Maryland,West Denton,107,0,0,0,17,22,39
Maryland,Templeville,159,6,0,6,0,9,21
Maryland,Westernport,2059,61,40,92,72,88,353
Maryland,Westminster,18646,399,216,1001,950,613,3179
Maryland,Indian Head,3903,39,44,291,277,327,978
Maryland,Zihlman,328,0,0,13,0,45,58
Maryland,Yarrowsburg,15,0,0,0,0,0,0
Maryland,Worton,94,0,0,0,16,8,24
Maryland,Woodsboro,1168,35,4,41,70,54,204
Maryland,Woodmore,3911,89,76,146,149,173,633
Maryland,Woodlawn CDP (Prince George's County),7973,108,203,488,288,521,1608
Maryland,Woodlawn CDP (Baltimore County),40390,714,614,2117,2496,1945,7886
Maryland,Woodland,52,0,0,0,0,0,0
Maryland,Wilson-Conococheague,2144,0,13,70,65,102,250
Maryland,Williston,98,0,0,0,0,10,10
Maryland,Williamsport,2218,18,26,95,100,65,304
Maryland,Willards,999,16,25,63,44,56,204
Maryland,White Oak,17975,295,248,1042,686,1206,3477
Maryland,White Marsh,9797,172,90,417,520,588,1787
Maryland,Whitehaven,107,0,0,18,17,0,35
Maryland,Wheaton,50688,774,782,2156,2388,2527,8627
Maryland,Whaleyville,129,0,0,0,0,0,0
Maryland,West Pocomoke,473,0,12,39,17,25,93
Maryland,Westphalia,7349,88,61,383,395,500,1427
Maryland,West Ocean City,4554,54,34,114,184,282,668
Maryland,West Laurel,4388,117,0,214,150,242,723
Maryland,Temple Hills,8023,243,17,523,366,516,1665
Maryland,Taylors Island,195,0,0,0,12,34,46
Maryland,Taneytown,6740,164,43,360,266,434,1267
Maryland,Queensland,1812,9,12,86,146,166,419
Maryland,Stevensville,6372,76,91,327,376,444,1314
Maryland,Spring Ridge,5899,143,182,257,612,408,1602
Maryland,Spring Gap,67,0,0,0,0,8,8
Maryland,Springdale,2992,14,13,123,225,209,584
Maryland,Spencerville,1746,18,0,56,154,210,438
Maryland,South Laurel,26394,602,398,1524,1541,992,5057
Maryland,South Kensington,8394,211,160,557,566,469,1963
Maryland,Somerset,1215,49,21,89,79,84,322
Maryland,Forestville,11298,174,110,514,557,595,1950
Maryland,Fort Meade,10137,296,231,917,695,507,2646
Maryland,Fort Ritchie,278,18,5,24,15,15,77
Maryland,Fort Washington,23611,334,222,590,1025,1143,3314
Maryland,Fountainhead-Orchard Hills,5737,0,121,312,286,304,1023
Maryland,Four Corners,8421,247,107,564,498,375,1791
Maryland,Franklin,297,0,0,17,0,0,17
Maryland,Frederick,67421,1311,1154,3425,3182,2902,11974
Maryland,Frenchtown-Rumbly,94,0,0,0,0,0,0
Maryland,Friendly,9708,204,75,341,253,519,1392
Maryland,Friendship,311,0,0,0,0,23,23
Maryland,Queenstown,620,19,1,31,32,28,111
Maryland,Queen Anne,328,19,11,23,13,13,79
Maryland,Queen Anne,1132,0,9,57,38,56,160
Maryland,Quantico,43,0,0,0,0,0,0
Maryland,Pylesville,872,21,0,49,75,72,217
Maryland,Tall Timbers,245,12,0,13,0,0,25
Maryland,Takoma Park,17478,288,259,861,727,841,2976
Maryland,Sykesville,4429,138,82,353,165,266,1004
Maryland,Swanton,52,0,0,0,0,0,0
Maryland,Hillsboro,105,0,0,2,16,2,20
Maryland,Summerfield,12403,225,112,480,571,734,2122
Maryland,Suitland,23824,394,454,1488,1114,1368,4818
Maryland,Sudlersville,464,3,2,42,30,30,107
Maryland,Stockton,107,0,0,0,0,0,0
Maryland,Point of Rocks,1582,57,14,80,121,157,429
Maryland,Jarrettsville,3258,65,59,160,191,217,692
Maryland,Pomfret,549,9,10,48,38,0,105
Maryland,Poolesville,5100,110,45,299,448,532,1434
Maryland,Port Deposit,560,9,0,21,23,17,70
Maryland,Port Tobacco Village,2,0,0,0,0,0,0
Maryland,Potomac,45945,1010,369,2557,2870,3322,10128
Maryland,Potomac Heights,1258,25,0,101,70,31,227
Maryland,Potomac Park,927,37,14,32,28,14,125
Maryland,Powellville,80,0,0,0,0,0,0
Maryland,Preston,936,27,2,68,83,73,253
Maryland,Prince Frederick,3240,35,32,185,187,213,652
Maryland,Princess Anne,3325,0,135,82,158,206,581
Maryland,Pondsville,82,0,0,0,0,0,0
Maryland,Pleasant Grove,341,0,0,8,8,33,49
Maryland,Pleasant Hills,3555,53,27,153,232,308,773
Maryland,Capitol Heights,4482,78,71,220,363,276,1008
Maryland,Charlestown,1152,20,39,67,41,59,226
Maryland,Columbia,103055,1991,1736,4635,5053,5386,18801
Maryland,Colmar Manor,1693,29,13,110,131,82,365
Maryland,College Park,31730,232,158,471,441,588,1890
Maryland,Colesville,14190,120,145,649,762,1006,2682
Maryland,Cockeysville,20603,342,234,894,692,866,3028
Maryland,Cobb Island,731,0,20,7,35,52,114
Maryland,Cloverly,15485,331,101,626,726,899,2683
Maryland,Clinton,39336,490,557,1907,1883,2018,6855
Maryland,Clear Spring,378,4,4,5,14,21,48
Maryland,Clarysville,56,0,0,0,0,0,0
Maryland,Clarksburg,18709,580,411,1661,1188,1133,4973
Maryland,Church Hill,858,2,22,60,40,86,210
Maryland,Church Creek,149,1,0,16,12,0,29
Maryland,Choptank,210,0,0,20,0,0,20
Maryland,Chillum,37150,662,480,1622,1744,1914,6422
Maryland,Chewsville,127,0,0,6,13,6,25
Maryland,Chevy Chase Village,1993,63,24,99,127,107,420
Maryland,Chevy Chase View,978,18,6,50,96,118,288
Maryland,Chevy Chase Section Three village,787,19,18,61,39,55,192
Maryland,Chevy Chase Section Five village,628,15,8,46,56,45,170
Maryland,Chance,283,0,0,11,0,0,11
Maryland,Centreville,4507,10,6,198,204,264,682
Maryland,Cedarville,633,0,0,0,7,22,29
Maryland,Cecilton,883,0,19,33,40,42,134
Maryland,Broomes Island,460,0,0,17,51,44,112
Maryland,Brownsville,199,0,0,0,0,0,0
Maryland,Brunswick,6055,119,62,462,339,295,1277
Maryland,Bryans Road,7458,105,143,413,452,553,1666
Maryland,Bryantown,759,0,11,29,63,16,119
Maryland,Buckeystown,1069,8,23,65,15,42,153
Maryland,Burkittsville,150,2,1,4,7,6,20
Maryland,Burtonsville,9488,137,150,570,455,668,1980
Maryland,Butlertown,387,0,0,33,54,0,87
Maryland,Cabin John,2174,26,44,130,203,79,482
Maryland,Chevy Chase,9450,311,124,520,629,505,2089
Maryland,California,12228,239,185,871,347,711,2353
Maryland,Calverton,18747,255,204,919,802,1041,3221
Maryland,Cambridge,12534,360,81,751,430,548,2170
Maryland,Camp Springs,20339,357,246,1100,1009,1279,3991
Maryland,Cape St. Claire,8862,138,129,595,608,522,1992
Maryland,Charlton,163,0,0,8,9,47,64
Maryland,Carlos,142,0,0,17,0,8,25
Maryland,Carney,29196,549,322,1405,1323,1221,4820
Maryland,Catonsville,42265,814,377,1983,1622,1673,6469
Maryland,Cavetown,1529,19,9,63,81,100,272
Maryland,Cearfoss,71,14,0,0,0,0,14
Maryland,Calvert Beach,701,0,0,51,0,22,73
Maryland,Brookview,42,2,0,4,0,4,10
Maryland,Chevy Chase,2927,93,47,270,197,151,758
Maryland,Chestertown,5186,14,0,114,152,101,381
Maryland,Bartonsville,1448,15,24,61,74,146,320
Maryland,Barton,532,18,4,28,23,6,79
Maryland,Barrelville,91,0,0,8,0,8,16
Maryland,Barnesville,164,0,2,9,9,10,30
Maryland,Barclay,65,0,0,0,0,0,0
Maryland,Baltimore Highlands,7703,187,157,414,413,350,1521
Maryland,Baltimore,622454,11100,8488,27914,26911,27650,102063
Maryland,Ballenger Creek,18490,375,369,962,1089,1203,3998
Maryland,Bakersville,74,0,0,0,0,11,11
Maryland,Bagtown,276,0,0,0,14,27,41
Maryland,Baden,2034,9,13,35,130,155,342
Maryland,Aspen Hill,52607,777,726,2428,2754,2876,9561
Maryland,Ashton-Sandy Spring,5684,59,129,303,291,540,1322
Maryland,Arnold,22574,571,323,984,1282,1605,4765
Maryland,Arden on the Severn,2473,36,108,24,39,106,313
Maryland,Arbutus,21662,469,256,1203,942,584,3454
Maryland,Aquasco,833,6,8,17,26,34,91
Maryland,Antietam,165,0,0,10,4,0,14
Maryland,Chesapeake Ranch Estates,10111,213,80,685,499,831,2308
Maryland,Chesapeake City,714,8,0,25,12,54,99
Maryland,Chesapeake Beach,5847,244,80,357,412,502,1595
Maryland,Beaver Creek,94,0,0,0,9,0,9
Maryland,Bel Air,1488,87,21,108,47,39,302
Maryland,Bel Air,10247,109,150,579,500,441,1779
Maryland,Bel Air North,31871,695,369,1776,1812,2080,6732
Maryland,Chester,4952,100,28,265,198,230,821
Maryland,Braddock Heights,2831,23,55,133,120,155,486
Maryland,Bowmans Addition,622,12,0,49,44,33,138
Maryland,Bowling Green,1109,16,6,40,31,70,163
Maryland,Bowleys Quarters,6124,81,46,306,201,220,854
Maryland,Bowie,56885,1263,625,2608,3127,3359,10982
Maryland,Boonsboro,3456,36,20,285,120,81,542
Maryland,Bloomington,235,0,0,15,0,9,24
Maryland,Bladensburg,9461,132,90,616,661,418,1917
Maryland,Bivalve,271,0,11,28,58,0,97
Maryland,Cheverly,6368,212,55,256,219,272,1014
Maryland,Bishopville,494,0,24,0,0,71,95
Maryland,Big Pool,50,0,0,0,0,0,0
Maryland,Bier,87,0,20,0,0,0,20
Maryland,Betterton,320,0,1,17,8,13,39
Maryland,Bethesda,62102,1561,940,3140,3263,3466,12370
Maryland,Berwyn Heights,3223,43,66,133,143,138,523
Maryland,Berlin,4520,102,28,219,257,290,896
Maryland,Bensville,12292,93,195,904,879,587,2658
Maryland,Benedict,473,0,0,0,0,0,0
Maryland,Beltsville,18306,213,363,1112,1150,852,3690
Maryland,Bel Air South,46955,914,613,2352,2421,2980,9280
Maryland,Big Spring,120,0,0,0,0,0,0
Maryland,Brookmont,3767,73,35,216,365,301,990
Maryland,Charlotte Hall,1344,0,0,109,88,54,251
Maryland,Annapolis Neck,11084,250,53,502,530,553,1888
Maryland,Pocomoke City,4162,57,107,192,345,326,1027
Maryland,Aberdeen,15238,334,256,620,694,605,2509
Maryland,Aberdeen Proving Ground,2351,28,53,180,120,128,509
Maryland,Accident,265,2,2,18,11,15,48
Maryland,Accokeek,11617,51,90,524,631,832,2128
Maryland,Adamstown,2692,86,40,195,297,185,803
Maryland,Algonquin,1518,49,49,68,59,78,303
Maryland,Allen,106,0,0,0,0,0,0
Maryland,Adelphi,15547,179,104,639,630,490,2042
Maryland,Annapolis,38841,728,588,1657,1217,2247,6437
Maryland,Brandywine,9309,168,199,492,452,635,1946
Maryland,Breathedsville,270,0,0,0,13,22,35
Maryland,Brentwood,3139,81,65,117,160,83,506
Maryland,Brock Hall,10635,148,217,539,642,712,2258
Maryland,Brookeville,167,6,0,16,4,3,29
Maryland,Andrews AFB,3226,50,147,367,190,62,816
Maryland,Brooklyn Park,14042,121,144,766,629,585,2245
Massachusetts,Palmer Town,12168,92,95,562,598,767,2114
Massachusetts,Pinehurst,7441,153,100,292,500,483,1528
Massachusetts,Petersham,252,0,0,3,16,23,42
Massachusetts,Pepperell,2245,13,34,130,90,200,467
Massachusetts,West Falmouth,2018,15,34,139,78,88,354
Massachusetts,Peabody,52065,763,527,2006,2155,2442,7893
Massachusetts,Oxford,6108,84,92,165,242,428,1011
Massachusetts,Orange,4160,42,36,136,365,279,858
Massachusetts,Provincetown,2744,0,0,31,20,32,83
Massachusetts,Stoneham,21752,450,216,559,985,999,3209
Massachusetts,Sturbridge,2515,19,35,128,156,263,601
Massachusetts,Swampscott,14036,298,180,573,744,861,2656
Massachusetts,Taunton,56276,1070,648,2275,2410,2825,9228
Massachusetts,West Brookfield,1333,11,41,32,15,37,136
Massachusetts,West Chatham,1337,26,0,63,94,37,220
Massachusetts,West Concord,7320,186,66,369,313,248,1182
Massachusetts,Northfield,1170,25,0,47,115,59,246
Massachusetts,North Lakeville,2464,46,0,91,76,48,261
Massachusetts,North Pembroke,3257,109,60,282,170,111,732
Massachusetts,North Plymouth,3803,50,48,185,178,274,735
Massachusetts,North Scituate,5077,100,41,298,516,383,1338
Massachusetts,North Seekonk,2703,36,23,140,84,121,404
Massachusetts,Northwest Harwich,3950,33,14,98,255,247,647
Massachusetts,North Westport,4585,121,15,166,203,193,698
Massachusetts,Norton Center,2868,19,0,53,81,167,320
Massachusetts,Norwood,28962,500,280,1213,1359,1364,4716
Massachusetts,Ocean Bluff-Brant Rock,5420,205,89,289,153,204,940
Massachusetts,Ocean Grove,2667,40,16,135,91,176,458
Massachusetts,Onset,1062,0,0,0,109,106,215
Massachusetts,Orleans,1669,10,8,46,18,17,99
Massachusetts,Pittsfield,43926,820,631,1740,1904,1945,7040
Massachusetts,Blandford,382,4,0,16,4,28,52
Massachusetts,Pocasset,3045,40,15,72,45,90,262
Massachusetts,Quincy,93177,1418,1135,2724,2468,3513,11258
Massachusetts,Randolph,33409,504,548,1616,1261,1737,5666
Massachusetts,Raynham Center,4534,154,44,280,336,326,1140
Massachusetts,Reading,25357,703,342,1569,1353,1503,5470
Massachusetts,Revere,53095,797,610,1844,1940,1794,6985
Massachusetts,Rockport,4846,76,59,143,79,237,594
Massachusetts,Rowley,1511,0,0,64,109,30,203
Massachusetts,Russell,485,10,9,3,10,0,32
Massachusetts,Rutland,2433,48,18,125,132,90,413
Massachusetts,Sagamore,3660,17,49,152,151,216,585
Massachusetts,Salem,42499,695,264,1765,1814,1719,6257
Massachusetts,Salisbury,4595,64,19,81,94,211,469
Massachusetts,Sandwich,2988,5,17,89,126,143,380
Massachusetts,Saugus,27620,509,230,1144,1103,1533,4519
Massachusetts,Plymouth,7532,90,79,220,169,491,1049
Massachusetts,Scituate,5355,114,60,322,425,210,1131
Massachusetts,Seconsett Island,23,0,0,0,0,0,0
Massachusetts,Sharon,5932,80,123,469,550,491,1713
Massachusetts,Shelburne Falls,1674,22,26,19,31,59,157
Massachusetts,Shirley,1283,0,0,0,17,31,48
Massachusetts,Siasconset,203,0,0,15,9,0,24
Massachusetts,Smith Mills,4534,111,131,192,187,264,885
Massachusetts,Somerset,18271,264,132,825,905,1003,3129
Massachusetts,Somerville,78595,784,795,1581,2028,2033,7221
Massachusetts,South Amherst,5071,51,19,187,192,215,664
Massachusetts,South Ashburnham,908,30,0,146,112,60,348
Massachusetts,Southbridge Town,16802,200,152,1036,757,904,3049
Massachusetts,Hatfield,1506,9,18,24,71,123,245
Massachusetts,Popponesset,208,0,0,0,0,0,0
Massachusetts,Spencer,5578,164,32,158,221,127,702
Massachusetts,Seabrook,461,0,0,0,16,35,51
Massachusetts,Beverly,40670,784,456,1482,1788,1845,6355
Massachusetts,South Yarmouth,11532,188,81,300,189,522,1280
Massachusetts,Southfield,0,0,0,0,0,0,0
Massachusetts,Athol,8427,105,73,354,526,518,1576
Massachusetts,Arlington,44128,975,531,1932,1766,1870,7074
Massachusetts,Andover,8783,200,67,390,449,488,1594
Massachusetts,Amherst Center,19543,39,19,110,183,222,573
Massachusetts,Amesbury Town,16907,244,197,664,782,1039,2926
Massachusetts,Agawam Town,28688,467,282,1202,1358,1583,4892
Massachusetts,Adams,5475,24,76,206,210,429,945
Massachusetts,Acushnet Center,2859,54,0,145,112,108,419
Massachusetts,Westfield,41480,700,436,1805,1814,1881,6636
Massachusetts,West Springfield Town,28600,321,167,1275,1533,1712,5008
Massachusetts,West Wareham,2850,163,15,244,84,27,533
Massachusetts,Newburyport,17766,647,186,560,876,778,3047
Massachusetts,New Seabury,867,0,0,11,66,52,129
Massachusetts,Newton,87675,2271,1184,4551,4561,4416,16983
Massachusetts,North Adams,13459,167,128,283,500,653,1731
Massachusetts,North Amherst,7500,53,16,114,122,155,460
Massachusetts,Northampton,28602,397,269,1195,1064,1196,4121
Massachusetts,Attleboro,43953,782,582,2025,2431,2540,8360
Massachusetts,Northborough,6528,149,164,460,344,334,1451
Massachusetts,Ayer,3103,71,29,73,132,135,440
Massachusetts,Barnstable Town,44591,561,348,1655,2021,2028,6613
Massachusetts,Bliss Corner,5757,68,35,228,233,308,872
Massachusetts,Boston,650281,7990,8736,21715,22482,24020,84943
Massachusetts,Bourne,1202,21,0,63,17,19,120
Massachusetts,Boxford,2366,104,0,252,86,133,575
Massachusetts,Braintree Town,36905,660,457,1928,2097,1915,7057
Massachusetts,Brewster,2280,0,22,8,72,80,182
Massachusetts,Bridgewater,8516,65,15,180,297,124,681
Massachusetts,Brockton,94532,1537,1584,5052,5223,6120,19516
Massachusetts,Brookfield,786,0,20,39,7,21,87
Massachusetts,Brookline,59132,1316,824,2414,2134,2352,9040
Massachusetts,Burlington,25467,435,126,1213,1379,1305,4458
Massachusetts,Buzzards Bay,3057,7,45,114,120,125,411
Massachusetts,Cambridge,107916,1230,1038,2280,2544,2105,9197
Massachusetts,Belmont,25337,590,452,1354,1470,1473,5339
Massachusetts,Bellingham,5396,45,81,298,66,317,807
Massachusetts,Belchertown,3289,85,0,187,251,233,756
Massachusetts,Barre,1075,0,15,93,145,62,315
Massachusetts,Baldwinville,2174,15,29,95,74,118,331
Massachusetts,South Lancaster,1862,14,0,61,64,198,337
Massachusetts,North Brookfield,2132,44,44,62,101,213,464
Massachusetts,North Falmouth,2800,44,63,141,82,92,422
Massachusetts,East Harwich,4573,26,26,188,165,265,670
Massachusetts,East Pepperell,1999,25,31,118,122,161,457
Massachusetts,East Sandwich,3840,110,23,189,209,207,738
Massachusetts,Edgartown,681,22,0,17,0,6,45
Massachusetts,Essex,1613,43,27,27,96,128,321
Massachusetts,Everett,43885,874,680,1969,2131,2840,8494
Massachusetts,Fall River,88727,1487,891,4226,3857,4075,14536
Massachusetts,Falmouth,3487,0,16,55,81,38,190
Massachusetts,Fiskdale,2361,21,99,46,179,126,471
Massachusetts,Fitchburg,40462,445,440,2040,1945,2022,6892
Massachusetts,Forestdale,4443,21,24,319,172,227,763
Massachusetts,Foxborough,5326,127,18,346,235,280,1006
Massachusetts,Framingham,70443,1202,803,3105,3228,3208,11546
Massachusetts,Abington,16112,198,222,918,627,665,2630
Massachusetts,South Deerfield,1715,27,0,56,72,135,290
Massachusetts,South Dennis,3428,58,5,120,98,68,349
Massachusetts,South Duxbury,3594,98,48,246,265,251,908
Massachusetts,Easthampton Town,16060,144,82,682,647,556,2111
Massachusetts,North Eastham,1821,25,8,90,52,43,218
Massachusetts,East Falmouth,6091,112,52,246,233,211,854
Massachusetts,East Dennis,2849,6,24,39,50,123,242
Massachusetts,Chatham,1516,13,0,48,75,73,209
Massachusetts,Chelsea,37581,567,578,1757,2188,1984,7074
Massachusetts,Cheshire,593,6,21,31,82,36,176
Massachusetts,Chester,754,8,15,59,39,26,147
Massachusetts,Chicopee,56186,878,624,2562,2491,2953,9508
Massachusetts,Clinton,7386,112,68,349,337,279,1145
Massachusetts,Cochituate,6893,253,50,393,408,431,1535
Massachusetts,Cordaville,2594,61,38,226,231,142,698
Massachusetts,Danvers,27400,290,237,1438,1659,1229,4853
Massachusetts,Dedham,25224,587,273,952,1088,1406,4306
Massachusetts,Deerfield,900,22,86,57,12,55,232
Massachusetts,Dennis,2551,7,0,57,70,48,182
Massachusetts,Dennis Port,2888,50,0,79,93,39,261
Massachusetts,Devens,1733,35,37,2,62,64,200
Massachusetts,Dover,2441,43,26,177,258,106,610
Massachusetts,Duxbury,1375,30,38,88,94,90,340
Massachusetts,East Brookfield,1169,6,19,43,77,64,209
Massachusetts,East Douglas,2821,26,14,196,248,281,765
Massachusetts,Harwich Port,1969,42,0,0,0,48,90
Massachusetts,Springfield,153947,2993,2403,9000,9581,9502,33479
Massachusetts,Popponesset Island,26,0,0,0,0,0,0
Massachusetts,Medford,57136,861,338,1641,1733,1773,6346
Massachusetts,Melrose,27681,722,248,1353,1146,1216,4685
Massachusetts,Methuen Town,48607,661,597,2734,2257,2842,9091
Massachusetts,Middleborough Center,7257,165,63,268,371,584,1451
Massachusetts,Milford,25729,480,284,1620,1300,1189,4873
Massachusetts,Millers Falls,974,0,32,36,22,37,127
Massachusetts,Millis-Clicquot,4089,60,59,178,236,212,745
Massachusetts,Milton,27303,505,487,1517,1592,1718,5819
Massachusetts,Monomoscoy Island,169,8,0,0,0,10,18
Massachusetts,Monson Center,1677,21,0,48,73,79,221
Massachusetts,Monument Beach,2903,23,22,32,82,198,357
Massachusetts,Nahant,3454,21,0,144,250,100,515
Massachusetts,Nantucket,7475,182,83,421,281,400,1367
Massachusetts,Needham,29853,817,488,1714,1884,1973,6876
Massachusetts,New Bedford,94909,1937,1045,4950,4168,4635,16735
Massachusetts,Malden,60612,835,627,2545,2303,2863,9173
Massachusetts,Teaticket,1440,0,7,46,19,19,91
Massachusetts,West Yarmouth,5639,64,83,254,154,128,683
Massachusetts,Weweantic,1938,0,0,42,94,72,208
Massachusetts,Weymouth Town,55304,1140,352,2212,2655,2511,8870
Massachusetts,White Island Shores,1636,0,0,176,59,56,291
Massachusetts,Whitinsville,6690,132,111,459,392,349,1443
Massachusetts,Wilbraham,3892,74,56,110,203,186,629
Massachusetts,Williamstown,4437,82,32,113,129,58,414
Massachusetts,Wilmington,23141,489,239,1223,1186,1598,4735
Massachusetts,Winchendon,3369,66,0,78,180,163,487
Massachusetts,Winchester,22075,649,343,1717,1699,1164,5572
Massachusetts,Winthrop Town,17962,333,245,703,937,486,2704
Massachusetts,Woburn,39104,644,487,1479,1778,1955,6343
Massachusetts,Medfield,6322,167,61,568,430,379,1605
Massachusetts,Maynard,10459,249,154,582,398,329,1712
Massachusetts,Mattapoisett Center,3429,63,34,180,167,314,758
Massachusetts,Mashpee Neck,774,23,0,22,52,29,126
Massachusetts,Mansfield Center,7806,98,116,350,486,648,1698
Massachusetts,Marblehead,20270,572,231,1042,1480,1140,4465
Massachusetts,Marion Center,1388,0,16,31,88,126,261
Massachusetts,Marlborough,39425,737,531,1482,1640,1804,6194
Massachusetts,Marshfield,4362,36,81,262,204,238,821
Massachusetts,Marshfield Hills,2277,52,0,96,192,212,552
Massachusetts,Lynnfield,12270,202,195,551,673,826,2447
Massachusetts,Lynn,91626,1228,1420,5126,4886,4640,17300
Massachusetts,Lunenburg,1798,70,19,112,97,47,345
Massachusetts,Lowell,109349,1409,1826,4939,4984,5588,18746
Massachusetts,Longmeadow,15877,245,315,690,968,1073,3291
Massachusetts,Littleton Common,2701,45,21,148,204,97,515
Massachusetts,Lexington,32700,799,461,1730,2230,2677,7897
Massachusetts,Leominster,41176,553,538,1902,1937,1968,6898
Massachusetts,Woods Hole,963,22,29,29,9,40,129
Massachusetts,Lenox,1599,9,6,59,55,116,245
Massachusetts,Lawrence,78804,1292,1262,4284,4771,5293,16902
Massachusetts,Kingston,6211,72,64,485,277,244,1142
Massachusetts,Ipswich,4235,77,69,209,206,100,661
Massachusetts,Huntington,679,0,0,12,9,41,62
Massachusetts,Hull,10403,126,34,320,364,410,1254
Massachusetts,Hudson,15340,255,227,417,738,934,2571
Massachusetts,Housatonic,854,17,18,19,60,13,127
Massachusetts,Hopkinton,2656,81,30,108,151,138,508
Massachusetts,Hopedale,3875,31,60,196,337,301,925
Massachusetts,Holyoke,40342,834,628,2167,1707,2460,7796
Massachusetts,Holland,1433,22,0,104,35,55,216
Massachusetts,Holbrook,10975,148,106,324,600,468,1646
Massachusetts,Hingham,5416,182,47,423,358,371,1381
Massachusetts,Haverhill,62079,885,954,3137,2738,3505,11219
Massachusetts,Lee,1773,18,58,104,56,74,310
Massachusetts,Worcester,183382,2719,2415,8493,8288,8535,30450
Massachusetts,Madaket,296,0,0,34,24,8,66
Massachusetts,Turners Falls,4356,32,105,298,211,210,856
Massachusetts,The Pinehills,1033,0,0,0,0,13,13
Massachusetts,Topsfield,3029,37,14,95,309,231,686
Massachusetts,Townsend,1294,56,0,56,132,39,283
Massachusetts,Upton,3028,64,52,49,222,189,576
Massachusetts,Vineyard Haven,2223,30,81,142,118,114,485
Massachusetts,Wakefield,26157,536,302,1093,1222,1158,4311
Massachusetts,Walpole,5881,145,35,244,417,507,1348
Massachusetts,Waltham,62438,930,516,1667,1451,1383,5947
Massachusetts,Ware,5772,94,134,286,235,272,1021
Massachusetts,Wareham Center,3506,0,119,154,141,40,454
Massachusetts,Warren,1271,0,0,85,31,45,161
Massachusetts,Watertown Town,33350,527,375,1043,708,1353,4006
Massachusetts,Webster,12522,303,95,522,718,527,2165
Massachusetts,Yarmouth Port,4792,33,62,114,83,154,446
Massachusetts,Westborough,4158,127,25,164,163,198,677
Massachusetts,Wellesley,28832,713,402,1985,2082,1841,7023
Massachusetts,Harwich Center,1705,7,7,42,125,36,217
Massachusetts,Hanson,1772,31,0,118,113,91,353
Massachusetts,Groton,1081,35,0,49,19,38,141
Massachusetts,Green Harbor-Cedar Crest,2873,19,65,156,202,93,535
Massachusetts,Greenfield Town,17514,201,207,513,717,813,2451
Massachusetts,Hanscom AFB,2074,170,47,209,117,65,608
Massachusetts,Granby,1431,0,0,31,63,114,208
Massachusetts,Gloucester,29399,490,179,925,1255,1518,4367
Massachusetts,Gardner,20306,503,134,1020,915,1052,3624
Massachusetts,Franklin Town,32731,963,354,1952,2407,2042,7718
Massachusetts,West Dennis,2347,0,10,86,25,74,195
Massachusetts,Great Barrington,2344,13,46,96,43,73,271
Michigan,Madison Heights,30123,548,265,1160,952,1560,4485
Michigan,Luna Pier,1341,12,3,97,59,46,217
Michigan,Mackinaw City village,702,6,19,13,26,40,104
Michigan,Mackinac Island,710,9,0,8,5,52,74
Michigan,McBride village,164,6,3,12,11,8,40
Michigan,McBain,671,12,12,21,23,27,95
Michigan,Lyons village,903,7,12,43,62,62,186
Michigan,Luther village,365,10,11,40,22,19,102
Michigan,Lupton,255,0,4,0,5,9,18
Michigan,Ludington,8055,35,163,392,361,214,1165
Michigan,Lincoln Park,37362,485,605,1906,2099,1812,6907
Michigan,Lost Lake Woods,344,0,0,10,3,14,27
Michigan,Loomis,194,0,0,0,3,11,14
Michigan,Livonia,95312,1265,1022,3880,4420,4746,15333
Michigan,Litchfield,1281,5,9,40,57,77,188
Michigan,Linden,3886,63,55,267,246,155,786
Michigan,Lincoln village,300,6,1,3,6,16,32
Michigan,Lexington village,1167,6,9,32,50,38,135
Michigan,Galien village,562,0,20,34,50,29,133
Michigan,Galesburg,1953,21,44,124,100,80,369
Michigan,Mancelona village,1466,26,20,92,87,76,301
Michigan,Lowell,3859,85,99,244,126,165,719
Michigan,Douglas,1113,13,3,49,41,26,132
Michigan,Manchester village,2124,44,38,102,147,132,463
Michigan,Manistee Lake,345,1,0,11,12,10,34
Michigan,Marine City,4172,57,6,205,178,253,699
Michigan,Marion village,721,8,9,55,28,33,133
Michigan,Marlette,1565,20,4,86,92,102,304
Michigan,Marquette,21444,184,176,468,520,677,2025
Michigan,Greenville,8443,116,186,580,520,451,1853
Michigan,Martin village,417,13,2,36,18,15,84
Michigan,Marysville,9797,221,170,432,395,479,1697
Michigan,Greilickville,1834,12,14,45,53,53,177
Michigan,Mason,8317,167,55,443,461,368,1494
Michigan,Grosse Pointe,5295,121,35,339,427,404,1326
Michigan,Marenisco,194,7,1,9,12,2,31
Michigan,Grosse Pointe Farms,9307,181,187,826,693,644,2531
Michigan,Grosse Pointe Woods,15859,270,211,730,740,1114,3065
Michigan,Gwinn,1987,0,9,78,98,175,360
Michigan,Hamtramck,22150,269,496,1506,1487,1256,5014
Michigan,Hancock,4601,53,16,160,144,168,541
Michigan,Hanover village,363,2,3,31,30,13,79
Michigan,Harbor Beach,1802,58,36,122,90,74,380
Michigan,Harbor Springs,1044,7,6,22,39,56,130
Michigan,Hardwood Acres,613,0,12,20,43,126,201
Michigan,Dowling,394,3,4,16,23,42,88
Michigan,Dowagiac,5866,81,122,411,337,374,1325
Michigan,Grosse Pointe Park,11343,226,109,592,660,847,2434
Michigan,Marcellus village,1052,8,21,91,55,59,234
Michigan,Maple Rapids village,688,11,7,26,31,51,126
Michigan,Maple Grove,32,0,0,0,0,0,0
Michigan,Manistique,3035,32,130,120,157,144,583
Michigan,Manitou Beach-Devils Lake,2050,10,47,33,24,112,226
Michigan,Garden village,183,5,0,8,3,10,26
Michigan,Garden City,27161,271,289,1278,1135,1297,4270
Michigan,Gaylord,3640,6,56,201,156,176,595
Michigan,Gibraltar,4566,38,13,189,272,248,760
Michigan,Gladstone,4902,81,98,220,297,239,935
Michigan,Gladwin,2904,111,34,151,148,211,655
Michigan,Glen Arbor,237,0,0,6,3,13,22
Michigan,Gobles,816,3,11,53,41,75,183
Michigan,Goodrich village,1823,29,20,127,156,125,457
Michigan,Grand Beach village,280,4,2,9,9,13,37
Michigan,Grand Blanc,8088,85,52,326,487,493,1443
Michigan,Grand Haven,10819,139,65,336,430,506,1476
Michigan,Grand Ledge,7792,143,66,396,330,564,1499
Michigan,Grand Rapids,192416,3424,3082,10159,9605,8867,35137
Michigan,Grandville,15739,89,377,775,972,774,2987
Michigan,Grant,859,23,18,37,63,51,192
Michigan,Grass Lake village,1285,19,19,57,67,61,223
Michigan,Grawn,727,0,0,25,74,42,141
Michigan,Grayling,1834,36,15,83,109,134,377
Michigan,Manton,1240,15,15,62,65,61,218
Michigan,Maple City,202,0,3,23,14,16,56
Michigan,Manistee,6136,80,125,273,270,326,1074
Michigan,Marshall,7038,105,100,369,227,250,1051
Michigan,Saline,9020,84,93,469,423,722,1791
Michigan,Levering,204,0,8,8,20,12,48
Michigan,Shepherd village,1525,18,14,47,103,71,253
Michigan,Shelby village,1908,67,31,152,120,175,545
Michigan,Sebewaing village,1703,6,11,44,70,80,211
Michigan,Scottville,1283,47,27,103,66,85,328
Michigan,Schoolcraft village,1496,20,4,67,72,62,225
Michigan,Sault Ste. Marie,14048,213,161,553,905,492,2324
Michigan,Saugatuck,842,8,18,34,34,26,120
Michigan,Saranac village,1312,26,11,61,91,72,261
Michigan,Sanford village,952,16,7,64,51,43,181
Michigan,Sandusky,2618,47,27,127,105,107,413
Michigan,Sand Lake village,569,28,15,45,43,26,157
Michigan,Sand Lake,1370,9,4,16,37,42,108
Michigan,Lake City,1071,23,13,67,64,84,251
Michigan,Lake Ann village,272,6,5,14,9,5,39
Michigan,Comstock Park,10431,205,189,470,471,666,2001
Michigan,Concord village,1127,12,24,86,33,63,218
Michigan,Constantine village,1736,28,30,86,81,111,336
Michigan,Conway,327,19,0,53,0,12,84
Michigan,Coopersville,4329,72,106,301,182,267,928
Michigan,Copemish village,134,0,2,2,0,1,5
Michigan,Copper City village,246,1,3,5,21,12,42
Michigan,Sheridan village,586,2,4,30,39,23,98
Michigan,Sherwood village,336,10,6,9,22,38,85
Michigan,Shields,6192,86,77,234,270,379,1046
Michigan,Shoreham village,888,7,13,59,33,47,159
Michigan,Sterling village,523,5,1,24,15,30,75
Michigan,Stephenson,964,5,14,28,51,51,149
Michigan,Stanwood village,200,0,5,18,13,12,48
Michigan,Stanton,1543,9,23,69,118,70,289
Michigan,Standish,1701,14,19,83,96,107,319
Michigan,Springport village,740,3,21,38,60,97,219
Michigan,Spring Lake village,2438,61,29,110,129,104,433
Michigan,Springfield,5216,87,59,231,285,330,992
Michigan,Spring Arbor,2928,0,40,40,94,82,256
Michigan,Sparta village,4235,81,58,166,217,283,805
Michigan,Copper Harbor,80,0,0,0,0,1,1
Michigan,South Rockwood village,1978,43,47,22,71,111,294
Michigan,South Monroe,6177,57,48,271,323,381,1080
Michigan,South Lyon,11616,152,190,713,605,553,2213
Michigan,South Haven,4357,41,7,272,130,248,698
Michigan,South Gull Lake,1363,7,0,75,36,69,187
Michigan,Southgate,29518,216,198,868,1053,1438,3773
Michigan,Southfield,72859,1017,681,3189,3366,3612,11865
Michigan,South Boardman,572,2,4,60,26,35,127
Michigan,Snover,451,15,21,17,30,26,109
Michigan,Skidway Lake,3340,39,71,104,143,125,482
Michigan,Shorewood-Tower Hills-Harbert,1199,29,11,0,0,57,97
Michigan,South Range village,858,19,11,62,34,33,159
Michigan,Lewiston,1342,26,13,64,74,31,208
Michigan,Corunna,3415,45,13,194,119,253,624
Michigan,Croswell,2578,92,49,142,153,160,596
Michigan,St. Ignace,2548,35,35,115,143,97,425
Michigan,St. Helen,2786,10,47,108,53,88,306
Michigan,St. Clair Shores,59888,637,681,2225,3033,2416,8992
Michigan,St. Clair,5394,29,103,311,301,289,1033
Michigan,St. Charles village,1971,12,40,69,118,101,340
Michigan,Saginaw,50288,823,664,3111,3029,3414,11041
Michigan,Royal Oak,58689,805,417,2098,1879,2106,7305
Michigan,Rothbury village,335,3,5,17,15,21,61
Michigan,Roseville,47529,661,605,2255,2397,2380,8298
Michigan,Rose City,612,17,2,48,34,26,127
Michigan,Rosebush village,358,8,7,19,14,23,71
Michigan,Roscommon village,1179,32,16,81,129,106,364
Michigan,Roosevelt Park,3819,38,33,201,307,155,734
Michigan,Romulus,23557,646,281,1462,1232,1674,5295
Michigan,Romeo village,3799,97,51,83,227,199,657
Michigan,Rogers City,2751,38,40,85,79,121,363
Michigan,Rockwood,3227,65,74,49,138,206,532
Michigan,Rockford,5956,98,117,375,403,364,1357
Michigan,Rochester Hills,72643,1407,889,3727,3701,3828,13552
Michigan,Rochester,12909,276,183,611,832,752,2654
Michigan,Robin Glen-Indiantown,1045,18,52,37,71,20,198
Michigan,St. James,226,0,0,4,32,12,48
Michigan,St. Johns,7954,76,173,445,418,422,1534
Michigan,St. Joseph,8311,149,44,121,305,264,883
Michigan,St. Louis,7355,53,48,168,206,262,737
Michigan,Crystal Downs Country Club,71,0,0,0,6,0,6
Michigan,Crystal Falls,1683,34,35,115,87,73,344
Michigan,Crystal Mountain,42,0,0,0,2,2,4
Michigan,Custer village,281,3,5,10,24,14,56
Michigan,Cutlerville,15142,212,220,816,609,912,2769
Michigan,Daggett village,196,7,1,9,3,12,32
Michigan,Dansville village,526,11,8,47,37,35,138
Michigan,Davison,5029,68,25,302,230,233,858
Michigan,Dearborn,96069,1767,1465,6124,6749,5825,21930
Michigan,Dearborn Heights,56656,895,653,2945,2962,3445,10900
Michigan,Cross Village,93,0,0,0,12,5,17
Michigan,Decatur village,2063,28,38,121,157,165,509
Michigan,Deerfield village,841,10,9,45,35,59,158
Michigan,Delton,1022,0,10,82,83,28,203
Michigan,De Tour Village village,236,0,0,3,10,10,23
Michigan,Detroit,690074,9718,9159,36897,39229,44753,139756
Michigan,Detroit Beach,2007,10,44,70,151,127,402
Michigan,DeWitt,4631,86,150,378,248,316,1178
Michigan,Dexter village,4682,140,119,433,306,291,1289
Michigan,Dimondale village,1162,19,4,42,67,62,194
Michigan,Dollar Bay,788,6,18,79,45,47,195
Michigan,Gaines village,374,2,6,13,16,24,61
Michigan,Deckerville village,850,2,3,35,55,60,155
Michigan,Gagetown village,357,7,8,12,8,8,43
Michigan,Pearl Beach,2895,14,23,76,39,151,303
Michigan,Fruitport village,1345,17,35,58,94,98,302
Michigan,Woodhaven,12645,196,136,692,658,759,2441
Michigan,Woodland village,409,8,8,11,15,18,60
Michigan,Woodland Beach,1896,49,66,92,107,108,422
Michigan,Wyandotte,25376,356,237,1117,1226,1436,4372
Michigan,Wyoming,74105,1141,1055,4047,4195,3756,14194
Michigan,Yale,1931,15,40,77,105,122,359
Michigan,Ypsilanti,19874,295,119,493,564,463,1934
Michigan,Zeba,314,2,4,18,2,17,43
Michigan,Zeeland,5591,71,58,300,296,310,1035
Michigan,Zilwaukee,1922,33,21,82,79,68,283
Michigan,Wolverine Lake village,4372,42,30,148,272,244,736
Michigan,Riverview,12266,132,27,597,519,504,1779
Michigan,Richmond,5825,28,98,406,255,388,1175
Michigan,Richland village,845,19,7,55,46,32,159
Michigan,Republic,401,2,4,10,12,19,47
Michigan,Reese village,1690,24,29,59,109,106,327
Michigan,Reed City,2828,23,59,192,233,142,649
Michigan,Reading,1215,12,36,80,99,121,348
Michigan,Ravenna village,1190,8,17,91,120,52,288
Michigan,Rapid City,1473,13,18,26,84,39,180
Michigan,Quinnesec,999,0,0,37,60,122,219
Michigan,Quincy village,1647,46,23,96,137,59,361
Michigan,River Rouge,7673,98,148,346,331,699,1622
Michigan,Prudenville,1578,15,8,63,26,100,212
Michigan,Wolverine village,242,2,2,10,11,26,51
Michigan,Wixom,13690,207,119,640,617,712,2295
Michigan,Ironwood,5153,29,55,201,247,248,780
Michigan,Ishpeming,6517,66,106,208,350,278,1008
Michigan,Ithaca,2856,37,13,159,135,257,601
Michigan,Jackson,33255,597,707,2155,2131,1957,7547
Michigan,Jasper,326,0,0,8,19,30,57
Michigan,Jenison,17004,291,195,1054,1026,1053,3619
Michigan,Jennings,207,0,0,16,14,9,39
Michigan,Jonesville,2173,35,30,89,129,266,549
Michigan,Kalamazoo,75499,1039,951,3548,3351,3071,11960
Michigan,Kaleva village,467,0,2,26,16,14,58
Michigan,Wolf Lake,4475,35,51,256,247,285,874
Michigan,Kalkaska village,2113,5,22,81,96,138,342
Michigan,Kent City village,1156,35,28,66,81,69,279
Michigan,Kentwood,50286,956,566,2715,2143,2961,9341
Michigan,Kinde village,490,16,1,35,18,29,99
Michigan,Kingsford,5104,68,0,165,238,376,847
Michigan,Kingsley village,1605,26,21,81,123,96,347
Michigan,Kingston village,432,10,2,25,24,16,77
Michigan,K. I. Sawyer,3114,63,60,264,211,194,792
Michigan,Laingsburg,1296,36,12,66,108,110,332
Michigan,Lake Angelus,269,0,0,10,15,0,25
Michigan,Williamston,3855,121,82,283,145,163,794
Michigan,Keego Harbor,3016,45,34,153,200,133,565
Michigan,Presque Isle Harbor,567,0,0,6,4,18,28
Michigan,Prescott village,296,2,4,12,12,48,78
Michigan,Powers village,484,0,10,16,21,10,57
Michigan,Omer,315,10,6,21,5,7,49
Michigan,Onaway,791,12,6,39,18,62,137
Michigan,Onekama village,448,8,4,22,16,26,76
Michigan,Onsted village,935,11,6,63,66,56,202
Michigan,Ontonagon village,1399,18,2,39,40,76,175
Michigan,Orchard Lake Village,2488,16,26,41,148,251,482
Michigan,Ortonville village,1635,45,26,164,101,131,467
Michigan,Oscoda,803,10,0,36,18,73,137
Michigan,Ossineke,977,11,4,95,65,61,236
Michigan,Otisville village,920,0,4,32,60,45,141
Michigan,Omena,198,0,21,0,9,0,30
Michigan,Otsego,3975,40,47,311,216,177,791
Michigan,Ovid village,1596,25,26,156,98,79,384
Michigan,Owendale village,210,10,13,4,16,5,48
Michigan,Owosso,14826,141,174,722,895,790,2722
Michigan,Oxford village,3495,22,46,196,187,210,661
Michigan,Palmer,417,2,8,24,43,10,87
Michigan,Parchment,2016,41,34,137,126,113,451
Michigan,Parkdale,640,8,0,0,5,14,27
Michigan,Parma village,870,21,12,60,108,68,269
Michigan,Paw Paw village,3445,75,96,98,88,189,546
Michigan,Paw Paw Lake,4037,52,65,81,169,331,698
Michigan,Otter Lake village,398,0,4,15,44,35,98
Michigan,Olivet,1570,4,10,58,88,75,235
Michigan,Pellston village,861,30,6,28,79,60,203
Michigan,Pentwater village,881,3,0,95,29,30,157
Michigan,Potterville,2612,59,32,166,154,132,543
Michigan,Posen village,222,0,0,16,15,17,48
Michigan,Port Sanilac village,546,3,7,17,17,20,64
Michigan,Portland,3910,49,128,255,256,174,862
Michigan,Port Huron,29508,383,423,1553,1696,1557,5612
Michigan,Port Hope village,251,0,1,1,11,10,23
Michigan,Port Austin village,712,12,0,34,31,29,106
Michigan,Portage,47496,824,899,2504,2478,2146,8851
Michigan,Pontiac,59928,1112,900,3575,3334,3203,12124
Michigan,Ponshewaing,43,0,0,0,0,4,4
Michigan,Plymouth,8952,157,83,410,470,349,1469
Michigan,Pleasant Ridge,2555,41,15,116,122,83,377
Michigan,Plainwell,3810,45,0,113,236,184,578
Michigan,Pinconning,1348,48,11,70,94,104,327
Michigan,Pinckney village,2672,17,32,194,243,153,639
Michigan,Pilgrim,50,0,0,0,0,0,0
Michigan,Pigeon village,1262,13,15,43,34,46,151
Michigan,Pierson village,190,5,0,13,9,13,40
Michigan,Pewamo village,515,4,16,36,22,31,109
Michigan,Petoskey,5725,43,39,236,193,131,642
Michigan,Petersburg,1315,14,7,82,72,84,259
Michigan,Perry,1994,18,32,102,148,95,395
Michigan,Perrinton village,575,8,20,77,45,18,168
Michigan,Ironton,162,0,0,0,20,11,31
Michigan,Gaastra,352,4,9,24,16,7,60
Michigan,Iron River,2944,70,36,78,173,129,486
Michigan,Ionia,11384,175,104,409,311,639,1638
Michigan,Fair Plain,7706,195,141,457,579,321,1693
Michigan,Fairgrove village,529,9,7,27,29,29,101
Michigan,Haring,515,0,42,43,0,31,116
Michigan,Harper Woods,13964,152,259,779,888,1083,3161
Michigan,Harrietta village,134,0,2,12,6,2,22
Michigan,Peck village,683,13,17,34,35,44,143
Michigan,Harrisville,380,2,2,11,2,7,24
Michigan,Hart,2105,27,27,125,94,141,414
Michigan,Hartford,2634,54,32,217,225,185,713
Michigan,Harvey,1734,16,16,40,100,79,251
Michigan,Farmington,10509,223,156,465,338,583,1765
Michigan,Haslett,20057,316,141,773,1019,885,3134
Michigan,Hazel Park,16600,231,270,864,811,876,3052
Michigan,Hemlock,1625,48,0,139,88,150,425
Michigan,Henderson,410,0,0,22,52,27,101
Michigan,Hersey village,355,14,2,29,22,15,82
Michigan,Hesperia village,893,7,12,73,45,64,201
Michigan,Hickory Corners,187,0,0,12,10,22,44
Michigan,Dryden village,1198,22,14,51,79,93,259
Michigan,Dundee village,3950,66,8,112,262,217,665
Michigan,Durand,3369,39,0,263,142,163,607
Michigan,Eagle village,93,9,0,7,3,5,24
Michigan,Hastings,7304,151,73,431,299,480,1434
Michigan,Eagle Harbor,128,2,0,0,0,0,2
Michigan,Farmington Hills,80971,1327,829,3578,4117,4282,14133
Michigan,Fennville,1777,33,61,155,187,95,531
Michigan,Fremont,4051,63,73,282,183,250,851
Michigan,Free Soil village,143,0,4,3,2,7,16
Michigan,Freeport village,512,8,19,29,24,34,114
Michigan,Freeland,7241,101,106,518,507,229,1461
Michigan,Fraser,14582,183,154,577,797,655,2366
Michigan,Franklin village,3198,37,59,199,273,163,731
Michigan,Frankfort,1396,5,8,79,52,61,205
Michigan,Frankenmuth,4947,89,65,130,330,192,806
Michigan,Fowlerville village,2887,43,52,104,200,197,596
Michigan,Fowler village,1229,24,10,76,77,86,273
Michigan,Farwell village,816,9,7,35,44,37,132
Michigan,Fountain village,146,3,5,8,2,5,23
Michigan,Forestville village,71,0,2,7,5,1,15
Michigan,Forest Hills,27415,836,519,1472,1923,2273,7023
Michigan,Flushing,8199,157,86,415,491,388,1537
Michigan,Flint,99802,1624,1368,6021,5475,5771,20259
Michigan,Flat Rock,9879,120,197,611,526,613,2067
Michigan,Filer City,133,0,0,8,9,24,41
Michigan,Fife Lake village,318,0,0,25,4,12,41
Michigan,Ferrysburg,2955,19,12,86,147,121,385
Michigan,Ferndale,20160,352,156,612,583,819,2522
Michigan,Fenton,11538,212,138,680,529,572,2131
Michigan,Fostoria,600,0,5,24,25,33,87
Michigan,Eagle River,69,0,0,3,0,0,3
Michigan,East Grand Rapids,11128,333,167,832,861,879,3072
Michigan,East Jordan,2474,80,42,137,129,132,520
Michigan,Hillsdale,8203,146,110,332,287,363,1238
Michigan,Holland,33526,556,440,1481,1875,1637,5989
Michigan,Holly village,6171,74,122,393,344,520,1453
Michigan,Holt,24289,312,520,1446,1455,1283,5016
Michigan,Homer village,1857,33,67,96,187,112,495
Michigan,Honor village,235,9,1,13,17,4,44
Michigan,Hopkins village,661,15,11,47,63,50,186
Michigan,Horton Bay,462,4,6,5,0,35,50
Michigan,Houghton,7942,31,51,119,242,165,608
Michigan,Houghton Lake,3236,11,29,95,92,114,341
Michigan,Hillman village,703,0,6,28,7,17,58
Michigan,Howard City village,1724,12,29,156,113,126,436
Michigan,Hubbard Lake,868,0,0,14,15,15,44
Michigan,Hubbardston village,338,13,0,22,24,16,75
Michigan,Hubbell,1012,3,30,39,46,73,191
Michigan,Hudson,2413,19,51,117,149,210,546
Michigan,Hudsonville,7271,185,93,369,377,329,1353
Michigan,Huntington Woods,6333,203,59,437,395,332,1426
Michigan,Imlay City,3582,18,18,236,276,298,846
Michigan,Indian River,1771,0,18,65,58,78,219
Michigan,Inkster,24897,402,429,1708,1417,1590,5546
Michigan,Interlochen,471,16,16,34,50,0,116
Michigan,Howell,9502,91,107,502,606,416,1722
Michigan,Highland Park,11102,129,142,598,731,577,2177
Michigan,Whittemore,444,9,8,28,28,17,90
Michigan,Whitmore Lake,6653,192,17,269,405,136,1019
Michigan,Eastlake village,490,5,12,6,41,18,82
Michigan,East Lansing,48669,306,322,812,731,631,2802
Michigan,Eastpointe,32585,243,495,2029,1939,2408,7114
Michigan,Eastport,212,0,0,10,0,0,10
Michigan,East Tawas,2761,7,8,96,59,118,288
Michigan,Eastwood,6254,50,123,362,421,203,1159
Michigan,Eaton Rapids,5221,139,141,322,259,378,1239
Michigan,Eau Claire village,602,4,20,29,50,27,130
Michigan,Ecorse,9338,192,133,770,508,382,1985
Michigan,Edgemont Park,2199,30,23,145,118,140,456
Michigan,Edmore village,1287,32,9,86,90,76,293
Michigan,Edwardsburg village,1161,15,12,81,53,88,249
Michigan,Elberta village,208,0,0,0,9,7,16
Michigan,Elk Rapids village,1541,21,15,46,58,64,204
Michigan,Elkton village,862,14,14,55,63,48,194
Michigan,Ellsworth village,399,6,0,14,11,43,74
Michigan,Elsie village,1080,9,12,63,41,42,167
Michigan,Emmett village,299,9,2,20,31,18,80
Michigan,Empire village,358,0,10,12,4,16,42
Michigan,Escanaba,12468,163,163,564,554,576,2020
Michigan,Essexville,3432,21,23,223,207,205,679
Michigan,Estral Beach village,397,3,0,7,10,23,43
Michigan,Evart,1515,20,32,105,90,73,320
Michigan,Iron Mountain,7571,63,178,398,444,520,1603
Michigan,Harrison,2011,31,17,44,88,75,255
Michigan,Sterling Heights,131139,1765,1347,6036,5980,6721,21849
Michigan,Mendon village,896,20,13,82,62,74,251
Michigan,Taylor,62021,1094,992,3156,3172,3279,11693
Michigan,Tecumseh,8393,91,58,396,466,436,1447
Michigan,Tekonsha village,648,24,12,42,23,26,127
Michigan,Thompsonville village,576,10,4,6,25,30,75
Michigan,Three Oaks village,1598,15,53,80,67,60,275
Michigan,Three Rivers,7787,104,64,561,482,443,1654
Michigan,Traverse City,15168,297,139,666,588,707,2397
Michigan,Trenton,18522,229,170,738,896,1031,3064
Michigan,Trowbridge Park,2291,28,44,44,39,142,297
Michigan,Troy,82542,1155,829,4161,4512,5080,15737
Michigan,Turner village,82,0,0,2,2,6,10
Michigan,Tustin village,242,2,0,13,7,33,55
Michigan,Twining village,171,3,0,4,11,18,36
Michigan,Twin Lake,1928,19,38,60,45,66,228
Michigan,Ubly village,755,7,11,27,29,37,111
Michigan,Tawas City,1888,20,15,58,52,56,201
Michigan,Sylvan Lake,1701,47,21,55,66,84,273
Michigan,Swartz Creek,5632,214,49,224,253,300,1040
Michigan,Suttons Bay village,584,3,2,40,26,16,87
Michigan,Mesick village,407,10,9,26,29,15,89
Michigan,Merrill village,706,4,17,43,54,44,162
Michigan,Menominee,8456,148,158,385,417,522,1630
Michigan,Memphis,1230,14,0,55,134,102,305
Michigan,Melvindale,10510,43,294,631,645,728,2341
Michigan,Melvin village,187,0,4,11,9,11,35
Michigan,Mecosta village,620,6,8,15,67,43,139
Michigan,Union City village,1618,58,21,78,115,100,372
Michigan,Mayville village,962,18,3,41,48,57,167
Michigan,Mattawan village,2081,13,29,138,181,147,508
Michigan,Stevensville village,1282,17,4,46,63,56,186
Michigan,Stockbridge village,1043,20,8,52,36,74,190
Michigan,Stony Point,1498,0,29,89,61,117,296
Michigan,Stronach,211,0,0,18,58,3,79
Michigan,Sturgis,10916,279,238,713,676,707,2613
Michigan,Sunfield village,588,13,3,32,38,13,99
Michigan,Maybee village,516,2,0,45,27,28,102
Michigan,Metamora village,597,9,13,47,74,42,185
Michigan,Unionville village,423,3,0,8,24,33,68
Michigan,Vandalia village,406,2,6,10,13,39,70
Michigan,Wayland,4109,48,81,372,305,265,1071
Michigan,Wayne,17251,168,186,977,829,851,3011
Michigan,Webberville village,1308,29,20,53,53,100,255
Michigan,Lakeview village,1073,28,10,59,76,65,238
Michigan,Lake Odessa village,1746,18,38,85,64,106,311
Michigan,Lake Michigan Beach,1167,0,0,12,114,97,223
Michigan,Lake Linden village,1120,23,19,29,39,69,179
Michigan,Lake Leelanau,176,0,0,8,0,32,40
Michigan,Lake Isabella village,1883,19,36,124,74,95,348
Michigan,Lake Fenton,5512,19,139,260,290,196,904
Michigan,Lakewood Club village,1230,13,6,46,60,73,198
Michigan,Lambertville,9731,138,139,235,629,697,1838
Michigan,L'Anse village,2129,32,31,104,61,124,352
Michigan,Lansing,114485,1919,1654,5775,5528,5742,20618
Michigan,Lapeer,8790,166,92,465,431,529,1683
Michigan,Waverly,24535,283,244,779,1192,1206,3704
Michigan,Watervliet,1773,36,38,160,106,83,423
Michigan,Watersmeet,415,20,6,23,15,3,67
Michigan,Warren,134857,1467,1602,6876,6520,7542,24007
Michigan,Vanderbilt village,583,5,9,28,16,30,88
Michigan,Vandercook Lake,4681,37,48,290,346,302,1023
Michigan,Vassar,2648,35,31,128,190,286,670
Michigan,Vermontville village,828,17,21,61,68,34,201
Michigan,Vernon village,973,3,3,71,29,101,207
Michigan,Vicksburg village,3089,53,41,180,176,211,661
Michigan,Village of Clarkston,922,19,9,37,52,38,155
Michigan,Utica,4794,46,85,202,82,186,601
Michigan,Village of Grosse Pointe Shores,2995,13,12,84,238,179,526
Michigan,Wacousta,1342,0,0,31,20,12,63
Michigan,Wakefield,1729,14,12,65,43,111,245
Michigan,Waldron village,594,6,16,39,31,29,121
Michigan,Walker,24242,299,215,1233,1221,1507,4475
Michigan,Walkerville village,175,2,0,6,12,6,26
Michigan,Walled Lake,7091,61,55,244,302,425,1087
Michigan,Walloon Lake,378,0,0,0,12,27,39
Michigan,Vineyard Lake,875,0,0,15,30,13,58
Michigan,Michiana village,198,0,0,5,2,1,8
Michigan,Michigamme,275,0,2,5,10,11,28
Michigan,Michigan Center,4704,26,33,224,380,193,856
Michigan,Boyne City,3766,58,46,234,225,178,741
Michigan,Boyne Falls village,340,3,11,24,17,5,60
Michigan,Breckenridge village,1180,9,17,69,72,55,222
Michigan,Okemos,22073,268,331,875,1047,1080,3601
Michigan,Oden,454,0,0,18,71,12,101
Michigan,Oak Park,29727,334,447,1545,1483,1974,5783
Michigan,Oakley village,196,4,5,4,0,2,15
Michigan,Oak Hill,741,0,37,24,23,51,135
Michigan,Novi,57577,1088,605,3051,3697,3109,11550
Michigan,Norwood,156,3,2,5,12,7,29
Michigan,Norway,2820,36,0,0,55,112,203
Michigan,Norton Shores,23982,199,384,957,1115,1237,3892
Michigan,Northville,5990,71,53,295,265,393,1077
Michigan,Northview,15278,121,167,896,661,876,2721
Michigan,Northport village,633,0,0,30,41,35,106
Michigan,Boon,241,9,2,12,12,2,37
Michigan,Bloomingdale village,655,5,13,41,51,54,164
Michigan,Bloomfield Hills,3956,65,0,230,309,280,884
Michigan,Blissfield village,3154,17,8,290,155,154,624
Michigan,Addison village,573,4,11,24,56,40,135
Michigan,Adrian,20878,285,289,1129,911,996,3610
Michigan,Advance,269,0,0,0,6,16,22
Michigan,Ahmeek village,109,0,0,6,6,5,17
Michigan,Akron village,413,6,3,17,26,37,89
Michigan,Alanson village,675,13,2,17,53,31,116
Michigan,Alba,337,9,0,6,6,7,28
Michigan,North Muskegon,3778,63,36,183,184,237,703
Michigan,Albion,8316,157,93,360,375,338,1323
Michigan,Algonac,4063,43,15,73,323,78,532
Michigan,Allegan,5036,39,75,304,352,277,1047
Michigan,Allen village,243,12,0,1,10,7,30
Michigan,Big Rapids,10532,57,42,246,398,414,1157
Michigan,Bingham Farms village,1158,15,10,37,49,93,204
Michigan,Birch Run village,1558,29,16,93,135,49,322
Michigan,Birmingham,20489,529,304,1239,1131,1099,4302
Michigan,Alden,112,3,0,3,0,0,6
Michigan,North Branch village,1003,25,12,80,57,61,235
Michigan,North Adams village,574,20,6,48,42,33,149
Michigan,Niles,11450,159,217,870,667,538,2451
Michigan,Morrice village,1172,15,32,81,60,41,229
Michigan,Morley village,729,5,11,36,68,63,183
Michigan,Morenci,2512,44,24,138,135,220,561
Michigan,Montrose,1659,7,33,127,140,110,417
Michigan,Montgomery village,300,3,3,35,17,14,72
Michigan,Montague,2408,70,21,191,146,137,565
Michigan,Monroe,20335,358,288,1311,866,1076,3899
Michigan,Mount Clemens,16381,266,158,767,791,896,2878
Michigan,Mio,1740,5,33,158,20,112,328
Michigan,Millington village,886,12,14,38,41,46,151
Michigan,Millersburg village,182,1,4,5,4,6,20
Michigan,Milford village,6390,144,28,244,293,342,1051
Michigan,Milan,5929,36,55,323,554,399,1367
Michigan,Midland,41995,546,609,2057,2160,2298,7670
Michigan,Middleville village,3304,11,55,343,315,230,954
Michigan,Middletown,689,8,0,11,0,32,51
Michigan,Minden City village,216,11,3,19,19,19,71
Michigan,Lathrup Village,4137,78,38,144,166,219,645
Michigan,Mount Morris,3003,37,76,93,139,159,504
Michigan,Muir village,672,19,24,52,33,27,155
Michigan,New Troy,627,13,0,28,44,55,140
Michigan,New Lothrop village,516,4,7,26,29,18,84
Michigan,New Haven village,4679,114,197,347,263,267,1188
Michigan,New Era village,486,5,4,29,24,29,91
Michigan,New Buffalo,1893,25,16,87,109,85,322
Michigan,Newberry village,1729,46,21,114,90,73,344
Michigan,New Baltimore,12212,247,110,781,978,637,2753
Michigan,Mount Pleasant,26134,234,244,652,571,666,2367
Michigan,Newaygo,1870,35,43,115,113,107,413
Michigan,Negaunee,4609,61,35,246,227,237,806
Michigan,Nashville village,1761,6,39,133,163,127,468
Michigan,Napoleon,1103,22,14,154,27,67,284
Michigan,Muskegon Heights,10809,290,319,821,697,688,2815
Michigan,Muskegon,37861,443,362,1783,2157,1985,6730
Michigan,Munising,2303,17,33,84,74,64,272
Michigan,Mulliken village,588,21,17,33,21,28,120
Michigan,Nessen City,161,0,0,2,7,14,23
Michigan,Laurium village,1906,40,26,96,123,122,407
Michigan,Temperance,9369,120,198,436,765,523,2042
Michigan,Lawton village,1712,51,42,92,107,126,418
Michigan,Columbiaville village,800,3,12,51,64,74,204
Michigan,Comstock Northwest,5140,14,109,180,213,182,698
Michigan,Berrien Springs village,1318,5,10,98,47,84,244
Michigan,Berkley,15178,203,185,553,806,828,2575
Michigan,Benzonia village,431,12,12,34,25,21,104
Michigan,Benton Heights,4235,117,130,483,319,352,1401
Michigan,Benton Harbor,10014,415,263,699,623,583,2583
Michigan,Colon village,1136,11,24,69,31,32,167
Michigan,Bendon,191,0,0,6,0,5,11
Michigan,Belleville,3919,44,43,342,129,203,761
Michigan,Bellaire village,917,6,4,33,68,56,167
Michigan,Belding,5771,78,62,336,340,364,1180
Michigan,Beechwood,2839,34,61,182,259,151,687
Michigan,Beecher,10184,220,157,779,454,611,2221
Michigan,Beaverton,1019,12,12,40,35,70,169
Michigan,Bear Lake village,275,1,5,21,13,18,58
Michigan,Bellevue village,1382,10,29,92,43,77,251
Michigan,Bear Lake,370,9,0,6,17,14,46
Michigan,Coloma,1600,13,14,101,118,118,364
Michigan,Coldwater,10866,240,182,778,595,636,2431
Michigan,Centreville village,1582,3,21,60,70,89,243
Michigan,Charlevoix,2523,22,15,69,63,35,204
Michigan,Charlotte,9057,79,97,480,595,541,1792
Michigan,Chatham village,204,0,0,15,9,14,38
Michigan,Cheboygan,4783,70,73,224,277,183,827
Michigan,Chelsea,5126,92,135,305,186,266,984
Michigan,Chesaning village,2471,52,51,165,164,85,517
Michigan,Coleman,1291,27,0,62,44,51,184
Michigan,Chums Corner,1072,48,0,118,17,66,249
Michigan,Clarksville village,402,13,4,26,13,19,75
Michigan,Lawrence village,980,31,14,74,86,29,234
Michigan,Clayton village,360,5,11,24,18,38,96
Michigan,Clifford village,329,1,7,9,12,25,54
Michigan,Climax village,736,10,11,27,43,56,147
Michigan,Clinton village,2237,29,56,119,135,79,418
Michigan,Clio,2582,24,39,110,180,119,472
Michigan,Clare,3042,46,49,123,113,97,428
Michigan,Beal City,438,0,5,40,35,25,105
Michigan,Bay View,221,7,0,0,0,0,7
Michigan,Bay Shore,841,30,12,52,41,14,149
Michigan,Ashley village,494,2,2,20,21,14,59
Michigan,Armada village,1998,21,24,123,158,165,491
Michigan,Argentine,2567,25,47,118,155,166,511
Michigan,Arcadia,236,2,0,6,9,2,19
Michigan,Applegate village,308,9,8,17,12,20,66
Michigan,Ann Arbor,116194,1371,842,3329,3086,3846,12474
Michigan,Amasa,299,6,4,18,9,16,53
Michigan,Athens village,1109,18,14,65,71,88,256
Michigan,Alpha village,75,0,0,4,0,3,7
Michigan,Almont village,2685,13,35,124,109,129,410
Michigan,Alma,9264,231,84,439,407,258,1419
Michigan,Allen Park,27676,451,219,1285,1143,1604,4702
Michigan,Allendale,18456,210,182,688,913,731,2724
Michigan,Lake Orion village,3038,51,30,112,139,195,527
Michigan,Lakes of the North,716,15,8,32,34,2,91
Michigan,Lake Victoria,885,0,0,72,78,55,205
Michigan,Alpena,10273,158,114,417,522,446,1657
Michigan,Atlanta,776,0,0,0,18,30,48
Michigan,Attica,671,0,16,31,7,43,97
Michigan,Auburn,2175,39,19,75,144,136,413
Michigan,Bay Port,403,0,6,10,20,9,45
Michigan,Bay City,34402,449,559,1927,1668,1751,6354
Michigan,Battle Creek,51830,804,708,2974,2983,2840,10309
Michigan,Bath,2142,37,27,113,213,147,537
Michigan,Barton Hills village,289,1,1,8,14,23,47
Michigan,Barryton village,404,7,16,12,10,26,71
Michigan,Baroda village,871,3,7,39,52,33,134
Michigan,Barnes Lake-Millers Lake,921,12,0,59,133,39,243
Michigan,Baraga village,3031,14,15,42,26,79,176
Michigan,Bangor,1849,22,29,129,61,76,317
Michigan,Bancroft village,635,28,20,37,42,41,168
Michigan,Baldwin village,1497,17,23,32,40,146,258
Michigan,Bad Axe,3052,49,0,91,91,175,406
Michigan,Au Sable,1401,12,5,44,52,61,174
Michigan,Augusta village,878,6,8,60,66,32,172
Michigan,Au Gres,832,9,3,40,58,29,139
Michigan,Auburn Hills,22085,308,218,702,700,1054,2982
Michigan,Central Lake village,1068,26,8,48,65,67,214
Michigan,Center Line,8306,36,47,468,432,371,1354
Michigan,Clawson,11988,143,112,482,419,579,1735
Michigan,Byron Center,6391,208,119,495,557,332,1711
Michigan,Caspian,723,0,9,13,20,34,76
Michigan,Cass City village,2542,52,27,146,127,143,495
Michigan,Cassopolis village,1901,49,48,114,48,168,427
Michigan,Wedgewood,198,10,0,5,10,12,37
Michigan,Weidman,934,15,0,103,55,40,213
Michigan,Wellston,304,5,0,4,8,6,23
Michigan,West Branch,2300,52,31,116,89,127,415
Michigan,West Ishpeming,2873,25,5,129,92,103,354
Michigan,Westland,82642,1042,878,3416,3778,3850,12964
Michigan,West Monroe,3345,26,76,81,173,235,591
Michigan,Westphalia village,933,14,24,29,42,44,153
Michigan,Westwood,9372,95,121,285,386,247,1134
Michigan,White Cloud,1351,8,20,87,99,48,262
Michigan,Whitehall,2701,14,42,119,185,172,532
Michigan,White Pigeon village,1519,17,19,51,107,84,278
Michigan,White Pine,395,2,6,9,11,9,37
Michigan,Brownlee Park,2016,67,9,103,96,160,435
Michigan,Beverly Hills village,10403,250,81,679,721,594,2325
Michigan,Beulah village,236,0,1,2,0,2,5
Michigan,Bessemer,1935,14,14,80,54,99,261
Michigan,Cedar,80,0,0,0,0,0,0
Michigan,Casnovia village,457,4,11,24,20,35,94
Michigan,Caseville,773,0,4,41,37,8,90
Michigan,Carsonville village,462,16,22,38,11,10,97
Michigan,Carson City,1124,21,20,58,66,55,220
Michigan,Brutus,174,0,3,4,12,12,31
Michigan,Buchanan,4401,86,20,287,206,351,950
Michigan,Buckley village,774,3,28,73,46,24,174
Michigan,Brooklyn village,1309,27,38,82,62,56,265
Michigan,Buena Vista,6192,53,250,345,322,317,1287
Michigan,Burlington village,263,8,3,13,11,15,50
Michigan,Burr Oak village,870,8,16,52,55,42,173
Michigan,Burt,1103,0,5,34,86,65,190
Michigan,Burton,29223,428,360,1265,1948,1555,5556
Michigan,Byron village,576,2,5,35,79,19,140
Michigan,Cedar Springs,3570,61,81,205,164,289,800
Michigan,Caberfae,20,0,0,0,0,1,1
Michigan,Caledonia village,1509,29,10,132,148,112,431
Michigan,Calumet village,684,8,0,33,38,33,112
Michigan,Camden village,573,10,6,48,41,31,136
Michigan,Canada Creek Ranch,302,6,0,5,16,9,36
Michigan,Canadian Lakes,2768,76,0,72,60,66,274
Michigan,Capac village,1909,13,10,215,151,139,528
Michigan,Carleton village,2447,32,38,186,113,120,489
Michigan,Carney village,237,5,0,0,6,27,38
Michigan,Caro,4142,28,73,76,139,247,563
Michigan,Carp Lake,454,7,0,14,16,10,47
Michigan,Cadillac,10327,155,193,482,521,382,1733
Michigan,Cement City village,466,3,11,11,14,43,82
Michigan,Big Bay,187,0,0,3,4,0,7
Michigan,Brown City,1193,9,3,33,70,87,202
Michigan,Leland,511,5,0,5,46,21,77
Michigan,Lennon village,458,7,14,28,31,21,101
Michigan,Leonard village,390,4,2,35,18,28,87
Michigan,Le Roy village,309,1,0,9,18,20,48
Michigan,Level Park-Oak Park,3595,42,31,114,191,155,533
Michigan,Breedsville village,249,8,1,19,21,9,58
Michigan,Brethren,349,0,3,31,31,28,93
Michigan,Bridgeport,6574,116,38,229,225,123,731
Michigan,Bridgman,1997,30,8,95,96,81,310
Michigan,Brighton,7555,92,21,193,407,425,1138
Michigan,Leslie,1720,21,4,129,123,121,398
Michigan,Bronson,2437,36,38,134,178,242,628
Michigan,Britton village,666,25,8,49,39,48,169
Minnesota,Wheaton,1526,33,38,78,72,71,292
Minnesota,Whipholt,97,2,1,6,5,3,17
Minnesota,White Bear Lake,24709,345,232,1321,1245,1209,4352
Minnesota,White Earth,567,25,12,56,37,31,161
Minnesota,Wilder,45,2,2,4,2,0,10
Minnesota,Willernie,576,13,22,39,31,10,115
Minnesota,Ironton,799,47,25,71,40,25,208
Minnesota,Isanti,5415,137,160,292,262,185,1036
Minnesota,Isle,762,17,7,31,19,26,100
Minnesota,Ivanhoe,535,3,1,16,3,32,55
Minnesota,Jackson,3268,90,39,106,138,220,593
Minnesota,Janesville,2667,61,26,121,132,202,542
Minnesota,Wilmont,387,10,1,33,17,13,74
Minnesota,Willow River,381,6,8,28,17,28,87
Minnesota,Willmar,19685,209,147,999,1338,1100,3793
Minnesota,Williams,197,3,6,12,3,12,36
Minnesota,Iron Junction,104,0,0,8,8,9,25
Minnesota,Kandiyohi,581,3,11,52,53,32,151
Minnesota,Jordan,5900,89,124,414,415,363,1405
Minnesota,Johnson,3,0,0,0,0,0,0
Minnesota,Jenkins,448,18,16,40,14,14,102
Minnesota,Jeffers,419,11,8,23,27,30,99
Minnesota,Jasper,598,3,4,37,33,40,117
Minnesota,Whalan,82,0,0,6,2,4,12
Minnesota,International Falls,6270,109,112,257,238,316,1032
Minnesota,West St. Paul,19709,385,189,962,911,1257,3704
Minnesota,Inger,251,8,9,12,14,10,53
Minnesota,Independence,3671,61,42,247,188,338,876
Minnesota,Ihlen,44,0,0,0,0,2,2
Minnesota,Hutchinson,13941,217,243,641,689,701,2491
Minnesota,Humboldt,18,0,0,0,0,0,0
Minnesota,Hugo,14053,321,192,914,829,710,2966
Minnesota,Hoyt Lakes,2002,39,28,61,85,78,291
Minnesota,Howard Lake,2115,51,17,131,189,209,597
Minnesota,Iona,128,0,5,8,4,3,20
Minnesota,Viking,130,0,4,17,11,5,37
Minnesota,Victoria,8103,230,124,628,646,520,2148
Minnesota,Vesta,322,3,6,8,11,23,51
Minnesota,Vernon Center,338,4,1,20,19,28,72
Minnesota,Verndale,733,10,9,55,52,32,158
Minnesota,Vermillion,471,6,1,12,22,18,59
Minnesota,Vergas,308,2,2,5,15,9,33
Minnesota,Vadnais Heights,12968,265,140,441,584,686,2116
Minnesota,Utica,308,11,1,20,37,11,80
Minnesota,Inver Grove Heights,34417,504,372,1718,2021,1906,6521
Minnesota,Westbrook,756,6,5,35,39,29,114
Minnesota,West Concord,812,12,12,72,46,43,185
Minnesota,Westport,37,2,0,2,1,4,9
Minnesota,West Roy Lake,52,0,0,1,6,5,12
Minnesota,West Union,142,4,0,10,4,16,34
Minnesota,Urbank,68,4,0,8,4,0,16
Minnesota,Waltham,167,11,2,1,1,4,19
Minnesota,Kasota,820,9,14,44,33,45,145
Minnesota,Lafayette,479,11,6,23,33,24,97
Minnesota,Lake Benton,685,8,20,29,25,39,121
Minnesota,Lake Bronson,228,0,2,10,11,13,36
Minnesota,Lake City,5111,133,17,167,218,223,758
Minnesota,Lake Crystal,2545,71,49,280,113,174,687
Minnesota,Lake Elmo,8199,122,61,516,603,563,1865
Minnesota,Lakefield,1527,34,39,75,65,47,260
Minnesota,Lake George,186,0,0,5,6,8,19
Minnesota,Lake Henry,78,0,0,3,9,6,18
Minnesota,Lakeland,1741,11,26,66,132,86,321
Minnesota,Lakeland Shores,304,8,3,13,16,15,55
Minnesota,Lake Lillian,271,17,4,14,4,6,45
Minnesota,Lake Park,725,24,23,21,29,36,133
Minnesota,Lake St. Croix Beach,1135,14,3,45,44,79,185
Minnesota,Lake Shore,1025,6,21,43,33,29,132
Minnesota,Lakeville,58592,1076,863,3914,4317,4702,14872
Minnesota,Lake Wilson,253,2,2,7,12,4,27
Minnesota,Lamberton,844,20,1,68,23,42,154
Minnesota,Lancaster,372,5,8,48,23,8,92
Minnesota,Landfall,752,7,21,66,24,50,168
Minnesota,Lanesboro,755,4,4,49,19,36,112
Minnesota,Lansing,184,9,0,23,3,16,51
Minnesota,Waseca,9324,165,189,521,388,398,1661
Minnesota,Warsaw,764,15,0,30,52,26,123
Minnesota,Warroad,1862,134,17,91,85,59,386
Minnesota,Warren,1576,11,31,86,90,83,301
Minnesota,Warba,108,0,0,0,12,5,17
Minnesota,Wanda,59,0,0,0,1,6,7
Minnesota,Wanamingo,1179,61,14,71,73,36,255
Minnesota,La Crescent,4815,168,111,253,210,270,1012
Minnesota,Kinney,160,5,0,12,10,5,32
Minnesota,Kingston,157,2,7,7,10,10,36
Minnesota,Kinbrae,2,0,0,0,0,0,0
Minnesota,Kasson,6049,130,39,472,485,366,1492
Minnesota,Keewatin,1080,18,19,32,25,52,146
Minnesota,Kelliher,303,0,11,24,10,17,62
Minnesota,Kellogg,385,3,4,34,8,8,57
Minnesota,Kennedy,241,4,0,8,20,31,63
Minnesota,Kenneth,69,2,0,7,2,8,19
Minnesota,Kensington,298,8,2,9,19,18,56
Minnesota,Kent,69,0,3,2,0,4,9
Minnesota,Kenyon,1724,34,36,92,79,84,325
Minnesota,Kerkhoven,793,16,15,67,33,42,173
Minnesota,Kerrick,52,0,0,0,1,0,1
Minnesota,Walters,121,6,4,1,9,0,20
Minnesota,Wilton,184,0,7,10,1,12,30
Minnesota,Villard,216,1,1,6,9,12,29
Minnesota,Karlstad,783,20,13,38,41,90,202
Minnesota,Vineland,962,30,20,115,75,30,270
Minnesota,Virginia,8658,107,172,420,318,439,1456
Minnesota,Wabasha,2659,41,31,123,89,131,415
Minnesota,Wabasso,636,25,5,33,23,41,127
Minnesota,Kettle River,156,3,3,5,4,11,26
Minnesota,Waconia,11494,310,141,728,974,695,2848
Minnesota,Wadena,4056,43,83,218,156,187,687
Minnesota,Wahkon,205,0,2,5,6,11,24
Minnesota,Waite Park,7429,79,60,353,283,466,1241
Minnesota,Waldorf,192,1,0,11,8,11,31
Minnesota,Walker,1036,19,7,28,57,42,153
Minnesota,Walnut Grove,821,21,28,60,50,44,203
Minnesota,Kiester,449,12,5,4,16,9,46
Minnesota,Kilkenny,327,38,6,18,9,2,73
Minnesota,Kimball,884,5,13,42,39,41,140
Minnesota,Vining,41,0,0,3,1,3,7
Minnesota,Windom,4601,120,106,236,252,163,877
Minnesota,Lastrup,151,7,0,6,6,0,19
Minnesota,Winnebago,1432,32,28,83,44,78,265
Minnesota,Arden Hills,9797,131,89,314,237,501,1272
Minnesota,Arco,116,3,2,15,5,0,25
Minnesota,Apple Valley,50309,833,658,2374,2697,2879,9441
Minnesota,Appleton,1540,30,28,97,67,97,319
Minnesota,Anoka,17244,224,282,754,805,815,2880
Minnesota,Annandale,3296,89,66,180,166,70,571
Minnesota,Argyle,569,4,7,12,32,52,107
Minnesota,Angle Inlet,22,0,0,0,0,0,0
Minnesota,Amboy,520,7,6,29,27,8,77
Minnesota,Alvarado,444,10,2,19,15,15,61
Minnesota,Altura,474,18,5,20,28,25,96
Minnesota,Alpha,269,1,0,41,7,5,54
Minnesota,Alexandria,11614,316,145,528,400,446,1835
Minnesota,Aldrich,68,0,0,3,2,0,5
Minnesota,Andover,31553,380,442,2103,2583,2688,8196
Minnesota,Alden,643,6,3,16,51,50,126
Minnesota,Arlington,2181,60,18,139,95,110,422
Minnesota,Ashby,473,4,10,42,39,26,121
Minnesota,Balaton,524,8,0,12,13,26,59
Minnesota,Baker,66,0,4,2,2,0,8
Minnesota,Bagley,1410,37,23,75,89,74,298
Minnesota,Badger,425,7,5,21,27,19,79
Minnesota,Backus,319,5,5,14,5,5,34
Minnesota,Babbitt,1537,38,17,55,40,42,192
Minnesota,Arnold,3071,0,24,69,270,151,514
Minnesota,Upsala,480,14,15,23,4,32,88
Minnesota,Avoca,89,0,0,0,3,0,3
Minnesota,Austin,24687,478,418,1332,1567,1487,5282
Minnesota,Aurora,1724,11,13,71,65,83,243
Minnesota,Audubon,593,9,25,33,31,29,127
Minnesota,Atwater,1071,11,25,80,63,51,230
Minnesota,Askov,370,9,1,18,8,19,55
Minnesota,Avon,1592,45,40,101,107,61,354
Minnesota,Ball Club,247,9,4,10,0,0,23
Minnesota,Albertville,7226,300,141,616,622,433,2112
Minnesota,Alberta,122,0,4,8,12,11,35
Minnesota,Danube,596,22,20,38,52,46,178
Minnesota,Dalton,292,10,18,15,18,9,70
Minnesota,Dakota,336,5,2,23,25,7,62
Minnesota,Cyrus,341,5,0,22,19,27,73
Minnesota,Wendell,116,0,0,1,2,0,3
Minnesota,Wells,2358,28,37,117,117,110,409
Minnesota,Danvers,140,0,4,10,10,13,37
Minnesota,Welcome,774,29,10,52,54,29,174
Minnesota,Waverly,1565,55,24,114,105,89,387
Minnesota,Waubun,511,6,3,28,28,20,85
Minnesota,Watson,176,3,0,5,8,14,30
Minnesota,Watkins,864,18,6,68,33,52,177
Minnesota,Waterville,1731,17,14,88,87,81,287
Minnesota,Watertown,4257,53,104,272,252,148,829
Minnesota,Wayzata,4166,41,68,169,196,111,585
Minnesota,Albert Lea,17843,287,204,826,753,832,2902
Minnesota,Darfur,115,0,1,14,4,0,19
Minnesota,Dassel,1447,36,20,98,62,56,272
Minnesota,Albany,2618,26,32,159,102,154,473
Minnesota,Akeley,397,15,1,17,19,3,55
Minnesota,Aitkin,2279,38,27,147,108,116,436
Minnesota,Afton,2932,15,28,85,165,194,487
Minnesota,Adrian,1278,14,32,64,65,37,212
Minnesota,Adams,742,6,14,29,51,42,142
Minnesota,Darwin,350,9,6,15,21,30,81
Minnesota,Ada,1681,11,6,79,103,118,317
Minnesota,Deerwood,455,9,5,23,17,21,75
Minnesota,Deer River,1027,16,8,59,60,63,206
Minnesota,Deer Creek,232,1,5,5,13,6,30
Minnesota,Deephaven,3769,168,54,323,209,223,977
Minnesota,Dayton,4857,93,55,210,311,269,938
Minnesota,Dawson,1518,27,13,72,83,112,307
Minnesota,De Graff,126,1,8,3,7,3,22
Minnesota,Winger,261,7,0,13,26,35,81
Minnesota,Barnesville,2571,23,33,247,162,168,633
Minnesota,Barrett,339,0,7,21,26,29,83
Minnesota,Zumbrota,3325,149,20,298,206,181,854
Minnesota,St. Leo,91,0,3,0,5,2,10
Minnesota,St. Joseph,6749,100,84,270,172,194,820
Minnesota,St. James,4508,138,49,373,271,162,993
Minnesota,St. Hilaire,283,1,1,14,8,5,29
Minnesota,St. Francis,7340,156,165,542,318,330,1511
Minnesota,Zumbro Falls,176,2,3,15,9,7,36
Minnesota,St. Cloud,66298,608,756,3020,2539,2613,9536
Minnesota,St. Charles,3710,131,95,263,114,125,728
Minnesota,St. Bonifacius,2472,25,52,128,157,175,537
Minnesota,St. Augusta,3486,80,72,253,154,138,697
Minnesota,St. Anthony city (Stearns County),106,2,0,17,4,6,29
Minnesota,St. Anthony city (Hennepin and Ramsey Counties),8662,134,132,381,280,251,1178
Minnesota,Sacred Heart,613,13,7,41,47,14,122
Minnesota,St. Clair,896,14,30,86,39,98,267
Minnesota,Sabin,582,9,2,50,34,58,153
Minnesota,Zimmerman,5280,91,136,571,308,301,1407
Minnesota,Wyoming,7755,116,89,420,568,609,1802
Minnesota,Winona,27437,146,169,698,834,955,2802
Minnesota,Winsted,2377,46,76,165,147,121,555
Minnesota,Winthrop,1370,55,4,66,88,101,314
Minnesota,Winton,105,1,1,1,1,4,8
Minnesota,Wolf Lake,57,2,0,9,9,0,20
Minnesota,Wolverton,93,2,2,6,0,0,10
Minnesota,Zemple,92,0,1,3,12,7,23
Minnesota,Woodbury,65667,1429,991,4112,4474,4010,15016
Minnesota,Woodland,443,4,7,23,23,32,89
Minnesota,Woodstock,149,8,0,6,6,9,29
Minnesota,Worthington,12990,293,122,812,732,831,2790
Minnesota,Wrenshall,489,3,3,40,28,24,98
Minnesota,Wright,148,9,0,17,5,1,32
Minnesota,Wykoff,418,6,12,20,22,11,71
Minnesota,Wood Lake,388,8,7,18,25,21,79
Minnesota,Barnum,664,9,20,49,35,21,134
Minnesota,Rutledge,194,0,4,10,11,9,34
Minnesota,Russell,404,20,10,28,23,21,102
Minnesota,Rockford,4218,83,135,250,155,181,804
Minnesota,Rock Creek,1653,7,28,92,96,101,324
Minnesota,Rochester,110275,2159,1457,6191,5358,5605,20770
Minnesota,Robbinsdale,14289,218,221,523,646,540,2148
Minnesota,Riverton,116,0,0,2,2,1,5
Minnesota,Riverland,271,9,13,49,30,14,115
Minnesota,Rockville,2481,71,26,116,103,155,471
Minnesota,Richville,75,2,0,4,2,3,11
Minnesota,Beardsley,170,2,3,9,8,6,28
Minnesota,Bayport,3648,32,68,153,59,91,403
Minnesota,Baxter,7768,121,44,472,573,570,1780
Minnesota,Baudette,1096,28,5,96,76,55,260
Minnesota,Battle Lake,868,7,0,28,68,60,163
Minnesota,Barry,9,0,0,0,0,0,0
Minnesota,Richmond,1498,18,6,66,101,105,296
Minnesota,Ruthton,258,5,4,6,15,25,55
Minnesota,Rogers,12002,141,220,891,738,794,2784
Minnesota,Ronneby,32,2,0,0,0,2,4
Minnesota,Rushmore,288,5,2,15,7,6,35
Minnesota,Rushford Village,946,14,8,48,59,58,187
Minnesota,Rushford,1916,32,58,105,113,128,436
Minnesota,Rush City,3068,15,29,45,178,210,477
Minnesota,Roy Lake,15,0,0,0,0,0,0
Minnesota,Royalton,1230,39,28,94,67,27,255
Minnesota,Rollingstone,615,10,7,31,33,54,135
Minnesota,Round Lake,398,3,5,20,11,22,61
Minnesota,Roseville,34948,567,385,1248,1695,1403,5298
Minnesota,Rosemount,22741,526,354,1686,1552,1615,5733
Minnesota,Rose Creek,382,15,5,32,14,11,77
Minnesota,Roseau,2647,18,74,115,163,210,580
Minnesota,Roscoe,132,1,0,10,2,2,15
Minnesota,Roosevelt,131,0,5,6,12,4,27
Minnesota,Rothsay,461,3,10,27,35,27,102
Minnesota,Underwood,384,4,2,26,33,14,79
Minnesota,Beaver Creek,304,6,9,20,11,30,76
Minnesota,Tyler,1244,42,35,94,43,41,255
Minnesota,St. Marys Point,351,3,2,19,24,26,74
Minnesota,St. Michael,16911,246,277,1265,1342,1147,4277
Minnesota,St. Paul,295043,4970,4279,16433,15070,16295,57047
Minnesota,St. Paul Park,5341,83,37,232,245,286,883
Minnesota,St. Peter,11492,222,34,518,536,430,1740
Minnesota,St. Rosa,74,0,1,7,2,4,14
Minnesota,Dexter,288,1,1,7,5,19,33
Minnesota,Detroit Lakes,8897,236,129,457,326,334,1482
Minnesota,Dent,162,4,4,8,8,2,26
Minnesota,St. Stephen,953,17,14,66,51,54,202
Minnesota,St. Vincent,35,1,0,0,0,1,2
Minnesota,Sanborn,337,2,4,9,6,6,27
Minnesota,Sandstone,2780,50,10,97,96,121,374
Minnesota,Sargeant,60,1,0,1,0,4,6
Minnesota,Sartell,16274,370,303,1204,1242,973,4092
Minnesota,Sauk Centre,4331,90,93,241,146,139,709
Minnesota,Sauk Rapids,13196,176,222,903,659,538,2498
Minnesota,Savage,28713,645,521,2333,1770,1722,6991
Minnesota,Scandia,3995,24,25,138,134,289,610
Minnesota,Scanlon,1209,16,26,49,108,51,250
Minnesota,Seaforth,89,2,0,15,17,6,40
Minnesota,St. Martin,364,6,10,37,20,22,95
Minnesota,St. Louis Park,47043,765,492,1841,1875,1742,6715
Minnesota,Dilworth,4166,85,88,274,282,187,916
Minnesota,Dodge Center,2680,72,79,208,183,211,753
Minnesota,Edgerton,1217,19,35,69,55,62,240
Minnesota,Eden Valley,957,15,13,53,64,78,223
Minnesota,Eden Prairie,62626,1447,717,3289,3869,3757,13079
Minnesota,Echo,299,5,3,15,25,29,77
Minnesota,Ebro,103,4,2,16,4,7,33
Minnesota,Easton,230,4,3,17,13,5,42
Minnesota,East Gull Lake,992,5,2,56,58,64,185
Minnesota,East Grand Forks,8611,158,186,396,481,528,1749
Minnesota,East Bethel,11625,122,104,475,644,677,2022
Minnesota,Eagle Lake,2612,92,36,223,140,87,578
Minnesota,Searles,196,6,1,13,16,10,46
Minnesota,Eagle Bend,450,0,13,29,19,9,70
Minnesota,Dunnell,173,2,0,10,3,7,22
Minnesota,Dundee,123,1,0,13,10,2,26
Minnesota,Dundas,1647,38,57,132,89,112,428
Minnesota,Dumont,98,4,0,4,6,5,19
Minnesota,Duluth,86178,1198,777,3329,3258,3621,12183
Minnesota,Dovray,69,0,6,0,0,0,6
Minnesota,Dover,811,29,13,76,68,36,222
Minnesota,Doran,31,4,0,0,0,0,4
Minnesota,Donnelly,245,0,8,19,14,10,51
Minnesota,Donaldson,19,0,0,0,0,0,0
Minnesota,Eagan,65424,1002,897,3398,3565,3810,12672
Minnesota,Sebeka,688,21,5,43,36,55,160
Minnesota,Sedan,42,1,0,0,0,5,6
Minnesota,Fertile,931,10,14,60,54,79,217
Minnesota,Garfield,251,1,0,15,13,7,36
Minnesota,Dennison,137,4,1,10,6,8,29
Minnesota,Denham,37,0,2,2,0,2,6
Minnesota,Dellwood,1164,17,11,66,85,100,279
Minnesota,Delhi,44,0,0,0,3,1,4
Minnesota,Delavan,245,6,8,18,15,20,67
Minnesota,Garrison,225,0,0,6,7,10,23
Minnesota,Garvin,120,0,1,10,9,4,24
Minnesota,Gary,266,2,1,20,28,16,67
Minnesota,Gaylord,2080,33,30,66,126,122,377
Minnesota,Garden City,373,13,0,25,30,20,88
Minnesota,Gem Lake,465,6,4,23,21,26,80
Minnesota,Genola,73,1,0,3,3,5,12
Minnesota,Georgetown,113,7,0,17,4,10,38
Minnesota,Ghent,344,9,7,14,14,33,77
Minnesota,Gibbon,825,41,25,61,34,32,193
Minnesota,Gilbert,1809,24,34,94,75,62,289
Minnesota,Gilman,183,8,6,8,4,4,30
Minnesota,Glencoe,5557,42,57,361,241,410,1111
Minnesota,Taconite,634,9,6,45,40,28,128
Minnesota,Tamarack,54,0,2,0,2,6,10
Minnesota,Taopi,54,1,0,1,1,1,4
Minnesota,Geneva,411,8,2,49,18,16,93
Minnesota,Edina,49373,1211,648,2793,2768,2976,10396
Minnesota,Funkley,5,0,0,0,0,0,0
Minnesota,Frost,227,1,8,10,8,24,51
Minnesota,Fifty Lakes,318,0,0,7,3,10,20
Minnesota,Finland,165,0,0,0,5,30,35
Minnesota,Finlayson,261,6,5,9,9,19,48
Minnesota,Fisher,464,8,5,40,36,15,104
Minnesota,Fish Lake,82,0,3,3,7,4,17
Minnesota,Flensburg,193,5,2,20,7,9,43
Minnesota,Floodwood,472,2,10,24,24,24,84
Minnesota,Florence,14,0,0,0,0,0,0
Minnesota,Foley,2636,47,31,263,143,145,629
Minnesota,Forada,211,4,1,6,6,6,23
Minnesota,Fulda,1296,29,13,53,62,53,210
Minnesota,Forest Lake,19170,309,328,1284,1128,1186,4235
Minnesota,Fort Ripley,103,0,2,3,2,0,7
Minnesota,Fosston,1624,17,34,78,100,101,330
Minnesota,Fountain,421,7,9,37,27,25,105
Minnesota,Foxhome,127,0,1,8,3,9,21
Minnesota,Franklin,636,25,9,36,50,45,165
Minnesota,Frazee,1320,30,30,49,80,85,274
Minnesota,Freeborn,333,8,11,26,16,14,75
Minnesota,Freeport,607,14,4,31,25,13,87
Minnesota,Fridley,27592,341,340,1385,1087,1503,4656
Minnesota,Frontenac,197,0,0,4,7,3,14
Minnesota,Foreston,643,14,9,49,53,51,176
Minnesota,Taunton,161,4,0,5,14,14,37
Minnesota,Effie,83,0,2,5,2,8,17
Minnesota,Elba,139,0,0,9,1,6,16
Minnesota,Loretto,709,18,18,59,33,34,162
Minnesota,Louisburg,35,1,0,0,0,0,1
Minnesota,Lowry,339,14,6,16,17,10,63
Minnesota,Lucan,175,5,4,13,10,10,42
Minnesota,Lutsen,437,28,0,22,1,4,55
Minnesota,Luverne,4665,90,115,301,246,207,959
Minnesota,Lyle,504,14,0,17,39,47,117
Minnesota,Lynd,563,22,8,26,24,38,118
Minnesota,Mabel,741,7,2,43,46,26,124
Minnesota,McGrath,82,0,5,2,2,4,13
Minnesota,McGregor,456,5,5,22,17,68,117
Minnesota,McIntosh,537,9,19,22,29,18,97
Minnesota,McKinley,159,0,2,23,0,6,31
Minnesota,Madelia,2368,89,41,137,142,86,495
Minnesota,Madison,1558,44,18,52,53,52,219
Minnesota,Madison Lake,985,34,15,52,41,27,169
Minnesota,Magnolia,212,0,4,5,8,23,40
Minnesota,Mahnomen,1275,25,8,68,65,29,195
Minnesota,Mahnomen,266,19,15,21,26,14,95
Minnesota,Mahtomedi,7999,122,60,575,564,634,1955
Minnesota,Mahtowa,428,19,9,50,19,31,128
Minnesota,Lonsdale,3781,139,55,236,324,187,941
Minnesota,Longville,92,0,0,0,2,5,7
Minnesota,Long Prairie,3392,72,53,283,165,254,827
Minnesota,Long Lake,1803,12,23,126,77,75,313
Minnesota,Lauderdale,2468,57,5,64,35,46,207
Minnesota,Le Center,2370,69,18,210,180,68,545
Minnesota,Lengby,63,0,0,0,0,0,0
Minnesota,Leonard,42,0,0,3,1,0,4
Minnesota,Leonidas,39,0,1,0,4,0,5
Minnesota,Leota,192,4,0,8,9,15,36
Minnesota,Le Roy,819,12,17,60,21,19,129
Minnesota,Lester Prairie,1737,28,25,154,128,89,424
Minnesota,Le Sueur,4020,41,20,177,256,241,735
Minnesota,Lewiston,1562,41,21,79,72,155,368
Minnesota,Manchester,39,0,0,0,1,3,4
Minnesota,Lewisville,222,3,8,12,4,8,35
Minnesota,Lilydale,750,2,8,4,5,16,35
Minnesota,Lindstrom,4417,149,30,128,294,320,921
Minnesota,Lino Lakes,20819,407,134,1064,1624,1784,5013
Minnesota,Lismore,250,5,4,12,21,24,66
Minnesota,Litchfield,6691,163,119,423,283,308,1296
Minnesota,Little Canada,10120,125,86,477,532,431,1651
Minnesota,Little Falls,8721,195,104,308,389,432,1428
Minnesota,Littlefork,671,7,12,41,28,24,112
Minnesota,Little Rock,1170,39,25,114,74,113,365
Minnesota,Long Beach,334,5,6,10,2,5,28
Minnesota,Lexington,1969,39,23,99,134,121,416
Minnesota,Manhattan Beach,69,0,0,0,9,4,13
Minnesota,Mankato,40557,731,421,1238,1371,1096,4857
Minnesota,Mantorville,1153,15,0,53,49,79,196
Minnesota,Farmington,22159,676,621,1648,1584,922,5451
Minnesota,Farwell,55,3,0,1,2,2,8
Minnesota,Federal Dam,94,5,0,7,4,7,23
Minnesota,Felton,150,0,2,6,3,1,12
Minnesota,Fergus Falls,13266,258,189,470,327,472,1716
Minnesota,Erhard,117,0,2,3,5,0,10
Minnesota,Emmons,413,13,3,27,18,25,86
Minnesota,Emily,746,3,2,11,54,29,99
Minnesota,Elysian,604,0,3,27,20,25,75
Minnesota,Ely,3445,21,16,84,157,117,395
Minnesota,Faribault,23509,397,386,1336,1401,1335,4855
Minnesota,Elrosa,174,7,1,7,4,9,28
Minnesota,Elmdale,84,0,1,3,8,8,20
Minnesota,Ellsworth,470,7,0,12,16,31,66
Minnesota,Ellendale,685,21,15,37,49,39,161
Minnesota,Elkton,111,2,4,15,7,1,29
Minnesota,Elk River,23563,361,433,1492,1272,1650,5208
Minnesota,Elko New Market,4529,214,149,364,296,231,1254
Minnesota,Elizabeth,172,3,0,13,11,9,36
Minnesota,Elgin,1184,21,17,65,92,82,277
Minnesota,Elbow Lake,1191,17,20,67,53,87,244
Minnesota,Elbow Lake,113,3,2,2,2,9,18
Minnesota,Elmore,614,34,3,25,37,60,159
Minnesota,Eitzen,229,6,6,10,2,2,26
Minnesota,Falcon Heights,5484,86,60,245,120,144,655
Minnesota,Fairhaven,356,3,2,33,36,3,77
Minnesota,Maple Grove,65687,1643,940,3609,3815,3857,13864
Minnesota,Maple Lake,2103,59,25,142,152,151,529
Minnesota,Maple Plain,1851,9,33,87,116,94,339
Minnesota,Mapleton,1759,54,32,89,118,158,451
Minnesota,Mapleview,209,2,3,10,10,1,26
Minnesota,Maplewood,39775,626,513,1980,2005,2314,7438
Minnesota,Marble,567,2,16,28,21,38,105
Minnesota,Marietta,139,0,0,2,0,9,11
Minnesota,Marine on St. Croix,722,7,9,46,36,44,142
Minnesota,Marshall,13608,330,230,561,565,707,2393
Minnesota,Fairmont,10387,201,137,428,455,503,1724
Minnesota,Martin Lake,1013,9,4,24,60,56,153
Minnesota,La Prairie,791,28,2,61,59,50,200
Minnesota,Laporte,178,0,2,5,11,30,48
Minnesota,Erskine,511,6,8,37,15,26,92
Minnesota,Esko,1638,11,7,63,133,149,363
Minnesota,Evan,51,2,0,1,0,1,4
Minnesota,Evansville,603,15,7,15,28,19,84
Minnesota,Eveleth,3692,55,91,195,119,182,642
Minnesota,Excelsior,2146,17,20,94,133,98,362
Minnesota,Eyota,2092,62,28,139,194,130,553
Minnesota,Fairfax,955,6,5,26,37,27,101
Minnesota,Mayer,1754,65,56,99,95,98,413
Minnesota,Ulen,550,3,8,16,20,26,73
Minnesota,Taylors Falls,1019,15,26,47,55,32,175
Minnesota,The Lakes,687,12,0,30,34,34,110
Minnesota,Comfrey,359,6,1,26,11,13,57
Minnesota,Shafer,991,37,27,49,64,51,228
Minnesota,Shakopee,39137,794,645,3009,2077,2291,8816
Minnesota,Shelly,199,1,0,5,5,11,22
Minnesota,Sherburn,1027,14,17,46,71,28,176
Minnesota,Shevlin,177,2,0,2,9,11,24
Minnesota,Shoreview,25951,400,213,1164,1203,1460,4440
Minnesota,Shorewood,7509,190,104,366,530,724,1914
Minnesota,Silver Bay,1745,28,20,26,46,85,205
Minnesota,Silver Creek,267,0,0,4,16,7,27
Minnesota,Silver Lake,964,19,33,58,61,36,207
Minnesota,Skyline,340,6,0,15,14,19,54
Minnesota,Slayton,2070,42,18,102,61,94,317
Minnesota,Sleepy Eye,3498,110,84,223,223,214,854
Minnesota,Sobieski,185,0,3,10,9,7,29
Minnesota,Solway,115,2,2,4,7,12,27
Minnesota,Soudan,435,6,2,10,30,21,69
Minnesota,South End,21,2,0,2,2,2,8
Minnesota,South Haven,236,4,9,26,27,13,79
Minnesota,South St. Paul,20413,334,169,1040,1075,1156,3774
Minnesota,Spicer,1294,23,14,73,63,69,242
Minnesota,Beaulieu,54,0,0,0,0,5,5
Minnesota,Beaver Bay,126,0,2,0,5,13,20
Minnesota,La Salle,48,1,0,6,2,1,10
Minnesota,Becker,4647,159,78,450,337,181,1205
Minnesota,Biwabik,933,13,0,34,46,28,121
Minnesota,Biscay,68,0,0,3,1,2,6
Minnesota,Bird Island,849,18,2,37,35,52,144
Minnesota,Birchwood Village,867,0,4,22,45,37,108
Minnesota,Bingham Lake,123,1,0,10,8,6,25
Minnesota,Big Lake,10285,202,187,909,678,901,2877
Minnesota,Big Lake,382,5,5,3,5,26,44
Minnesota,Bigfork,412,0,2,13,13,11,39
Minnesota,Big Falls,228,0,7,4,13,4,28
Minnesota,Bigelow,224,1,6,13,11,9,40
Minnesota,Springfield,2039,29,31,114,155,133,462
Minnesota,Bethel,423,5,4,23,26,29,87
Minnesota,Benson,3139,48,59,123,132,108,470
Minnesota,Bena,141,2,3,17,13,13,48
Minnesota,Bemidji,14417,211,84,588,537,588,2008
Minnesota,Belview,412,0,5,12,15,27,59
Minnesota,Beltrami,120,1,0,0,9,8,18
Minnesota,Bellingham,144,0,0,4,5,7,16
Minnesota,Belle Plaine,6838,256,104,478,361,299,1498
Minnesota,Bellechester,217,3,1,13,13,19,49
Minnesota,Belgrade,714,4,23,29,49,47,152
Minnesota,Bejou,97,8,0,2,1,2,13
Minnesota,Bertha,512,12,7,32,10,69,130
Minnesota,Spring Grove,1241,14,5,73,71,25,188
Minnesota,Spring Hill,50,0,0,1,2,3,6
Minnesota,Spring Lake Park,6504,51,79,326,312,352,1120
Minnesota,Courtland,714,17,7,46,47,22,139
Minnesota,Cromwell,246,9,0,10,2,17,38
Minnesota,Crookston,7847,114,78,374,277,416,1259
Minnesota,Crosby,2324,19,16,131,120,141,427
Minnesota,Crosslake,2030,23,7,55,38,69,192
Minnesota,Crystal,22607,338,430,915,1252,894,3829
Minnesota,Sunburg,82,2,0,3,1,3,9
Minnesota,Currie,209,3,1,8,4,7,23
Minnesota,Cuyuna,283,8,5,20,21,25,79
Minnesota,Tonka Bay,1481,34,29,81,115,96,355
Minnesota,Cottonwood,1257,21,26,93,92,61,293
Minnesota,Tower,620,2,13,7,28,15,65
Minnesota,Trail,69,0,0,2,7,0,9
Minnesota,Trimont,755,21,2,49,45,47,164
Minnesota,Trommald,92,2,0,0,2,2,6
Minnesota,Trosky,102,1,0,7,10,4,22
Minnesota,Truman,1145,13,7,53,51,68,192
Minnesota,Turtle River,107,0,2,18,5,0,25
Minnesota,Twin Lakes,176,6,0,7,5,13,31
Minnesota,Twin Lakes,176,5,2,9,15,8,39
Minnesota,Twin Valley,752,11,18,59,47,43,178
Minnesota,Two Harbors,3643,105,32,195,137,242,711
Minnesota,Tracy,2110,34,47,131,146,96,454
Minnesota,Blackduck,812,58,22,38,34,48,200
Minnesota,Cottage Grove,35405,890,528,2554,1857,2241,8070
Minnesota,Correll,22,2,0,0,0,1,3
Minnesota,Spring Park,1731,19,10,30,17,24,100
Minnesota,Spring Valley,2555,47,24,177,94,144,486
Minnesota,Squaw Lake,111,3,5,5,16,8,37
Minnesota,Stacy,1517,39,19,92,57,77,284
Minnesota,Stanchfield,104,0,0,13,8,7,28
Minnesota,Staples,2848,95,55,100,142,257,649
Minnesota,Starbuck,1197,11,33,57,41,36,178
Minnesota,Steen,226,5,2,15,14,30,66
Minnesota,Stephen,788,13,5,37,58,23,136
Minnesota,Stewart,518,7,0,50,27,17,101
Minnesota,Cosmos,494,12,6,8,27,23,76
Minnesota,Stewartville,6006,68,107,578,331,379,1463
Minnesota,Stockton,690,23,17,32,28,47,147
Minnesota,Storden,248,5,5,14,24,8,56
Minnesota,Strandquist,90,0,0,4,0,7,11
Minnesota,Strathcona,30,0,0,0,0,0,0
Minnesota,Sturgeon Lake,441,12,9,23,20,32,96
Minnesota,Comstock,124,1,2,3,10,9,25
Minnesota,Conger,176,4,0,20,17,1,42
Minnesota,Cook,606,16,0,15,32,24,87
Minnesota,Coon Rapids,61946,958,895,3022,2898,3026,10799
Minnesota,Corcoran,5521,95,77,223,282,418,1095
Minnesota,Stillwater,18677,393,157,1172,1355,1426,4503
Minnesota,Tenstrike,187,2,6,8,10,4,30
Minnesota,Blaine,60224,1236,982,3671,3497,3249,12635
Minnesota,Blooming Prairie,1897,63,22,82,135,150,452
Minnesota,Chokio,379,7,0,27,18,4,56
Minnesota,Circle Pines,4931,128,90,129,239,203,789
Minnesota,Clara City,1381,28,43,96,62,72,301
Minnesota,Claremont,551,33,1,20,26,14,94
Minnesota,Clarissa,834,22,22,42,30,56,172
Minnesota,Clarkfield,824,13,12,40,25,52,142
Minnesota,Clarks Grove,606,3,11,32,13,29,88
Minnesota,Clearbrook,503,33,4,15,14,13,79
Minnesota,Clear Lake,581,26,13,29,37,25,130
Minnesota,Clearwater,1783,48,39,106,62,58,313
Minnesota,Clements,185,8,1,12,13,8,42
Minnesota,Cleveland,635,8,8,27,36,41,120
Minnesota,Climax,290,5,11,26,20,15,77
Minnesota,Clinton,364,11,4,17,10,23,65
Minnesota,Clitherall,76,0,0,0,0,3,3
Minnesota,Clontarf,125,4,0,4,2,3,13
Minnesota,Cloquet,12071,272,246,674,639,619,2450
Minnesota,Coates,139,0,2,12,2,3,19
Minnesota,Cobden,23,0,0,0,0,4,4
Minnesota,Cohasset,2737,15,17,126,200,166,524
Minnesota,Cokato,2724,19,72,212,132,145,580
Minnesota,Chisholm,5006,64,41,301,286,177,869
Minnesota,Chisago City,4930,45,35,341,231,206,858
Minnesota,Chickamaw Beach,128,0,2,7,2,3,14
Minnesota,Chatfield,2935,62,33,159,220,184,658
Minnesota,The Ranch,1,0,0,0,0,0,0
Minnesota,Thief River Falls,8711,143,118,301,399,482,1443
Minnesota,Tintah,49,0,0,5,9,0,14
Minnesota,Callaway,207,5,2,13,25,12,57
Minnesota,Delano,5671,133,69,282,580,407,1471
Minnesota,Cambridge,8300,55,102,488,472,405,1522
Minnesota,Campbell,188,4,0,7,25,6,42
Minnesota,Canby,1696,19,9,94,65,74,261
Minnesota,Cannon Falls,4075,35,76,128,291,222,752
Minnesota,Canton,295,2,2,17,20,5,46
Minnesota,Cold Spring,4034,109,59,228,383,202,981
Minnesota,Carlos,506,11,12,37,16,23,99
Minnesota,Carver,4136,118,59,489,325,343,1334
Minnesota,Cass Lake,586,15,10,43,23,36,127
Minnesota,Cedar Mills,47,0,0,2,5,1,8
Minnesota,Center City,679,15,4,16,24,43,102
Minnesota,Centerville,3865,75,39,258,361,334,1067
Minnesota,Ceylon,322,7,2,18,20,26,73
Minnesota,Champlin,23731,322,372,1305,1542,1668,5209
Minnesota,Chandler,313,1,6,25,11,31,74
Minnesota,Chanhassen,24437,580,366,1530,1697,1831,6004
Minnesota,Chaska,24524,633,355,1772,1343,1572,5675
Minnesota,Carlton,1025,8,9,42,18,20,97
Minnesota,Coleraine,1881,34,26,110,100,101,371
Minnesota,Cologne,1631,55,45,105,126,121,452
Minnesota,Columbia Heights,19632,187,274,765,1065,1036,3327
Minnesota,Brooten,644,9,6,30,53,38,136
Minnesota,Brookston,140,0,0,0,4,11,15
Minnesota,Brooks,120,1,0,4,2,10,17
Minnesota,Brook Park,102,4,0,2,3,14,23
Minnesota,Brooklyn Park,78195,1255,1249,4982,4596,4867,16949
Minnesota,Brooklyn Center,30684,434,496,2164,1539,1923,6556
Minnesota,Bricelyn,315,5,7,27,5,4,48
Minnesota,Brewster,461,2,6,35,37,39,119
Minnesota,Breezy Point,2197,32,28,185,145,121,511
Minnesota,Breckenridge,3360,58,52,192,140,172,614
Minnesota,Browerville,742,7,12,52,42,28,141
Minnesota,Brandon,496,24,14,17,29,17,101
Minnesota,Braham,1944,39,50,115,143,100,447
Minnesota,Boy River,31,0,0,0,0,0,0
Minnesota,Boyd,109,2,0,1,3,3,9
Minnesota,Bowlus,345,11,12,33,8,8,72
Minnesota,Bovey,830,8,19,49,52,23,151
Minnesota,Borup,83,0,0,1,2,4,7
Minnesota,Bock,89,0,0,6,2,5,13
Minnesota,Bluffton,223,3,9,17,10,17,56
Minnesota,Blue Earth,3279,47,7,171,170,200,595
Minnesota,Bloomington,85826,1237,705,3430,3548,4126,13046
Minnesota,Brainerd,13462,179,148,743,735,653,2458
Minnesota,Blomkest,98,0,0,2,2,4,8
Minnesota,Brownsdale,782,6,14,38,25,26,109
Minnesota,Brownsville,473,6,4,19,13,31,73
Minnesota,Columbus,3967,12,26,184,206,301,729
Minnesota,Glenville,586,22,2,29,22,28,103
Minnesota,Glenwood,2536,9,53,96,164,97,419
Minnesota,Glyndon,1446,20,35,142,121,94,412
Minnesota,Golden Valley,20866,260,197,985,911,834,3187
Minnesota,Gonvick,220,0,5,15,10,18,48
Minnesota,Goodhue,1253,35,44,99,84,102,364
Minnesota,Goodridge,129,0,2,2,11,8,23
Minnesota,Good Thunder,518,5,2,13,30,27,77
Minnesota,Goodview,4052,28,100,130,244,187,689
Minnesota,Browns Valley,518,1,0,26,25,18,70
Minnesota,Graceville,607,9,7,34,39,22,111
Minnesota,Byron,5105,150,148,320,281,309,1208
Minnesota,Butterfield,633,6,13,31,27,37,114
Minnesota,Burtrum,128,2,0,4,13,6,25
Minnesota,Burnsville,61255,1044,1132,2867,2871,3535,11449
Minnesota,Buhl,1144,9,17,60,35,82,203
Minnesota,Buffalo Lake,723,22,15,26,44,52,159
Minnesota,Buffalo,15825,195,267,1324,1160,1053,3999
Minnesota,Buckman,234,6,5,22,17,13,63
Minnesota,Bruno,89,0,6,11,6,2,25
Minnesota,Brownton,797,2,10,33,75,52,172
Minnesota,Caledonia,2806,34,52,131,156,144,517
Minnesota,Calumet,425,9,10,23,22,37,101
Minnesota,Swanville,328,5,9,25,10,14,63
Minnesota,Hazel Run,24,0,0,0,0,0,0
Minnesota,Hayfield,1336,43,25,73,97,72,310
Minnesota,Hawley,1905,22,49,119,162,65,417
Minnesota,Hatfield,39,0,4,0,0,2,6
Minnesota,Hastings,22423,271,300,1168,1213,781,3733
Minnesota,Hartland,343,5,8,40,11,13,77
Minnesota,Harris,997,6,31,88,41,44,210
Minnesota,Hayward,269,0,0,0,11,6,17
Minnesota,Harmony,1013,15,15,19,48,48,145
Minnesota,Harding,152,0,2,15,20,2,39
Minnesota,Hanska,378,9,1,17,14,14,55
Minnesota,Hanover,3006,89,52,187,174,130,632
Minnesota,Hanley Falls,398,19,17,41,20,22,119
Minnesota,Hancock,835,17,17,50,37,45,166
Minnesota,Hampton,742,25,6,74,69,68,242
Minnesota,Hardwick,184,6,0,2,5,13,26
Minnesota,Nassau,49,0,0,0,0,8,8
Minnesota,Hector,1042,11,3,36,67,75,192
Minnesota,Heidelberg,130,3,3,8,3,5,22
Minnesota,Hinckley,1688,33,42,82,102,76,335
Minnesota,Hilltop,847,2,10,33,56,28,129
Minnesota,Hills,741,40,23,46,41,27,177
Minnesota,Hillman,26,0,0,2,0,5,7
Minnesota,Hill City,554,4,3,18,24,30,79
Minnesota,Hibbing,16284,320,153,850,930,693,2946
Minnesota,Hewitt,248,3,4,17,10,14,48
Minnesota,Heron Lake,610,6,11,41,36,31,125
Minnesota,Hermantown,9627,132,66,325,487,412,1422
Minnesota,Herman,371,4,0,0,21,11,36
Minnesota,Henriette,68,0,0,0,10,2,12
Minnesota,Henning,857,24,18,32,41,47,162
Minnesota,Hendrum,352,10,11,22,37,15,95
Minnesota,Hendricks,667,20,2,19,22,35,98
Minnesota,Henderson,842,24,8,49,13,48,142
Minnesota,Hammond,80,0,0,4,4,5,13
Minnesota,Ham Lake,15714,245,119,891,1062,1165,3482
Minnesota,Hamburg,471,4,2,11,6,30,53
Minnesota,Halstad,611,21,16,19,21,22,99
Minnesota,Granada,299,2,6,13,4,16,41
Minnesota,Naytahwaush,505,20,14,55,36,23,148
Minnesota,Nelson,159,1,0,11,10,7,29
Minnesota,Nerstrand,269,0,1,21,20,15,57
Minnesota,Nett Lake,355,2,5,24,10,17,58
Minnesota,Nevis,415,24,4,24,33,18,103
Minnesota,New Auburn,500,2,8,22,40,52,124
Minnesota,New Brighton,22080,377,244,1038,1047,1055,3761
Minnesota,Newfolden,368,11,4,12,11,29,67
Minnesota,New Germany,392,9,6,12,17,39,83
Minnesota,New Hope,20775,310,243,1181,1057,977,3768
Minnesota,New London,1317,23,8,68,56,52,207
Minnesota,New Munich,363,15,0,15,23,25,78
Minnesota,Newport,3470,33,43,189,144,249,658
Minnesota,New Prague,7500,250,119,327,636,632,1964
Minnesota,Grand Marais,1039,28,7,32,40,44,151
Minnesota,Hitterdal,184,0,0,3,7,19,29
Minnesota,Grand Meadow,1170,14,38,104,92,60,308
Minnesota,Granite Falls,2471,44,74,133,97,105,453
Minnesota,Halma,50,1,0,2,3,3,9
Minnesota,Hallock,1026,18,25,38,15,30,126
Minnesota,Hadley,43,3,2,0,0,0,5
Minnesota,Hackensack,360,4,3,10,17,22,56
Minnesota,Gully,101,2,0,6,7,6,21
Minnesota,Grygla,187,7,2,10,18,11,48
Minnesota,Grove City,624,21,21,25,61,28,156
Minnesota,Grey Eagle,349,5,12,26,10,21,74
Minnesota,Greenwood,790,12,16,30,16,27,101
Minnesota,Greenwald,242,2,0,15,3,9,29
Minnesota,Green Isle,555,4,9,66,40,40,159
Minnesota,Greenfield,2863,48,62,174,187,234,705
Minnesota,Greenbush,819,16,9,38,59,91,213
Minnesota,Grasston,223,0,7,12,21,13,53
Minnesota,Grant,4126,127,75,161,184,313,860
Minnesota,Grand Rapids,10996,188,114,865,456,492,2115
Minnesota,Hoffman,710,11,12,51,17,33,124
Minnesota,Hokah,551,5,10,45,35,9,104
Minnesota,Nashwauk,869,20,4,25,23,30,102
Minnesota,Mendota,230,2,0,18,18,16,54
Minnesota,Menahga,1346,38,16,74,41,63,232
Minnesota,Melrose,3604,43,78,227,243,266,857
Minnesota,Meire Grove,212,4,1,11,13,15,44
Minnesota,Medina,5378,90,55,313,447,443,1348
Minnesota,Medicine Lake,345,3,3,15,16,19,56
Minnesota,Medford,1401,42,25,124,73,118,382
Minnesota,Meadowlands,84,0,0,3,5,8,16
Minnesota,Mazeppa,835,14,21,68,36,38,177
Minnesota,Maynard,347,14,1,16,9,9,49
Minnesota,Preston,1423,56,22,85,85,33,281
Minnesota,Princeton,4728,150,77,317,170,306,1020
Minnesota,Prinsburg,496,14,5,17,24,23,83
Minnesota,Prior Lake,24402,618,327,1408,1916,1670,5939
Minnesota,Proctor,3060,32,15,148,211,104,510
Minnesota,Mendota Heights,11172,253,166,474,493,755,2141
Minnesota,Quamba,131,3,8,9,2,11,33
Minnesota,Mentor,191,0,5,12,6,5,28
Minnesota,Middle River,289,3,0,26,25,12,66
Minnesota,Minnetonka Beach,570,23,6,34,33,63,159
Minnesota,Minnetonka,51249,915,663,2188,2387,2425,8578
Minnesota,Minnesota Lake,620,16,16,19,35,26,112
Minnesota,Minnesota City,217,4,6,36,4,9,59
Minnesota,Minneota,1407,34,32,61,50,60,237
Minnesota,Minneiska,98,0,3,0,2,5,10
Minnesota,Minneapolis,399950,6909,4590,18055,15317,16080,60951
Minnesota,Miltona,372,6,9,29,23,14,81
Minnesota,Milroy,231,4,0,11,15,10,40
Minnesota,Millville,131,2,2,3,0,6,13
Minnesota,Millerville,95,0,8,7,4,0,19
Minnesota,Milan,362,4,6,12,20,42,84
Minnesota,Milaca,2895,73,13,202,136,227,651
Minnesota,Miesville,147,2,0,0,14,10,26
Minnesota,Midway,12,0,0,1,0,2,3
Minnesota,Merrifield,94,0,0,5,0,0,5
Minnesota,New Richland,1174,7,7,66,112,55,247
Minnesota,Racine,440,10,14,28,23,25,100
Minnesota,Randall,662,10,17,41,43,20,131
Minnesota,Moorhead,40935,619,613,1623,1427,1538,5820
Minnesota,Moose Lake,2763,9,26,45,51,140,271
Minnesota,Mora,3507,63,44,192,182,159,640
Minnesota,Morgan,916,9,16,60,74,40,199
Minnesota,Morris,5349,80,38,237,185,241,781
Minnesota,Morristown,950,21,15,51,66,41,194
Minnesota,Morton,341,3,1,12,11,13,40
Minnesota,Motley,688,21,14,34,21,37,127
Minnesota,Mound,9249,148,54,316,403,539,1460
Minnesota,Mounds View,12584,227,250,571,530,732,2310
Minnesota,Mountain Iron,2873,33,8,107,77,169,394
Minnesota,Mountain Lake,2076,34,16,161,129,142,482
Minnesota,Murdock,312,4,0,23,17,9,53
Minnesota,Myrtle,54,0,0,5,3,8,16
Minnesota,Nashua,29,0,3,2,4,4,13
Minnesota,Montrose,2999,48,85,233,190,144,700
Minnesota,Ramsey,24846,387,270,1642,1636,1669,5604
Minnesota,Monticello,13065,163,369,914,642,733,2821
Minnesota,Montevideo,5240,113,24,219,206,358,920
Minnesota,Randolph,432,14,9,26,23,25,97
Minnesota,Ranier,521,0,14,18,9,14,55
Minnesota,Raymond,695,11,5,56,40,53,165
Minnesota,Redby,1578,25,47,114,84,209,479
Minnesota,Red Lake,1508,10,49,71,142,137,409
Minnesota,Red Lake Falls,1229,20,6,79,49,59,213
Minnesota,Red Wing,16484,281,153,748,773,822,2777
Minnesota,Redwood Falls,5128,69,26,363,223,369,1050
Minnesota,Regal,46,1,1,2,0,0,4
Minnesota,Remer,391,8,0,29,8,23,68
Minnesota,Renville,1487,48,3,49,77,97,274
Minnesota,Revere,100,2,1,2,8,2,15
Minnesota,Rice,1491,8,51,88,139,75,361
Minnesota,Rice Lake,299,17,7,42,35,12,113
Minnesota,Richfield,36059,581,437,1541,1412,1424,5395
Minnesota,Montgomery,2934,22,59,239,161,86,567
Minnesota,Minnetrista,6810,119,88,640,487,447,1781
Minnesota,Mizpah,99,2,5,8,3,5,23
Minnesota,Pine Bend,20,0,0,2,2,0,4
Minnesota,Paynesville,2423,19,18,127,97,84,345
Minnesota,Park Rapids,3907,31,53,126,218,193,621
Minnesota,Parkers Prairie,1035,11,23,86,85,68,273
Minnesota,Palisade,168,1,0,0,6,7,14
Minnesota,Owatonna,25552,611,187,1577,1574,1322,5271
Minnesota,Ottertail,436,0,0,6,9,3,18
Minnesota,Otsego,14634,300,217,871,1005,616,3009
Minnesota,Ostrander,207,0,2,2,2,7,13
Minnesota,Osseo,2555,30,17,89,68,51,255
Minnesota,Oslo,227,3,1,11,14,10,39
Minnesota,Osakis,1669,22,29,93,96,111,351
Minnesota,Osage,247,0,0,3,19,16,38
Minnesota,Ortonville,2020,25,25,78,48,91,267
Minnesota,Orr,256,13,5,10,4,5,37
Minnesota,Oronoco,1522,44,39,130,94,92,399
Minnesota,Pease,276,0,1,22,9,18,50
Minnesota,Pelican Rapids,2510,65,43,108,162,191,569
Minnesota,Pemberton,297,7,5,7,19,22,60
Minnesota,Pennock,631,35,13,55,42,43,188
Minnesota,Peterson,192,3,2,8,6,4,23
Minnesota,Pine City,3093,28,11,153,107,76,375
Minnesota,Pine Island,3375,20,69,280,220,209,798
Minnesota,Pine Point,245,15,15,33,11,9,83
Minnesota,Pine River,713,10,11,33,18,10,82
Minnesota,Pine Springs,407,4,3,8,21,34,70
Minnesota,Pipestone,4186,99,57,211,163,171,701
Minnesota,Orono,7795,150,149,417,412,471,1599
Minnesota,Plainview,3269,24,98,170,211,152,655
Minnesota,Plummer,436,12,13,51,50,19,145
Minnesota,Plymouth,73896,1404,1090,3543,3345,3904,13286
Minnesota,Ponemah,791,22,8,114,57,13,214
Minnesota,Porter,183,0,1,10,15,15,41
Minnesota,Perley,92,1,0,3,2,3,9
Minnesota,Perham,3106,56,51,158,207,104,576
Minnesota,Pequot Lakes,2445,9,43,151,129,189,521
Minnesota,Plato,313,10,7,8,11,8,44
Minnesota,Pillager,450,4,10,36,19,33,102
Minnesota,Ormsby,118,1,1,9,2,11,24
Minnesota,Holland,183,2,0,9,2,6,19
Minnesota,Northrop,276,1,4,22,18,31,76
Minnesota,Northome,229,0,0,20,20,14,54
Minnesota,North Oaks,4715,83,13,250,249,268,863
Minnesota,North Mankato,13438,204,169,680,694,713,2460
Minnesota,Northfield,20309,292,229,776,828,752,2877
Minnesota,North Branch,10104,194,153,756,461,639,2203
Minnesota,Norcross,46,0,0,3,3,0,6
Minnesota,Nisswa,2068,29,17,72,34,114,266
Minnesota,Nimrod,89,0,2,3,5,3,13
Minnesota,Nielsville,106,3,6,2,0,2,13
Minnesota,Nicollet,1136,37,15,65,83,37,237
Minnesota,New York Mills,1383,30,0,67,47,49,193
Minnesota,New Ulm,13287,174,202,512,514,608,2010
Minnesota,New Trier,142,11,8,16,9,4,48
Minnesota,Sunfish Lake,518,6,7,36,39,31,119
Minnesota,North St. Paul,11966,299,173,409,399,472,1752
Minnesota,Norwood Young America,3630,74,72,212,274,225,857
Minnesota,Nowthen,4522,42,73,288,304,394,1101
Minnesota,Oakdale,27850,368,492,1270,1642,1648,5420
Minnesota,Hollandale,297,8,6,20,18,14,66
Minnesota,Holloway,95,3,1,1,3,4,12
Minnesota,Holt,111,1,5,2,10,7,25
Minnesota,Homer,155,0,0,12,11,0,23
Minnesota,Hopkins,17992,318,211,1189,786,863,3367
Minnesota,Houston,1074,26,17,55,57,80,235
Minnesota,Onamia,905,8,7,48,26,74,163
Minnesota,Holdingford,593,2,16,23,41,23,105
Minnesota,Olivia,2327,53,49,102,117,52,373
Minnesota,Okabena,170,7,5,11,4,2,29
Minnesota,Ogilvie,427,11,13,25,27,22,98
Minnesota,Ogema,182,1,2,16,18,17,54
Minnesota,Odin,109,3,0,8,4,3,18
Minnesota,Odessa,157,4,2,4,20,9,39
Minnesota,Oak Park Heights,4737,33,42,172,144,221,612
Minnesota,Oak Grove,8215,121,82,537,478,543,1761
Minnesota,Oklee,463,11,5,18,33,6,73
Minnesota,Pierz,1429,26,8,31,77,71,213
Mississippi,Anguilla,542,0,10,34,36,41,121
Mississippi,Bassfield,272,4,0,17,11,10,42
Mississippi,Mize,305,0,14,27,19,12,72
Mississippi,Monticello,1559,66,32,132,50,55,335
Mississippi,Mooreville,822,0,59,44,31,47,181
Mississippi,Moorhead,1975,23,8,128,168,114,441
Mississippi,Morgan City,264,2,9,14,13,16,54
Mississippi,Morgantown,1502,116,23,150,50,93,432
Mississippi,Morton,3456,39,57,170,192,137,595
Mississippi,Moss Point,13685,176,81,535,672,660,2124
Mississippi,Mound Bayou,1863,69,41,137,121,146,514
Mississippi,Mount Olive,981,12,44,37,61,95,249
Mississippi,Myrtle,493,19,3,30,23,45,120
Mississippi,Natchez,15474,391,230,956,593,683,2853
Mississippi,Nellieburg,1317,0,17,20,27,26,90
Mississippi,Nettleton,1665,27,13,45,77,71,233
Mississippi,New Albany,8466,182,117,460,741,469,1969
Mississippi,New Augusta,835,14,19,57,50,84,224
Mississippi,New Hamilton,457,0,0,14,2,6,22
Mississippi,Baldwyn,3139,71,16,104,89,251,531
Mississippi,Ashland,524,12,14,35,19,14,94
Mississippi,Artesia,380,9,6,20,14,20,69
Mississippi,Arnold Line,2609,0,51,112,31,139,333
Mississippi,Arcola,274,5,6,23,17,13,64
Mississippi,Bay St. Louis,10861,197,174,472,699,610,2152
Mississippi,Batesville,7413,254,154,304,413,550,1675
Mississippi,Amory,7151,120,109,491,516,304,1540
Mississippi,Algoma,677,19,8,56,38,19,140
Mississippi,Alcorn State University,774,0,0,0,31,28,59
Mississippi,Ackerman,1861,31,40,99,70,133,373
Mississippi,Aberdeen,5466,79,74,283,227,188,851
Mississippi,Abbeville,447,1,10,31,11,11,64
Mississippi,New Hebron,526,16,11,26,46,21,120
Mississippi,Alligator,328,32,4,35,45,14,130
Mississippi,Bay Springs,1738,9,2,53,67,68,199
Mississippi,Union,1826,18,28,122,111,126,405
Mississippi,Beauregard village,328,0,5,19,27,38,89
Mississippi,Waynesboro,4974,189,17,247,247,565,1265
Mississippi,Waveland,6449,113,123,194,471,380,1281
Mississippi,Water Valley,3344,25,3,197,148,107,480
Mississippi,Walthall village,133,3,0,9,6,1,19
Mississippi,Walnut Grove,913,12,1,21,37,52,123
Mississippi,Walnut,827,13,17,27,66,38,161
Mississippi,Walls,1247,10,54,166,67,74,371
Mississippi,Wade,887,0,0,71,163,27,261
Mississippi,Vicksburg,23439,497,326,1679,1207,1371,5080
Mississippi,Verona,3062,57,49,153,107,198,564
Mississippi,Vardaman,1316,3,43,33,100,97,276
Mississippi,Vancleave,5783,101,87,501,344,347,1380
Mississippi,Vaiden,802,31,0,47,22,15,115
Mississippi,Utica,830,3,0,55,50,95,203
Mississippi,University,4619,0,0,0,0,0,0
Mississippi,Webb,250,0,2,22,10,8,42
Mississippi,Beaumont,1110,30,16,37,62,81,226
Mississippi,Weir,507,10,0,8,35,34,87
Mississippi,West,177,0,0,6,23,10,39
Mississippi,Tylertown,1641,7,6,105,27,73,218
Mississippi,Beechwood,4528,72,102,238,315,358,1085
Mississippi,Belmont,2119,54,35,112,95,135,431
Mississippi,Belzoni,2325,57,49,116,154,147,523
Mississippi,Benoit,462,9,12,22,33,20,96
Mississippi,Bentonia,521,28,12,18,22,31,111
Mississippi,Beulah,359,10,7,16,16,41,90
Mississippi,Big Creek village,265,3,4,12,16,30,65
Mississippi,Big Point,841,0,0,86,92,55,233
Mississippi,Winstonville,223,7,0,7,0,2,16
Mississippi,Winona,4704,103,70,225,322,203,923
Mississippi,Wiggins,4487,17,42,283,294,258,894
Mississippi,White Oak,660,16,14,37,24,44,135
Mississippi,West Point,11122,237,108,628,617,839,2429
Mississippi,West Hattiesburg,6674,49,177,374,648,378,1626
Mississippi,Wesson,2134,75,35,72,65,106,353
Mississippi,Tutwiler,3516,33,63,111,255,115,577
Mississippi,Isola,1003,30,14,84,77,45,250
Mississippi,Tunica Resorts,1514,50,0,33,12,24,119
Mississippi,Columbus,23360,499,219,1070,1298,973,4059
Mississippi,Columbia,6367,242,145,405,286,342,1420
Mississippi,Collinsville,1663,57,41,142,34,15,289
Mississippi,Collins,2557,51,10,95,101,183,440
Mississippi,Coldwater,1251,0,37,41,67,46,191
Mississippi,Coffeeville,1044,59,23,87,65,30,264
Mississippi,Coahoma,390,5,0,27,29,25,86
Mississippi,Cloverdale,772,0,9,46,33,0,88
Mississippi,Clinton,25475,528,399,1177,1522,1490,5116
Mississippi,Cleveland,12339,359,304,571,528,577,2339
Mississippi,Cleary,1090,14,14,15,70,68,181
Mississippi,Clarksdale,17314,575,368,1202,1048,921,4114
Mississippi,Clara,589,0,17,0,59,0,76
Mississippi,Chunky,406,0,6,13,35,8,62
Mississippi,Charleston,1164,28,0,46,68,28,170
Mississippi,Centreville,1765,11,22,78,119,127,357
Mississippi,Cary,348,3,9,33,16,15,76
Mississippi,Carthage,4966,64,46,459,331,301,1201
Mississippi,Carrollton,146,1,0,0,26,9,36
Mississippi,Canton,13413,211,247,656,863,926,2903
Mississippi,Calhoun City,1850,21,56,79,120,99,375
Mississippi,Caledonia,1332,16,46,84,110,79,335
Mississippi,Byram,11592,197,203,648,803,620,2471
Mississippi,Columbus AFB,1443,65,16,77,112,47,317
Mississippi,Como,1374,15,25,31,42,62,175
Mississippi,Conehatta,1124,46,17,151,104,84,402
Mississippi,Corinth,14839,281,136,763,631,736,2547
Mississippi,Durant,2978,118,43,220,317,149,847
Mississippi,Duncan,435,8,11,30,22,10,81
Mississippi,Dumas,470,5,9,20,47,18,99
Mississippi,Duck Hill,1000,23,2,63,42,28,158
Mississippi,Drew,1941,59,84,107,182,151,583
Mississippi,Doddsville,339,0,0,0,95,19,114
Mississippi,D'Lo,432,4,4,7,20,21,56
Mississippi,D'Iberville,10532,107,139,668,522,605,2041
Mississippi,Diamondhead,8246,83,140,463,354,290,1330
Mississippi,Derma,1056,11,19,103,42,61,236
Mississippi,DeLisle,1121,0,0,53,39,128,220
Mississippi,Byhalia,1358,16,34,86,66,157,359
Mississippi,De Kalb,1082,44,15,42,45,85,231
Mississippi,Darling,284,7,7,0,18,31,63
Mississippi,Crystal Springs,4970,54,83,361,279,315,1092
Mississippi,Cruger,336,10,6,17,25,24,82
Mississippi,Crowder,701,10,17,67,42,43,179
Mississippi,Crosby,413,5,7,16,30,14,72
Mississippi,Crenshaw,975,20,0,40,57,44,161
Mississippi,Crawford,569,21,17,29,33,67,167
Mississippi,Yazoo City,11421,215,149,806,776,727,2673
Mississippi,Woodville,1245,0,45,29,64,143,281
Mississippi,Woodland village,170,11,0,11,12,8,42
Mississippi,Courtland,725,14,18,98,72,36,238
Mississippi,Decatur,2100,41,5,110,87,100,343
Mississippi,Burnsville,1089,30,20,63,37,82,232
Mississippi,Bude,905,3,20,36,40,47,146
Mississippi,Buckatunna,464,10,0,106,5,0,121
Mississippi,Southaven,51090,710,833,3753,3292,3100,11688
Mississippi,Standing Pine,363,41,10,66,39,0,156
Mississippi,Starkville,24754,641,222,1233,936,753,3785
Mississippi,State Line,677,3,3,28,46,60,140
Mississippi,Stonewall,1315,51,24,92,106,76,349
Mississippi,Mississippi Valley State University,1296,28,22,29,0,25,104
Mississippi,Sturgis,438,2,26,35,47,46,156
Mississippi,Summit,2307,36,31,157,283,165,672
Mississippi,Sumner,252,4,2,1,3,3,13
Mississippi,Sumrall,1714,40,42,102,126,57,367
Mississippi,Sunflower,1047,27,20,72,106,62,287
Mississippi,Soso,472,6,5,25,27,27,90
Mississippi,Sylvarena village,101,0,0,8,5,11,24
Mississippi,Taylorsville,1348,31,34,103,73,67,308
Mississippi,Tchula,1885,92,51,150,105,121,519
Mississippi,Terry,1477,9,42,91,139,94,375
Mississippi,Thaxton,996,16,13,114,53,24,220
Mississippi,Tillatoba,264,0,0,33,56,91,180
Mississippi,Tishomingo,489,14,1,14,23,47,99
Mississippi,Toccopola,219,4,0,10,8,4,26
Mississippi,Toomsuba,1180,18,74,117,59,20,288
Mississippi,Tremont,477,11,5,28,17,22,83
Mississippi,Tucker,497,35,2,39,32,25,133
Mississippi,Tunica,1233,32,5,34,98,43,212
Mississippi,Taylor village,304,10,3,31,11,6,61
Mississippi,Tupelo,35561,813,517,1837,2431,2118,7716
Mississippi,Snow Lake Shores,354,0,3,6,2,7,18
Mississippi,Sledge,476,9,6,27,24,34,100
Mississippi,Bruce,1660,39,0,56,41,168,304
Mississippi,Brooksville,914,45,4,81,48,69,247
Mississippi,Brookhaven,12465,170,310,710,799,932,2921
Mississippi,Bridgetown,1937,0,17,81,130,28,256
Mississippi,Braxton village,207,5,2,8,6,9,30
Mississippi,Brandon,22897,468,472,1461,1443,1420,5264
Mississippi,Boyle,1053,55,49,60,84,51,299
Mississippi,Booneville,8780,196,80,454,772,433,1935
Mississippi,Bolton,423,3,0,17,4,11,35
Mississippi,Bogue Chitto CDP (Lincoln County),631,0,34,0,0,98,132
Mississippi,Bogue Chitto CDP (Kemper and Neshoba Counties),673,0,19,18,15,41,93
Mississippi,Smithville,695,14,8,20,34,18,94
Mississippi,Blue Springs village,282,0,7,22,8,8,45
Mississippi,Biloxi,44825,673,490,2162,1934,1908,7167
Mississippi,Sharon,1306,0,0,62,78,137,277
Mississippi,Shaw,1672,18,38,86,105,97,344
Mississippi,Shelby,2381,37,42,131,175,167,552
Mississippi,Sherman,784,35,11,72,53,66,237
Mississippi,Shubuta,342,6,6,5,31,16,64
Mississippi,Shuqualak,453,11,13,10,16,21,71
Mississippi,Sidon,489,15,7,32,45,57,156
Mississippi,Silver City,343,8,10,7,28,8,61
Mississippi,Silver Creek,206,0,5,6,22,15,48
Mississippi,Slate Springs village,101,0,0,6,0,0,6
Mississippi,Blue Mountain,937,0,27,41,54,44,166
Mississippi,Mississippi State,3797,0,0,0,28,0,28
Mississippi,Montrose,108,0,0,10,4,9,23
Mississippi,Merigold,468,15,10,22,24,25,96
Mississippi,Gulfport,70642,952,1092,3801,3372,3371,12588
Mississippi,Gunnison,305,3,7,8,10,20,48
Mississippi,Guntown,2412,54,32,140,170,138,534
Mississippi,Hamilton,396,0,7,16,10,38,71
Mississippi,Hatley,494,0,0,43,26,39,108
Mississippi,Hattiesburg,46762,1100,663,1845,1775,1725,7108
Mississippi,Hazlehurst,3942,80,61,264,102,175,682
Mississippi,Heidelberg,702,8,1,18,34,44,105
Mississippi,Helena,1049,0,0,15,16,83,114
Mississippi,Henderson Point,112,0,0,7,0,0,7
Mississippi,Hernando,14984,217,153,1019,1086,981,3456
Mississippi,Hickory,604,12,17,32,43,110,214
Mississippi,Hickory Flat,729,0,23,22,33,36,114
Mississippi,Hide-A-Way Lake,1555,0,0,0,0,75,75
Mississippi,Hillsboro,1022,0,10,43,146,101,300
Mississippi,Metcalfe,1120,30,30,134,75,56,325
Mississippi,Hollandale,2621,52,16,181,284,213,746
Mississippi,Holly Springs,7572,95,177,273,330,220,1095
Mississippi,Horn Lake,26662,540,542,1713,1776,1287,5858
Mississippi,Houston,3566,84,48,131,294,281,838
Mississippi,Hurley,1166,0,0,65,12,75,152
Mississippi,Indianola,10281,343,162,654,586,651,2396
Mississippi,Inverness,934,23,3,67,39,51,183
Mississippi,Shannon,1780,35,29,91,124,138,417
Mississippi,Senatobia,8017,99,180,511,195,409,1394
Mississippi,Seminary,447,4,5,23,32,60,124
Mississippi,Sebastopol,314,3,0,25,24,6,58
Mississippi,Scooba,1052,40,6,37,23,45,151
Mississippi,Schlater,374,7,3,30,8,34,82
Mississippi,Gulf Park Estates,6113,213,114,268,503,388,1486
Mississippi,Gulf Hills,8493,301,90,578,483,355,1807
Mississippi,Grenada,12908,490,200,514,635,838,2677
Mississippi,Greenwood,15734,386,431,1143,862,889,3711
Mississippi,Edwards,1177,44,17,78,95,90,324
Mississippi,Elliott,1430,16,16,251,117,21,421
Mississippi,Ellisville,4566,74,86,124,217,132,633
Mississippi,Enterprise,716,3,20,56,56,66,201
Mississippi,Escatawpa,3825,34,32,132,240,138,576
Mississippi,Ethel,505,5,9,34,36,41,125
Mississippi,Eupora,2191,25,24,80,140,123,392
Mississippi,Falcon,192,0,0,31,13,5,49
Mississippi,Falkner,551,14,16,41,20,21,112
Mississippi,Farmington,2333,17,78,115,176,136,522
Mississippi,Farrell,440,0,0,0,0,44,44
Mississippi,Fayette,1563,24,15,106,82,82,309
Mississippi,Flora,1954,64,47,144,165,182,602
Mississippi,Florence,4279,130,25,228,321,399,1103
Mississippi,Saucier,1060,0,0,129,37,57,223
Mississippi,Flowood,8385,52,0,423,389,411,1275
Mississippi,Foxworth,389,0,14,33,8,0,55
Mississippi,French Camp,216,3,6,19,16,31,75
Mississippi,Friars Point,870,31,5,48,46,68,198
Mississippi,Fulton,4014,47,59,113,236,164,619
Mississippi,Gattman village,113,0,0,0,6,0,6
Mississippi,Gautier,18563,488,325,902,1394,1520,4629
Mississippi,Georgetown,294,11,6,13,9,11,50
Mississippi,Glen,461,8,11,47,37,34,137
Mississippi,Glendale,1833,91,0,117,130,126,464
Mississippi,Glendora village,78,7,1,3,3,2,16
Mississippi,Gloster,972,6,3,78,68,70,225
Mississippi,Golden,188,8,2,5,19,8,42
Mississippi,Goodman,1288,24,7,53,28,53,165
Mississippi,Greenville,33119,813,475,1860,2067,2112,7327
Mississippi,Forest,5713,185,110,285,344,187,1111
Mississippi,Eden village,104,0,0,7,2,1,10
Mississippi,Satartia village,11,0,0,1,1,0,2
Mississippi,Sandersville,685,3,9,20,27,23,82
Mississippi,Polkville,820,8,6,44,42,18,118
Mississippi,Plantersville,1010,15,0,44,63,18,140
Mississippi,Pittsboro village,188,11,3,8,3,5,30
Mississippi,Pickens,818,12,10,67,73,57,219
Mississippi,Picayune,10784,235,234,769,471,743,2452
Mississippi,Philadelphia,7433,133,174,494,455,413,1669
Mississippi,Petal,10723,103,290,739,874,613,2619
Mississippi,Pelahatchie,1340,51,18,97,122,83,371
Mississippi,Pearl River,4040,106,82,276,376,350,1190
Mississippi,Pearlington,1397,0,0,46,160,63,269
Mississippi,Pearl,26222,255,462,1275,1812,1266,5070
Mississippi,Pass Christian,5130,59,122,220,263,470,1134
Mississippi,Pascagoula,22230,510,121,1316,969,1259,4175
Mississippi,Paden village,93,0,3,2,7,6,18
Mississippi,Pachuta,286,7,0,17,7,14,45
Mississippi,Pace,174,4,0,6,6,0,16
Mississippi,Oxford,20769,469,378,631,471,739,2688
Mississippi,Osyka,425,15,2,40,40,55,152
Mississippi,Olive Branch,35018,476,551,2020,2225,2725,7997
Mississippi,Okolona,2658,26,45,146,114,142,473
Mississippi,Ocean Springs,17528,348,248,1061,1036,846,3539
Mississippi,Oakland,702,10,0,88,46,41,185
Mississippi,Noxapater,374,8,7,25,13,7,60
Mississippi,North Tunica,1060,24,17,77,45,75,238
Mississippi,North Carrollton,498,0,10,17,26,39,92
Mississippi,Nicholson,2636,0,39,215,190,145,589
Mississippi,Newton,3347,16,20,139,177,106,458
Mississippi,New Houlka,813,0,17,32,88,91,228
Mississippi,New Hope,3083,38,45,220,221,136,660
Mississippi,Pontotoc,5808,0,208,442,339,481,1470
Mississippi,Pope village,231,7,12,15,29,8,71
Mississippi,Poplarville,2919,65,13,69,266,225,638
Mississippi,Port Gibson,1607,22,20,60,85,75,262
Mississippi,Saltillo,4958,135,55,318,197,37,742
Mississippi,Sallis,147,0,0,10,4,11,25
Mississippi,St. Martin,7728,215,144,442,573,431,1805
Mississippi,Ruleville,2877,109,43,217,148,112,629
Mississippi,Roxie,551,0,3,29,28,14,74
Mississippi,Rosedale,1743,41,15,111,88,160,415
Mississippi,Rolling Fork,2491,52,13,126,92,146,429
Mississippi,Robinhood,1443,8,21,101,35,92,257
Mississippi,Ripley,5350,127,89,382,240,188,1026
Mississippi,Rienzi,343,0,0,7,16,24,47
Mississippi,Ridgeland,24276,567,509,1176,1395,1229,4876
Mississippi,Richton,928,14,8,68,13,62,165
Mississippi,Richland,7055,215,49,469,360,450,1543
Mississippi,Renova,820,16,11,37,71,49,184
Mississippi,Sardis,1953,43,71,110,82,59,365
Mississippi,Redwater,603,26,0,37,40,29,132
Mississippi,Kilmichael,869,34,10,34,28,51,157
Mississippi,Kearney Park,1402,50,0,61,52,162,325
Mississippi,Jumpertown,653,9,21,52,27,12,121
Mississippi,Jonestown,1436,79,20,87,78,111,375
Mississippi,Jackson,173212,3132,2725,10687,10699,10153,37396
Mississippi,Iuka,3005,0,16,267,205,110,598
Mississippi,Itta Bena,2103,31,31,84,65,188,399
Mississippi,Rawls Springs,1214,0,31,31,156,0,218
Mississippi,Raleigh,1454,25,0,53,97,114,289
Mississippi,Quitman,2147,30,8,153,68,134,393
Mississippi,Purvis,2160,21,33,109,158,126,447
Mississippi,Puckett village,350,5,9,15,16,65,110
Mississippi,Prentiss,1193,3,15,32,61,56,167
Mississippi,Potts Camp,525,7,16,23,37,20,103
Mississippi,Raymond,1995,7,0,50,40,50,147
Mississippi,Ecru,1379,4,67,63,126,81,341
Mississippi,Holcomb,462,11,0,52,34,28,125
Mississippi,Maben,677,17,25,39,54,39,174
Mississippi,Lucedale,2993,110,95,139,222,100,666
Mississippi,Louisville,6407,239,92,421,354,400,1506
Mississippi,Louise,150,0,3,0,0,0,3
Mississippi,Meridian Station,636,0,0,11,0,0,11
Mississippi,Long Beach,15369,274,191,954,976,825,3220
Mississippi,Liberty,771,21,9,60,53,14,157
Mississippi,Lexington,2106,33,73,131,129,118,484
Mississippi,Lena,200,2,1,1,11,7,22
Mississippi,Leland,4318,48,89,231,272,249,889
Mississippi,Learned,44,0,1,1,1,0,3
Mississippi,Leakesville,802,7,20,31,39,51,148
Mississippi,Laurel,18770,289,461,1386,846,1019,4001
Mississippi,Lauderdale,686,0,0,96,0,0,96
Mississippi,Latimer,7009,67,74,484,435,437,1497
Mississippi,Lambert,1302,37,0,60,107,85,289
Mississippi,Lake,435,3,13,21,11,25,73
Mississippi,Kossuth village,263,3,9,4,11,7,34
Mississippi,Lula,292,3,0,10,17,35,65
Mississippi,Lumberton,2080,75,54,130,128,89,476
Mississippi,Lyman,2136,89,0,27,138,33,287
Mississippi,Lynchburg,2307,0,9,96,134,103,342
Mississippi,Meridian,40507,1170,386,2553,2329,2378,8816
Mississippi,Mendenhall,2511,61,21,130,114,125,451
Mississippi,Meadville,454,7,8,14,24,27,80
Mississippi,Mayersville,634,11,10,28,18,23,90
Mississippi,Mathiston,760,3,8,53,40,36,140
Mississippi,Marks,1630,13,18,65,119,82,297
Mississippi,Marion,1547,37,32,117,80,88,354
Mississippi,Marietta,333,11,1,14,15,19,60
Mississippi,Kosciusko,7242,163,211,507,333,465,1679
Mississippi,Mantee village,331,1,4,20,36,23,84
Mississippi,Magnolia,2021,36,25,129,79,124,393
Mississippi,Magee,4399,77,157,363,284,208,1089
Mississippi,Madison,25167,614,399,1437,2237,1575,6262
Mississippi,Macon,2659,63,68,144,145,123,543
Mississippi,McLain,428,0,1,33,39,19,92
Mississippi,McCool,148,0,0,3,5,14,22
Mississippi,McComb,12723,400,326,576,547,668,2517
Mississippi,Lyon,320,5,3,11,19,6,44
Mississippi,Mantachie,1403,39,25,93,40,112,309
Mississippi,Kiln,2169,0,0,51,27,131,209
Mississippi,Louin,237,5,3,9,8,22,47
Missouri,Bogard,181,0,6,13,10,5,34
Missouri,Fillmore,197,0,3,10,8,17,38
Missouri,Fidelity,240,3,0,11,22,10,46
Missouri,Festus,11839,124,182,639,474,699,2118
Missouri,Ferrelview village,403,3,3,19,18,7,50
Missouri,Ferguson,21120,578,442,1163,820,1315,4318
Missouri,Fenton,4033,78,17,245,306,160,806
Missouri,Fayette,2708,23,57,65,105,96,346
Missouri,Farmington,17570,253,191,774,651,1106,2975
Missouri,Farley village,229,2,3,15,13,10,43
Missouri,Farber,315,0,0,4,5,18,27
Missouri,Fairview,336,5,3,14,18,17,57
Missouri,Fair Play,480,10,14,15,51,34,124
Missouri,Fisk,464,9,11,24,29,33,106
Missouri,Fair Grove,1612,46,31,107,120,89,393
Missouri,Fairdealing,1151,0,9,108,39,25,181
Missouri,Exeter,786,13,23,36,34,65,171
Missouri,Excelsior Springs,11512,307,83,641,762,543,2336
Missouri,Excelsior Estates village,175,4,8,8,8,5,33
Missouri,Excello,102,0,0,0,0,32,32
Missouri,Ewing,358,10,6,22,26,29,93
Missouri,Everton,338,3,9,30,14,18,74
Missouri,Evergreen village,35,0,0,2,2,2,6
Missouri,Eureka,10450,280,226,604,904,900,2914
Missouri,Ethel,51,0,0,1,1,3,5
Missouri,Essex,546,7,0,37,32,39,115
Missouri,Eolia village,511,3,2,37,33,37,112
Missouri,Fairfax,664,7,0,20,52,41,120
Missouri,Fleming,130,1,0,1,13,11,26
Missouri,Flemington village,116,5,6,2,2,7,22
Missouri,Flint Hill,548,7,2,41,36,55,141
Missouri,Pleasant Valley,3032,66,7,137,136,185,531
Missouri,Pleasant Hope,652,10,8,30,63,68,179
Missouri,Fort Leonard Wood,17576,254,206,754,661,1063,2938
Missouri,Pleasant Hill,8216,221,170,642,288,386,1707
Missouri,Plattsburg,2383,65,39,103,163,87,457
Missouri,Platte Woods,468,2,4,14,23,35,78
Missouri,Platte City,4793,43,103,271,291,274,982
Missouri,Plato village,134,5,0,8,12,24,49
Missouri,Pinhook village,9,0,0,0,0,0,0
Missouri,Pineville,883,0,10,55,54,76,195
Missouri,Pine Lawn,3363,54,0,181,167,360,762
Missouri,Pilot Knob,699,0,0,42,43,17,102
Missouri,Pilot Grove,713,11,2,31,36,39,119
Missouri,Pierpont village,87,0,1,5,8,11,25
Missouri,Pierce City,1261,23,28,90,70,55,266
Missouri,Piedmont,2246,23,44,49,195,102,413
Missouri,Pickering,174,2,1,16,4,5,28
Missouri,Phillipsburg village,160,2,0,5,9,1,17
Missouri,Fortescue,5,0,0,0,0,0,0
Missouri,Forsyth,2068,0,17,45,43,89,194
Missouri,Foristell,473,2,5,25,16,29,77
Missouri,Forest City,273,2,4,14,12,4,36
Missouri,Fordland,897,11,22,119,78,79,309
Missouri,Foley,127,0,3,11,3,18,35
Missouri,Florissant,52356,844,671,2816,2902,3286,10519
Missouri,Florida village,0,0,0,0,0,0,0
Missouri,Flordell Hills,843,3,13,76,59,83,234
Missouri,Emma,247,3,5,8,13,10,39
Missouri,Bolckow,220,4,2,4,17,14,41
Missouri,Eminence,604,0,0,24,27,26,77
Missouri,Blanchard,42,5,0,0,0,0,5
Missouri,Bosworth,235,2,0,10,12,32,56
Missouri,Boonville,8350,114,56,452,442,535,1599
Missouri,Bonne Terre,7064,51,55,253,205,431,995
Missouri,Bolivar,10507,169,182,362,421,599,1733
Missouri,Edmundson,898,31,28,30,53,68,210
Missouri,Edinburg,132,0,0,8,36,13,57
Missouri,Edina,1187,9,3,83,57,84,236
Missouri,Edgerton,607,3,10,13,23,48,97
Missouri,Edgar Springs,216,3,4,22,22,1,52
Missouri,East Prairie,3178,46,87,217,337,92,779
Missouri,Easton,254,2,4,7,11,4,28
Missouri,Aullville village,99,1,8,7,4,2,22
Missouri,Bourbon,1458,11,42,98,90,62,303
Missouri,Eagleville,264,2,3,10,23,20,58
Missouri,Dutchtown village,34,0,0,1,1,0,2
Missouri,Duquesne village,1747,0,30,49,119,59,257
Missouri,Duenweg,1218,31,0,65,71,43,210
Missouri,Dudley,158,0,0,6,5,6,17
Missouri,Drexel,911,4,22,42,44,47,159
Missouri,Downing,278,1,4,9,11,8,33
Missouri,Blodgett village,233,14,1,7,6,23,51
Missouri,Bloomfield,1952,14,66,58,65,52,255
Missouri,Bloomsdale,631,7,14,47,25,20,113
Missouri,Blue Eye,220,5,2,2,11,9,29
Missouri,Blue Springs,53364,1015,898,3615,3690,3103,12321
Missouri,Blythedale village,164,8,3,6,11,8,36
Missouri,Eagle Rock,124,0,0,0,0,12,12
Missouri,Bowling Green,5465,53,95,182,131,215,676
Missouri,Bragg City,127,0,2,9,11,9,31
Missouri,Brandsville,109,0,0,6,13,4,23
Missouri,Bland,478,4,14,26,22,0,66
Missouri,Emerald Beach village,279,0,0,16,0,23,39
Missouri,Elsberry,1930,38,32,134,35,72,311
Missouri,Elmo,180,3,5,18,2,1,29
Missouri,Elmira village,60,0,0,5,0,0,5
Missouri,Phelps City,0,0,0,0,0,0,0
Missouri,Pevely,5596,150,124,332,235,122,963
Missouri,Perryville,8333,222,104,663,457,495,1941
Missouri,Perry,656,3,0,31,23,14,71
Missouri,Penermon village,91,16,5,18,0,0,39
Missouri,Pendleton village,23,0,0,0,1,3,4
Missouri,Elmer,89,0,2,11,3,7,23
Missouri,Ellsinore,502,44,7,45,45,24,165
Missouri,Ellisville,9181,145,57,550,707,531,1990
Missouri,Ellington,1119,18,17,78,92,78,283
Missouri,El Dorado Springs,3553,71,54,354,253,75,807
Missouri,Eldon,4617,126,132,401,199,156,1014
Missouri,Peculiar,4808,50,122,287,347,244,1050
Missouri,Peaceful Village village,8,0,0,0,0,0,0
Missouri,Paynesville village,58,0,4,0,0,3,7
Missouri,Pattonsburg,379,15,0,12,17,25,69
Missouri,Passaic,38,0,0,0,0,1,1
Missouri,Pascola village,111,0,0,0,0,15,15
Missouri,Braymer,684,17,3,12,56,34,122
Missouri,Brashear,226,5,5,12,10,4,36
Missouri,Branson West,434,23,4,17,27,23,94
Missouri,Branson,11084,193,74,444,620,311,1642
Missouri,Blairstown,125,0,0,5,7,1,13
Missouri,Blackwater,141,1,3,15,20,6,45
Missouri,Verona,591,16,21,43,45,16,141
Missouri,Blackburn,299,4,3,12,20,20,59
Missouri,Warsaw,2362,58,74,101,87,116,436
Missouri,Warson Woods,1758,60,39,102,112,73,386
Missouri,Washburn,533,5,5,19,25,4,58
Missouri,Washington,13993,203,77,708,674,813,2475
Missouri,Wasola,36,0,0,0,0,0,0
Missouri,Clearmont,194,0,0,3,9,13,25
Missouri,Clayton,15900,305,113,524,742,578,2262
Missouri,Claycomo village,1457,14,4,56,55,22,151
Missouri,Clarkton,1228,35,25,83,76,82,301
Missouri,Clarksville,444,5,1,6,23,9,44
Missouri,Clarkson Valley,2634,33,37,124,187,163,544
Missouri,Clarksdale,271,1,4,19,5,22,51
Missouri,Watson village,47,1,0,0,1,3,5
Missouri,Waverly,823,38,14,61,36,100,249
Missouri,Wayland,537,4,22,16,17,34,93
Missouri,Waynesville,5250,61,144,313,205,236,959
Missouri,Weatherby,101,0,0,1,7,6,14
Missouri,Weatherby Lake,1834,13,13,97,74,84,281
Missouri,Weaubleau,443,4,0,41,21,23,89
Missouri,Webb City,11035,139,321,488,712,625,2285
Missouri,Webster Groves,23120,704,424,1300,1457,1326,5211
Missouri,Weingarten,68,0,0,0,0,0,0
Missouri,Cleveland,609,15,2,16,17,14,64
Missouri,Clever,2381,73,30,217,116,89,525
Missouri,Cliff Village village,30,0,0,4,2,0,6
Missouri,Bel-Nor village,1486,35,15,55,30,33,168
Missouri,Bel-Ridge village,2726,118,15,185,232,177,727
Missouri,Warrenton,8025,79,142,525,674,696,2116
Missouri,Belton,23209,513,379,1910,1258,1322,5382
Missouri,Warrensburg,19739,362,248,524,722,695,2551
Missouri,Wardell,349,0,5,24,16,18,63
Missouri,Velda Village Hills village,905,13,11,78,50,35,187
Missouri,Velda City,1315,10,39,65,90,40,244
Missouri,Vanduser village,128,0,0,6,5,0,11
Missouri,Vandiver village,97,0,0,16,9,8,33
Missouri,Vandalia,4126,23,43,207,141,282,696
Missouri,Van Buren,1044,13,32,125,56,35,261
Missouri,Valley Park,6970,158,89,193,262,177,879
Missouri,Utica village,272,14,0,3,0,37,54
Missouri,Urich,453,12,6,27,29,5,79
Missouri,Urbana,376,6,1,15,37,15,74
Missouri,Uplands Park village,384,6,6,10,11,26,59
Missouri,University City,35172,829,374,1236,1187,1463,5089
Missouri,Unity Village village,114,0,0,0,4,14,18
Missouri,Unionville,1989,25,47,104,106,112,394
Missouri,Union Star,344,4,0,16,14,16,50
Missouri,Union,10644,105,196,538,733,318,1890
Missouri,Umber View Heights village,71,0,0,2,0,1,3
Missouri,Viburnum,721,19,7,27,38,44,135
Missouri,Vienna,721,34,1,56,11,13,115
Missouri,Village of Four Seasons village,2218,39,14,121,128,174,476
Missouri,Villa Ridge,2800,53,79,166,102,72,472
Missouri,Vinita Park,1940,47,13,77,113,56,306
Missouri,Vinita Terrace village,220,0,0,18,10,6,34
Missouri,Vista village,48,0,0,4,5,6,15
Missouri,Waco,52,0,1,10,2,0,13
Missouri,Walker,275,4,6,14,15,18,57
Missouri,Walnut Grove,689,12,15,52,31,23,133
Missouri,Wardsville village,1890,12,53,151,229,133,578
Missouri,Black Jack,6938,163,112,460,261,214,1210
Missouri,Bennett Springs,114,0,0,0,0,0,0
Missouri,Benton City village,176,0,6,29,7,3,45
Missouri,Baker village,0,0,0,0,0,0,0
Missouri,Bakersfield village,289,2,6,5,11,27,51
Missouri,Baldwin Park village,66,0,0,5,5,1,11
Missouri,Ballwin,30484,801,342,1911,1733,1722,6509
Missouri,Baring,153,0,0,10,13,9,32
Missouri,Barnard,268,13,0,11,16,31,71
Missouri,Barnett,163,0,0,2,8,1,11
Missouri,Barnhart,5858,87,86,283,333,421,1210
Missouri,Bates City,235,0,5,26,18,4,53
Missouri,Battlefield,5844,82,128,317,298,209,1034
Missouri,Bella Villa,756,16,2,21,42,23,104
Missouri,Bell City,491,4,13,30,29,49,125
Missouri,Belle,1738,11,14,70,130,117,342
Missouri,Bellefontaine Neighbors,10814,152,168,728,654,603,2305
Missouri,Bellerive village,183,2,0,5,10,7,24
Missouri,Bellflower,337,2,5,16,10,33,66
Missouri,Westphalia,381,4,0,8,10,12,34
Missouri,Weston,1673,22,15,77,104,147,365
Missouri,West Line village,89,0,0,2,5,15,22
Missouri,Westboro,181,0,6,9,12,26,53
Missouri,West Alton,545,4,4,19,12,24,63
Missouri,Wentzville,32827,824,822,2471,2307,1990,8414
Missouri,Wentworth village,103,0,2,3,0,8,13
Missouri,Wellsville,1138,17,11,71,66,65,230
Missouri,Wellston,1949,18,77,127,153,191,566
Missouri,Versailles,2826,19,33,172,154,184,562
Missouri,Plevna,15,0,0,0,0,0,0
Missouri,Bagnell,52,0,1,1,0,2,4
Missouri,Benton,937,16,4,47,84,43,194
Missouri,Avondale,392,14,0,18,7,8,47
Missouri,Ava,2961,79,59,127,124,193,582
Missouri,Weldon Spring,5517,73,18,233,275,275,874
Missouri,Weldon Spring Heights,92,0,0,1,1,5,7
Missouri,Wellington,850,7,28,46,59,63,203
Missouri,Twin Oaks village,332,14,4,15,14,7,54
Missouri,Tuscumbia,252,2,4,6,17,14,43
Missouri,Turney village,111,0,2,5,1,7,15
Missouri,Truxton village,90,0,7,10,13,6,36
Missouri,Truesdale,869,11,14,73,46,69,213
Missouri,Troy,11175,186,216,743,820,705,2670
Missouri,Berger,168,1,0,9,10,7,27
Missouri,Berkeley,9083,148,137,675,482,581,2023
Missouri,Bernie,1992,21,29,129,84,75,338
Missouri,Bertrand,807,10,3,30,24,14,81
Missouri,Bethany,3080,75,65,114,163,100,517
Missouri,Marshfield,6860,156,32,460,462,498,1608
Missouri,Beverly Hills,450,11,0,18,10,22,61
Missouri,Bevier,642,0,10,28,22,28,88
Missouri,Biehle,0,0,0,0,0,0,0
Missouri,Bigelow village,8,0,0,0,0,0,0
Missouri,Big Lake village,102,2,0,4,0,0,6
Missouri,Big Spring,29,0,0,0,0,0,0
Missouri,Billings,921,13,11,36,17,48,125
Missouri,Birch Tree,559,14,8,22,8,35,87
Missouri,Birmingham village,212,3,3,12,8,10,36
Missouri,Bismarck,1336,25,22,50,82,82,261
Missouri,Aurora,7473,144,140,512,351,430,1577
Missouri,Auxvasse,1298,18,46,74,70,117,325
Missouri,Avilla,100,0,7,11,9,0,27
Missouri,Pocahontas,124,5,4,7,14,13,43
Missouri,Harwood village,106,2,0,7,0,12,21
Missouri,Polo,606,2,18,36,56,43,155
Missouri,Dadeville village,259,0,4,17,18,22,61
Missouri,Dalton,15,0,0,0,3,2,5
Missouri,Danville,71,0,0,10,17,0,27
Missouri,Dardenne Prairie,12383,120,167,1007,949,1095,3338
Missouri,Darlington village,75,1,2,3,2,3,11
Missouri,Dawn,111,0,0,11,7,7,25
Missouri,Dearborn,412,4,8,6,25,19,62
Missouri,Deepwater,427,4,11,37,40,0,92
Missouri,Deerfield village,70,2,0,0,5,8,15
Missouri,Defiance,161,9,0,0,0,11,20
Missouri,De Kalb,202,0,2,2,16,2,22
Missouri,Dellwood,5011,89,85,325,297,476,1272
Missouri,Delta,422,0,0,17,25,26,68
Missouri,Dennis Acres village,45,0,6,6,5,0,17
Missouri,Denver village,47,0,0,4,6,0,10
Missouri,Des Arc village,170,10,1,4,4,7,26
Missouri,Desloge,4966,92,58,241,130,271,792
Missouri,De Soto,6469,163,14,365,499,255,1296
Missouri,Des Peres,8480,220,138,357,473,663,1851
Missouri,De Witt,101,2,2,3,4,10,21
Missouri,Dexter,7920,135,181,398,287,266,1267
Missouri,Diamond,921,8,15,48,32,20,123
Missouri,Diehlstadt village,184,5,0,4,8,15,32
Missouri,Curryville,240,0,7,10,20,19,56
Missouri,Diggins village,280,0,0,13,7,17,37
Missouri,Cuba,3377,109,56,159,291,170,785
Missouri,Crystal Lake Park,494,12,10,27,32,37,118
Missouri,Conception Junction,210,3,0,11,36,21,71
Missouri,Concord,16953,351,141,570,932,1006,3000
Missouri,Concordia,2373,62,8,111,126,126,433
Missouri,Coney Island village,68,0,0,0,0,0,0
Missouri,Conway,918,14,16,58,64,98,250
Missouri,Cool Valley,1167,9,16,63,52,31,171
Missouri,Cooter,428,0,2,29,43,26,100
Missouri,Corder,337,8,3,22,10,36,79
Missouri,Corning,4,0,0,0,0,0,0
Missouri,Cosby village,151,0,0,12,16,16,44
Missouri,Cottleville,3836,49,38,226,316,280,909
Missouri,Country Club village,2833,28,12,250,175,104,569
Missouri,Country Club Hills,1398,52,79,104,99,97,431
Missouri,Country Life Acres village,138,0,0,8,15,14,37
Missouri,Cowgill,139,5,4,7,3,10,29
Missouri,Craig,208,5,4,6,9,5,29
Missouri,Crane,2022,23,0,142,173,141,479
Missouri,Creighton,320,3,1,6,18,45,73
Missouri,Crestwood,11961,297,130,488,679,596,2190
Missouri,Creve Coeur,17944,302,161,789,783,868,2903
Missouri,Crocker,997,13,51,60,65,36,225
Missouri,Cross Timbers,239,0,4,32,11,17,64
Missouri,Crystal City,4829,128,92,234,172,242,868
Missouri,Crystal Lakes,322,4,2,13,16,21,56
Missouri,Conception,262,0,2,5,6,2,15
Missouri,Dixon,1443,31,42,148,86,75,382
Missouri,Doniphan,2337,53,73,128,106,32,392
Missouri,Sedalia,21457,218,264,1198,1032,1159,3871
Missouri,Sedgewickville village,255,0,7,11,0,10,28
Missouri,Seligman,1021,0,18,65,85,29,197
Missouri,Senath,1813,39,39,85,138,123,424
Missouri,Seneca,2285,5,50,136,144,173,508
Missouri,Seymour,1789,18,37,103,98,74,330
Missouri,Shelbina,1583,41,30,95,86,63,315
Missouri,Shelbyville,546,14,3,43,14,19,93
Missouri,Sheldon,672,23,6,31,11,45,116
Missouri,Shell Knob,1475,0,0,67,129,42,238
Missouri,Zalma village,146,2,0,8,4,27,41
Missouri,Wyatt,443,2,2,10,5,36,55
Missouri,Wyaconda,199,0,2,15,7,8,32
Missouri,Wright City,3355,49,128,144,171,304,796
Missouri,Worthington village,96,7,4,6,4,9,30
Missouri,Wortham,226,0,0,0,15,0,15
Missouri,Worth village,53,2,0,5,4,0,11
Missouri,Wooldridge village,35,0,0,0,0,2,2
Missouri,Woodson Terrace,4072,32,29,226,259,285,831
Missouri,Wood Heights,748,12,15,35,59,56,177
Missouri,Winston village,226,1,0,17,23,9,50
Missouri,Winona,1202,13,25,75,58,103,274
Missouri,Winigan,61,2,0,0,4,3,9
Missouri,Scott City,4527,80,31,234,245,225,815
Missouri,Doe Run,1096,30,0,27,41,0,98
Missouri,Scotsdale,228,3,0,8,23,6,40
Missouri,Savannah,5092,22,14,252,410,297,995
Missouri,Doolittle,658,2,2,12,53,29,98
Missouri,Dover,115,6,0,6,0,2,14
Missouri,St. Charles,67479,1198,727,2856,2808,2962,10551
Missouri,St. Clair,4706,100,81,277,248,104,810
Missouri,St. Clement,108,0,0,0,14,0,14
Missouri,St. Cloud village,64,9,0,0,0,0,9
Missouri,Ste. Genevieve,4437,84,125,284,277,187,957
Missouri,St. Elizabeth village,319,7,7,21,21,11,67
Missouri,St. Francisville,102,0,0,0,4,14,18
Missouri,St. James,4172,46,116,285,215,239,901
Missouri,St. John,6491,34,86,412,208,395,1135
Missouri,St. Joseph,77037,1311,1016,4120,3526,4177,14150
Missouri,St. Louis,317850,5657,3468,13462,13412,13896,49895
Missouri,St. Martins,1223,24,24,69,55,80,252
Missouri,St. Mary,407,2,5,23,27,30,87
Missouri,St. Paul,1863,5,13,62,92,113,285
Missouri,St. Peters,55135,1117,468,2818,2621,2557,9581
Missouri,St. Robert,5151,145,127,431,149,215,1067
Missouri,St. Thomas,225,0,2,21,8,16,47
Missouri,Salem,4976,33,125,193,266,151,768
Missouri,Salisbury,1667,59,43,88,65,101,356
Missouri,Sappington,7113,126,32,345,595,287,1385
Missouri,Sarcoxie,1181,46,25,70,64,87,292
Missouri,Schell City,241,1,0,25,12,18,56
Missouri,Commerce village,44,0,0,0,0,5,5
Missouri,Columbia,115391,1624,1403,4259,4570,4015,15871
Missouri,Collins village,132,0,0,4,2,3,9
Missouri,Mine La Motte,225,0,0,11,10,0,21
Missouri,Miner,963,19,17,22,39,11,108
Missouri,Mineral Point,389,7,15,24,18,26,90
Missouri,Miramiguoa Park village,112,6,7,8,1,3,25
Missouri,Missouri City,311,1,0,22,6,9,38
Missouri,Moberly,13879,261,123,728,703,778,2593
Missouri,Mokane,156,2,7,13,8,17,47
Missouri,Moline Acres,2377,51,11,162,145,184,553
Missouri,Monett,8957,199,220,513,481,520,1933
Missouri,Monroe City,2439,50,27,87,121,130,415
Missouri,Montgomery City,2795,31,60,192,204,179,666
Missouri,Monticello village,139,0,0,5,0,8,13
Missouri,Montier,51,0,0,0,0,0,0
Missouri,Montreal,55,9,0,19,0,0,28
Missouri,Montrose,355,2,4,28,11,7,52
Missouri,Mooresville village,122,0,11,1,10,8,30
Missouri,Morehouse,826,0,30,14,15,72,131
Missouri,Morley,728,14,13,28,24,27,106
Missouri,Morrison,91,0,0,9,4,2,15
Missouri,Morrisville,378,11,6,9,17,37,80
Missouri,Mosby,206,0,2,13,1,3,19
Missouri,Moscow Mills,2550,12,85,204,194,127,622
Missouri,Mound City,1265,10,31,55,48,79,223
Missouri,Mindenmines,270,0,3,12,12,19,46
Missouri,Moundville,132,1,1,4,4,6,16
Missouri,Milo village,108,0,2,8,13,9,32
Missouri,Miller,732,28,25,40,24,35,152
Missouri,Marston,417,15,13,29,9,42,108
Missouri,Marthasville,1273,36,15,106,69,70,296
Missouri,Martinsburg,325,9,2,20,10,12,53
Missouri,Maryland Heights,27401,530,289,1179,1054,966,4018
Missouri,Maryville,11997,136,107,256,250,235,984
Missouri,Matthews,736,0,18,27,37,43,125
Missouri,Maysville,1115,20,4,18,19,56,117
Missouri,Mayview,335,2,26,41,28,17,114
Missouri,Meadville,415,8,3,29,31,20,91
Missouri,Mehlville,29953,240,213,1605,1101,1445,4604
Missouri,Memphis,1938,58,60,79,96,99,392
Missouri,Mendon,156,0,0,8,13,11,32
Missouri,Mercer,413,5,2,29,11,8,55
Missouri,Merriam Woods village,1668,24,26,103,69,128,350
Missouri,Merwin village,37,0,0,0,1,3,4
Missouri,Meta,244,5,5,13,11,11,45
Missouri,Metz,36,2,0,2,0,1,5
Missouri,Mexico,11588,302,114,670,599,526,2211
Missouri,Miami,142,0,2,11,14,3,30
Missouri,Middletown,232,9,7,9,7,15,47
Missouri,Milan,2110,30,23,135,170,142,500
Missouri,Milford village,31,0,0,0,0,0,0
Missouri,Millard village,66,0,0,6,1,3,10
Missouri,Mill Spring village,160,0,9,1,0,17,27
Missouri,Mountain Grove,4712,63,61,257,373,279,1033
Missouri,Mountain View,2701,51,38,215,138,79,521
Missouri,Mount Leonard,83,4,0,1,11,3,19
Missouri,Rock Hill,4638,116,45,332,163,141,797
Missouri,Rock Port,1359,27,25,45,65,65,227
Missouri,Rockville,140,0,3,16,11,9,39
Missouri,Rogersville,3453,60,96,303,226,188,873
Missouri,Rolla,19910,206,277,765,866,815,2929
Missouri,Roscoe village,111,0,0,3,2,6,11
Missouri,Rosebud,436,2,2,16,37,32,89
Missouri,Rosendale,129,1,6,11,19,9,46
Missouri,Rothville village,131,0,0,17,5,6,28
Missouri,Rush Hill village,137,0,3,3,3,10,19
Missouri,Rushville,258,0,9,12,1,10,32
Missouri,Russellville,837,3,18,73,44,58,196
Missouri,Rutledge,72,2,0,7,3,2,14
Missouri,Saddlebrooke village,284,0,8,6,8,15,37
Missouri,Saginaw village,338,1,6,19,20,16,62
Missouri,St. Ann,12973,281,258,892,480,407,2318
Missouri,Clifton Hill,105,5,0,6,4,0,15
Missouri,Climax Springs village,166,0,5,4,20,10,39
Missouri,Clinton,9012,146,118,463,360,543,1630
Missouri,Clyde village,90,3,6,8,2,4,23
Missouri,Cobalt village,256,0,2,9,5,31,47
Missouri,Coffey,135,3,0,13,3,7,26
Missouri,Cole Camp,1443,7,38,57,77,143,322
Missouri,Rockaway Beach,832,10,5,33,53,33,134
Missouri,Rocheport,243,0,0,8,7,11,26
Missouri,Rives,56,0,0,3,0,4,7
Missouri,Riverview Estates village,120,0,0,8,14,8,30
Missouri,Mount Moriah,124,0,0,5,3,15,23
Missouri,Mount Vernon,4531,32,40,238,197,196,703
Missouri,Murphy,8745,109,76,476,270,497,1428
Missouri,Napoleon,243,4,2,17,19,11,53
Missouri,Naylor,756,19,24,29,51,47,170
Missouri,Neck City,139,0,4,11,0,9,24
Missouri,Neelyville,529,16,21,60,30,41,168
Missouri,Nelson,158,0,8,14,2,3,27
Missouri,Neosho,12102,119,180,781,614,753,2447
Missouri,Nevada,8454,93,171,483,504,461,1712
Missouri,Newark village,68,0,0,2,2,1,5
Missouri,Winfield,1698,17,20,168,176,99,480
Missouri,New Bloomfield,806,4,36,9,28,56,133
Missouri,Rich Hill,1446,39,30,106,93,75,343
Missouri,Richland,1678,48,17,101,64,114,344
Missouri,Richmond,5654,87,50,264,360,228,989
Missouri,Richmond Heights,8510,127,74,398,290,266,1155
Missouri,Ridgely village,106,0,2,0,11,14,27
Missouri,Ridgeway,479,19,1,32,18,34,104
Missouri,Risco,362,0,8,12,5,26,51
Missouri,Ritchey,78,11,0,3,2,3,19
Missouri,River Bend village,6,0,0,0,0,0,0
Missouri,Riverside,3056,86,20,139,115,62,422
Missouri,Riverview village,2849,55,50,120,141,225,591
Missouri,Richards,115,0,1,13,9,8,31
Missouri,Windsor Place village,383,7,2,27,27,14,77
Missouri,Windsor,2753,61,63,62,130,118,434
Missouri,Winchester,1612,29,27,81,104,66,307
Missouri,Clark,261,11,4,5,17,14,51
Missouri,Clarksburg,256,6,9,5,24,20,64
Missouri,Adrian,1953,68,36,163,147,87,501
Missouri,Advance,1449,14,19,123,116,57,329
Missouri,Affton,21345,311,133,948,751,966,3109
Missouri,Agency village,907,5,6,74,41,43,169
Missouri,Airport Drive village,877,2,19,41,71,60,193
Missouri,Alba,503,9,2,34,14,11,70
Missouri,Albany,2178,50,38,106,111,112,417
Missouri,Aldrich village,76,0,1,2,2,9,14
Missouri,Alexandria,142,1,0,0,1,14,16
Missouri,Allendale village,44,1,0,0,0,0,1
Missouri,Allenville village,68,0,3,0,1,0,4
Missouri,Alma,387,9,2,12,11,33,67
Missouri,Altamont village,175,1,5,17,13,6,42
Missouri,Altenburg,477,15,0,25,36,22,98
Missouri,Alton,1087,9,13,40,50,79,191
Missouri,Amazonia village,253,0,5,8,9,19,41
Missouri,Amity,18,0,0,0,1,0,1
Missouri,Amoret,140,0,0,8,4,11,23
Missouri,Amsterdam,231,1,4,9,15,14,43
Missouri,Anderson,2435,50,22,129,158,159,518
Missouri,Annada village,42,0,0,4,3,6,13
Missouri,Clarence,918,13,15,85,53,30,196
Missouri,Annapolis,466,15,2,19,25,30,91
Missouri,Chula,245,6,7,20,8,22,63
Missouri,Chilhowee,272,4,0,18,7,4,33
Missouri,Carytown,282,7,9,28,14,15,73
Missouri,Cassville,3286,155,36,195,176,157,719
Missouri,Castle Point,3368,93,77,289,298,230,987
Missouri,Catron,82,0,0,3,4,6,13
Missouri,Cave,1,0,0,0,0,0,0
Missouri,Cedar Hill,1694,0,24,62,105,120,311
Missouri,Cedar Hill Lakes village,205,1,0,6,4,5,16
Missouri,Center,382,0,2,16,17,13,48
Missouri,Centertown,288,0,7,24,16,17,64
Missouri,Centerview,253,1,3,49,21,19,93
Missouri,Centerville,244,3,5,6,2,12,28
Missouri,Centralia,4159,154,69,176,141,164,704
Missouri,Chaffee,2943,55,69,65,238,182,609
Missouri,Chain of Rocks village,133,5,0,14,6,8,33
Missouri,Chain-O-Lakes village,122,2,7,4,12,6,31
Missouri,Chamois,396,16,3,29,21,18,87
Missouri,Champ village,10,0,0,0,0,0,0
Missouri,Charlack,1483,52,34,83,44,56,269
Missouri,Charleston,5877,53,53,219,222,282,829
Missouri,Charmwood,24,0,0,0,6,2,8
Missouri,Cherokee Pass,242,0,0,10,10,0,20
Missouri,Chesapeake,116,0,0,0,0,0,0
Missouri,Chesterfield,47706,863,582,2419,2517,2542,8923
Missouri,Chillicothe,9025,114,118,537,373,407,1549
Missouri,Anniston,215,2,0,11,6,13,32
Missouri,Appleton City,1322,9,49,55,56,65,234
Missouri,Arbela,19,0,1,0,0,3,4
Missouri,Raymore,19813,504,259,1070,1214,1396,4443
Missouri,Raymondville,406,17,4,19,30,38,108
Missouri,Ravenwood,436,14,15,28,20,7,84
Missouri,Ravanna,44,0,0,0,0,0,0
Missouri,Randolph village,28,0,0,1,3,3,7
Missouri,Qulin,446,10,8,21,18,24,81
Missouri,Quitman,45,0,0,8,3,1,12
Missouri,Queen City,686,15,3,39,42,24,123
Missouri,Puxico,782,7,2,33,48,35,125
Missouri,Purdy,1416,18,17,57,106,131,329
Missouri,Purdin,194,0,3,12,13,11,39
Missouri,Purcell,399,14,11,41,35,36,137
Missouri,Princeton,1080,27,19,33,63,51,193
Missouri,Preston village,273,3,3,15,14,10,45
Missouri,Prathersville village,111,1,0,1,8,5,15
Missouri,Prairie Home,328,7,0,16,14,21,58
Missouri,Powersville village,79,1,0,1,7,4,13
Missouri,Potosi,2666,20,0,128,212,119,479
Missouri,Portageville,3168,9,17,177,193,318,714
Missouri,Portage Des Sioux,403,9,3,17,36,34,99
Missouri,Poplar Bluff,17195,307,303,784,1035,689,3118
Missouri,Pontiac,278,0,26,0,26,0,52
Missouri,Pomona,306,0,0,11,0,0,11
Missouri,Raytown,29486,432,501,1600,1718,1685,5936
Missouri,Rayville,201,0,0,6,15,10,31
Missouri,Rea,53,2,0,2,2,0,6
Missouri,Redings Mill village,197,0,0,8,10,9,27
Missouri,Arbyrd,531,13,5,25,48,24,115
Missouri,Arcadia,831,0,8,45,78,51,182
Missouri,Archie,1359,37,37,112,90,105,381
Missouri,Arcola village,61,0,0,4,1,6,11
Missouri,Argyle,163,0,5,6,0,4,15
Missouri,Arkoe,75,0,5,6,6,3,20
Missouri,Armstrong,364,1,6,28,38,23,96
Missouri,Arnold,21123,350,194,1054,987,1003,3588
Missouri,Arrow Point village,125,0,1,8,4,0,13
Missouri,Arrow Rock,37,0,0,0,0,0,0
Missouri,Asbury,171,0,0,3,3,2,8
Missouri,Caruthersville,6026,135,64,295,466,302,1262
Missouri,Ashburn,40,0,0,0,0,0,0
Missouri,Ashland,3828,47,75,351,158,241,872
Missouri,Ashley,75,0,0,0,0,0,0
Missouri,Atlanta,512,8,8,43,34,27,120
Missouri,Augusta,284,0,5,9,10,9,33
Missouri,Rhineland,156,0,0,1,5,25,31
Missouri,Revere,83,4,0,3,4,3,14
Missouri,Republic,15594,276,289,1189,822,772,3348
Missouri,Rensselaer village,243,2,3,10,12,4,31
Missouri,Renick village,193,9,0,4,1,4,18
Missouri,Reeds Spring,905,9,4,92,40,59,204
Missouri,Reeds,71,0,0,0,0,9,9
Missouri,Ash Grove,1567,15,17,36,109,83,260
Missouri,Pollock village,40,0,0,0,0,2,2
Missouri,Carthage,14278,206,203,988,799,663,2859
Missouri,Carrollton,3734,28,24,207,255,200,714
Missouri,Humphreys village,108,0,11,2,0,3,16
Missouri,Hume,373,10,6,31,39,34,120
Missouri,Humansville,1140,36,16,37,84,53,226
Missouri,Hughesville village,160,0,0,6,5,6,17
Missouri,Howardville,286,2,4,25,9,23,63
Missouri,Houston Lake,347,6,2,2,13,22,45
Missouri,Houstonia,207,0,3,5,20,2,30
Missouri,Houston,2354,62,51,174,78,147,512
Missouri,Hornersville,803,5,16,58,64,34,177
Missouri,Horine,1332,101,15,84,45,96,341
Missouri,Hopkins,485,7,2,13,41,34,97
Missouri,Homestown,169,0,9,13,17,16,55
Missouri,Homestead village,175,3,2,9,9,5,28
Missouri,Holts Summit,3447,57,27,130,136,253,603
Missouri,Holt,474,13,13,34,47,20,127
Missouri,Hollister,4441,150,0,229,169,279,827
Missouri,Holliday village,102,0,2,6,10,2,20
Missouri,Holland,199,2,6,7,9,8,32
Missouri,Holden,2284,41,34,161,106,94,436
Missouri,Holcomb,749,4,4,50,78,61,197
Missouri,Hoberg village,47,0,0,4,2,4,10
Missouri,Hillsdale village,1327,6,38,89,71,122,326
Missouri,Hillsboro,2980,51,38,178,213,248,728
Missouri,Hunnewell,136,1,0,0,2,10,13
Missouri,High Ridge,3553,60,22,159,237,190,668
Missouri,Hunter,106,0,0,0,0,0,0
Missouri,Huntsdale,25,0,0,0,0,0,0
Missouri,Wilson City village,55,0,0,2,2,5,9
Missouri,Willow Springs,2294,68,17,137,119,89,430
Missouri,Williamsville,390,5,5,9,20,30,69
Missouri,Willard,5429,147,0,441,406,406,1400
Missouri,Wildwood,35776,752,621,2273,2386,2882,8914
Missouri,Wilbur Park village,505,23,3,11,2,20,59
Missouri,Whitewater,99,0,4,5,3,7,19
Missouri,Whiteside village,56,0,3,6,5,0,14
Missouri,Whiteman AFB,3893,75,81,230,149,153,688
Missouri,Wheeling,280,0,0,18,24,12,54
Missouri,Wheaton,689,14,2,50,48,37,151
Missouri,Wheatland,289,0,0,15,11,8,34
Missouri,Westwood village,298,4,1,13,14,27,59
Missouri,West Sullivan,59,0,0,2,5,0,7
Missouri,West Plains,12230,278,86,720,705,636,2425
Missouri,Indian Point village,541,9,14,12,16,25,76
Missouri,Independence,117192,1475,1702,6098,5455,5334,20064
Missouri,Imperial,4807,111,48,273,229,212,873
Missouri,Iberia,693,22,26,37,34,25,144
Missouri,Iatan village,41,0,4,0,3,0,7
Missouri,Hurley,220,2,7,6,16,9,40
Missouri,Hurdland,118,0,3,4,2,13,22
Missouri,Huntsville,1570,15,51,57,96,105,324
Missouri,Huntleigh,372,0,0,21,39,22,82
Missouri,Highlandville,1040,8,29,107,103,55,302
Missouri,High Hill,196,0,1,8,10,9,28
Missouri,Higginsville,4706,94,175,234,204,164,871
Missouri,Burgess,59,1,0,2,3,1,7
Missouri,Burlington Junction,468,17,11,49,17,21,115
Missouri,Butler,4153,172,113,205,155,207,852
Missouri,Butterfield village,483,7,14,19,35,24,99
Missouri,Byrnes Mill,2822,53,19,122,186,118,498
Missouri,Cabool,2309,23,46,148,175,142,534
Missouri,Cainsville,240,5,2,12,11,12,42
Missouri,Cairo village,314,22,2,28,26,14,92
Missouri,Caledonia village,173,0,0,7,13,20,40
Missouri,Calhoun,414,10,9,42,18,37,116
Missouri,California,4351,96,81,332,247,214,970
Missouri,Callao,436,2,4,47,27,74,154
Missouri,Calverton Park village,1289,22,24,41,80,59,226
Missouri,Camden,242,9,1,12,20,13,55
Missouri,Camden Point,502,4,5,38,20,40,107
Missouri,Camdenton,3822,178,97,317,196,151,939
Missouri,Cameron,10167,92,56,447,686,684,1965
Missouri,Campbell,1997,24,29,126,169,119,467
Missouri,Canalou,278,0,0,9,23,18,50
Missouri,Canton,2522,51,22,116,141,130,460
Missouri,Cape Girardeau,38959,504,436,1736,1378,1453,5507
Missouri,Cardwell,698,13,2,56,46,18,135
Missouri,Carl Junction,7577,147,210,564,403,352,1676
Missouri,Gunn City village,79,0,2,1,3,11,17
Missouri,Hale,459,10,6,24,22,32,94
Missouri,Halfway village,126,0,0,3,6,6,15
Missouri,Hallsville,1593,12,26,85,176,81,380
Missouri,Higbee,589,20,16,45,1,30,112
Missouri,Hermitage,801,9,23,48,45,25,150
Missouri,Hermann,2461,42,39,67,91,116,355
Missouri,Herculaneum,3762,70,14,217,211,241,753
Missouri,Henrietta,303,2,0,9,17,12,40
Missouri,Hazelwood,25686,366,262,1554,1014,1441,4637
Missouri,Haywood City village,151,0,0,7,2,21,30
Missouri,Hayward,130,4,16,8,19,0,47
Missouri,Hayti Heights,557,16,22,57,40,26,161
Missouri,Hayti,2840,93,7,80,175,174,529
Missouri,Hawk Point,796,18,31,72,51,31,203
Missouri,Carterville,1795,20,31,120,124,90,385
Missouri,Breckenridge,277,6,1,21,14,5,47
Missouri,Hartwell,0,0,0,0,0,0,0
Missouri,Hartville,588,4,4,16,58,18,100
Missouri,Hartsburg,100,0,0,4,9,3,16
Missouri,Harrisonville,10003,148,147,575,530,732,2132
Missouri,Harrisburg,347,21,8,28,32,23,112
Missouri,Harris,46,0,0,0,0,2,2
Missouri,Hardin,555,12,7,31,34,26,110
Missouri,Hannibal,17717,312,151,978,831,692,2964
Missouri,Hanley Hills village,2194,75,30,50,123,97,375
Missouri,Hamilton,1663,18,21,92,71,181,383
Missouri,Halltown village,109,0,0,6,5,3,14
Missouri,Harviell,163,0,82,0,0,0,82
Missouri,Breckenridge Hills,4728,104,0,219,158,373,854
Missouri,East Lynne,248,12,0,15,13,19,59
Missouri,Brewer,419,15,0,10,22,22,69
Missouri,Granby,2170,13,8,206,168,93,488
Missouri,Grain Valley,13134,210,128,1048,873,880,3139
Missouri,Graham,214,6,5,17,15,12,55
Missouri,Gower,1588,41,6,111,95,119,372
Missouri,Goss,0,0,0,0,0,0,0
Missouri,Gordonville village,416,2,1,6,8,26,43
Missouri,Goodnight village,12,0,0,2,3,0,5
Missouri,Goodman,1141,14,8,62,50,32,166
Missouri,Golden City,578,7,5,20,27,48,107
Missouri,Golden,491,0,0,0,7,36,43
Missouri,Glenwood village,175,0,5,12,14,5,36
Missouri,Glen Echo Park village,126,2,2,16,3,7,30
Missouri,Glendale,5928,230,97,487,420,293,1527
Missouri,Glen Allen,100,0,0,2,4,0,6
Missouri,Glenaire,440,6,11,24,17,15,73
Missouri,Brentwood,8052,143,58,313,297,386,1197
Missouri,Marshall,13048,261,209,702,703,635,2510
Missouri,Grand Falls Plaza,111,1,2,4,6,0,13
Missouri,Marquand,318,0,5,11,28,22,66
Missouri,Grandin,175,5,1,0,23,16,45
Missouri,Grandview,24997,249,412,1538,1405,1558,5162
Missouri,Guilford,54,0,0,1,5,0,6
Missouri,Greenwood,5400,139,52,457,430,413,1491
Missouri,Greenville,530,5,10,31,38,18,102
Missouri,Greentop,446,3,10,36,10,23,82
Missouri,Green Ridge,467,0,7,37,32,25,101
Missouri,Green Park,2630,52,30,115,107,138,442
Missouri,Greenfield,1325,33,5,65,81,79,263
Missouri,Greendale,636,3,17,12,24,10,66
Missouri,Green City,695,14,2,33,33,32,114
Missouri,Greencastle,330,4,2,5,18,19,48
Missouri,Gray Summit,2943,139,37,186,209,100,671
Missouri,Grayridge,68,0,0,0,0,0,0
Missouri,Grayhawk,536,0,0,20,18,11,49
Missouri,Gravois Mills,154,1,0,1,42,10,54
Missouri,Grantwood Village,962,31,12,19,52,67,181
Missouri,Grant City,835,19,12,39,24,35,129
Missouri,Granger village,28,2,0,2,0,0,4
Missouri,Grand Pass village,73,0,0,0,4,19,23
Missouri,Innsbrook village,786,82,1,0,0,23,106
Missouri,Marlborough village,2006,0,0,36,62,6,104
Missouri,Triplett,18,0,0,0,0,2,2
Missouri,Sunset Hills,8533,220,153,520,546,324,1763
Missouri,Sunrise Beach village,421,1,5,11,15,23,55
Missouri,Sundown,27,0,0,0,0,0,0
Missouri,Sumner,106,2,2,16,8,4,32
Missouri,Summersville,636,0,18,45,20,22,105
Missouri,Sullivan,6998,115,98,309,333,346,1201
Missouri,Sugar Creek,3339,54,48,90,82,37,311
Missouri,Sturgeon,778,7,11,43,48,37,146
Missouri,Strasburg,143,0,0,9,12,8,29
Missouri,Strafford,2137,31,42,130,172,137,512
Missouri,Stover,1204,52,26,41,55,57,231
Missouri,Stoutsville village,53,0,1,2,1,3,7
Missouri,Stoutland,171,4,0,0,3,6,13
Missouri,Stotts City,152,0,6,9,15,8,38
Missouri,Stotesbury,14,0,0,0,0,0,0
Missouri,Stockton,1849,41,20,70,78,146,355
Missouri,Stewartsville,767,3,1,28,42,28,102
Missouri,Sweet Springs,1521,27,30,34,88,91,270
Missouri,Marionville,2153,61,22,127,115,143,468
Missouri,Sycamore Hills village,623,9,2,16,26,28,81
Missouri,Tallapoosa,205,0,15,4,5,7,31
Missouri,Trimble,680,10,13,27,36,48,134
Missouri,Trenton,6042,108,25,259,338,258,988
Missouri,Tracy,214,12,0,3,7,3,25
Missouri,Town and Country,10960,210,30,452,626,821,2139
Missouri,Tipton,3303,17,34,86,83,198,418
Missouri,Tindall,78,0,0,2,9,12,23
Missouri,Tina village,93,3,0,1,5,2,11
Missouri,Tightwad village,62,0,0,2,2,5,9
Missouri,Three Creeks village,4,0,0,0,0,0,0
Missouri,Thomasville,38,0,0,0,0,0,0
Missouri,Theodosia village,231,6,0,7,6,4,23
Missouri,Thayer,2236,7,43,119,96,122,387
Missouri,Terre du Lac,2401,0,0,225,99,148,472
Missouri,Tarrants village,0,0,0,0,0,0,0
Missouri,Tarkio,1420,14,16,57,53,58,198
Missouri,Taos,1233,28,7,114,144,58,351
Missouri,Taneyville village,327,4,2,38,15,15,74
Missouri,Syracuse,178,1,1,5,8,14,29
Missouri,Stella,124,0,2,9,0,8,19
Missouri,Ionia,119,0,1,0,6,0,7
Missouri,Irondale,451,12,8,33,45,20,118
Missouri,Lamar,4457,50,60,265,307,236,918
Missouri,Lake Winnebago,1287,51,13,28,50,65,207
Missouri,Lake Waukomis,885,18,3,37,24,38,120
Missouri,Lake Viking,360,0,5,0,5,6,16
Missouri,Lake Tekakwitha village,235,0,0,9,4,10,23
Missouri,Lake Tapawingo,689,6,0,10,27,34,77
Missouri,Lakeside,0,0,0,0,0,0,0
Missouri,Lakeshire,1579,34,11,64,61,88,258
Missouri,Lake St. Louis,14933,209,265,886,800,836,2996
Missouri,Lake Ozark,1626,20,22,109,69,62,282
Missouri,Lake Mykee Town village,491,9,4,29,49,19,110
Missouri,Lake Lotawana,2100,8,18,39,163,103,331
Missouri,Lake Lafayette,332,4,3,21,11,13,52
Missouri,Lake Annette,136,0,0,2,12,4,18
Missouri,La Grange,950,27,4,49,45,25,150
Missouri,Ladue,8559,250,73,609,515,633,2080
Missouri,La Due village,55,0,0,0,0,3,3
Missouri,Lamar Heights,200,0,1,12,10,20,43
Missouri,Laddonia,556,0,24,16,39,49,128
Missouri,Lambert village,0,0,0,0,0,0,0
Missouri,Northwoods,4208,18,51,134,148,295,646
Missouri,New Florence,794,2,5,44,30,34,115
Missouri,New Franklin,1242,25,16,41,67,78,227
Missouri,New Hampton,270,3,5,23,14,13,58
Missouri,New Haven,2194,38,46,192,157,99,532
Missouri,New London,959,9,18,65,35,60,187
Missouri,New Madrid,3042,38,5,286,218,101,648
Missouri,New Melle,448,5,2,16,16,14,53
Missouri,Newtonia,258,0,2,13,12,9,36
Missouri,Newtown,218,0,0,9,11,9,29
Missouri,Niangua,396,8,3,22,23,9,65
Missouri,Nixa,20177,323,387,1759,1387,1201,5057
Missouri,Noel,1877,19,24,124,156,137,460
Missouri,Norborne,739,16,5,30,39,50,140
Missouri,Normandy,4985,122,97,355,190,114,878
Missouri,North Kansas City,4298,11,46,77,141,305,580
Missouri,North Lilbourn village,37,0,0,0,0,0,0
Missouri,Northmoor,380,0,11,15,8,23,57
Missouri,La Monte,1406,41,64,103,83,66,357
Missouri,Irena village,23,0,0,0,0,4,4
Missouri,Laclede,326,0,0,10,20,18,48
Missouri,LaBarque Creek,1857,14,42,144,131,40,371
Missouri,Junction City village,474,6,10,10,18,66,110
Missouri,Josephville village,399,3,4,19,23,35,84
Missouri,Joplin,51042,837,620,2077,2496,2180,8210
Missouri,Jonesburg,754,3,19,43,27,31,123
Missouri,Jerico Springs village,180,0,0,3,6,16,25
Missouri,Jennings,14755,218,208,861,897,1038,3222
Missouri,Jefferson City,43186,564,469,1797,2130,2277,7237
Missouri,Jasper,987,33,12,64,54,64,227
Missouri,Jane,460,0,35,48,46,26,155
Missouri,Jamestown,351,4,8,27,24,17,80
Missouri,Jamesport,543,15,4,25,42,39,125
Missouri,Jameson,82,0,0,2,3,6,11
Missouri,Jacksonville village,159,10,3,5,2,6,26
Missouri,Jackson,14439,150,280,1090,772,822,3114
Missouri,Irwin,35,0,0,0,0,0,0
Missouri,Ironton,1571,34,32,65,57,78,266
Missouri,Iron Mountain Lake,826,10,20,43,30,48,151
Missouri,Kahoka,1969,35,7,145,148,84,419
Missouri,La Belle,647,11,0,16,32,39,98
Missouri,Kansas City,467990,7242,5796,24217,23136,22004,82395
Missouri,Kelso village,588,2,1,27,35,13,78
Missouri,Koshkonong,248,5,3,7,9,11,35
Missouri,Knox City,261,5,5,16,13,15,54
Missouri,Knob Noster,2779,50,43,67,101,148,409
Missouri,Kissee Mills,998,0,11,60,38,48,157
Missouri,Kirkwood,27612,719,339,1219,1367,1057,4701
Missouri,Kirksville,17574,172,254,505,630,531,2092
Missouri,Kirbyville village,244,0,0,8,24,20,52
Missouri,Kinloch,267,6,0,14,1,21,42
Missouri,Kingsville,233,0,1,18,9,13,41
Missouri,Kingston,332,3,1,6,12,12,34
Missouri,Kingdom City village,135,0,0,2,2,0,4
Missouri,King City,1006,44,21,60,27,53,205
Missouri,Kimmswick,143,0,2,11,8,2,23
Missouri,Kimberling City,2687,26,20,106,100,39,291
Missouri,Kidder,215,2,0,10,7,6,25
Missouri,Keytesville,515,50,0,22,6,20,98
Missouri,Kennett,10678,169,187,480,512,452,1800
Missouri,Kearney,9039,296,123,871,618,612,2520
Missouri,Steelville,2225,71,26,200,110,102,509
Missouri,Steele,2237,44,42,120,142,173,521
Missouri,Stark City,138,1,0,3,3,5,12
Missouri,Paris,1215,4,39,58,83,41,225
Missouri,Parkdale village,197,0,0,11,7,10,28
Missouri,Park Hills,8695,196,161,570,516,325,1768
Missouri,Parkville,5946,133,78,217,391,466,1285
Missouri,Parkway village,355,13,2,23,15,16,69
Missouri,Parma,649,12,16,19,58,21,126
Missouri,Parnell,137,4,5,11,8,2,30
Missouri,Pasadena Hills,935,19,2,26,24,16,87
Missouri,Pasadena Park village,555,5,3,17,30,23,78
Missouri,McCord Bend village,280,0,0,30,0,11,41
Missouri,McBaine,6,0,0,0,0,0,0
Missouri,Luray village,61,0,0,10,0,1,11
Missouri,Lupus,30,0,0,0,0,1,1
Missouri,Ludlow,119,3,1,2,5,12,23
Missouri,Lucerne village,93,0,5,5,4,0,14
Missouri,Lowry City,522,7,4,18,22,15,66
Missouri,Louisiana,3322,71,34,165,181,239,690
Missouri,Palmyra,3622,125,79,118,269,292,883
Missouri,Louisburg village,146,0,1,9,8,7,25
Missouri,Pagedale,3309,27,56,267,219,265,834
Missouri,Ozora,159,5,0,7,0,8,20
Missouri,Old Monroe,243,0,7,7,9,6,29
Missouri,Olean,99,0,0,0,9,0,9
Missouri,Olivette,7843,114,83,356,713,392,1658
Missouri,Olympian Village,651,12,11,70,46,24,163
Missouri,Oran,1313,25,8,81,58,51,223
Missouri,Oregon,933,4,16,47,42,28,137
Missouri,Oronogo,2568,78,54,197,182,198,709
Missouri,Orrick,785,22,7,30,59,51,169
Missouri,Osage Beach,4477,17,82,206,103,76,484
Missouri,Osborn,514,6,5,11,26,35,83
Missouri,Osceola,904,6,4,14,40,42,106
Missouri,Osgood village,19,0,0,0,0,0,0
Missouri,Otterville,498,5,4,35,32,29,105
Missouri,Overland,16011,240,97,621,770,755,2483
Missouri,Owensville,2648,36,55,170,126,134,521
Missouri,Oxly,113,0,0,6,0,20,26
Missouri,Ozark,18608,411,302,1151,852,867,3583
Missouri,Pacific,6305,122,13,272,368,196,971
Missouri,Old Jamestown,19239,185,193,918,989,1557,3842
Missouri,Longtown,128,8,6,3,1,13,31
Missouri,Loma Linda,804,8,4,16,29,59,116
Missouri,Leisure Lake,205,0,6,0,0,6,12
Missouri,Leeton,678,25,14,39,26,35,139
Missouri,Lee's Summit,93618,2075,1308,5756,6259,5754,21152
Missouri,Lebanon,14637,332,313,845,684,767,2941
Missouri,Leawood village,652,2,9,51,42,35,139
Missouri,Leasburg village,466,18,8,38,23,25,112
Missouri,Leadwood,1543,15,33,119,48,130,345
Missouri,Leadington,360,0,0,12,13,6,31
Missouri,Lawson,2319,66,15,151,104,124,460
Missouri,Laurie,960,11,7,40,27,17,102
Missouri,La Tour,62,0,0,0,0,0,0
Missouri,Lathrop,2215,36,22,128,145,127,458
Missouri,La Russell,235,3,8,22,10,23,66
Missouri,Laredo,209,6,2,5,7,11,31
Missouri,La Plata,1323,40,4,52,76,43,215
Missouri,Lancaster,726,12,34,50,24,31,151
Missouri,Lanagan,428,6,7,44,27,22,106
Missouri,Lemay,16603,154,110,748,697,639,2348
Missouri,Lone Jack,1076,36,29,70,81,57,273
Missouri,Leonard village,59,5,0,4,2,2,13
Missouri,Levasy,75,0,0,4,0,3,7
Missouri,Lohman,192,0,9,7,8,8,32
Missouri,Lockwood,1054,5,14,45,96,51,211
Missouri,Lock Springs village,64,1,3,17,4,0,25
Missouri,Loch Lloyd village,656,8,3,22,21,31,85
Missouri,Livonia village,82,0,0,4,1,5,10
Missouri,Lithium village,38,0,0,4,0,0,4
Missouri,Linneus,350,4,8,11,17,6,46
Missouri,Linn Creek,218,2,0,3,6,7,18
Missouri,Linn,1567,41,17,60,121,68,307
Missouri,Lincoln,1141,12,23,58,84,64,241
Missouri,Lilbourn,1202,29,7,82,63,76,257
Missouri,Licking,3066,40,25,68,97,217,447
Missouri,Liberty,30035,410,466,1960,1728,1701,6265
Missouri,Liberal,739,4,4,50,45,41,144
Missouri,Lexington,4633,134,44,179,226,242,825
Missouri,Lewistown,533,6,3,38,15,12,74
Missouri,Lewis and Clark Village,122,2,0,8,15,0,25
Missouri,Leslie village,138,0,6,18,12,10,46
Missouri,Old Appleton,19,0,0,0,0,0,0
Missouri,O'Fallon,83053,1744,1151,5760,5932,5027,19614
Missouri,Odessa,5222,160,90,317,345,382,1294
Missouri,Shoal Creek Drive village,303,7,2,17,14,8,48
Missouri,Sheridan,234,10,0,16,13,7,46
Missouri,Glasgow Village,5178,141,147,341,496,400,1525
Missouri,Glasgow,1135,11,10,67,85,81,254
Missouri,Gladstone,26309,260,412,1073,799,1005,3549
Missouri,Ginger Blue village,35,0,0,0,0,0,0
Missouri,Gilman City,394,10,4,23,18,24,79
Missouri,Gilliam,188,2,2,9,0,16,29
Missouri,Gideon,1150,15,22,82,59,96,274
Missouri,Gibbs village,126,0,0,2,10,16,28
Missouri,Gerster,22,0,0,2,1,0,3
Missouri,Gerald,1374,5,43,139,101,47,335
Missouri,Gentry village,54,0,0,6,0,4,10
Missouri,Gasconade,222,0,3,11,16,9,39
Missouri,Garden City,1534,27,36,75,87,85,310
Missouri,Galt,206,0,9,4,13,0,26
Missouri,Gallatin,1784,36,31,65,105,108,345
Missouri,Shoal Creek Estates village,126,1,0,16,7,4,28
Missouri,Galena,556,10,23,66,56,30,185
Missouri,Shrewsbury,6208,93,13,296,250,195,847
Missouri,Sikeston,16436,332,303,981,633,886,3135
Missouri,Stanberry,1359,12,24,95,69,69,269
Missouri,Springfield,163763,2026,2024,5988,5394,5491,20923
Missouri,Spokane,181,0,0,0,17,0,17
Missouri,Spickard,334,11,6,49,26,11,103
Missouri,Sparta,1943,45,29,143,101,60,378
Missouri,Spanish Lake,19218,561,385,1024,1141,1147,4258
Missouri,Southwest City,1020,33,15,67,43,45,203
Missouri,South Lineville,25,0,0,0,0,4,4
Missouri,South Greenfield village,149,0,0,1,3,16,20
Missouri,South Gorin,108,2,1,3,5,10,21
Missouri,South Gifford village,49,0,0,4,0,1,5
Missouri,South Fork,190,12,0,0,0,12,24
Missouri,Smithville,8911,163,255,528,530,399,1875
Missouri,Smithton,483,19,22,17,27,32,117
Missouri,Slater,2065,8,21,132,129,84,374
Missouri,Skidmore,269,5,0,37,24,14,80
Missouri,Silex village,71,0,0,0,0,3,3
Missouri,Sibley village,302,3,2,17,19,17,58
Missouri,Gainesville,799,12,7,57,41,31,148
Missouri,Fulton,12812,107,212,596,390,558,1863
Missouri,Frontenac,3523,66,27,207,153,321,774
Missouri,Macks Creek,516,5,24,59,14,54,156
Missouri,McKittrick,68,0,2,2,0,0,4
Missouri,Mackenzie village,123,2,0,3,0,1,6
Missouri,McFall,106,7,3,7,7,9,33
Missouri,Norwood,675,3,11,31,57,42,144
Missouri,Norwood Court,868,3,12,18,32,41,106
Missouri,Novelty village,164,0,0,3,1,12,16
Missouri,Novinger,456,11,5,16,29,23,84
Missouri,Oak Grove,7839,117,146,532,517,518,1830
Missouri,Oak Grove Village village,406,1,4,16,32,3,56
Missouri,Oakland,1506,23,16,65,54,82,240
Missouri,Oak Ridge,235,7,2,17,10,26,62
Missouri,Oaks village,128,4,5,14,6,1,30
Missouri,Oakview village,512,8,3,33,31,11,86
Missouri,Oakville,36663,608,503,1790,1431,2370,6702
Missouri,Oakwood village,153,0,3,7,9,8,27
Missouri,Oakwood Park village,185,2,3,5,4,10,24
Missouri,Macon,5468,109,155,343,221,320,1148
Missouri,Madison,635,5,17,44,63,36,165
Missouri,Maitland,294,9,3,13,15,13,53
Missouri,Malden,4407,166,35,284,324,305,1114
Missouri,Frohna,243,2,0,13,32,7,54
Missouri,Fremont Hills,894,13,5,34,43,39,134
Missouri,Fremont,64,7,0,0,0,0,7
Missouri,Freistatt village,131,0,0,2,3,5,10
Missouri,Freeman,511,11,2,30,34,36,113
Missouri,Freeburg village,447,12,0,23,17,20,72
Missouri,Fredericktown,4054,170,0,235,114,140,659
Missouri,Franklin,70,0,0,2,0,6,8
Missouri,New Cambria,164,0,6,6,5,8,25
Missouri,Frankford,441,3,1,13,20,12,49
Missouri,Fountain N' Lakes village,332,2,18,12,24,31,87
Missouri,Foster village,188,0,0,10,7,9,26
Missouri,Marceline,2154,31,25,96,206,146,504
Missouri,Marble Hill,1613,20,5,68,114,62,269
Missouri,Maplewood,7960,80,118,169,319,176,862
Missouri,Mansfield,1191,24,13,71,70,49,227
Missouri,Manchester,18187,390,208,739,1003,933,3273
Missouri,Malta Bend,330,7,5,10,21,47,90
Missouri,Frankclay,120,0,0,0,0,0,0
Missouri,Newburg,657,5,0,56,7,33,101
Missouri,Bethel village,103,0,1,0,3,6,10
Missouri,Brumley,65,0,0,0,2,4,6
Missouri,Brooklyn Heights,123,0,0,5,2,2,9
Missouri,Browning,241,1,2,18,22,18,61
Missouri,Brownington,88,0,0,9,8,0,17
Missouri,Brimson village,63,0,0,2,1,2,5
Missouri,Brunswick,858,14,4,41,81,34,174
Missouri,Bucklin,511,9,3,24,23,8,67
Missouri,Buckner,3077,26,86,248,185,164,709
Missouri,Buffalo,3066,0,45,301,128,190,664
Missouri,Bull Creek village,522,7,15,43,58,25,148
Missouri,Bunceton,339,7,4,7,8,47,73
Missouri,Bunker,412,5,9,22,15,32,83
Missouri,Bridgeton,11699,176,198,433,508,564,1879
Missouri,Brookfield,4391,84,61,303,264,181,893
Missouri,Bronaugh,219,0,9,32,8,3,52
Montana,Old Agency,117,11,0,6,9,2,28
Montana,Noxon,257,0,7,26,8,27,68
Montana,North Browning,2444,71,41,347,158,57,674
Montana,Niarada,11,0,0,0,0,0,0
Montana,Neihart,36,0,0,0,0,0,0
Montana,Nashua,305,1,2,7,23,5,38
Montana,Musselshell,65,0,0,0,0,0,0
Montana,Alder,87,0,6,0,3,2,11
Montana,Moore,177,5,3,7,6,10,31
Montana,Montana City,2793,30,24,164,218,170,606
Montana,Missoula,69190,1002,804,2772,2749,2586,9913
Montana,Muddy,616,8,15,85,66,59,233
Montana,Olney,201,0,7,0,21,30,58
Montana,Opheim,76,0,0,2,11,9,22
Montana,Orchard Homes,5576,109,59,310,232,228,938
Montana,Outlook,79,0,4,3,17,0,24
Montana,Ovando,81,0,0,0,4,3,7
Montana,Pablo,2725,54,131,171,126,139,621
Montana,Paradise,204,3,0,9,3,5,20
Montana,Park City,1014,14,34,89,49,115,301
Montana,Parker School,606,17,5,39,72,48,181
Montana,Philipsburg,666,10,7,0,8,32,57
Montana,Piltzville,408,4,0,7,0,17,28
Montana,Sun River,101,0,0,0,5,5,10
Montana,Miles City,8627,123,118,482,363,410,1496
Montana,Midvale,330,0,41,83,39,40,203
Montana,Manhattan,1191,25,25,23,53,26,152
Montana,Medicine Lake,314,4,12,12,21,22,71
Montana,Lewistown,5883,199,33,227,225,183,867
Montana,Lewistown Heights,736,8,17,72,47,142,286
Montana,Libby,2671,70,25,120,114,103,432
Montana,Lima,185,4,6,8,3,2,23
Montana,Lincoln,829,9,0,16,38,58,121
Montana,Lindisfarne,283,0,0,0,0,24,24
Montana,Little Bitterroot Lake,207,0,0,0,0,0,0
Montana,Little Browning,277,8,10,40,17,40,115
Montana,Livingston,7136,248,86,325,212,176,1047
Montana,Lockwood,7437,64,190,435,309,418,1416
Montana,Lodge Grass,325,10,9,28,22,17,86
Montana,Melstone,82,0,0,0,0,2,2
Montana,Lodge Pole,274,19,6,13,11,20,69
Montana,Lolo,4125,114,57,111,394,149,825
Montana,Loma,36,0,0,0,0,0,0
Montana,Lonepine,164,0,0,21,10,7,38
Montana,Malmstrom AFB,3651,50,62,341,176,38,667
Montana,Malta,1867,31,27,52,106,44,260
Montana,Superior,804,0,0,7,10,14,31
Montana,Marion,852,0,2,67,55,41,165
Montana,Martin City,380,0,0,0,0,10,10
Montana,Martinsdale,81,0,0,5,0,0,5
Montana,Marysville,95,0,0,0,0,0,0
Montana,Maxville,109,0,0,0,0,0,0
Montana,Logan,41,0,0,0,0,0,0
Montana,Swan Lake,114,0,0,0,4,10,14
Montana,Townsend,1970,9,2,180,76,104,371
Montana,Sylvanite,116,0,3,7,3,2,15
Montana,Whitehall,926,10,8,16,51,59,144
Montana,White Haven,602,0,65,32,49,0,146
Montana,White Sulphur Springs,979,29,3,64,53,62,211
Montana,Whitewater,43,0,1,0,3,4,8
Montana,Wibaux,522,0,6,5,19,41,71
Montana,Willow Creek,180,0,2,0,15,21,38
Montana,Wilsall,198,5,0,7,0,3,15
Montana,Wineglass,386,0,30,7,45,81,163
Montana,Winifred,179,4,3,5,10,7,29
Montana,Winnett,177,0,0,0,7,11,18
Montana,Winston,0,0,0,0,0,0,0
Montana,Wisdom,87,0,0,0,0,3,3
Montana,Wolf Point,2755,56,47,189,196,106,594
Montana,Woods Bay,626,0,0,41,20,25,86
Montana,Worden,749,33,6,14,41,18,112
Montana,Wye,482,2,6,86,9,8,111
Montana,Wyola,142,5,2,5,4,5,21
Montana,Yaak,260,0,0,9,12,0,21
Montana,Zortman,23,0,0,0,0,0,0
Montana,Crow Agency,1890,47,33,164,173,87,504
Montana,Culbertson,826,9,33,80,42,45,209
Montana,Custer,146,0,0,0,10,11,21
Montana,Cut Bank,2985,91,37,299,179,131,737
Montana,Whitefish,6692,87,119,161,182,112,661
Montana,Wheatland,447,23,0,13,11,17,64
Montana,West Yellowstone,1279,18,10,43,48,87,206
Montana,West Kootenai,89,0,0,0,0,0,0
Montana,Terry,838,0,6,13,104,25,148
Montana,The Silos,640,0,22,45,31,48,146
Montana,Thompson Falls,941,11,0,43,34,39,127
Montana,Three Forks,1888,20,10,115,99,69,313
Montana,Toston,237,0,0,39,40,0,79
Montana,Lavina,194,0,7,6,23,11,47
Montana,Trego,644,0,0,68,62,42,172
Montana,Trout Creek,189,0,0,7,12,4,23
Montana,Troy,710,0,14,0,41,35,90
Montana,Turah,431,5,5,12,57,45,124
Montana,Turner,85,0,0,3,5,4,12
Montana,Sweet Grass,85,0,0,0,0,0,0
Montana,Turtle Lake,304,30,17,55,0,0,102
Montana,Ulm,559,12,2,15,16,22,67
Montana,Valier,577,12,14,37,31,62,156
Montana,Vaughn,863,11,9,53,38,54,165
Montana,Victor,829,0,28,62,103,11,204
Montana,Virginia City,239,0,0,0,4,15,19
Montana,Walkerville,878,21,37,40,108,32,238
Montana,Weeksville,79,0,0,0,0,16,16
Montana,Westby,170,0,2,6,7,14,29
Montana,West Glacier,311,0,3,14,23,0,40
Montana,West Glendive,2067,33,24,134,115,53,359
Montana,West Havre,167,0,0,0,22,0,22
Montana,Twin Bridges,260,2,8,12,6,7,35
Montana,Laurel,6933,127,115,382,442,223,1289
Montana,Lame Deer,2106,56,31,148,129,140,504
Montana,Lakeside,2918,0,53,99,150,175,477
Montana,Boneau,364,5,3,30,57,29,124
Montana,Bonner-West Riverside,1600,0,47,88,85,45,265
Montana,Evergreen,6955,126,119,298,498,524,1565
Montana,Evaro,339,0,10,25,14,0,49
Montana,Eureka,1254,18,42,38,63,38,199
Montana,Ennis,864,0,0,8,25,30,63
Montana,Emigrant,358,0,0,19,5,16,40
Montana,Elmo,195,0,5,9,0,8,22
Montana,Elliston,286,0,2,11,0,18,31
Montana,Elkhorn,18,0,0,0,0,0,0
Montana,Ekalaka,297,0,3,14,7,11,35
Montana,Edgar,134,0,0,0,7,4,11
Montana,East Missoula,2359,22,0,101,80,237,440
Montana,East Helena,2306,10,54,145,135,92,436
Montana,East Glacier Park Village,486,2,0,35,21,8,66
Montana,Dutton,326,4,2,15,6,24,51
Montana,Dupuyer,87,0,0,0,0,0,0
Montana,Drummond,377,1,0,33,10,22,66
Montana,Kremlin,76,0,0,0,2,0,2
Montana,Lake Mary Ronan,86,0,9,0,0,21,30
Montana,Sun Prairie,1258,9,19,62,116,44,250
Montana,Sunburst,254,3,7,11,14,20,55
Montana,Sula,70,0,0,0,0,0,0
Montana,Stryker,35,0,0,0,0,0,0
Montana,Stockett,204,9,16,23,5,30,83
Montana,Stevensville,2048,95,56,86,67,81,385
Montana,Starr School,90,0,0,0,0,33,33
Montana,Black Eagle,1151,6,0,58,60,145,269
Montana,Birney,92,4,8,16,4,12,44
Montana,Billings,108134,1537,1562,6038,4827,5168,19132
Montana,Big Timber,1517,18,18,72,112,105,325
Montana,Alberton,479,22,16,36,13,12,99
Montana,Absarokee,1068,9,0,38,17,39,103
Montana,Amsterdam,155,0,11,12,8,11,42
Montana,Anaconda-Deer Lodge,9211,146,14,415,290,471,1336
Montana,Antelope,57,0,0,6,7,0,13
Montana,Arlee,651,4,14,69,48,45,180
Montana,Ashland,981,10,27,131,105,51,324
Montana,Augusta,267,6,0,4,19,18,47
Montana,Avon,128,0,0,5,20,9,34
Montana,Azure,180,5,5,19,22,13,64
Montana,Babb,149,7,0,9,0,0,16
Montana,Bainville,276,0,11,36,23,19,89
Montana,Baker,1838,45,33,91,75,59,303
Montana,Stanford,375,0,2,4,22,6,34
Montana,Ballantine,195,0,0,0,0,0,0
Montana,Batavia,367,0,0,15,11,31,57
Montana,Bearcreek,138,8,0,5,16,5,34
Montana,Bear Dance,261,0,0,0,0,0,0
Montana,Beaver Creek,378,4,0,16,40,36,96
Montana,Belfry,197,7,0,13,13,18,51
Montana,Belgrade,7738,159,86,576,572,294,1687
Montana,Belknap,189,0,0,0,0,0,0
Montana,Belt,683,9,5,42,39,47,142
Montana,Biddle,20,0,0,0,0,0,0
Montana,Big Arm,230,0,0,0,28,0,28
Montana,Bigfork,4621,59,96,138,225,167,685
Montana,Big Sandy,677,0,0,34,49,42,125
Montana,Big Sky,2767,84,34,110,158,75,461
Montana,Basin,227,1,6,8,12,13,40
Montana,Darby,673,0,3,73,13,33,122
Montana,Springhill,58,0,0,0,10,0,10
Montana,Spokane Creek,306,0,0,15,13,0,28
Montana,Ronan,1858,29,15,123,122,110,399
Montana,Rollins,284,4,10,25,4,0,43
Montana,Rocky Point,91,0,0,0,0,0,0
Montana,Rocky Boy West,975,19,23,80,84,80,286
Montana,Rocky Boy's Agency,474,28,14,45,36,22,145
Montana,Roberts,301,0,0,15,18,12,45
Montana,Riverbend,420,0,0,0,0,67,67
Montana,Richey,165,2,4,12,3,13,34
Montana,Rexford,89,0,0,0,9,0,9
Montana,Reserve,32,0,3,0,6,2,11
Montana,Reed Point,232,0,0,2,1,9,12
Montana,Red Lodge,2236,3,26,76,145,88,338
Montana,Ravalli,61,0,0,0,0,0,0
Montana,Radersburg,208,0,7,9,9,0,25
Montana,Rader Creek,195,0,0,10,0,0,10
Montana,Pryor,630,18,14,40,52,41,165
Montana,Pray,599,0,0,20,13,45,78
Montana,Power,172,0,2,6,12,15,35
Montana,Poplar,830,23,24,61,57,31,196
Montana,Pony,154,0,0,0,0,5,5
Montana,Ponderosa Pines,464,0,5,29,44,22,100
Montana,Polson,4643,79,133,243,131,105,691
Montana,Plevna,142,10,4,17,4,4,39
Montana,Plentywood,1891,27,20,88,84,71,290
Montana,Plains,758,8,0,21,38,3,70
Montana,Pioneer Junction,794,0,0,42,77,12,131
Montana,Pinesdale,985,14,29,90,102,102,337
Montana,Roscoe,53,0,0,0,0,0,0
Montana,Rosebud,119,0,0,0,3,0,3
Montana,Roundup,1900,12,47,67,100,117,343
Montana,Roy,140,0,1,3,0,0,4
Montana,South Hills,504,13,4,32,61,56,166
Montana,South Glastonbury,284,0,8,0,0,18,26
Montana,South Browning,1852,90,36,195,106,195,622
Montana,Somers,1000,0,39,41,75,82,237
Montana,Simms,427,15,17,32,6,17,87
Montana,Silver Gate,20,0,0,0,0,0,0
Montana,Silesia,111,0,0,10,0,0,10
Montana,Sidney,6216,152,95,243,422,231,1143
Montana,Sheridan,706,0,0,38,47,22,107
Montana,Shepherd,564,7,0,55,0,22,84
Montana,Shelby,3272,22,61,153,146,122,504
Montana,Shawmut,47,0,0,0,2,2,4
Montana,Seeley Lake,1081,29,13,28,59,31,160
Montana,Springdale,43,0,0,13,3,0,16
Montana,Sedan,121,4,0,0,5,0,9
Montana,Savage,339,4,6,13,5,34,62
Montana,Santa Rita,89,0,0,26,25,16,67
Montana,Sangrey,444,9,5,44,21,60,139
Montana,Sand Coulee,245,10,0,3,3,19,35
Montana,St. Xavier,4,0,0,0,0,0,0
Montana,St. Regis,261,0,0,12,23,8,43
Montana,St. Pierre,498,26,17,15,53,66,177
Montana,St. Marie,619,0,26,34,39,23,122
Montana,St. Ignatius,850,20,6,58,59,53,196
Montana,Saddle Butte,175,0,0,69,20,0,89
Montana,Saco,202,0,0,3,19,3,25
Montana,Ryegate,196,0,0,7,2,6,15
Montana,Rudyard,201,0,8,10,7,10,35
Montana,Scobey,1129,25,27,36,50,36,174
Montana,Dayton,89,0,3,0,0,4,7
Montana,Alzada,21,0,0,0,0,1,1
Montana,Deer Lodge,3056,51,26,168,174,107,526
Montana,Gardiner,1099,6,6,34,61,132,239
Montana,Garrison,57,0,0,0,1,2,3
Montana,Geraldine,259,0,3,24,40,18,85
Montana,Boulder,1287,11,12,47,73,109,252
Montana,Box Elder,83,0,0,0,9,26,35
Montana,Boyd,20,0,0,0,0,0,0
Montana,Bozeman,40319,677,365,1387,1064,967,4460
Montana,Gallatin River Ranch,74,0,0,0,0,4,4
Montana,Brady,174,0,9,0,0,0,9
Montana,Bridger,11,0,0,0,0,0,0
Montana,Broadus,477,3,8,24,34,31,100
Montana,Broadview,163,3,4,5,13,17,42
Montana,Brockton,173,0,4,10,15,11,40
Montana,Browning,1108,22,30,43,86,80,261
Montana,Busby,690,33,18,61,106,47,265
Montana,Butte-Silver Bow (balance),33671,268,590,1561,1343,1391,5153
Montana,Bridger,894,8,25,38,24,36,131
Montana,Gallatin Gateway,933,19,3,10,50,63,145
Montana,Fromberg,388,5,6,13,21,22,67
Montana,Froid,148,4,2,0,2,3,11
Montana,Herron,35,0,0,0,0,0,0
Montana,Heron,222,0,0,0,0,11,11
Montana,Helena West Side,1365,0,19,21,27,14,81
Montana,Helena Valley West Central,8564,138,133,434,582,587,1874
Montana,Helena Valley Southeast,7383,162,46,488,425,499,1620
Montana,Cooke City,35,0,0,0,0,0,0
Montana,Conrad,2604,66,29,195,111,184,585
Montana,Conner,90,0,0,0,10,14,24
Montana,Condon,431,6,0,25,9,17,57
Montana,Columbus,2181,54,12,135,109,111,421
Montana,Fortine,465,18,3,33,13,33,100
Montana,Fort Peck,197,0,0,0,7,15,22
Montana,Fort Shaw,161,0,4,5,0,23,32
Montana,Fort Smith,37,0,0,0,0,0,0
Montana,Fox Lake,100,0,0,3,5,17,25
Montana,Frazer,244,4,9,23,15,19,70
Montana,Frenchtown,1657,26,0,42,21,115,204
Montana,Bynum,39,0,0,0,0,0,0
Montana,Camas,37,0,0,5,0,0,5
Montana,Camp Three,101,0,0,11,7,5,23
Montana,Cardwell,40,0,3,4,1,3,11
Montana,Hamilton,4501,45,114,124,148,116,547
Montana,Choteau,1685,14,20,70,95,81,280
Montana,Churchill,997,8,13,82,77,41,221
Montana,Circle,607,7,0,28,25,31,91
Montana,Clancy,1563,38,3,53,76,51,221
Montana,Clinton,1127,19,6,63,72,41,201
Montana,Clyde Park,230,0,2,1,13,38,54
Montana,Colstrip,2289,0,57,143,163,146,509
Montana,Columbia Falls,4856,48,21,259,276,455,1059
Montana,Geyser,96,0,0,2,5,6,13
Montana,Gibson Flats,162,0,0,0,35,0,35
Montana,Gildford,76,0,0,0,0,3,3
Montana,Glasgow,3376,77,34,136,240,90,577
Montana,Glendive,5284,145,81,235,219,256,936
Montana,Grass Range,115,0,0,4,5,8,17
Montana,Great Falls,59563,768,902,3069,2680,2312,9731
Montana,Greycliff,68,0,0,8,1,5,14
Montana,Happys Inn,70,0,0,0,0,0,0
Montana,Highwood,224,1,1,8,10,36,56
Montana,Hardin,3754,80,57,380,155,258,930
Montana,Harlowton,899,4,4,28,53,73,162
Montana,Carlton,647,36,0,42,31,13,122
Montana,Carter,77,2,0,0,6,8,16
Montana,Cascade,648,0,12,29,44,38,123
Montana,Charlo,386,0,13,26,31,16,86
Montana,Charlos Heights,148,0,0,29,0,0,29
Montana,Chester,884,0,22,36,42,32,132
Montana,Chinook,1058,0,11,23,40,17,91
Montana,Helena Valley Northwest,3990,73,98,365,220,159,915
Montana,Helena Valley Northeast,3238,46,48,246,199,146,685
Montana,Helena Flats,916,4,5,42,70,39,160
Montana,Helena,29600,267,321,1076,1035,1158,3857
Montana,Hebgen Lake Estates,148,3,0,0,15,24,42
Montana,Heart Butte,567,18,13,52,61,35,179
Montana,Hays,1088,27,21,123,91,29,291
Montana,Havre North,714,0,22,19,17,22,80
Montana,Havre,9790,158,111,587,557,404,1817
Montana,Harrison,237,0,5,0,0,0,5
Montana,Harlem,865,13,8,89,73,54,237
Montana,Hingham,108,0,4,3,0,4,11
Montana,Four Corners,3406,45,57,272,206,116,696
Montana,Hobson,264,10,4,16,11,19,60
Montana,Fort Belknap Agency,1300,48,18,85,144,108,403
Montana,Jette,211,0,0,0,0,0,0
Montana,Joliet,532,1,0,15,29,25,70
Montana,Fairfield,749,10,8,47,46,41,152
Montana,Fairview,792,0,0,36,42,40,118
Montana,Fallon,149,0,0,11,3,14,28
Montana,Finley Point,688,0,0,0,0,0,0
Montana,Flaxville,95,0,2,6,6,4,18
Montana,Florence,644,6,0,12,28,39,85
Montana,Forest Hill Village,210,0,0,0,0,0,0
Montana,Forsyth,1874,0,12,94,112,81,299
Montana,Crane,197,0,32,16,0,0,48
Montana,Hinsdale,167,0,0,4,6,7,17
Montana,Jordan,332,0,0,15,5,7,27
Montana,Judith Gap,86,0,0,0,5,0,5
Montana,De Borgia,0,0,0,0,0,0,0
Montana,Kalispell,21142,286,292,1074,1190,893,3735
Montana,Kerr,164,0,0,0,0,0,0
Montana,Klein,248,8,23,8,7,0,46
Montana,Kings Point,122,0,0,0,0,0,0
Montana,King Arthur Park,1009,18,0,77,30,0,125
Montana,Kila,387,0,3,3,3,9,18
Montana,Kicking Horse,167,0,7,7,0,0,14
Montana,Kevin,110,0,0,2,5,19,26
Montana,Joplin,220,6,0,20,8,0,34
Montana,Dillon,4193,17,15,136,214,258,640
Montana,Fort Benton,1349,10,15,50,49,36,160
Montana,Corwin Springs,106,0,5,3,0,4,12
Montana,Craig,31,0,0,0,6,0,6
Montana,Denton,246,0,4,9,10,45,68
Montana,Jefferson City,715,0,0,37,118,44,199
Montana,Ismay,18,0,0,0,6,2,8
Montana,Inverness,104,0,0,9,8,7,24
Montana,Indian Springs,124,0,0,0,0,0,0
Montana,Hysham,363,0,2,18,25,56,101
Montana,Huson,11,0,0,0,0,0,0
Montana,Jardine,22,0,0,0,0,0,0
Montana,Hungry Horse,757,0,0,37,25,18,80
Montana,Hot Springs,544,2,4,11,8,32,57
Montana,Corvallis,1047,0,0,54,89,54,197
Montana,Dodson,166,4,0,13,0,16,33
Montana,Dixon,224,4,3,22,19,13,61
Montana,Coram,585,0,0,0,32,25,57
Montana,Huntley,504,24,0,6,0,0,30
Moore County metropolitan government; Tennessee,Lynchburg,6351,88,33,368,296,374,1159
Nebraska,Stella village,190,2,4,4,13,8,31
Nebraska,Steinauer village,75,0,0,9,7,5,21
Nebraska,Steele City village,74,3,0,6,3,6,18
Nebraska,Stapleton village,298,4,0,9,11,12,36
Nebraska,Stamford village,195,7,0,11,16,13,47
Nebraska,Stanton,1650,30,33,89,166,102,420
Nebraska,Inavale,66,0,0,0,0,0,0
Nebraska,Imperial,1917,35,26,148,30,121,360
Nebraska,Hyannis village,200,0,0,0,7,6,13
Nebraska,Sterling village,470,14,2,33,22,53,124
Nebraska,Aten,49,0,0,0,0,0,0
Nebraska,Staplehurst village,254,2,3,20,22,16,63
Nebraska,Indianola,591,11,0,38,33,44,126
Nebraska,Tekamah,1830,24,23,111,145,99,402
Nebraska,Inland,89,0,0,9,5,14,28
Nebraska,Tarnov village,67,0,5,2,12,2,21
Nebraska,Tamora,78,0,0,5,6,0,11
Nebraska,Talmage village,218,1,0,18,9,6,34
Nebraska,Table Rock village,282,8,0,16,9,17,50
Nebraska,Syracuse,1933,33,5,97,94,87,316
Nebraska,Swanton village,93,3,0,1,5,12,21
Nebraska,Sutton,1706,23,21,120,155,97,416
Nebraska,Sutherland village,1446,21,36,96,88,94,335
Nebraska,Ashton village,179,2,6,11,8,4,31
Nebraska,Surprise village,50,0,1,1,5,3,10
Nebraska,Inglewood village,372,12,3,31,13,24,83
Nebraska,Superior,1957,22,15,78,111,54,280
Nebraska,Sumner village,246,5,2,17,12,21,57
Nebraska,Stuart village,605,21,14,30,25,27,117
Nebraska,Stromsburg,1129,12,16,57,75,77,237
Nebraska,Stratton village,404,2,14,22,12,29,79
Nebraska,Strang village,20,0,2,0,0,0,2
Nebraska,Stockville village,10,0,0,0,0,0,0
Nebraska,Stockham village,46,0,0,0,0,3,3
Nebraska,Taylor village,158,2,2,5,10,11,30
Nebraska,Tecumseh,1518,49,32,96,69,50,296
Nebraska,Inman village,119,0,1,10,12,2,25
Nebraska,Sunol,88,0,0,8,0,0,8
Nebraska,Ashland,2419,67,33,146,128,68,442
Nebraska,Long Pine,270,0,8,7,27,13,55
Nebraska,Arnold village,520,0,3,12,24,20,59
Nebraska,Battle Creek,1131,6,11,56,78,113,264
Nebraska,Bayard,1064,15,12,61,116,61,265
Nebraska,Bazile Mills village,20,2,0,0,1,1,4
Nebraska,Beatrice,12355,266,163,550,524,672,2175
Nebraska,Beaver City,644,10,3,16,33,26,88
Nebraska,Beaver Crossing village,393,5,11,8,7,16,47
Nebraska,Bee village,215,1,1,11,9,11,33
Nebraska,Beemer village,629,12,9,39,23,26,109
Nebraska,Belden village,87,1,0,3,4,0,8
Nebraska,Huntley village,43,2,0,4,5,0,11
Nebraska,Big Springs village,575,6,23,51,35,26,141
Nebraska,Berwyn village,89,4,0,1,4,0,9
Nebraska,Bertrand village,749,18,17,38,39,49,161
Nebraska,Berea,22,0,0,0,0,0,0
Nebraska,Bennington,1608,16,34,83,69,111,313
Nebraska,Bennet village,875,11,11,52,60,31,165
Nebraska,Benkelman,936,17,6,32,37,48,140
Nebraska,Benedict village,239,8,5,7,8,10,38
Nebraska,Belvidere village,31,1,0,2,0,0,3
Nebraska,Belmar,146,0,0,0,0,11,11
Nebraska,Bellwood village,345,19,2,26,13,19,79
Nebraska,Bellevue,54067,902,698,3368,2945,3151,11064
Nebraska,Belgrade village,137,2,1,5,2,1,11
Nebraska,Bladen village,196,6,1,9,7,6,29
Nebraska,Blair,7995,110,94,356,561,406,1527
Nebraska,Bloomfield,977,8,6,29,29,61,133
Nebraska,Bassett,594,5,0,13,21,32,71
Nebraska,Arlington village,1205,33,18,68,79,91,289
Nebraska,Archer,44,0,0,0,0,0,0
Nebraska,Louisville,1039,30,16,66,84,62,258
Nebraska,Lorton village,45,0,0,1,2,0,3
Nebraska,Loretto,68,7,0,17,0,0,24
Nebraska,Lorenzo,99,0,0,0,0,18,18
Nebraska,Loomis village,411,7,1,12,26,33,79
Nebraska,Atkinson,1347,45,21,105,75,64,310
Nebraska,Atlanta village,104,4,0,8,4,6,22
Nebraska,Auburn,3387,59,33,145,199,226,662
Nebraska,Daykin village,200,10,4,11,23,10,58
Nebraska,Arthur village,129,1,7,10,9,9,36
Nebraska,Decatur village,440,2,3,6,3,36,50
Nebraska,Deshler,621,11,5,12,32,41,101
Nebraska,Deweese village,67,0,0,0,6,2,8
Nebraska,Aurora,4455,82,103,272,279,279,1015
Nebraska,Avoca village,227,6,12,15,8,13,54
Nebraska,Axtell village,651,3,13,36,33,14,99
Nebraska,Ayr village,68,0,0,5,6,4,15
Nebraska,Bancroft village,547,22,10,34,18,40,124
Nebraska,Barada village,11,0,0,0,0,0,0
Nebraska,Barneston village,101,0,6,2,0,4,12
Nebraska,Bartlett village,135,6,0,4,10,8,28
Nebraska,Bartley village,272,6,10,14,14,7,51
Nebraska,Denton village,240,2,3,11,11,6,33
Nebraska,Humphrey,744,20,17,37,45,54,173
Nebraska,Harrison village,247,2,3,8,3,12,28
Nebraska,Hubbell village,65,2,0,2,0,2,6
Nebraska,Greeley Center village,339,3,0,25,16,10,54
Nebraska,Terrytown,972,23,14,61,56,47,201
Nebraska,Thayer village,58,3,2,9,4,0,18
Nebraska,Thedford village,144,0,2,3,6,9,20
Nebraska,Thurston village,121,4,1,13,2,10,30
Nebraska,Tilden,1172,27,27,95,52,39,240
Nebraska,Tobias village,96,0,0,1,1,6,8
Nebraska,Greenwood village,578,14,14,27,19,36,110
Nebraska,Trenton village,517,7,13,24,28,1,73
Nebraska,Litchfield village,262,6,2,4,5,23,40
Nebraska,Lisco,36,0,0,0,0,0,0
Nebraska,Linwood village,103,2,0,1,5,0,8
Nebraska,Lindy,17,0,0,0,0,3,3
Nebraska,Lindsay village,237,0,1,14,15,12,42
Nebraska,Lincoln,269726,4146,3309,13794,12647,11686,45582
Nebraska,Yutan,1121,6,13,73,92,72,256
Nebraska,Lodgepole village,278,6,5,6,17,6,40
Nebraska,Gresham village,283,10,9,26,3,17,65
Nebraska,Gretna,5026,52,68,359,436,410,1325
Nebraska,Gross village,3,0,0,0,0,0,0
Nebraska,Curtis,884,19,0,19,58,61,157
Nebraska,Cushing village,53,2,1,3,0,7,13
Nebraska,Dakota City,2271,43,36,154,136,161,530
Nebraska,Dalton village,298,4,6,21,31,23,85
Nebraska,Danbury village,105,0,0,2,4,15,21
Nebraska,Dannebrog village,319,7,0,13,19,17,56
Nebraska,Davenport village,270,3,4,28,9,8,52
Nebraska,Davey village,128,4,2,4,10,7,27
Nebraska,David City,2862,27,63,163,186,158,597
Nebraska,Dawson village,137,3,0,5,3,2,13
Nebraska,Hamlet village,64,0,0,4,4,4,12
Nebraska,Halsey village,70,0,0,3,0,5,8
Nebraska,Hallam village,233,6,4,26,11,7,54
Nebraska,Haigler village,170,7,0,13,11,0,31
Nebraska,Hadar village,302,6,3,15,15,19,58
Nebraska,Gurley village,200,0,3,9,6,6,24
Nebraska,Guide Rock village,220,2,6,14,12,14,48
Nebraska,York,7908,188,110,321,360,364,1343
Nebraska,Yankee Hill,318,0,0,34,51,43,128
Nebraska,Wynot village,179,2,2,8,6,20,38
Nebraska,Wymore,1483,13,25,63,70,103,274
Nebraska,Weeping Water,1180,5,12,85,59,103,264
Nebraska,Liberty village,42,1,2,1,0,0,4
Nebraska,Lexington,10152,280,265,825,539,754,2663
Nebraska,Lewiston village,93,1,0,15,2,11,29
Nebraska,Lewellen village,188,0,0,7,7,0,14
Nebraska,Leshara village,101,4,0,5,6,0,15
Nebraska,Lemoyne,54,0,0,0,0,0,0
Nebraska,Leigh village,483,11,2,12,24,10,59
Nebraska,Lebanon village,39,0,0,0,1,0,1
Nebraska,Lawrence village,334,3,0,7,11,8,29
Nebraska,La Vista,16895,441,202,1051,969,905,3568
Nebraska,Laurel,1177,13,27,65,64,88,257
Nebraska,La Platte,116,0,7,0,7,0,14
Nebraska,Lamar village,31,0,0,0,0,0,0
Nebraska,Lakeview,309,0,0,20,19,33,72
Nebraska,King Lake,110,0,0,0,0,0,0
Nebraska,Kimball,2577,35,60,104,118,146,463
Nebraska,Wellfleet village,69,0,0,3,4,8,15
Nebraska,Culbertson village,631,10,2,34,24,37,107
Nebraska,Western village,311,3,0,12,16,58,89
Nebraska,Weston village,334,8,12,33,22,24,99
Nebraska,Wood River,1393,43,3,102,78,105,331
Nebraska,Woodland Park,1884,50,49,182,84,102,467
Nebraska,Woodland Hills,145,0,0,13,0,4,17
Nebraska,Wood Lake village,44,1,1,1,2,0,5
Nebraska,Wolbach village,286,1,3,23,26,9,62
Nebraska,Wisner,1313,24,27,65,70,53,239
Nebraska,Winslow village,51,0,0,0,2,0,2
Nebraska,Winside village,419,10,8,29,25,37,109
Nebraska,Winnetoon village,60,0,0,0,4,6,10
Nebraska,Winnebago village,895,34,42,76,84,66,302
Nebraska,Wilsonville village,94,0,0,0,2,3,5
Nebraska,Willow Island,11,0,0,0,0,0,0
Nebraska,Wilcox village,473,3,11,37,22,42,115
Nebraska,Wilber,1716,8,42,80,80,121,331
Nebraska,Whitney village,54,0,0,0,0,0,0
Nebraska,White Clay,0,0,0,0,0,0,0
Nebraska,West Point,3346,17,80,111,233,278,719
Nebraska,Westerville,17,0,0,0,5,0,5
Nebraska,Crookston village,35,0,0,0,6,0,6
Nebraska,Crofton,708,30,12,35,21,41,139
Nebraska,Crete,7080,125,305,344,462,280,1516
Nebraska,Hazard village,60,2,0,2,0,0,4
Nebraska,Hay Springs village,521,0,3,10,13,31,57
Nebraska,Hayes Center village,361,0,5,2,17,38,62
Nebraska,Hastings,24973,544,343,1454,1161,1097,4599
Nebraska,Harvard,785,15,3,52,49,40,159
Nebraska,Hartington,1715,18,27,108,103,91,347
Nebraska,Loup City,1031,21,19,34,69,50,193
Nebraska,Harrisburg,60,0,0,0,3,2,5
Nebraska,Hardy village,153,5,10,1,11,4,31
Nebraska,Harbine village,53,3,0,0,2,0,5
Nebraska,Hampton village,433,5,7,22,27,40,101
Nebraska,Burton village,18,0,0,0,0,0,0
Nebraska,Burwell,1219,44,2,80,34,54,214
Nebraska,Bushnell village,147,0,0,2,2,4,8
Nebraska,Butte village,333,3,2,4,11,21,41
Nebraska,Byron village,102,1,0,0,2,3,6
Nebraska,Cairo village,888,21,18,52,65,57,213
Nebraska,Heartwell village,62,0,1,5,2,3,11
Nebraska,Callaway village,644,4,5,61,43,30,143
Nebraska,Hebron,1627,9,3,66,50,75,203
Nebraska,Henderson,947,37,1,43,46,40,167
Nebraska,Hubbard village,208,13,2,1,8,8,32
Nebraska,Howells village,602,6,6,39,20,60,131
Nebraska,Howard City village,168,0,1,3,14,3,21
Nebraska,Hoskins village,197,4,2,6,7,9,28
Nebraska,Hordville village,145,1,0,7,18,8,34
Nebraska,Hooper,792,17,6,46,42,29,140
Nebraska,Homer village,595,5,16,11,40,35,107
Nebraska,Holstein village,265,2,2,18,5,20,47
Nebraska,Holmesville,49,0,0,0,0,0,0
Nebraska,Holdrege,5528,115,96,290,228,303,1032
Nebraska,Holbrook village,241,0,0,28,10,6,44
Nebraska,Hildreth village,487,3,4,25,36,30,98
Nebraska,Hickman,1888,48,31,185,159,101,524
Nebraska,Hershey village,598,7,2,46,51,43,149
Nebraska,Herman village,223,3,0,9,7,13,32
Nebraska,Henry village,78,0,0,4,7,2,13
Nebraska,Hendley village,21,0,0,0,0,0,0
Nebraska,Hemingford village,869,19,19,72,57,50,217
Nebraska,Humboldt,857,26,16,42,40,42,166
Nebraska,Cambridge,1093,11,20,42,96,34,203
Nebraska,Carleton village,95,1,0,2,2,4,9
Nebraska,Coleridge village,538,10,9,43,38,16,116
Nebraska,Colon village,167,0,0,6,5,6,17
Nebraska,Columbus,22584,365,361,1350,1542,1179,4797
Nebraska,Comstock village,108,0,0,12,6,7,25
Nebraska,Concord village,144,5,4,9,4,8,30
Nebraska,Cook village,317,5,5,10,13,19,52
Nebraska,Cordova village,109,0,0,11,9,6,26
Nebraska,Cornlea village,61,3,5,2,7,6,23
Nebraska,Cortland village,527,19,3,25,47,14,108
Nebraska,Cotesfield village,27,0,0,0,0,2,2
Nebraska,Cowles village,12,0,0,0,1,1,2
Nebraska,Cozad,3905,101,38,234,238,266,877
Nebraska,Crab Orchard village,57,0,0,3,1,1,5
Nebraska,Craig village,201,2,6,11,7,21,47
Nebraska,Crawford,1113,17,15,51,61,99,243
Nebraska,Creighton,1151,13,3,53,56,74,199
Nebraska,Creston village,163,8,0,11,2,12,33
Nebraska,Cody village,116,1,0,3,11,11,26
Nebraska,Campbell village,303,5,3,8,13,11,40
Nebraska,Clinton village,39,0,0,0,0,1,1
Nebraska,Clay Center,802,8,12,25,44,35,124
Nebraska,Carroll village,190,2,9,8,8,6,33
Nebraska,Cedar Bluffs village,526,4,4,21,21,20,70
Nebraska,Cedar Creek village,394,2,4,15,18,21,60
Nebraska,Cedar Rapids village,401,1,0,26,20,19,66
Nebraska,Center village,101,1,2,3,2,6,14
Nebraska,Central City,2902,50,17,72,164,176,479
Nebraska,Ceresco village,945,17,18,51,64,63,213
Nebraska,Chadron,5828,13,80,247,142,184,666
Nebraska,Chalco,11258,94,155,806,617,486,2158
Nebraska,Chambers village,277,2,5,6,9,17,39
Nebraska,Champion,64,0,0,0,0,0,0
Nebraska,Chapman village,257,0,0,11,22,4,37
Nebraska,Chappell,894,24,12,56,47,44,183
Nebraska,Chester village,231,4,3,14,5,6,32
Nebraska,Clarks village,387,6,6,20,29,13,74
Nebraska,Clarkson,806,25,13,30,32,29,129
Nebraska,Clatonia village,323,7,8,25,22,8,70
Nebraska,Clearwater village,330,2,8,14,25,15,64
Nebraska,Lushton village,34,0,0,3,0,0,3
Nebraska,Walthill village,781,16,29,69,73,55,242
Nebraska,Lynch village,234,2,5,6,14,11,38
Nebraska,Norman village,67,1,0,8,6,3,18
Nebraska,Norfolk,24393,594,380,1189,1385,1274,4822
Nebraska,Nora village,18,0,0,0,0,0,0
Nebraska,Niobrara village,344,0,3,13,7,24,47
Nebraska,Nickerson village,386,2,20,15,47,22,106
Nebraska,Newport village,125,2,0,3,8,4,17
Nebraska,Newman Grove,631,5,6,25,25,30,91
Nebraska,North Bend,1292,39,21,105,75,81,321
Nebraska,Newcastle village,252,3,4,17,10,11,45
Nebraska,Nemaha village,170,0,2,0,7,9,18
Nebraska,Nelson,499,3,0,22,26,19,70
Nebraska,Neligh,1484,32,7,87,72,62,260
Nebraska,Nehawka village,314,5,1,46,33,7,92
Nebraska,Nebraska City,7301,68,99,292,402,508,1369
Nebraska,Naponee village,80,6,0,0,1,3,10
Nebraska,Naper village,72,3,0,4,3,0,10
Nebraska,Nenzel village,33,0,0,0,0,5,5
Nebraska,Murray village,417,7,3,19,30,16,75
Nebraska,North Loup village,331,3,7,5,21,4,40
Nebraska,Oak village,47,0,0,2,0,1,3
Nebraska,Orleans village,381,7,5,15,14,5,46
Nebraska,Ord,2257,23,36,109,95,118,381
Nebraska,Orchard village,461,5,3,27,9,10,54
Nebraska,Ong village,75,0,1,1,2,9,13
Nebraska,O'Neill,3673,19,35,207,160,163,584
Nebraska,Omaha,440034,7348,6091,24227,23410,24054,85130
Nebraska,Ohiowa village,176,9,0,0,26,28,63
Nebraska,North Platte,24420,550,313,1342,1502,1268,4975
Nebraska,Ogallala,4605,75,78,253,223,121,750
Nebraska,Odessa,72,3,2,0,7,0,12
Nebraska,Odell village,313,18,4,8,22,16,68
Nebraska,Octavia village,128,0,0,10,4,4,18
Nebraska,Oconto village,129,2,0,3,8,3,16
Nebraska,Obert village,22,0,0,2,0,0,2
Nebraska,Oakland,1325,31,18,73,49,68,239
Nebraska,Oakdale village,300,3,4,17,27,12,63
Nebraska,Offutt AFB,4919,150,140,337,268,156,1051
Nebraska,Osceola,824,2,8,49,60,46,165
Nebraska,Murdock village,254,0,3,5,7,4,19
Nebraska,Morse Bluff village,144,2,0,13,8,8,31
Nebraska,Friend,1232,16,3,55,60,59,193
Nebraska,Fremont,26483,424,492,1423,1314,1323,4976
Nebraska,Franklin,1050,5,0,48,63,59,175
Nebraska,Foster village,56,0,0,0,3,4,7
Nebraska,Fort Calhoun,691,16,8,36,27,17,104
Nebraska,Fordyce village,135,1,3,5,4,11,24
Nebraska,Fontanelle,69,0,0,0,0,0,0
Nebraska,Fullerton,1416,25,28,65,78,59,255
Nebraska,Lyman village,452,9,11,44,47,44,155
Nebraska,Farwell village,130,5,4,5,6,3,23
Nebraska,Farnam village,237,1,2,15,12,15,45
Nebraska,Falls City,4246,62,58,212,339,214,885
Nebraska,Fairmont village,583,3,4,16,37,15,75
Nebraska,Fairfield,396,3,5,26,29,39,102
Nebraska,Fairbury,3863,99,0,162,268,171,700
Nebraska,Exeter village,624,10,12,18,31,25,96
Nebraska,Filley village,101,0,0,1,3,2,6
Nebraska,Mullen village,391,11,5,12,5,1,34
Nebraska,Funk village,209,4,2,12,3,15,36
Nebraska,Garland village,243,1,6,9,11,17,44
Nebraska,Morrill village,885,43,0,49,27,21,140
Nebraska,Grant,1250,22,13,94,36,54,219
Nebraska,Grand Island,50582,1111,840,2810,3183,2832,10776
Nebraska,Grafton village,127,0,0,3,4,4,11
Nebraska,Gothenburg,3542,59,86,302,168,253,868
Nebraska,Gordon,1665,24,20,115,126,43,328
Nebraska,Goehner village,89,2,2,1,2,4,11
Nebraska,Gandy village,26,0,0,0,0,0,0
Nebraska,Glenwood,767,8,0,101,74,62,245
Nebraska,Giltner village,388,7,8,25,34,26,100
Nebraska,Gilead village,43,5,0,0,0,8,13
Nebraska,Gibbon,1904,56,29,94,173,140,492
Nebraska,Gering,8429,238,135,426,475,417,1691
Nebraska,Genoa,1006,11,5,31,48,42,137
Nebraska,Geneva,2271,53,23,150,74,183,483
Nebraska,Garrison village,68,5,0,2,3,5,15
Nebraska,Glenvil village,281,12,2,9,15,18,56
Nebraska,Ewing village,410,0,11,33,22,15,81
Nebraska,Oshkosh,792,6,10,34,28,43,121
Nebraska,Otoe village,150,0,3,4,15,14,36
Nebraska,Ames,74,0,0,0,0,22,22
Nebraska,Alvo village,125,3,4,23,8,0,38
Nebraska,Alma,1195,7,20,48,36,38,149
Nebraska,Alliance,8500,154,154,450,518,654,1930
Nebraska,Allen village,356,0,8,25,18,34,85
Nebraska,Alexandria village,151,0,0,11,8,21,40
Nebraska,Alda village,607,11,0,45,57,49,162
Nebraska,Amherst village,230,2,4,6,8,11,31
Nebraska,Albion,1667,35,26,103,95,75,334
Nebraska,Adams village,596,12,4,37,26,29,108
Nebraska,Abie village,107,1,1,3,0,4,9
Nebraska,Moorefield village,28,0,0,0,0,0,0
Nebraska,Monroe village,353,8,2,51,16,13,90
Nebraska,Monowi village,0,0,0,0,0,0,0
Nebraska,Mitchell,1821,19,15,91,110,105,340
Nebraska,Minden,3112,54,63,137,151,174,579
Nebraska,Ainsworth,1695,18,17,66,81,118,300
Nebraska,Minatare,791,21,18,35,30,81,185
Nebraska,Anoka village,16,0,0,0,0,0,0
Nebraska,Ansley village,406,8,0,19,5,26,58
Nebraska,Ithaca village,133,1,3,3,18,5,30
Nebraska,Jackson village,194,2,2,14,15,5,38
Nebraska,Jansen village,142,2,0,12,2,0,16
Nebraska,Johnson village,318,14,7,14,11,16,62
Nebraska,Johnstown village,76,0,0,4,4,0,8
Nebraska,Julian village,73,0,0,3,3,3,9
Nebraska,Juniata village,878,11,10,30,73,66,190
Nebraska,Anselmo village,202,10,0,11,7,16,44
Nebraska,Kearney,32217,659,333,1457,1298,1193,4940
Nebraska,Kennard village,342,3,4,23,16,19,65
Nebraska,Keystone,123,0,0,0,22,19,41
Nebraska,Kilgore village,59,0,4,6,2,3,15
Nebraska,Plattsmouth,6475,172,154,230,376,476,1408
Nebraska,Platte Center village,338,3,2,20,28,35,88
Nebraska,Arcadia village,307,5,3,14,8,22,52
Nebraska,Arapahoe,924,18,7,53,50,69,197
Nebraska,Kenesaw village,1014,13,9,56,67,91,236
Nebraska,Osmond,759,24,11,32,23,45,135
Nebraska,Milligan village,343,8,2,19,38,3,70
Nebraska,Milford,2373,26,22,171,97,122,438
Nebraska,Phillips village,301,4,4,22,29,28,87
Nebraska,Petersburg village,321,0,3,13,17,24,57
Nebraska,Peru,850,18,3,30,36,20,107
Nebraska,Pender village,1117,9,31,26,55,81,202
Nebraska,Paxton village,551,10,8,19,35,37,109
Nebraska,Pawnee City,893,18,36,30,24,32,140
Nebraska,Parks,27,0,0,0,0,0,0
Nebraska,Pickrell village,186,2,1,2,13,9,27
Nebraska,Papillion,19463,423,208,1105,1039,1202,3977
Nebraska,Palmyra village,664,3,11,19,43,32,108
Nebraska,Palmer village,584,9,14,46,25,26,120
Nebraska,Palisade village,407,4,12,17,22,19,74
Nebraska,Page village,212,1,2,4,9,28,44
Nebraska,Oxford village,780,3,2,26,40,53,124
Nebraska,Overton village,677,6,15,60,55,38,174
Nebraska,Overland,199,0,0,0,10,20,30
Nebraska,Panama village,284,0,10,21,14,7,52
Nebraska,Miller village,168,5,10,17,12,12,56
Nebraska,Pierce,1959,39,20,116,154,138,467
Nebraska,Plainview,990,15,20,31,33,31,130
Nebraska,Merriman village,91,1,0,1,6,4,12
Nebraska,Merna village,388,31,1,21,9,24,86
Nebraska,Memphis village,93,3,0,3,2,8,16
Nebraska,Melbeta village,129,7,0,2,2,3,14
Nebraska,Meadow Grove village,329,4,4,16,13,14,51
Nebraska,Mead village,584,5,9,48,48,16,126
Nebraska,Maywood village,297,7,2,21,16,9,55
Nebraska,Pilger village,276,3,0,15,10,11,39
Nebraska,Maxwell village,283,1,4,8,18,4,35
Nebraska,Mason City village,176,0,0,5,9,13,27
Nebraska,Maskell village,76,1,2,4,9,5,21
Nebraska,Martinsburg village,67,1,2,3,7,2,15
Nebraska,Martin,136,0,0,0,0,0,0
Nebraska,Marquette village,231,2,2,19,15,28,66
Nebraska,Manley village,146,1,0,7,6,4,18
Nebraska,Malmo village,226,2,0,17,27,13,59
Nebraska,Max,44,0,0,10,9,3,22
Nebraska,Eustis village,394,5,10,17,26,17,75
Nebraska,Firth village,550,12,4,42,50,30,138
Nebraska,Endicott village,121,0,2,2,1,10,15
Nebraska,Brady village,343,8,12,13,29,16,78
Nebraska,Brainard village,291,1,5,6,3,25,40
Nebraska,Brewster village,5,0,0,0,0,0,0
Nebraska,Bridgeport,1807,32,30,152,131,78,423
Nebraska,Bristow village,51,0,0,0,0,0,0
Nebraska,Broadwater village,154,0,3,11,2,12,28
Nebraska,Brock village,147,2,0,4,2,0,8
Nebraska,Bradshaw village,280,1,2,16,12,13,44
Nebraska,Broken Bow,3518,38,30,234,267,187,756
Nebraska,Brownville village,117,0,0,7,6,1,14
Nebraska,Brule village,376,1,11,12,18,26,68
Nebraska,Bruning village,219,1,1,12,11,7,32
Nebraska,Bruno village,145,7,1,7,14,6,35
Nebraska,Brunswick village,169,1,5,5,0,12,23
Nebraska,Burchard village,53,0,0,6,0,3,9
Nebraska,Burr village,27,0,0,1,0,1,2
Nebraska,Brownlee,8,0,0,0,0,0,0
Nebraska,Malcolm village,363,6,2,17,18,19,62
Nebraska,Boys Town village,913,0,5,13,67,495,580
Nebraska,Blue Springs,331,2,8,10,12,36,68
Nebraska,Shickley village,340,10,3,24,31,8,76
Nebraska,Sholes village,16,0,0,1,2,1,4
Nebraska,Shubert village,154,3,1,4,10,3,21
Nebraska,Sidney,6830,105,184,331,300,285,1205
Nebraska,Silver Creek village,397,7,3,43,38,15,106
Nebraska,Smithfield village,30,0,0,0,0,3,3
Nebraska,Snyder village,348,0,5,16,38,31,90
Nebraska,Bow Valley,102,0,0,9,5,7,21
Nebraska,South Bend village,94,0,0,1,2,4,7
Nebraska,Spalding village,546,16,16,18,25,32,107
Nebraska,Spencer village,482,8,4,43,22,21,98
Nebraska,Sprague village,142,4,2,4,11,2,23
Nebraska,Springfield,1423,5,19,34,96,86,240
Nebraska,Springview village,210,2,8,7,3,15,35
Nebraska,Bloomington village,131,0,0,6,9,16,31
Nebraska,Blue Hill,908,4,10,33,41,84,172
Nebraska,Ericson village,148,2,0,8,5,1,16
Nebraska,Shelton village,1154,5,21,26,106,97,255
Nebraska,Magnet village,46,0,0,3,0,4,7
Nebraska,Madison,2545,5,20,77,195,174,471
Nebraska,Verdel village,25,0,0,1,0,1,2
Nebraska,Venice,55,0,0,0,0,0,0
Nebraska,Venango village,141,0,2,4,2,3,11
Nebraska,Valparaiso village,708,12,8,31,61,52,164
Nebraska,Valley,2018,48,19,104,95,93,359
Nebraska,Valentine,2782,54,17,126,159,68,424
Nebraska,Utica village,779,19,11,26,40,45,141
Nebraska,Verdigre village,575,4,4,38,17,8,71
Nebraska,Upland village,158,1,1,8,5,10,25
Nebraska,Unadilla village,276,4,1,5,17,14,41
Nebraska,Ulysses village,249,6,2,1,13,9,31
Nebraska,Uehling village,258,4,2,11,11,27,55
Nebraska,Tryon,81,0,0,1,3,2,6
Nebraska,Trumbull village,229,0,1,23,17,13,54
Nebraska,McCook,7649,103,83,347,524,375,1432
Nebraska,Lyons,925,13,23,57,28,49,170
Nebraska,Union village,204,5,0,8,17,10,40
Nebraska,Madrid village,302,9,6,10,11,17,53
Nebraska,Verdon village,164,4,0,7,4,11,26
Nebraska,Waco village,294,11,4,8,11,16,50
Nebraska,Macy,877,31,14,107,97,62,311
Nebraska,McLean village,28,0,0,0,0,0,0
Nebraska,McGrew village,74,0,1,0,9,10,20
Nebraska,McCool Junction village,473,14,4,20,26,54,118
Nebraska,Wayne,5553,33,18,51,317,250,669
Nebraska,Waverly,3614,122,88,290,240,192,932
Nebraska,Wausa village,718,17,13,22,44,25,121
Nebraska,Virginia village,44,1,1,0,3,3,8
Nebraska,Wauneta village,699,38,14,18,29,33,132
Nebraska,Waterbury village,59,0,0,0,2,5,7
Nebraska,Washington village,116,0,0,2,3,12,17
Nebraska,Wann,164,0,0,0,32,30,62
Nebraska,Walton,332,9,0,0,0,9,18
Nebraska,Wallace village,299,0,4,22,16,16,58
Nebraska,Wakefield,1539,40,12,84,106,110,352
Nebraska,Wahoo,4505,134,54,294,282,270,1034
Nebraska,Waterloo village,1086,50,27,59,65,23,224
Nebraska,Shelby village,766,9,7,54,39,72,181
Nebraska,South Sioux City,13315,294,165,879,896,871,3105
Nebraska,Seneca village,50,0,0,0,6,2,8
Nebraska,Dix village,283,8,2,17,19,5,51
Nebraska,Diller village,186,0,1,9,6,14,30
Nebraska,De Witt village,487,8,6,28,12,32,86
Nebraska,Pleasant Dale village,237,4,3,15,6,2,30
Nebraska,Pleasanton village,304,7,6,17,18,29,77
Nebraska,Plymouth village,423,20,16,18,9,11,74
Nebraska,Polk village,332,0,0,18,12,14,44
Nebraska,Ponca,1037,20,12,42,53,69,196
Nebraska,Poole,53,7,6,0,0,0,13
Nebraska,Potter village,315,3,2,13,28,12,58
Nebraska,Prague village,356,1,9,19,12,20,61
Nebraska,Preston village,26,0,1,1,2,0,4
Nebraska,Primrose village,78,0,2,15,1,2,20
Nebraska,Prosser village,109,7,4,3,2,3,19
Nebraska,Raeville,0,0,0,0,0,0,0
Nebraska,Ragan village,60,0,0,3,7,2,12
Nebraska,Ralston,5997,15,38,168,214,320,755
Nebraska,Randolph,786,21,9,56,44,23,153
Nebraska,Ravenna,1466,31,21,106,117,94,369
Nebraska,Raymond village,139,1,1,3,2,6,13
Nebraska,Red Cloud,1075,38,25,72,21,60,216
Nebraska,Dixon village,84,1,0,3,5,11,20
Nebraska,Republican City village,147,5,2,2,2,7,18
Nebraska,Dodge village,651,0,24,33,46,49,152
Nebraska,Dorchester village,525,16,2,30,39,35,122
Nebraska,Enders,36,0,0,0,0,0,0
Nebraska,Emmet village,38,0,0,3,0,5,8
Nebraska,Emerson village,842,28,0,30,41,45,144
Nebraska,Elyria village,43,0,3,7,0,3,13
Nebraska,Elwood village,756,9,20,57,41,58,185
Nebraska,Elsie village,115,0,2,3,10,8,23
Nebraska,Elmwood village,607,6,13,32,26,54,131
Nebraska,Elm Creek village,909,36,14,81,59,41,231
Nebraska,Elk Creek village,102,0,0,4,3,6,13
Nebraska,Elgin,609,5,7,34,21,20,87
Nebraska,Elba village,271,13,0,11,9,22,55
Nebraska,Edison village,164,0,0,12,16,9,37
Nebraska,Edgar,472,15,9,17,20,23,84
Nebraska,Eddyville village,127,9,4,9,5,3,30
Nebraska,Eagle village,1043,19,24,85,51,25,204
Nebraska,Dwight village,169,0,1,4,6,9,20
Nebraska,Dunning village,103,6,1,2,2,6,17
Nebraska,Duncan village,451,9,5,19,19,23,75
Nebraska,Dunbar village,188,0,0,5,11,11,27
Nebraska,Du Bois village,172,13,1,4,23,2,43
Nebraska,Douglas village,199,2,0,9,7,18,36
Nebraska,Doniphan village,1020,33,36,94,58,56,277
Nebraska,Reynolds village,70,0,0,1,2,8,11
Nebraska,Richfield,175,8,20,27,38,0,93
Nebraska,Richland village,70,0,0,6,4,7,17
Nebraska,Rushville,852,6,5,20,70,112,213
Nebraska,Ruskin village,116,3,4,4,2,4,17
Nebraska,St. Edward,778,16,7,23,41,46,133
Nebraska,Seward,7109,126,66,401,354,339,1286
Nebraska,St. Helena village,85,0,0,3,7,8,18
Nebraska,St. Libory,341,19,22,42,8,14,105
Nebraska,St. Paul,2313,60,17,148,154,103,482
Nebraska,Salem village,90,4,1,4,4,5,18
Nebraska,Santee village,381,8,15,45,71,26,165
Nebraska,Sarben,16,0,0,0,0,0,0
Nebraska,Sargent,598,3,5,24,29,33,94
Nebraska,Saronville village,83,1,0,10,0,1,12
Nebraska,Schuyler,6196,103,154,497,456,382,1592
Nebraska,Scotia village,365,3,6,29,17,25,80
Nebraska,Scottsbluff,14955,367,296,1034,661,813,3171
Nebraska,Scribner,942,6,6,47,69,58,186
Nebraska,Rulo village,189,2,0,7,20,13,42
Nebraska,Royal village,84,0,0,2,0,3,5
Nebraska,Roseland village,254,5,4,18,17,19,63
Nebraska,Roscoe,14,0,0,0,0,0,0
Nebraska,Rosalie village,221,4,8,19,24,10,65
Nebraska,Rogers village,56,0,1,3,4,4,12
Nebraska,Rockville village,86,0,0,4,6,3,13
Nebraska,Roca village,220,11,4,11,5,17,48
Nebraska,Riverton village,109,0,4,2,3,2,11
Nebraska,Riverdale village,166,8,4,9,8,3,32
Nebraska,Rising City village,292,1,0,9,22,18,50
Nevada,Zephyr Cove,463,0,0,5,3,25,33
Nevada,Yerington,3021,22,49,87,132,201,491
Nevada,Walker Lake,355,0,14,24,0,0,38
Nevada,Winchester,28365,148,265,1424,1135,1138,4110
Nevada,Sunrise Manor,191464,1863,2752,11736,11638,13918,41907
Nevada,Sun Valley,19663,231,326,1397,1161,1081,4196
Nevada,Sutcliffe,194,3,0,0,26,15,44
Nevada,Tonopah,2360,0,22,96,72,128,318
Nevada,Topaz Lake,264,0,0,0,0,3,3
Nevada,Topaz Ranch Estates,1704,5,17,49,41,43,155
Nevada,Unionville,13,0,0,0,0,0,0
Nevada,Winnemucca,7810,143,149,525,519,404,1740
Nevada,Ursine,94,0,0,0,0,0,0
Nevada,Verdi,1525,6,23,56,18,62,165
Nevada,Virginia City,717,0,0,0,0,13,13
Nevada,Wadsworth,900,14,9,70,69,52,214
Nevada,Washoe Valley,3348,15,30,131,206,63,445
Nevada,Wells,1288,20,47,74,70,55,266
Nevada,West Wendover,4422,72,83,480,320,446,1401
Nevada,Whitney,40165,428,626,2226,1920,1856,7056
Nevada,Valmy,8,0,0,0,0,0,0
Nevada,Panaca,1257,15,11,47,70,127,270
Nevada,Fish Springs,909,3,15,29,123,87,257
Nevada,Oasis,0,0,0,0,0,0,0
Nevada,McGill,1321,52,35,132,66,19,304
Nevada,Mesquite,16533,117,100,595,864,602,2278
Nevada,Mina,24,0,0,0,0,0,0
Nevada,Minden,3180,0,24,133,115,163,435
Nevada,Moapa Town,1149,0,37,105,64,106,312
Nevada,Moapa Valley,7099,48,89,494,636,644,1911
Nevada,Mogul,1353,0,0,53,76,197,326
Nevada,Montello,89,0,0,0,0,0,0
Nevada,Mount Charleston,373,0,0,0,4,5,9
Nevada,Mount Wilson,27,0,0,0,0,0,0
Nevada,Nellis AFB,3554,221,180,319,274,114,1108
Nevada,Nelson,36,0,0,0,0,0,0
Nevada,Nixon,308,14,13,22,5,12,66
Nevada,North Las Vegas,226860,2886,4180,16136,14288,15298,52788
Nevada,Orovada,144,0,0,0,0,0,0
Nevada,Osino,983,40,0,171,67,37,315
Nevada,Owyhee,1367,12,52,101,86,81,332
Nevada,Summerlin South,25338,305,414,1284,1061,1019,4083
Nevada,Stateline,1160,6,0,56,76,75,213
Nevada,Stagecoach,1668,19,37,100,68,24,248
Nevada,Spring Creek,13564,65,262,884,956,827,2994
Nevada,Sparks,93437,1211,1783,4732,5040,5062,17828
Nevada,Spanish Springs,15789,212,167,1130,824,952,3285
Nevada,McDermitt,155,0,27,0,0,0,27
Nevada,Lund,217,25,0,0,0,24,49
Nevada,Lovelock,2306,41,21,144,119,178,503
Nevada,Logan Creek,39,0,0,0,0,0,0
Nevada,Golden Valley,2127,45,40,112,62,88,347
Nevada,Goldfield,443,0,6,51,38,16,111
Nevada,Goodsprings,101,0,0,0,0,0,0
Nevada,Grass Valley,834,26,14,42,79,9,170
Nevada,Hawthorne,3095,12,35,65,80,177,369
Nevada,Henderson,271725,2958,2894,14825,13975,13403,48055
Nevada,Hiko,131,9,0,28,0,0,37
Nevada,Humboldt River Ranch,31,0,0,0,0,0,0
Nevada,Imlay,65,0,0,0,0,0,0
Nevada,Golconda,211,0,0,30,10,0,40
Nevada,Glenbrook,123,0,0,0,0,0,0
Nevada,Smith Valley,1182,7,0,96,14,129,246
Nevada,Gerlach,194,0,0,0,0,0,0
Nevada,Indian Hills,6193,41,58,208,352,345,1004
Nevada,Indian Springs,1050,0,32,111,52,60,255
Nevada,Jackpot,1579,0,81,86,129,101,397
Nevada,Johnson Lane,6441,53,50,340,363,364,1170
Nevada,Kingsbury,1970,11,22,13,34,87,167
Nevada,Kingston,172,0,0,0,0,0,0
Nevada,Lakeridge,318,0,0,0,0,8,8
Nevada,Lamoille,340,33,28,0,0,0,61
Nevada,Las Vegas,605097,6904,8310,33867,32465,33918,115464
Nevada,Laughlin,7622,20,90,269,207,280,866
Nevada,Lemmon Valley,5073,19,104,151,241,186,701
Nevada,Incline Village,8734,134,29,235,357,189,944
Nevada,Skyland,230,0,0,0,0,17,17
Nevada,Spring Valley,186632,1642,1807,7539,7997,8313,27298
Nevada,Silver Peak,61,0,0,0,0,0,0
Nevada,Caliente,1029,68,30,68,38,67,271
Nevada,Silver Springs,5351,8,91,299,235,360,993
Nevada,Boulder City,15266,121,87,585,655,787,2235
Nevada,Blue Diamond,344,4,12,16,17,0,49
Nevada,Bennett Springs,146,0,0,0,0,8,8
Nevada,Beaverdam,28,0,6,0,6,6,18
Nevada,Beatty,1051,0,0,18,51,50,119
Nevada,Battle Mountain,3276,71,25,111,267,141,615
Nevada,Baker,30,0,0,0,0,0,0
Nevada,Austin,93,0,0,0,6,7,13
Nevada,Alamo,1095,21,63,0,141,68,293
Nevada,Cal-Nev-Ari,137,0,0,0,0,0,0
Nevada,Silver City,222,0,0,0,19,0,19
Nevada,Schurz,824,23,9,36,46,27,141
Nevada,Sandy Valley,1385,0,35,78,0,47,160
Nevada,Ruth,391,8,0,0,0,24,32
Nevada,Ruhenstroth,1101,0,0,79,0,51,130
Nevada,Round Hill Village,849,30,0,15,10,27,82
Nevada,Reno,234161,2576,2868,11695,11261,12175,40575
Nevada,Rachel,87,0,0,0,0,0,0
Nevada,Preston,20,0,0,0,0,0,0
Nevada,Pioche,911,0,0,0,60,88,148
Nevada,Paradise Valley,158,0,0,14,0,1,15
Nevada,Paradise,226957,1991,2504,10708,10580,10452,36235
Nevada,Searchlight,416,0,9,18,9,11,47
Nevada,Carlin,2299,16,40,75,78,128,337
Nevada,Bunkerville,1374,8,7,116,86,126,343
Nevada,Fallon Station,799,48,4,49,19,6,126
Nevada,Genoa,1087,24,0,55,24,116,219
Nevada,Gardnerville Ranchos,11023,196,164,589,503,470,1922
Nevada,Gardnerville,5636,46,152,414,177,372,1161
Nevada,Gabbs,126,0,0,0,0,0,0
Nevada,Fort McDermitt,613,31,9,61,34,40,175
Nevada,Pahrump,34902,421,443,1205,1546,1583,5198
Nevada,Fernley,19185,150,371,1241,964,1105,3831
Nevada,Carson,54482,355,669,2468,2873,2923,9288
Nevada,Fallon,8442,70,263,537,246,483,1599
Nevada,Eureka,487,2,12,14,3,25,56
Nevada,Empire,20,0,0,0,0,0,0
Nevada,Enterprise,125498,1459,1752,7128,6465,5579,22383
Nevada,Elko,19709,399,167,1249,1102,1203,4120
Nevada,Carter Springs,555,7,3,25,28,48,111
Nevada,Cold Springs,8868,105,163,540,669,697,2174
Nevada,Crescent Valley,346,9,0,60,8,14,91
Nevada,Crystal Bay,239,0,0,0,0,0,0
Nevada,Ely,4206,84,24,189,228,406,931
Nevada,Denio,42,0,0,0,0,0,0
Nevada,Dayton,9163,136,109,607,391,562,1805
Nevada,Dry Valley,45,0,0,0,0,0,0
Nevada,Dyer,264,0,5,0,0,0,5
Nevada,East Valley,1266,0,0,54,31,80,165
Nevada,Double Spring,176,0,6,0,2,6,14
New Hampshire,Londonderry,10729,131,125,501,592,702,2051
New Hampshire,Littleton,4663,162,112,220,303,179,976
New Hampshire,Manchester,110139,1445,1569,4904,4567,5271,17756
New Hampshire,Loudon,533,7,0,26,36,16,85
New Hampshire,Marlborough,1008,5,5,44,44,31,129
New Hampshire,Milton,791,22,0,23,57,47,149
New Hampshire,Meredith,1749,90,0,113,125,31,359
New Hampshire,Milford,9107,94,91,537,506,384,1612
New Hampshire,Lisbon,973,9,17,49,72,69,216
New Hampshire,Milton Mills,411,21,0,0,49,33,103
New Hampshire,Melvin Village,161,0,0,0,0,13,13
New Hampshire,Lincoln,761,0,0,37,14,10,61
New Hampshire,New London,1486,0,0,0,0,38,38
New Hampshire,Lancaster,1417,28,50,34,28,113,253
New Hampshire,West Stewartstown,293,0,0,0,0,6,6
New Hampshire,Warner,417,4,0,10,8,48,70
New Hampshire,Walpole,311,0,0,0,9,8,17
New Hampshire,Troy,1379,29,16,72,75,44,236
New Hampshire,Tilton Northfield,3725,36,40,288,151,236,751
New Hampshire,Suncook,5247,169,63,322,370,220,1144
New Hampshire,Suissevale,133,0,0,0,0,0,0
New Hampshire,South Hooksett,5825,46,85,229,207,266,833
New Hampshire,New Hampton,327,0,0,0,19,24,43
New Hampshire,Mountain Lakes,416,0,5,5,8,16,34
New Hampshire,Lebanon,13535,95,164,465,518,598,1840
New Hampshire,Nashua,87110,1461,1051,4325,3784,4037,14658
New Hampshire,Union,161,0,0,0,0,19,19
New Hampshire,Hinsdale,1508,42,10,63,58,52,225
New Hampshire,Henniker,1623,15,28,73,29,42,187
New Hampshire,Goffstown,3124,131,55,94,142,134,556
New Hampshire,Franklin,8460,73,49,391,413,408,1334
New Hampshire,Farmington,4203,0,130,151,346,111,738
New Hampshire,Exeter,9223,78,63,306,513,547,1507
New Hampshire,Epping,1597,0,32,10,132,125,299
New Hampshire,Hanover,8360,79,72,108,264,259,782
New Hampshire,Enfield,1129,0,24,46,21,0,91
New Hampshire,Dover,30534,422,432,1258,1284,1397,4793
New Hampshire,Derry,22363,140,164,1017,1200,1310,3831
New Hampshire,Conway,3325,110,65,145,69,156,545
New Hampshire,Contoocook,1801,0,0,122,171,162,455
New Hampshire,Concord,42537,639,616,1702,1846,2129,6932
New Hampshire,Colebrook,1286,31,21,77,55,29,213
New Hampshire,East Merrimack,3774,29,13,163,121,117,443
New Hampshire,Claremont,13076,141,150,571,773,798,2433
New Hampshire,Hancock,199,0,5,13,5,9,32
New Hampshire,Hampton,9338,153,69,578,424,550,1774
New Hampshire,Gorham,1518,30,0,70,65,67,232
New Hampshire,Newfields,324,22,17,9,10,24,82
New Hampshire,Somersworth,11778,132,160,526,450,733,2001
New Hampshire,Seabrook Beach,629,0,10,0,0,11,21
New Hampshire,Sanbornville,867,0,0,0,43,24,67
New Hampshire,Rochester,29954,276,186,1278,1268,1584,4592
New Hampshire,Hampton Beach,2068,15,41,60,20,27,163
New Hampshire,Laconia,16075,148,173,708,904,622,2555
New Hampshire,Hillsborough,1697,0,16,155,81,68,320
New Hampshire,Jaffrey,2478,0,0,106,139,172,417
New Hampshire,Hudson,7388,84,127,410,314,387,1322
New Hampshire,Hooksett,3820,24,47,111,139,179,500
New Hampshire,Greenville,1178,67,14,71,33,38,223
New Hampshire,Groveton,1132,22,0,60,66,50,198
New Hampshire,Keene,23403,286,240,727,817,1074,3144
New Hampshire,Charlestown,1020,34,35,19,29,30,147
New Hampshire,Durham,10640,73,25,221,176,149,644
New Hampshire,Center Ossipee,358,0,0,35,10,25,70
New Hampshire,Pinardville,4903,95,43,104,98,348,688
New Hampshire,Peterborough,3113,21,19,18,218,145,421
New Hampshire,North Woodstock,299,0,0,4,0,17,21
New Hampshire,North Walpole,1023,15,19,26,65,153,278
New Hampshire,North Haverhill,711,15,9,18,0,5,47
New Hampshire,Center Sandwich,172,0,0,3,4,0,7
New Hampshire,Pittsfield,1629,13,20,75,117,43,268
New Hampshire,Newport,4798,73,29,164,461,169,896
New Hampshire,Woodsville,1364,47,31,66,116,55,315
New Hampshire,Wolfeboro,2600,19,0,76,93,85,273
New Hampshire,Winchester,1544,0,26,36,34,74,170
New Hampshire,Wilton,939,0,25,8,67,28,128
New Hampshire,Whitefield,1087,21,36,83,23,55,218
New Hampshire,West Swanzey,1402,114,67,100,67,13,361
New Hampshire,Newmarket,5319,85,43,168,252,242,790
New Hampshire,Plainfield,232,12,0,14,0,0,26
New Hampshire,North Conway,2314,24,0,76,119,161,380
New Hampshire,Portsmouth,21426,339,206,644,674,710,2573
New Hampshire,Plymouth,3913,35,24,67,83,62,271
New Hampshire,Bristol,1928,0,64,133,85,90,372
New Hampshire,Bradford,411,7,20,52,26,9,114
New Hampshire,Blodgett Landing,150,0,0,0,0,14,14
New Hampshire,Berlin,9580,207,61,454,339,431,1492
New Hampshire,Bennington,335,10,10,20,15,21,76
New Hampshire,Bethlehem,916,19,15,103,32,59,228
New Hampshire,Bartlett,239,0,0,7,7,8,22
New Hampshire,Ashland,1412,19,0,33,19,65,136
New Hampshire,Antrim,1302,20,45,49,83,106,303
New Hampshire,Amherst,558,16,8,34,33,31,122
New Hampshire,Alton,154,0,0,0,0,0,0
New Hampshire,Raymond,3052,123,34,167,106,80,510
New Hampshire,Belmont,1738,0,40,58,112,126,336
New Hampshire,Canaan,501,34,0,14,21,17,86
New Jersey,Belle Mead,189,8,8,0,9,0,25
New Jersey,Berlin borough,7618,183,120,329,255,378,1265
New Jersey,Belleplain,584,0,3,44,37,2,86
New Jersey,Bellmawr borough,11507,109,153,563,527,662,2014
New Jersey,Belmar borough,5745,30,113,115,101,279,638
New Jersey,Belvidere,2634,37,47,143,118,183,528
New Jersey,Bergenfield borough,27339,470,273,1286,1355,1401,4785
New Jersey,Smithville,7090,33,37,324,221,266,881
New Jersey,Beverly,2569,85,5,138,70,110,408
New Jersey,Somers Point,10776,151,199,381,532,594,1857
New Jersey,Somerset,24409,554,245,899,918,988,3604
New Jersey,Somerdale borough,5298,95,66,220,147,217,745
New Jersey,Society Hill,3651,102,40,117,116,203,578
New Jersey,Skillman,115,0,0,0,22,0,22
New Jersey,Belford,1513,10,12,88,66,96,272
New Jersey,Bernardsville borough,7786,199,109,548,522,362,1740
New Jersey,Beckett,4809,51,94,249,345,447,1186
New Jersey,Hampton borough,1213,6,20,33,53,52,164
New Jersey,Beachwood borough,11128,192,123,612,579,564,2070
New Jersey,Wallington borough,11584,191,134,444,470,513,1752
New Jersey,Waldwick borough,9902,183,156,559,530,522,1950
New Jersey,Voorhees,1058,25,0,65,94,22,206
New Jersey,Vista Center,2158,0,0,34,61,43,138
New Jersey,Villas,9029,84,116,476,411,668,1755
New Jersey,Vienna,796,0,0,0,56,86,142
New Jersey,Wanamassa,4542,86,0,339,289,355,1069
New Jersey,Victory Lakes,1751,20,20,76,15,102,233
New Jersey,Vernon Valley,1427,0,0,61,41,186,288
New Jersey,Vernon Center,1892,31,15,123,30,73,272
New Jersey,Ventnor City,10593,105,93,289,321,508,1316
New Jersey,Upper Stewartsville,171,0,0,0,0,0,0
New Jersey,Upper Saddle River borough,8335,198,42,689,759,504,2192
New Jersey,Upper Pohatcong,1470,15,17,58,103,62,255
New Jersey,Victory Gardens borough,1593,47,21,148,67,71,354
New Jersey,Beattystown,4403,15,91,287,166,132,691
New Jersey,New Village,443,21,0,14,30,6,71
New Jersey,North Beach Haven,2130,0,0,32,43,29,104
New Jersey,Beach Haven West,4076,0,0,36,109,77,222
New Jersey,Beach Haven borough,991,9,3,25,22,28,87
New Jersey,Bayonne,65378,1047,819,2882,2955,3708,11411
New Jersey,Bay Head borough,992,14,12,35,59,39,159
New Jersey,Haworth borough,3451,68,38,196,230,297,829
New Jersey,Hawthorne borough,18989,355,330,863,912,695,3155
New Jersey,North Arlington borough,15734,243,123,891,536,621,2414
New Jersey,Egg Harbor City,4246,37,26,214,206,353,836
New Jersey,Ellisburg,4301,72,29,271,219,232,823
New Jersey,Elmer borough,1460,15,11,120,88,65,299
New Jersey,Elmwood Park borough,19959,378,274,1073,988,1122,3835
New Jersey,Elwood,1635,38,0,65,95,82,280
New Jersey,Emerson borough,7616,169,154,364,355,618,1660
New Jersey,Englewood,27992,602,394,1369,1031,1123,4519
New Jersey,Elizabeth,127759,3099,2511,7239,7388,6334,26571
New Jersey,Vineland,60987,1225,879,3341,2785,3899,12129
New Jersey,Saddle River borough,3229,44,44,51,238,191,568
New Jersey,Singac,5108,66,0,147,397,218,828
New Jersey,Rockaway borough,6490,120,86,231,400,384,1221
New Jersey,Robertsville,11334,267,163,570,721,786,2507
New Jersey,Robbinsville,3326,53,36,368,200,125,782
New Jersey,Riverton borough,2766,22,39,101,157,97,416
New Jersey,River Edge borough,11566,270,155,446,742,846,2459
New Jersey,Riverdale borough,4154,49,41,182,99,153,524
New Jersey,Rio Grande,2499,67,0,69,49,84,269
New Jersey,Ringwood borough,12387,276,115,530,905,850,2676
New Jersey,Edgewater borough,11935,239,342,604,388,237,1810
New Jersey,Eatontown borough,12298,293,71,471,474,406,1715
New Jersey,East Rutherford borough,9076,206,115,158,409,487,1375
New Jersey,East Rocky Hill,208,0,0,19,21,0,40
New Jersey,East Orange,64578,1561,945,2933,3325,3491,12255
New Jersey,East Newark borough,2577,58,36,143,147,171,555
New Jersey,East Millstone,481,0,0,31,27,21,79
New Jersey,East Freehold,5633,50,160,245,350,345,1150
New Jersey,East Franklin,7493,12,209,530,467,313,1531
New Jersey,Dunellen borough,7368,345,33,253,530,383,1544
New Jersey,Dumont borough,17820,345,347,571,1136,831,3230
New Jersey,Dover Beaches South,1185,0,0,12,10,62,84
New Jersey,Dover Beaches North,1157,0,0,0,21,20,41
New Jersey,Dover,18324,268,287,894,1014,1001,3464
New Jersey,Diamond Beach,145,0,0,0,0,0,0
New Jersey,Demarest borough,5004,124,92,244,315,399,1174
New Jersey,Delaware Park,728,0,22,16,30,50,118
New Jersey,Delaware,78,0,0,0,0,0,0
New Jersey,Deal borough,757,5,5,31,11,21,73
New Jersey,Rockleigh borough,576,1,4,21,26,29,81
New Jersey,Rocky Hill borough,615,13,16,30,37,26,122
New Jersey,Roebling,3550,95,86,99,152,146,578
New Jersey,Roosevelt borough,800,24,6,45,44,50,169
New Jersey,Silver Ridge,1299,0,0,0,0,7,7
New Jersey,Silver Lake CDP (Warren County),328,3,7,18,35,20,83
New Jersey,Silver Lake CDP (Essex County),3908,104,51,106,195,159,615
New Jersey,Shrewsbury borough,3923,90,40,217,211,328,886
New Jersey,Short Hills,12831,433,162,1157,1178,1044,3974
New Jersey,Ship Bottom borough,914,3,3,11,30,16,63
New Jersey,Shiloh borough,492,4,5,20,17,36,82
New Jersey,Shark River Hills,3721,89,26,196,102,85,498
New Jersey,Sewaren,2530,10,22,127,116,122,397
New Jersey,Secaucus,18170,368,265,599,811,819,2862
New Jersey,Seaside Park borough,1543,6,5,44,28,24,107
New Jersey,Seaside Heights borough,2885,34,15,164,137,78,428
New Jersey,Sea Isle City,1788,9,0,33,36,16,94
New Jersey,Six Mile Run,3002,56,80,156,98,39,429
New Jersey,Sea Girt borough,1683,8,15,47,67,112,249
New Jersey,Sea Bright borough,1387,0,0,23,74,16,113
New Jersey,Sayreville borough,44051,940,369,2191,2037,2169,7706
New Jersey,Salem,4997,116,137,333,254,284,1124
New Jersey,Upper Montclair,11753,349,156,801,834,845,2985
New Jersey,Rutherford borough,18434,190,243,912,624,1069,3038
New Jersey,Runnemede borough,8414,100,128,405,371,363,1367
New Jersey,Rumson borough,6993,217,68,446,631,747,2109
New Jersey,Rossmoor,2823,0,0,0,0,0,0
New Jersey,Ross Corner,0,0,0,0,0,0,0
New Jersey,Rosenhayn,1226,5,4,21,86,73,189
New Jersey,Roselle Park borough,13555,102,193,961,698,782,2736
New Jersey,Roselle borough,21466,343,229,1134,1256,1238,4200
New Jersey,Roseland borough,5853,97,57,344,410,344,1252
New Jersey,Seabrook Farms,993,57,0,126,72,11,266
New Jersey,Union City,68656,1240,1025,3219,3401,3794,12679
New Jersey,Spring Lake borough,2989,34,32,171,132,173,542
New Jersey,Twin Rivers,7303,120,67,481,297,228,1193
New Jersey,Wildwood,5234,116,9,241,189,229,784
New Jersey,Wildwood Crest borough,3227,18,19,93,166,107,403
New Jersey,Williamstown,15539,239,222,911,958,1145,3475
New Jersey,Woodbine borough,2710,52,34,143,119,76,424
New Jersey,Woodbridge,19822,370,377,843,893,774,3257
New Jersey,Woodbury,10087,158,105,606,358,495,1722
New Jersey,Woodbury Heights borough,3022,42,41,113,120,116,432
New Jersey,Woodcliff Lake borough,5818,122,124,396,376,358,1376
New Jersey,Woodland Park borough,12267,117,90,606,430,596,1839
New Jersey,Woodlynne borough,2970,59,16,206,236,200,717
New Jersey,Wood-Ridge borough,7938,156,72,315,328,354,1225
New Jersey,Woodstown borough,3562,26,104,197,237,217,781
New Jersey,Wrightstown borough,821,2,21,38,39,45,145
New Jersey,Yardville,6868,84,58,379,319,269,1109
New Jersey,Whittingham,2570,0,0,0,58,21,79
New Jersey,Yorketown,6547,103,67,308,467,383,1328
New Jersey,Leisure Knoll,2378,0,0,0,0,0,0
New Jersey,Lebanon borough,1836,16,33,83,97,164,393
New Jersey,Lawrenceville,3825,45,12,191,76,67,391
New Jersey,Lawnside borough,2926,68,43,153,100,164,528
New Jersey,Lavallette borough,2108,22,17,38,73,96,246
New Jersey,Laurence Harbor,7232,75,143,214,323,271,1026
New Jersey,Laurel Springs borough,1923,26,24,76,85,96,307
New Jersey,Laurel Lake,3193,129,49,240,189,243,850
New Jersey,Lambertville,3851,50,86,123,149,66,474
New Jersey,Lakewood,53591,2078,1996,5869,4850,4207,19000
New Jersey,Lake Telemark,1340,106,21,42,24,98,291
New Jersey,Lake Mohawk,9635,268,141,698,358,785,2250
New Jersey,Lakehurst borough,2669,75,41,166,145,196,623
New Jersey,Lake Como borough,1489,30,16,55,57,47,205
New Jersey,Zarephath,0,0,0,0,0,0,0
New Jersey,Whitesboro,2500,49,31,252,197,213,742
New Jersey,White Meadow Lake,8943,231,149,498,575,569,2022
New Jersey,White House Station,1936,0,18,103,33,65,219
New Jersey,Ashland,8548,152,70,457,470,503,1652
New Jersey,Atlantic City,39547,640,523,2514,2098,1796,7571
New Jersey,Atlantic Highlands borough,4346,39,89,182,137,202,649
New Jersey,Audubon borough,8772,175,92,413,479,387,1546
New Jersey,Audubon Park borough,1010,8,0,15,40,3,66
New Jersey,Avalon borough,1596,0,11,27,32,31,101
New Jersey,Avenel,18793,251,102,596,868,735,2552
New Jersey,Avon-by-the-Sea borough,1809,17,4,48,72,118,259
New Jersey,Barclay,4376,115,68,195,187,278,843
New Jersey,Barnegat,3180,150,63,112,56,354,735
New Jersey,Barnegat Light borough,589,17,0,10,12,9,48
New Jersey,Barrington borough,6877,112,117,243,329,307,1108
New Jersey,Little Silver borough,5937,156,111,433,482,314,1496
New Jersey,Little Ferry borough,10856,148,49,354,474,620,1645
New Jersey,Linwood,7036,188,99,325,405,371,1388
New Jersey,Lindenwold borough,17492,232,221,834,563,772,2622
New Jersey,Linden,41322,433,479,1876,1634,2346,6768
New Jersey,White Horse,8447,70,85,373,232,408,1168
New Jersey,Wharton borough,6607,97,71,335,373,401,1277
New Jersey,Westwood borough,11140,269,136,454,724,599,2182
New Jersey,West Wildwood borough,448,0,2,4,3,17,26
New Jersey,Westville borough,4247,59,55,254,169,244,781
New Jersey,Weston,2008,0,11,0,40,44,95
New Jersey,Kinnelon borough,10372,204,34,571,674,696,2179
New Jersey,Leisuretowne,3454,0,0,0,52,36,88
New Jersey,Leisure Village East,3721,0,0,0,16,0,16
New Jersey,Leisure Village West,3072,0,0,0,0,0,0
New Jersey,Leonardo,2495,70,40,144,64,63,381
New Jersey,Leonia borough,9129,144,215,448,532,513,1852
New Jersey,Lincoln Park borough,10478,235,137,499,339,487,1697
New Jersey,Lincroft,6431,193,23,449,343,492,1500
New Jersey,Leisure Village,4340,0,14,44,112,105,275
New Jersey,Union Beach borough,5885,48,16,149,298,412,923
New Jersey,Kingston Estates,6573,115,37,324,419,364,1259
New Jersey,Keyport borough,7195,206,91,458,249,163,1167
New Jersey,South Bound Brook borough,4612,39,88,202,232,140,701
New Jersey,South Plainfield borough,23871,371,313,1323,1081,1294,4382
New Jersey,South River borough,16274,116,261,576,989,1255,3197
New Jersey,South Toms River borough,3706,64,64,185,186,406,905
New Jersey,Spotswood borough,8413,162,51,405,562,301,1481
New Jersey,Springdale,14145,321,71,864,602,895,2753
New Jersey,Dayton,7388,181,79,418,646,596,1920
New Jersey,Spring Lake Heights borough,4683,14,126,244,116,206,706
New Jersey,Stanhope borough,3509,118,47,155,205,228,753
New Jersey,Stewartsville,276,0,15,0,15,41,71
New Jersey,Stockton borough,624,9,14,28,26,45,122
New Jersey,Stone Harbor borough,875,0,0,9,37,30,76
New Jersey,Stratford borough,7007,83,55,388,312,412,1250
New Jersey,Strathmere,191,0,0,0,0,0,0
New Jersey,South Amboy,8787,85,55,271,288,371,1070
New Jersey,Strathmore,7010,181,74,295,405,454,1409
New Jersey,Summit,21869,468,268,1731,1435,1558,5460
New Jersey,Surf City borough,1130,3,0,9,29,11,52
New Jersey,Sussex borough,1972,37,16,116,109,90,368
New Jersey,Swedesboro borough,2612,106,19,132,149,175,581
New Jersey,Tavistock borough,8,0,0,0,0,2,2
New Jersey,Tenafly borough,14788,425,255,1052,1454,1087,4273
New Jersey,Ten Mile Run,1504,31,21,48,47,27,174
New Jersey,Teterboro borough,85,0,0,9,3,0,12
New Jersey,Tinton Falls borough,17872,180,73,451,936,878,2518
New Jersey,Toms River,88687,1602,1046,4072,4806,4637,16163
New Jersey,Totowa borough,10931,109,142,277,591,415,1534
New Jersey,Trenton,84632,2100,1101,4539,4602,4965,17307
New Jersey,Tuckerton borough,3364,78,26,149,127,181,561
New Jersey,Turnersville,3521,61,48,215,233,187,744
New Jersey,Succasunna,8859,103,61,403,551,579,1697
New Jersey,Somerville borough,12212,222,142,482,617,534,1997
New Jersey,Heathcote,5802,170,0,325,461,362,1318
New Jersey,Helmetta borough,2350,10,48,86,123,146,413
New Jersey,Kenvil,2854,34,26,132,106,154,452
New Jersey,Kenilworth borough,8104,93,92,520,271,441,1417
New Jersey,Kendall Park,10323,175,89,671,770,645,2350
New Jersey,Kearny,41866,689,588,2331,2066,2178,7852
New Jersey,Keansburg borough,9967,123,106,271,353,535,1388
New Jersey,Juliustown,301,5,0,12,5,5,27
New Jersey,Johnsonburg,95,16,0,10,0,10,36
New Jersey,Jersey City,259651,5509,3234,11251,9894,10362,40250
New Jersey,Jamesburg borough,5978,187,144,318,248,352,1249
New Jersey,Island Heights borough,1640,25,23,69,53,90,260
New Jersey,Iselin,19146,282,159,701,1151,824,3117
New Jersey,Interlaken borough,795,6,4,14,36,36,96
New Jersey,Hutchinson,126,7,4,12,3,0,26
New Jersey,Hopewell borough,1845,41,26,101,110,78,356
New Jersey,Hope,193,3,0,26,5,5,39
New Jersey,Hopatcong borough,14802,220,226,645,726,670,2487
New Jersey,Holiday Heights,2120,0,0,0,0,0,0
New Jersey,High Bridge borough,3581,64,48,169,218,161,660
New Jersey,Highland Lakes,4862,109,100,259,273,48,789
New Jersey,Highland Park borough,14263,387,301,698,818,821,3025
New Jersey,Highlands borough,4947,20,51,151,175,160,557
New Jersey,Hightstown borough,5529,34,90,227,143,172,666
New Jersey,Hillsdale borough,10452,237,68,832,791,614,2542
New Jersey,Kingston,1274,24,0,97,61,85,267
New Jersey,Hi-Nella borough,831,14,16,31,20,21,102
New Jersey,Ho-Ho-Kus borough,4132,75,103,216,282,287,963
New Jersey,Holiday City-Berkeley,12132,0,0,5,0,45,50
New Jersey,Newton,8036,272,82,335,214,397,1300
New Jersey,New Providence borough,12355,518,214,1017,579,622,2950
New Jersey,Englewood Cliffs borough,5369,195,80,272,283,329,1159
New Jersey,Holiday City South,4087,0,21,83,19,87,210
New Jersey,Hoboken,52452,1189,742,1037,728,676,4372
New Jersey,Crestwood Village,7958,0,0,0,0,0,0
New Jersey,Echelon,11276,290,95,297,457,526,1665
New Jersey,Crandon Lakes,1371,6,11,65,32,61,175
New Jersey,Guttenberg,11595,192,117,475,365,468,1617
New Jersey,Groveville,2879,64,40,145,130,130,509
New Jersey,Griggstown,911,0,7,46,64,31,148
New Jersey,Greenwich,2586,38,32,224,356,260,910
New Jersey,Greentree,11283,190,107,725,651,623,2296
New Jersey,Green Knoll,6403,120,63,277,354,450,1264
New Jersey,Hackensack,44035,640,398,1245,1282,1695,5260
New Jersey,Great Meadows,316,34,0,65,34,0,133
New Jersey,Gloucester City,11386,425,200,495,479,588,2187
New Jersey,Glen Rock borough,11859,361,226,935,885,728,3135
New Jersey,Glen Ridge borough,7607,233,101,678,747,559,2318
New Jersey,Glen Gardner borough,1560,28,5,50,53,66,202
New Jersey,Glendora,4442,17,49,133,257,344,800
New Jersey,Glassboro borough,18958,308,232,891,557,726,2714
New Jersey,Golden Triangle,3888,34,91,112,194,212,643
New Jersey,Hackettstown,9579,250,100,332,549,438,1669
New Jersey,Haddonfield borough,11474,457,184,852,706,754,2953
New Jersey,Haddon Heights borough,7497,145,61,445,338,533,1522
New Jersey,West Long Branch borough,7974,122,99,366,261,414,1262
New Jersey,West Freehold,14000,238,143,939,834,801,2955
New Jersey,Westfield,30552,978,355,1924,2152,2389,7798
New Jersey,West Cape May borough,966,17,4,44,25,53,143
New Jersey,West Belmar,2424,16,54,103,91,108,372
New Jersey,Wenonah borough,2199,57,45,77,166,133,478
New Jersey,Watchung borough,5900,151,112,162,174,508,1107
New Jersey,Washington borough,6466,126,59,357,469,348,1359
New Jersey,Waretown,1773,35,10,30,57,112,244
New Jersey,Wanaque borough,11617,228,131,316,519,558,1752
New Jersey,Hammonton,14735,165,109,755,861,830,2720
New Jersey,Hamilton Square,13456,188,59,570,724,899,2440
New Jersey,Hamburg borough,3209,71,51,167,148,155,592
New Jersey,Haledon borough,8412,154,74,473,414,643,1758
New Jersey,Hainesburg,70,0,0,4,0,5,9
New Jersey,Gibbstown,3775,20,45,280,179,134,658
New Jersey,West New York,51860,1348,671,1984,1986,2020,8009
New Jersey,Gibbsboro borough,2236,39,23,96,117,117,392
New Jersey,Garfield,31265,675,492,1598,1440,1594,5799
New Jersey,Fanwood borough,7479,297,63,532,614,408,1914
New Jersey,Fairview,3843,59,12,239,300,191,801
New Jersey,Fairview borough,14233,165,198,289,326,494,1472
New Jersey,Fairton,1117,39,18,39,29,42,167
New Jersey,Fair Lawn borough,33164,466,393,1885,1566,1786,6096
New Jersey,Fair Haven borough,6075,212,80,545,479,427,1743
New Jersey,Far Hills borough,1052,21,16,44,39,93,213
New Jersey,Estell Manor,1728,17,11,54,86,118,286
New Jersey,Erma,2238,39,38,99,55,131,362
New Jersey,Englishtown borough,2186,24,33,94,162,154,467
New Jersey,Burleigh,404,0,9,0,0,34,43
New Jersey,Buena borough,4566,28,60,191,228,225,732
New Jersey,Budd Lake,8403,166,89,454,696,316,1721
New Jersey,Brownville,2727,45,60,87,125,116,433
New Jersey,Essex Fells borough,2153,40,24,136,172,191,563
New Jersey,Farmingdale borough,1434,33,4,73,80,91,281
New Jersey,Fieldsboro borough,624,22,10,50,41,32,155
New Jersey,Finderne,6333,114,117,182,239,360,1012
New Jersey,Frenchtown borough,1444,45,30,17,51,52,195
New Jersey,Cresskill borough,8729,197,284,352,509,784,2126
New Jersey,Franklin Park,15238,369,181,851,970,583,2954
New Jersey,Franklin Lakes borough,10799,123,88,665,495,1009,2380
New Jersey,Franklin Center,4275,14,56,82,156,129,437
New Jersey,Franklin borough,4944,100,39,247,180,201,767
New Jersey,Fort Lee borough,36251,633,409,1156,1321,1342,4861
New Jersey,Fort Dix,8305,160,90,236,169,264,919
New Jersey,Forked River,5194,55,36,268,249,369,977
New Jersey,Fords,15085,230,198,730,557,584,2299
New Jersey,Folsom borough,1891,43,14,86,115,121,379
New Jersey,Florham Park borough,11802,323,165,362,487,452,1789
New Jersey,Florence,4409,75,47,248,152,207,729
New Jersey,Flemington borough,4676,136,72,253,174,204,839
New Jersey,Finesville,210,0,0,61,8,9,78
New Jersey,Garwood borough,4306,76,76,200,157,200,709
New Jersey,Browns Mills,10831,140,173,624,547,490,1974
New Jersey,Burlington,9868,223,94,386,560,615,1878
New Jersey,Buttzville,165,0,0,0,0,20,20
New Jersey,New Milford borough,16640,327,262,755,877,774,2995
New Jersey,Asbury,304,0,0,6,10,0,16
New Jersey,Asbury Park,15945,336,309,889,738,577,2849
New Jersey,Camden,76904,2595,1637,5798,5249,4635,19914
New Jersey,Califon borough,1283,63,13,89,98,60,323
New Jersey,North Caldwell borough,6415,41,104,461,537,469,1612
New Jersey,Annandale,1413,27,19,48,83,83,260
New Jersey,North Cape May,2751,55,0,126,109,98,388
New Jersey,North Haledon borough,8507,334,75,256,386,401,1452
New Jersey,North Middletown,3212,18,0,224,115,158,515
New Jersey,North Plainfield borough,22156,323,341,1427,1257,1059,4407
New Jersey,Northvale borough,4763,97,40,230,275,260,902
New Jersey,North Wildwood,3957,41,29,120,151,90,431
New Jersey,Norwood borough,5823,85,67,249,292,357,1050
New Jersey,Northfield,8597,129,110,328,674,667,1908
New Jersey,Andover borough,662,3,0,21,19,41,84
New Jersey,Anderson,294,0,0,0,15,16,31
New Jersey,Hasbrouck Heights borough,12100,240,132,500,637,898,2407
New Jersey,Absecon,8394,66,58,440,320,400,1284
New Jersey,Allamuchy,116,0,0,0,5,4,9
New Jersey,Allendale borough,6717,199,96,514,506,470,1785
New Jersey,Allenhurst borough,486,8,0,15,38,19,80
New Jersey,Allentown borough,1888,31,21,74,107,150,383
New Jersey,Allenwood,973,21,11,70,27,70,199
New Jersey,Alloway,1686,51,55,97,96,184,483
New Jersey,Alpha borough,2272,38,21,145,172,111,487
New Jersey,Alpine borough,1559,26,8,51,70,65,220
New Jersey,Hancocks Bridge,210,12,0,33,28,18,91
New Jersey,Harlingen,188,0,0,23,10,0,33
New Jersey,Harmony,382,12,4,0,30,40,86
New Jersey,Harrington Park borough,4764,135,23,253,441,324,1176
New Jersey,Harrison,14629,309,259,508,800,654,2530
New Jersey,Harvey Cedars borough,416,5,0,3,11,15,34
New Jersey,Oakhurst,3727,26,29,164,262,343,824
New Jersey,Butler borough,7659,119,77,306,280,377,1159
New Jersey,Oakland borough,13003,329,131,630,1013,889,2992
New Jersey,Oak Valley,3325,44,15,93,140,175,467
New Jersey,Peapack and Gladstone borough,2588,91,52,87,178,202,610
New Jersey,Pedricktown,516,3,3,42,17,36,101
New Jersey,Pemberton borough,1485,18,32,71,37,34,192
New Jersey,Pemberton Heights,2595,16,50,103,49,84,302
New Jersey,Pennington borough,2599,70,29,126,135,213,573
New Jersey,Penns Grove borough,5032,114,107,400,391,509,1521
New Jersey,Paulsboro borough,6025,75,43,436,391,390,1335
New Jersey,Pennsville,11623,70,152,468,490,715,1895
New Jersey,Phillipsburg,14608,418,113,775,683,736,2725
New Jersey,Pine Beach borough,2175,62,33,98,119,102,414
New Jersey,Pine Hill borough,10419,204,111,521,520,468,1824
New Jersey,Pine Lake Park,9064,137,167,622,539,420,1885
New Jersey,Caldwell borough,7902,97,38,258,397,389,1179
New Jersey,Byram Center,39,0,0,0,5,0,5
New Jersey,Perth Amboy,52179,1188,830,3079,2832,2662,10591
New Jersey,Paterson,146987,3355,2497,8781,8695,8492,31820
New Jersey,Passaic,70618,2483,1716,4985,4817,5365,19366
New Jersey,Park Ridge borough,8820,142,121,466,505,582,1816
New Jersey,Ocean Acres,16000,513,150,932,767,1225,3587
New Jersey,Ocean City,11470,142,89,297,330,583,1441
New Jersey,Ocean Gate borough,2105,30,44,79,60,134,347
New Jersey,Ocean Grove,3015,71,0,34,77,128,310
New Jersey,Oceanport borough,5800,186,46,347,314,301,1194
New Jersey,Ogdensburg borough,2432,72,36,202,128,158,596
New Jersey,Old Bridge,23550,360,248,1113,1228,1240,4189
New Jersey,Old Tappan borough,5922,104,56,278,486,412,1336
New Jersey,Olivet,1444,16,28,78,55,59,236
New Jersey,Oradell borough,8146,234,92,628,621,572,2147
New Jersey,Oxford,1069,10,17,44,17,55,143
New Jersey,Palisades Park borough,20364,307,93,618,646,721,2385
New Jersey,Palmyra borough,7356,69,144,322,193,276,1004
New Jersey,Panther Valley,3518,84,53,94,123,90,444
New Jersey,Paramus borough,26760,565,333,1062,1259,1582,4801
New Jersey,Oaklyn borough,4004,69,49,123,148,131,520
New Jersey,Brooklawn borough,1944,24,20,75,106,95,320
New Jersey,Freehold borough,11978,244,251,734,394,823,2446
New Jersey,Brookdale,9813,239,88,451,488,463,1729
New Jersey,Ridgefield borough,11256,48,217,338,529,762,1894
New Jersey,Ridgefield Park village,12969,113,151,652,907,820,2643
New Jersey,Ridgewood village,25370,608,412,2020,2290,2014,7344
New Jersey,Cape May,3553,42,42,35,78,106,303
New Jersey,Cape May Court House,5472,70,50,197,283,230,830
New Jersey,Carlstadt borough,6225,58,105,289,200,489,1141
New Jersey,Richwood,3130,41,37,137,217,315,747
New Jersey,Carneys Point,7162,133,105,283,243,347,1111
New Jersey,Cedar Glen Lakes,1459,0,0,0,0,0,0
New Jersey,Cedar Glen West,1001,0,0,0,0,0,0
New Jersey,Cedarville,681,0,0,11,37,28,76
New Jersey,Brookfield,638,0,0,0,0,0,0
New Jersey,Cherry Hill Mall,13829,320,112,530,557,811,2330
New Jersey,Chesilhurst borough,1662,12,19,63,47,79,220
New Jersey,Carteret borough,23965,386,264,956,1522,1531,4659
New Jersey,Chester borough,1612,47,13,128,124,96,408
New Jersey,Red Bank borough,12238,344,174,470,433,672,2093
New Jersey,Ramtown,6050,70,78,352,408,441,1349
New Jersey,Lopatcong Overlook,545,18,29,21,20,0,88
New Jersey,Long Valley,1835,18,40,125,114,163,460
New Jersey,Longport borough,999,10,6,7,19,23,65
New Jersey,Long Branch,30721,621,584,1795,1568,1141,5709
New Jersey,Lodi borough,24590,549,370,1336,1131,1149,4535
New Jersey,Loch Arbour village,189,3,4,5,17,9,38
New Jersey,Raritan borough,7328,121,119,340,407,393,1380
New Jersey,Prince,28936,760,231,1188,1303,1340,4822
New Jersey,Princeton Meadows,13839,293,84,876,568,740,2561
New Jersey,Prospect Park borough,5924,152,156,383,431,308,1430
New Jersey,Quinton,596,0,28,50,33,37,148
New Jersey,Rahway,28644,573,326,1305,1483,1448,5135
New Jersey,Ramblewood,5823,82,52,289,221,254,898
New Jersey,Ramsey borough,14889,298,117,935,820,1167,3337
New Jersey,Princeton Junction,2423,82,121,116,87,108,514
New Jersey,McGuire AFB,5113,126,106,473,438,184,1327
New Jersey,Pine Ridge at Crestwood,2247,0,0,0,0,0,0
New Jersey,Pitman borough,8932,131,137,516,495,639,1918
New Jersey,Cliffside Park borough,24493,396,274,868,747,1082,3367
New Jersey,Cliffwood Beach,3151,50,60,100,190,165,565
New Jersey,Clifton,85552,1621,1091,3992,3704,4291,14699
New Jersey,Clinton,2681,35,32,154,177,161,559
New Jersey,Closter borough,8582,155,61,423,771,636,2046
New Jersey,Clyde,253,23,0,16,13,17,69
New Jersey,Clementon borough,4968,83,50,254,210,179,776
New Jersey,Collings Lakes,1242,20,0,39,96,69,224
New Jersey,Colonia,17517,186,138,989,748,988,3049
New Jersey,Columbia,331,0,0,15,61,24,100
New Jersey,Concordia,3227,13,0,0,0,0,13
New Jersey,Corbin City,482,7,2,9,27,36,81
New Jersey,Country Lake Estates,3658,44,29,196,155,193,617
New Jersey,Cranbury,2283,40,31,138,227,127,563
New Jersey,Collingswood borough,13925,196,218,532,604,571,2121
New Jersey,Pine Valley borough,3,0,0,0,0,0,0
New Jersey,Clearbrook Park,2713,0,0,24,10,0,34
New Jersey,Presidential Lakes Estates,2235,38,46,300,7,95,486
New Jersey,Plainfield,50678,1095,958,3018,2149,2478,9698
New Jersey,Plainsboro Center,2785,108,49,103,52,86,398
New Jersey,Pleasant Plains,694,16,11,12,57,11,107
New Jersey,Pleasantville,20518,435,351,1149,1083,1016,4034
New Jersey,Point Pleasant borough,18426,398,223,763,904,1149,3437
New Jersey,Point Pleasant Beach borough,4604,21,18,261,256,334,890
New Jersey,Clayton borough,8292,158,115,520,480,396,1669
New Jersey,Pomona,7495,167,45,356,616,370,1554
New Jersey,Port Colden,126,0,0,0,0,16,16
New Jersey,Port Monmouth,3568,58,83,179,146,145,611
New Jersey,Port Murray,96,0,0,0,0,0,0
New Jersey,Port Norris,1282,34,0,37,39,76,186
New Jersey,Port Reading,3634,140,52,174,167,287,820
New Jersey,Port Republic,996,3,8,26,27,66,130
New Jersey,Pompton Lakes borough,11179,210,140,449,578,702,2079
New Jersey,Madison borough,16091,464,265,785,883,930,3327
New Jersey,Chatham borough,9011,443,137,750,791,568,2689
New Jersey,Madison Park,6690,103,118,323,339,338,1221
New Jersey,Newfield borough,1616,33,3,91,86,108,321
New Jersey,New Egypt,2016,11,58,103,112,81,365
New Jersey,New Brunswick,56338,1103,637,2917,2604,2664,9925
New Jersey,Newark,279793,7349,4697,14688,14961,15646,57341
New Jersey,Netcong borough,3258,34,58,141,93,188,514
New Jersey,Neptune City borough,4834,70,77,214,286,323,970
New Jersey,Navesink,1738,12,53,101,130,221,517
New Jersey,National Park borough,3005,62,43,122,148,143,518
New Jersey,Mystic Island,7864,159,38,254,235,423,1109
New Jersey,Mullica Hill,4377,62,77,126,167,142,574
New Jersey,Mount Hermon,108,6,3,2,0,7,18
New Jersey,Mount Ephraim borough,4646,64,53,199,224,170,710
New Jersey,Mount Arlington borough,5187,44,63,240,148,244,739
New Jersey,Mountainside borough,6832,161,40,417,481,534,1633
New Jersey,Mountain Lakes borough,4262,119,81,252,412,501,1365
New Jersey,Blackwells Mills,503,12,0,13,14,100,139
New Jersey,Mountain Lake,579,5,4,4,10,47,70
New Jersey,Blackwood,4662,41,8,327,221,162,759
New Jersey,Blawenburg,343,10,0,42,47,16,115
New Jersey,Broadway,194,0,0,18,0,0,18
New Jersey,Brigantine,9347,66,104,333,263,240,1006
New Jersey,Brielle borough,4769,61,65,329,271,275,1001
New Jersey,Bridgeville,173,0,0,31,0,0,31
New Jersey,Bridgeton,25201,644,555,1709,1236,1501,5645
New Jersey,Branchville borough,889,16,13,67,29,60,185
New Jersey,Brainards,189,6,5,0,9,17,37
New Jersey,Bradley Gardens,13994,264,143,1280,966,926,3579
New Jersey,Bradley Beach borough,4297,0,56,153,119,176,504
New Jersey,Bound Brook borough,10515,199,136,398,164,612,1509
New Jersey,Bordentown,3903,45,65,253,100,186,649
New Jersey,Boonton,8422,271,140,380,266,280,1337
New Jersey,Bogota borough,8329,102,109,376,347,434,1368
New Jersey,Bloomsbury borough,720,11,8,43,39,38,139
New Jersey,Bloomingdale borough,7933,73,96,274,194,341,978
New Jersey,Blairstown,540,0,0,79,0,71,150
New Jersey,Morristown,18563,281,379,560,728,737,2685
New Jersey,Brass Castle,1575,20,0,46,91,132,289
New Jersey,Morganville,4999,71,19,313,420,390,1213
New Jersey,Medford Lakes borough,4124,74,9,257,276,196,812
New Jersey,Maywood borough,9694,177,126,399,403,476,1581
New Jersey,Mays Landing,1932,23,0,107,155,58,343
New Jersey,Matawan borough,8887,173,58,524,381,439,1575
New Jersey,Martinsville,11950,131,110,528,817,885,2471
New Jersey,Marlton,10271,177,87,414,485,518,1681
New Jersey,Mendham borough,5016,166,89,331,404,408,1398
New Jersey,Marksboro,96,0,0,7,7,5,19
New Jersey,Manville borough,10454,117,213,493,434,446,1703
New Jersey,Mantoloking borough,340,0,0,2,7,9,18
New Jersey,Manasquan borough,5830,64,9,120,313,360,866
New Jersey,Manahawkin,2474,66,20,74,86,149,395
New Jersey,Morris Plains borough,5598,122,72,229,266,326,1015
New Jersey,Magnolia borough,4314,83,27,166,185,199,660
New Jersey,Margate City,6304,106,20,146,119,138,529
New Jersey,Mercerville,13371,219,212,452,508,583,1974
New Jersey,Cape May Point borough,240,0,0,0,0,4,4
New Jersey,Milltown borough,6989,199,110,440,268,353,1370
New Jersey,Monmouth Beach borough,3258,84,44,173,177,117,595
New Jersey,Millville,28515,567,414,1840,1570,1489,5880
New Jersey,Merchantville borough,3793,64,48,156,166,129,563
New Jersey,Monmouth Junction,3267,70,114,257,131,406,978
New Jersey,Millstone borough,487,11,4,22,30,41,108
New Jersey,Milford borough,1123,24,6,42,35,58,165
New Jersey,Moonachie borough,2753,37,14,78,139,116,384
New Jersey,Middlesex borough,13831,233,111,749,598,800,2491
New Jersey,Middlebush,2478,16,24,153,99,179,471
New Jersey,Metuchen borough,13765,323,214,929,831,535,2832
New Jersey,Moorestown-Lenola,14217,192,164,890,1023,891,3160
New Jersey,Midland Park borough,7269,209,67,537,351,314,1478
New Jersey,Montvale borough,8199,256,145,509,472,399,1781
New Mexico,Lower Frisco,0,0,0,0,0,0,0
New Mexico,Lovington,11499,141,249,996,927,650,2963
New Mexico,Loving village,1451,23,14,90,46,88,261
New Mexico,Los Ranchos de Albuquerque village,6067,169,49,186,210,302,916
New Mexico,Los Ojos,114,0,0,0,0,0,0
New Mexico,Luis Lopez,246,0,0,0,55,0,55
New Mexico,Williamsburg village,512,35,0,15,15,0,65
New Mexico,Los Luceros,523,0,0,121,1,8,130
New Mexico,Lumberton,114,0,0,0,0,0,0
New Mexico,Los Chaves,5067,20,0,217,330,456,1023
New Mexico,Los Cerrillos,421,0,0,23,22,0,45
New Mexico,Los Alamos,11815,265,131,548,508,611,2063
New Mexico,Lordsburg,2740,0,38,183,66,290,577
New Mexico,Logan village,1012,0,0,45,28,56,129
New Mexico,Los Lunas village,15281,88,318,880,930,1098,3314
New Mexico,Luna,130,0,0,0,0,0,0
New Mexico,Malaga,66,0,0,0,0,0,0
New Mexico,McCartys Village,88,0,0,0,5,19,24
New Mexico,Middle Frisco,165,0,0,27,0,0,27
New Mexico,Mesquite,563,0,11,108,0,77,196
New Mexico,Mesita,627,14,13,50,24,51,152
New Mexico,Mesilla,2403,58,13,54,38,50,213
New Mexico,Mescalero,1520,43,10,117,79,99,348
New Mexico,Melrose village,634,41,20,28,4,38,131
New Mexico,Meadow Lake,4813,106,69,531,429,422,1557
New Mexico,Lyden,386,0,0,0,105,62,167
New Mexico,Mayhill,234,0,36,0,0,0,36
New Mexico,Manzano Springs,149,0,0,27,0,0,27
New Mexico,Manzano,13,0,0,0,0,0,0
New Mexico,Loco Hills,34,0,0,0,0,0,0
New Mexico,Magdalena village,603,0,0,32,14,21,67
New Mexico,Madrone,577,30,12,34,47,20,143
New Mexico,Madrid,178,0,0,0,0,0,0
New Mexico,McIntosh,809,0,0,16,54,35,105
New Mexico,Maxwell village,137,0,1,7,2,4,14
New Mexico,Llano del Medio,49,0,0,0,0,0,0
New Mexico,Las Palomas,444,0,0,43,42,30,115
New Mexico,Lemitar,331,0,0,76,0,39,115
New Mexico,La Jara,197,0,0,0,14,0,14
New Mexico,La Huerta,1116,23,21,42,158,59,303
New Mexico,La Hacienda,671,0,0,91,0,23,114
New Mexico,Laguna,1510,64,25,64,101,81,335
New Mexico,La Cueva,113,0,0,0,0,0,0
New Mexico,La Cienega,2884,42,54,148,235,195,674
New Mexico,Kirtland,6068,28,169,244,500,448,1389
New Mexico,Kingston,9,0,0,0,0,0,0
New Mexico,Yah-ta-hey,383,11,0,10,65,20,106
New Mexico,Young Place,108,0,0,0,0,0,0
New Mexico,Youngsville,87,0,0,0,0,0,0
New Mexico,Zia Pueblo,879,33,20,69,55,54,231
New Mexico,Zuni Pueblo,9494,124,175,515,369,492,1675
New Mexico,Winston,20,0,0,0,0,0,0
New Mexico,Windmill,63,8,0,0,0,0,8
New Mexico,La Joya,0,0,0,0,0,0,0
New Mexico,Livingston Wheeler,645,0,0,0,154,50,204
New Mexico,Lake Arthur,436,2,11,9,26,61,109
New Mexico,Lake Roberts Heights,25,0,0,0,0,0,0
New Mexico,Lee Acres,6480,74,111,577,352,280,1394
New Mexico,La Villita,1153,0,0,63,0,51,114
New Mexico,La Union,1561,31,18,161,185,122,517
New Mexico,Las Vegas,13713,95,123,556,567,543,1884
New Mexico,Las Nutrias,335,0,0,0,34,33,67
New Mexico,Las Maravillas,1994,87,62,87,144,95,475
New Mexico,Las Cruces,101164,1184,1324,5531,5235,4937,18211
New Mexico,La Puebla,1000,0,0,43,78,29,150
New Mexico,La Plata,751,0,60,65,6,6,137
New Mexico,Lamy,174,0,0,33,23,0,56
New Mexico,La Mesilla,2134,21,39,77,86,83,306
New Mexico,La Mesa,887,29,33,68,48,123,301
New Mexico,La Luz,1837,16,27,88,87,221,439
New Mexico,Lake Valley,55,3,0,1,2,3,9
New Mexico,Lake Sumner,166,0,0,7,27,38,72
New Mexico,Lake Roberts,0,0,0,0,0,0,0
New Mexico,La Madera,123,0,0,0,0,0,0
New Mexico,Jarales,2000,0,9,73,158,112,352
New Mexico,Abiquiu,61,0,0,17,0,0,17
New Mexico,Pueblitos,708,0,2,17,0,22,41
New Mexico,Pueblo,16,0,0,0,0,0,0
New Mexico,Pueblo of Sandia Village,362,16,4,32,32,24,108
New Mexico,Pueblo Pintado,407,29,4,36,15,19,103
New Mexico,Des Moines village,123,0,5,5,5,8,23
New Mexico,Dexter,1390,61,53,143,120,64,441
New Mexico,Dixon,1009,0,0,0,98,0,98
New Mexico,Do?a Ana,1313,48,0,85,47,0,180
New Mexico,Dora village,65,2,0,6,2,3,13
New Mexico,Pueblito,112,0,0,4,4,0,8
New Mexico,Dulce,2499,62,33,198,185,169,647
New Mexico,Abeytas,28,0,0,0,0,0,0
New Mexico,Puerto de Luna,174,10,0,22,21,0,53
New Mexico,Pulpotio Bareas,151,0,0,0,0,25,25
New Mexico,Quemado,72,0,0,0,0,39,39
New Mexico,Questa village,1748,44,32,58,74,78,286
New Mexico,Radium Springs,1400,0,0,66,124,64,254
New Mexico,Ramah,278,0,29,42,10,0,81
New Mexico,Rancho Grande,157,0,0,0,0,0,0
New Mexico,Ranchos de Taos,2435,0,0,49,251,287,587
New Mexico,Duran,15,0,0,3,2,0,5
New Mexico,Raton,6493,119,32,389,323,283,1146
New Mexico,Portales,12416,174,190,677,715,509,2265
New Mexico,Ponderosa,498,0,39,75,74,10,198
New Mexico,Paradise Hills,4733,26,38,431,237,245,977
New Mexico,Paraje,817,23,0,31,18,50,122
New Mexico,Pastura,8,0,0,0,0,0,0
New Mexico,Peak Place,347,8,4,35,18,30,95
New Mexico,Pecan Park,33,0,0,0,0,0,0
New Mexico,Pecos village,1409,0,0,23,122,89,234
New Mexico,Pe?a Blanca,584,11,0,24,60,40,135
New Mexico,Pe?asco,527,12,5,22,15,23,77
New Mexico,Peralta,3625,0,29,180,192,134,535
New Mexico,Ponderosa Pine,1225,11,0,27,36,54,128
New Mexico,Picuris Pueblo,49,0,0,0,3,0,3
New Mexico,Pinehill,81,0,0,6,0,0,6
New Mexico,Pinon,26,0,0,0,0,0,0
New Mexico,Pinos Altos,226,0,0,48,66,0,114
New Mexico,Placitas CDP (Do?a Ana County),678,26,0,103,111,0,240
New Mexico,Placitas CDP (Sandoval County),4917,0,7,102,65,176,350
New Mexico,Playas,157,9,0,0,0,0,9
New Mexico,Pleasanton,119,0,0,0,0,47,47
New Mexico,Pojoaque,2202,59,31,118,118,130,456
New Mexico,Polvadera,783,0,0,75,55,211,341
New Mexico,Pie Town,123,0,0,0,0,0,0
New Mexico,Pajarito Mesa,329,0,0,34,54,32,120
New Mexico,Red River,328,3,2,17,6,15,43
New Mexico,Reserve village,613,0,0,5,16,24,45
New Mexico,Sandia Knolls,1486,8,28,95,47,14,192
New Mexico,Sandia Park,105,0,0,0,0,0,0
New Mexico,San Felipe Pueblo,3167,114,72,294,237,165,882
New Mexico,San Fidel,133,0,35,0,0,0,35
New Mexico,San Ildefonso Pueblo,699,10,11,26,22,24,93
New Mexico,San Jon village,153,5,2,4,2,0,13
New Mexico,San Jose CDP (Rio Arriba County),677,5,8,25,32,41,111
New Mexico,San Jose CDP (San Miguel County),161,0,0,0,0,0,0
New Mexico,San Lorenzo,51,0,0,0,0,0,0
New Mexico,Sandia Heights,3377,51,17,35,88,122,313
New Mexico,San Luis,29,0,0,0,0,0,0
New Mexico,San Miguel,1213,13,13,141,92,80,339
New Mexico,Sanostee,387,6,16,38,25,26,111
New Mexico,San Pablo,1042,26,0,50,78,57,211
New Mexico,San Pedro,187,0,0,0,0,0,0
New Mexico,San Rafael,1055,0,0,0,98,37,135
New Mexico,Santa Ana Pueblo,645,4,8,41,34,49,136
New Mexico,Santa Clara village,1560,37,15,81,33,85,251
New Mexico,Santa Clara Pueblo,1086,16,23,67,66,67,239
New Mexico,Santa Cruz,351,7,12,31,26,4,80
New Mexico,San Mateo,316,0,0,0,0,54,54
New Mexico,Regina,4,0,0,0,0,0,0
New Mexico,San Cristobal,288,0,0,0,0,0,0
New Mexico,San Antonito CDP (Bernalillo County),952,0,0,74,28,106,208
New Mexico,Ribera,763,0,19,45,0,123,187
New Mexico,Rincon,54,9,0,17,0,13,39
New Mexico,Rio Communities,5189,140,94,336,188,131,889
New Mexico,Corona village,132,0,0,0,6,2,8
New Mexico,Rio Lucio,392,5,0,16,14,21,56
New Mexico,Rio Rancho,91807,1539,1293,5780,5441,5617,19670
New Mexico,Rivers,0,0,0,0,0,0,0
New Mexico,Rock Springs,314,4,0,24,71,62,161
New Mexico,Rodeo,95,0,0,9,8,0,17
New Mexico,San Antonito CDP (Socorro County),123,0,0,0,0,0,0
New Mexico,Rodey,198,0,0,25,0,21,46
New Mexico,Roswell,48553,784,807,3161,2676,2815,10243
New Mexico,Rowe,361,0,0,14,0,0,14
New Mexico,Roy village,222,1,4,0,0,9,14
New Mexico,Ruidoso village,7884,118,78,358,383,229,1166
New Mexico,Ruidoso Downs,2674,4,72,212,127,236,651
New Mexico,Sacramento,92,0,0,0,0,0,0
New Mexico,Salem,975,0,0,127,65,91,283
New Mexico,San Acacia,87,0,0,39,0,0,39
New Mexico,San Antonio,32,0,0,0,0,0,0
New Mexico,Rosedale,267,0,0,0,0,0,0
New Mexico,Paguate,328,0,0,0,8,0,8
New Mexico,Orogrande,109,0,0,0,21,0,21
New Mexico,Organ,189,0,0,0,0,23,23
New Mexico,Cedro,302,0,0,9,0,6,15
New Mexico,Cedar Hill,693,12,0,0,10,25,47
New Mexico,Cedar Grove,669,0,0,0,20,68,88
New Mexico,Cedar Crest,919,0,0,13,4,101,118
New Mexico,Causey village,56,3,0,1,0,2,6
New Mexico,Casa Colorada,112,0,0,0,0,7,7
New Mexico,Carrizozo,934,22,5,32,1,22,82
New Mexico,Carnuel,1687,6,8,46,58,59,177
New Mexico,Carlsbad,27592,441,417,1854,1870,1580,6162
New Mexico,Chama village,868,0,26,49,65,55,195
New Mexico,Capulin,100,0,2,12,9,0,23
New Mexico,Canova,0,0,0,0,0,0,0
New Mexico,Ca?ones,65,0,0,0,0,0,0
New Mexico,Ca?on,219,0,0,31,31,10,72
New Mexico,Cannon AFB,2575,60,70,100,73,75,378
New Mexico,Canjilon,340,0,0,0,11,0,11
New Mexico,Ca?ada de los Alamos,229,0,0,0,0,0,0
New Mexico,Caballo,46,0,0,0,0,0,0
New Mexico,Buckhorn,182,0,0,14,0,0,14
New Mexico,Brimhall Nizhoni,371,8,9,12,9,16,54
New Mexico,Capitan village,1306,10,20,50,41,107,228
New Mexico,Brazos,51,0,0,0,0,0,0
New Mexico,Chamberino,923,38,0,59,0,110,207
New Mexico,Chamita,987,15,16,34,37,54,156
New Mexico,Cordova,417,31,0,0,0,0,31
New Mexico,Conchas Dam,82,0,0,27,0,14,41
New Mexico,Columbus village,1265,29,38,68,106,56,297
New Mexico,Cochiti Lake,590,12,0,16,22,14,64
New Mexico,Cochiti,453,9,8,31,37,21,106
New Mexico,Cobre,18,0,0,0,0,0,0
New Mexico,Clovis,39466,784,674,2467,1856,2417,8198
New Mexico,Cloudcroft village,530,0,0,9,19,6,34
New Mexico,Cliff,334,0,0,30,26,16,72
New Mexico,Chamisal,285,0,1,5,13,7,26
New Mexico,Clayton,2816,42,0,124,35,156,357
New Mexico,Cimarron village,1035,15,4,38,47,56,160
New Mexico,Church Rock,1051,29,9,85,98,108,329
New Mexico,Chupadero,270,0,0,1,1,3,5
New Mexico,Chimayo,2369,0,80,65,117,81,343
New Mexico,Chilili,46,0,0,0,0,0,0
New Mexico,Chili,648,38,0,29,0,0,67
New Mexico,Chical,134,0,0,0,4,2,6
New Mexico,Chaparral,13629,194,148,1241,1072,1526,4181
New Mexico,Chamizal,44,0,0,0,0,0,0
New Mexico,City of the Sun,38,0,0,0,0,0,0
New Mexico,Costilla,61,0,9,0,0,0,9
New Mexico,Cotton City,284,0,5,14,10,13,42
New Mexico,Coyote,150,11,0,0,0,5,16
New Mexico,Nakaibito,473,14,0,14,18,38,84
New Mexico,Nambe,1906,31,18,117,89,127,382
New Mexico,Napi Headquarters,688,11,10,49,67,67,204
New Mexico,Nara Visa,52,0,0,0,0,0,0
New Mexico,Naschitti,229,0,0,0,8,19,27
New Mexico,Navajo,1918,58,59,190,219,122,648
New Mexico,Navajo Dam,91,0,19,0,0,0,19
New Mexico,Nenahnezad,812,20,23,43,51,54,191
New Mexico,Newcomb,265,10,1,12,11,15,49
New Mexico,Nageezi,284,2,3,60,12,19,96
New Mexico,Newkirk,0,0,0,0,0,0,0
New Mexico,North Acomita Village,250,4,4,5,6,16,35
New Mexico,North Hobbs,6034,82,83,312,405,364,1246
New Mexico,North Hurley,290,0,0,0,71,19,90
New Mexico,North Light Plant,426,12,11,30,73,0,126
New Mexico,North San Ysidro,121,0,0,22,0,0,22
New Mexico,North Valley,11221,44,124,757,732,614,2271
New Mexico,Oasis,113,0,0,0,0,0,0
New Mexico,Ohkay Owingeh,1531,12,15,81,111,141,360
New Mexico,Ojo Amarillo,659,15,4,73,48,54,194
New Mexico,Nogal,112,0,0,0,0,15,15
New Mexico,Nadine,381,0,0,44,39,6,89
New Mexico,Mountain View,88,0,0,0,0,0,0
New Mexico,Mountainair,1137,14,29,90,87,94,314
New Mexico,Crownpoint,2565,43,61,202,121,158,585
New Mexico,Cruzville,167,0,40,39,40,0,119
New Mexico,Crystal,364,0,5,29,28,29,91
New Mexico,Cuartelez,404,0,0,0,48,0,48
New Mexico,Cuba village,725,28,0,53,70,43,194
New Mexico,Cubero,256,0,17,0,0,23,40
New Mexico,Cundiyo,11,0,0,0,0,0,0
New Mexico,Cuyamungue,548,11,7,29,55,24,126
New Mexico,Cuyamungue Grant,127,0,0,0,1,0,1
New Mexico,Datil,109,0,0,0,0,0,0
New Mexico,Deming,14667,340,233,799,746,873,2991
New Mexico,Midway,1065,5,49,96,88,78,316
New Mexico,Milan village,3257,51,61,178,143,201,634
New Mexico,Mimbres,737,0,0,32,28,28,88
New Mexico,Monterey Park,1697,31,9,142,99,197,478
New Mexico,Monument,159,5,5,0,0,0,10
New Mexico,Moquino,0,0,0,0,0,0,0
New Mexico,Mora,751,0,0,67,0,155,222
New Mexico,Moriarty,2227,51,36,202,56,164,509
New Mexico,Morningside,970,97,0,138,0,49,284
New Mexico,Mosquero village,52,0,0,0,14,0,14
New Mexico,Santa Fe,83008,987,1091,4135,3749,3682,13644
New Mexico,Santa Rosa,3040,0,20,53,130,183,386
New Mexico,Rio en Medio,196,0,0,0,10,0,10
New Mexico,Santo Domingo Pueblo,2665,63,41,129,161,169,563
New Mexico,South Acomita Village,116,0,0,4,5,0,9
New Mexico,South Valley,41660,315,522,2328,2166,2731,8062
New Mexico,Spencerville,1587,15,8,52,171,99,345
New Mexico,Springer,1051,20,10,42,45,24,141
New Mexico,Sunland Park,15142,327,332,801,1396,1294,4150
New Mexico,Sunshine,307,0,16,0,42,31,89
New Mexico,Tajique,58,0,0,0,0,0,0
New Mexico,Talpa,1014,0,0,0,62,48,110
New Mexico,Taos,5711,106,11,201,216,322,856
New Mexico,Taos Pueblo,1098,23,10,36,57,55,181
New Mexico,Taos Ski Valley village,115,0,0,0,2,0,2
New Mexico,Tatum,751,7,16,73,47,43,186
New Mexico,Tecolote,96,0,0,0,0,0,0
New Mexico,Sombrillo,398,16,2,3,3,8,32
New Mexico,Tecolotito,123,0,0,32,17,16,65
New Mexico,Tesuque Pueblo,243,6,1,12,12,20,51
New Mexico,Texico,1355,17,33,90,81,100,321
New Mexico,Thoreau,1570,18,60,96,132,105,411
New Mexico,Tierra Amarilla,598,0,0,0,34,92,126
New Mexico,Tijeras village,530,2,3,7,23,34,69
New Mexico,Timberon,357,0,23,21,0,0,44
New Mexico,Tohatchi,1004,33,8,68,73,67,249
New Mexico,Tome,1855,0,11,116,70,91,288
New Mexico,Torreon CDP (Sandoval County),368,10,4,18,24,26,82
New Mexico,Torreon CDP (Torrance County),184,0,0,0,0,0,0
New Mexico,Trout Valley,0,0,0,0,0,0,0
New Mexico,Truchas,388,0,0,29,0,1,30
New Mexico,Truth or Consequences,6266,34,27,87,262,247,657
New Mexico,Tesuque,961,4,4,39,10,0,57
New Mexico,Soham,191,0,0,0,0,29,29
New Mexico,Socorro,8843,122,220,666,520,452,1980
New Mexico,Skyline-Ganipa,1232,38,0,112,118,101,369
New Mexico,Hagerman,1112,51,10,93,48,74,276
New Mexico,Hanover,190,0,0,29,51,0,80
New Mexico,Happy Valley,850,0,0,30,134,74,238
New Mexico,Hatch village,1757,48,35,102,109,119,413
New Mexico,Hernandez,937,12,7,51,48,68,186
New Mexico,Highland Meadows,688,0,13,46,55,60,174
New Mexico,High Rolls,558,0,0,0,0,84,84
New Mexico,Hillsboro,110,0,0,0,0,0,0
New Mexico,Hobbs,36191,562,792,2288,2308,2291,8241
New Mexico,Holloman AFB,4112,81,90,241,259,131,802
New Mexico,Homestead,52,0,0,0,0,0,0
New Mexico,Hope village,98,0,0,10,2,0,12
New Mexico,Hot Springs Landing,150,0,0,0,0,0,0
New Mexico,House village,38,0,0,0,0,0,0
New Mexico,Hurley,1275,9,15,48,57,67,196
New Mexico,Indian Hills,1374,0,47,59,68,82,256
New Mexico,Isleta Village Proper,509,18,0,22,12,15,67
New Mexico,Jacona,449,3,0,19,16,18,56
New Mexico,Jaconita,476,2,12,14,36,19,83
New Mexico,Jal,2161,28,14,133,140,121,436
New Mexico,Jemez Pueblo,1969,64,29,113,61,90,357
New Mexico,Jemez Springs village,272,1,0,2,30,4,37
New Mexico,Keeler Farm,1823,0,22,142,212,106,482
New Mexico,Seboyeta,108,0,0,18,18,0,36
New Mexico,Sedillo,851,0,0,29,41,30,100
New Mexico,Sena,157,0,0,0,0,0,0
New Mexico,Sheep Springs,215,0,2,20,15,26,63
New Mexico,Shiprock,8496,276,154,733,508,545,2216
New Mexico,Silver City,10184,115,159,444,596,431,1745
New Mexico,Tse Bonito,207,0,0,0,41,70,111
New Mexico,Hachita,57,0,0,0,0,0,0
New Mexico,Tucumcari,5157,74,62,236,184,284,840
New Mexico,Twin Forks,101,0,0,0,0,0,0
New Mexico,Berino,1775,21,31,206,158,177,593
New Mexico,Bent,123,0,0,0,0,0,0
New Mexico,Belen,7209,109,123,400,460,249,1341
New Mexico,Beclabito,267,6,5,8,11,9,39
New Mexico,Bayard,2490,49,36,157,93,97,432
New Mexico,Aztec,6501,70,260,349,235,380,1294
New Mexico,Atoka,727,0,0,14,13,51,78
New Mexico,Artesia,11641,115,104,785,760,609,2373
New Mexico,Arroyo Seco,888,0,16,19,0,38,73
New Mexico,Arroyo Hondo,334,18,0,0,49,15,82
New Mexico,Arrey,312,0,0,22,30,30,82
New Mexico,Arenas Valley,1524,17,0,63,99,196,375
New Mexico,Aragon,9,0,0,0,0,0,0
New Mexico,Bernalillo,8522,104,136,417,359,376,1392
New Mexico,Apache Creek,21,0,0,0,0,0,0
New Mexico,Anton Chico,39,0,0,0,0,0,0
New Mexico,Anthony,9429,249,158,733,502,644,2286
New Mexico,Animas,167,0,0,0,12,6,18
New Mexico,Angel Fire village,960,0,3,31,11,50,95
New Mexico,Algodones,932,8,22,21,44,86,181
New Mexico,Alcalde,210,4,0,0,8,29,41
New Mexico,Albuquerque,556092,8426,7158,29185,28584,28589,101942
New Mexico,Alamogordo,31198,259,510,1799,1304,1281,5153
New Mexico,Alamo,607,12,15,0,20,28,75
New Mexico,Alamillo,106,0,0,0,0,0,0
New Mexico,Agua Fria,2857,49,169,185,95,257,755
New Mexico,Adelino,841,0,0,0,0,20,20
New Mexico,Acomita Lake,375,2,8,18,25,32,85
New Mexico,Anzac Village,129,0,0,6,24,0,30
New Mexico,Bibo,173,0,0,47,0,0,47
New Mexico,Black Rock,1613,30,32,213,185,98,558
New Mexico,Blanco,200,0,0,25,30,0,55
New Mexico,Twin Lakes,908,10,11,28,40,83,172
New Mexico,Tyrone,545,5,14,26,60,0,105
New Mexico,University Park,3276,22,36,93,15,30,196
New Mexico,Upper Fruitland,1660,30,32,133,84,94,373
New Mexico,Ute Park,100,0,0,0,0,0,0
New Mexico,Vadito,300,7,4,11,7,25,54
New Mexico,Vado,2681,17,8,205,228,156,614
New Mexico,Valencia,2295,26,0,10,130,112,278
New Mexico,Vaughn,437,18,10,11,42,27,108
New Mexico,Veguita,108,0,0,15,30,15,60
New Mexico,Velarde,409,0,0,0,0,0,0
New Mexico,Ventura,183,0,0,0,0,9,9
New Mexico,Villanueva,133,0,11,0,0,0,11
New Mexico,Virden village,172,0,0,4,26,1,31
New Mexico,Wagon Mound village,649,2,9,12,9,7,39
New Mexico,Waterflow,1784,21,34,103,193,83,434
New Mexico,Watrous,0,0,0,0,0,0,0
New Mexico,Weed,46,0,0,0,0,0,0
New Mexico,West Hammond,2867,16,26,115,56,164,377
New Mexico,White Rock,5927,7,28,231,586,533,1385
New Mexico,White Sands,1567,20,21,171,100,16,328
New Mexico,Whites City,164,0,0,0,0,0,0
New Mexico,White Signal,235,0,0,5,13,4,22
New Mexico,Willard village,230,0,0,33,11,15,59
New Mexico,Bosque Farms village,3864,49,21,294,255,111,730
New Mexico,Boles Acres,2053,0,8,88,19,26,141
New Mexico,Bluewater Village,350,0,25,55,15,40,135
New Mexico,Bluewater Acres,347,0,0,0,48,15,63
New Mexico,Bloomfield,7735,111,183,502,265,257,1318
New Mexico,Tularosa village,2914,77,0,57,69,229,432
New Mexico,Santa Teresa,4710,18,90,308,315,270,1001
New Mexico,Corrales village,8455,100,102,267,456,311,1236
New Mexico,Grenville village,28,0,0,3,2,2,7
New Mexico,Grady village,84,2,2,4,1,11,20
New Mexico,Golden,38,0,0,0,7,0,7
New Mexico,Glorieta,549,0,0,13,6,70,89
New Mexico,Glenwood,0,0,0,0,0,0,0
New Mexico,Ensenada,161,0,0,0,0,23,23
New Mexico,Escondida,23,0,0,0,0,0,0
New Mexico,Escudilla Bonita,31,0,0,0,0,0,0
New Mexico,Glen Acres,276,7,19,0,17,5,48
New Mexico,Espa?ola,10168,118,146,629,521,468,1882
New Mexico,Estancia,1804,43,26,64,16,81,230
New Mexico,Grants,9243,183,188,508,388,753,2020
New Mexico,Gila,318,0,7,39,7,0,53
New Mexico,Gallup,22467,697,445,1773,1683,1888,6486
New Mexico,Gallina,268,12,0,0,9,5,26
New Mexico,Galisteo,194,0,0,7,33,15,55
New Mexico,Eunice,3060,13,40,139,256,162,610
New Mexico,Fairacres,1030,0,0,15,0,58,73
New Mexico,Farmington,44865,672,801,3018,2517,2752,9760
New Mexico,Faywood,113,0,0,0,0,0,0
New Mexico,Fence Lake,0,0,0,0,0,0,0
New Mexico,Flora Vista,2040,49,0,18,102,54,223
New Mexico,Floyd village,121,1,4,9,9,7,30
New Mexico,Garfield,50,0,0,0,0,0,0
New Mexico,Folsom village,41,0,0,0,0,6,6
New Mexico,Fort Sumner village,1251,11,12,48,91,80,242
New Mexico,Eldorado at Santa Fe,6486,16,51,222,170,141,600
New Mexico,Edgewood,3773,51,35,257,187,174,704
New Mexico,Edith Endave,328,16,6,36,3,18,79
New Mexico,El Cerro,2965,0,0,133,164,232,529
New Mexico,El Cerro Mission,4547,45,34,249,430,177,935
New Mexico,El Duende,972,0,0,140,165,0,305
New Mexico,Elephant Butte,1393,26,0,54,69,27,176
New Mexico,Elida,190,0,0,14,13,10,37
New Mexico,East Pecos,569,0,0,145,0,0,145
New Mexico,El Rancho,1219,6,7,75,110,61,259
New Mexico,El Valle de Arroyo Seco,1291,13,0,40,100,121,274
New Mexico,Encinal,111,0,0,0,0,0,0
New Mexico,Encino village,36,0,0,0,0,0,0
New Mexico,Seama,366,0,0,19,8,12,39
New Mexico,Sausal,1322,121,0,45,169,42,377
New Mexico,San Ysidro village,177,0,0,9,6,7,22
New Mexico,San Ysidro,2432,43,85,97,110,145,480
New Mexico,El Rito,1051,36,0,112,0,41,189
New Mexico,Eagle Nest village,264,0,0,30,14,23,67
New York,Lake Placid village,2539,121,11,53,143,100,428
New York,Lake Katrine,2322,15,0,50,29,68,162
New York,Lake Mohegan,5663,112,159,239,145,507,1162
New York,Lake Luzerne,1252,10,0,73,48,131,262
New York,Lakeland,2747,9,23,153,101,64,350
New York,Lake Erie Beach,4228,25,41,155,188,210,619
New York,Lake Grove village,11262,212,39,635,694,693,2273
New York,Lake George village,851,11,4,11,0,54,80
New York,Brentwood,61374,851,903,3803,3235,3652,12444
New York,Kennedy,504,10,5,5,11,0,31
New York,Lake Carmel,8294,125,61,379,355,432,1352
New York,La Fargeville,560,19,0,30,50,47,146
New York,Lacona village,682,6,8,30,55,63,162
New York,Lackawanna,18019,353,142,782,818,601,2696
New York,Windsor village,1030,3,40,67,53,64,227
New York,Kysorville,156,0,10,18,3,0,31
New York,Kiryas Joel village,21749,1142,1322,3452,2486,1993,10395
New York,Kingston,23625,521,423,1163,829,1079,4015
New York,Kings Point village,5071,80,68,409,290,305,1152
New York,Kings Park,17823,306,135,976,922,813,3152
New York,Kinderhook village,1389,24,8,40,23,66,161
New York,Keuka Park,875,0,9,0,0,0,9
New York,Kerhonkson,2247,39,55,137,114,139,484
New York,Lake Ronkonkoma,19943,576,268,991,912,1184,3931
New York,Winthrop,371,0,0,0,0,0,0
New York,Keeseville village,1776,26,26,122,107,77,358
New York,Kenmore village,15271,159,194,741,525,614,2233
New York,Kensington village,1113,45,3,53,69,68,238
New York,Lake Success village,3027,61,51,137,146,197,592
New York,Lakeview,6569,86,120,293,371,798,1668
New York,Lakeville,1055,17,0,0,107,18,142
New York,Brighton,36929,597,306,1367,1476,1597,5343
New York,Brightwaters village,3102,69,51,157,193,182,652
New York,Brinckerhoff,2602,15,10,59,97,139,320
New York,Broadalbin village,1550,21,10,101,113,105,350
New York,Brockport village,8428,43,52,118,182,240,635
New York,Brocton village,1518,8,13,61,81,77,240
New York,Bridgewater,612,21,7,41,62,57,188
New York,Bronxville village,6409,199,105,555,545,414,1818
New York,Brookville village,3546,55,44,120,167,183,569
New York,Brownville village,958,3,15,79,81,78,256
New York,Brushton village,578,14,0,29,37,42,122
New York,Buchanan village,2218,48,25,158,85,153,469
New York,Buffalo,259517,3481,3503,13061,12950,14032,47027
New York,Wheatley Heights,5220,76,74,334,285,425,1194
New York,Brookhaven,3138,19,34,113,178,166,510
New York,Bridgeport,1668,34,56,75,31,109,305
New York,Bridgehampton,1274,40,14,18,58,56,186
New York,Briarcliff Manor village,7739,49,22,385,672,438,1566
New York,Breesport,738,24,0,100,19,23,166
New York,Brasher Falls,452,0,0,44,29,11,84
New York,Boonville village,2067,37,14,106,98,103,358
New York,Bolton Landing,416,0,32,23,0,6,61
New York,Bolivar village,1123,29,11,82,66,53,241
New York,Bohemia,9977,65,73,622,523,820,2103
New York,Blue Point,4725,120,22,344,210,211,907
New York,Bloomville,186,0,0,0,3,10,13
New York,Brewster village,2212,20,24,152,46,30,272
New York,Bloomfield village,1550,11,17,146,108,84,366
New York,Blodgett Mills,321,0,0,9,11,12,32
New York,Bliss,613,6,6,41,27,46,126
New York,Blauvelt,5394,122,59,341,295,381,1198
New York,Blasdell village,2579,25,51,111,127,151,465
New York,Brewster Hill,1378,32,0,115,52,14,213
New York,Whitehall village,2769,61,4,184,202,156,607
New York,White Plains,57790,1072,656,2641,2865,2379,9613
New York,Whitesboro village,3731,25,67,197,100,154,543
New York,Whitney Point village,1004,15,17,49,58,96,235
New York,Liberty village,4241,90,58,265,175,153,741
New York,Lewiston village,2598,55,8,199,125,128,515
New York,Levittown,51593,775,443,2444,2725,2996,9383
New York,Le Roy village,4333,73,59,287,234,259,912
New York,Leicester village,444,3,6,13,25,30,77
New York,Leeds,480,0,10,38,36,7,91
New York,Lawrence village,6529,121,141,354,417,646,1679
New York,Laurens village,233,4,0,8,16,4,32
New York,Laurel Hollow village,1835,52,30,125,150,134,491
New York,Laurel,1250,0,0,23,39,164,226
New York,Lattingtown village,1542,18,14,84,110,100,326
New York,Larchmont village,6005,257,119,491,412,252,1531
New York,Lansing village,3629,60,37,179,103,125,504
New York,Lancaster village,10300,185,210,384,625,399,1803
New York,Lakewood village,2951,21,20,74,205,150,470
New York,Lido Beach,2600,37,24,71,166,140,438
New York,Brewerton,4414,60,15,172,210,190,647
New York,Lima village,2433,21,43,192,111,76,443
New York,Limestone,330,9,0,7,39,28,83
New York,Williamson,2324,35,17,77,50,116,295
New York,Williamsville village,5269,43,14,150,229,219,655
New York,Williston Park village,7322,115,101,407,406,518,1547
New York,Willsboro,891,0,14,42,27,39,122
New York,Wilmington,1055,27,3,69,37,69,205
New York,Wilson village,1163,11,16,58,66,53,204
New York,Windham,312,0,0,0,4,4,8
New York,Liverpool village,2230,19,7,42,67,132,267
New York,Little Valley village,1276,26,15,99,94,61,295
New York,Little Falls,4878,70,9,163,271,219,732
New York,Lisle village,257,0,6,8,13,8,35
New York,Linwood,64,0,0,0,23,0,23
New York,Lindenhurst village,27310,474,201,1171,1111,1493,4450
New York,Lincoln Park,2082,13,0,123,63,69,268
New York,Lincolndale,1537,55,44,118,70,102,389
New York,Lime Lake,661,18,0,13,58,37,126
New York,Bloomingburg village,471,5,0,19,26,42,92
New York,Chatham village,1381,4,9,74,30,62,179
New York,Woodbury village,10873,225,224,579,528,844,2400
New York,Canandaigua,10499,106,99,598,489,447,1739
New York,Canaseraga village,600,8,2,43,44,52,149
New York,Canastota village,4707,102,90,291,205,208,896
New York,Candor village,677,21,14,38,43,20,136
New York,Canisteo village,2298,21,42,113,170,217,563
New York,Canton village,6665,64,49,182,110,140,545
New York,Cape Vincent village,645,11,0,17,53,49,130
New York,Carle Place,5152,53,46,219,296,289,903
New York,Carmel Hamlet,6542,94,114,435,487,326,1456
New York,Caroga Lake,496,1,7,8,4,17,37
New York,Carthage village,3682,76,105,277,253,116,827
New York,Cassadaga village,709,10,5,47,38,66,166
New York,Castile village,922,18,3,26,43,53,143
New York,Castleton-on-Hudson village,1322,35,23,52,70,56,236
New York,Castorland village,376,11,7,47,17,24,106
New York,Cato village,655,8,19,34,48,64,173
New York,Catskill village,3952,179,50,153,252,137,771
New York,Cattaraugus village,1035,6,3,50,43,45,147
New York,Cayuga village,545,6,0,11,15,43,75
New York,Cayuga Heights village,3789,23,35,101,81,115,355
New York,Cazenovia village,2815,5,10,42,83,124,264
New York,Cedarhurst village,6655,111,109,301,413,442,1376
New York,Celoron village,1183,2,34,25,60,32,153
New York,Centereach,32649,491,332,1468,1594,2124,6009
New York,Center Moriches,8418,30,200,613,428,531,1802
New York,Centerport,5447,123,47,267,350,422,1209
New York,Central Bridge,282,0,0,0,29,15,44
New York,Canajoharie village,2195,54,27,134,138,121,474
New York,Campbell,630,0,34,44,0,39,117
New York,Camillus village,1242,4,19,45,59,92,219
New York,Camden village,2491,15,50,157,119,193,534
New York,Jamestown West,2267,0,35,63,72,122,292
New York,Jefferson Heights,1116,18,0,9,15,205,247
New York,Jefferson Valley-Yorktown,14923,316,124,607,882,1248,3177
New York,Jeffersonville village,387,0,7,23,14,6,50
New York,Jericho,13746,312,161,676,717,965,2831
New York,Johnson City village,14903,331,122,677,609,803,2542
New York,Johnstown,8500,107,23,397,424,324,1275
New York,Jordan village,1495,8,15,69,91,88,271
New York,Kaser village,4998,244,243,677,508,560,2232
New York,Katonah,2196,47,0,118,223,224,612
New York,Clarkson,4325,115,75,415,209,150,964
New York,Clark Mills,2139,39,22,68,145,0,274
New York,Clarence Center,2151,38,30,127,196,203,594
New York,Central Islip,34960,586,558,1747,1849,2213,6953
New York,Clarence,3164,28,29,146,219,205,627
New York,Chittenango village,4992,26,125,276,211,420,1058
New York,Chestnut Ridge village,8090,135,206,376,477,376,1570
New York,Wolcott village,1723,13,34,98,124,113,382
New York,Burdett village,364,8,2,3,15,22,50
New York,Burke village,169,0,1,14,15,9,39
New York,Busti,477,21,0,23,16,7,67
New York,Byersville,131,0,0,11,34,5,50
New York,Cairo,1325,0,24,9,71,32,136
New York,Calcium,4102,46,79,284,143,111,663
New York,Caledonia village,2137,27,19,80,102,127,355
New York,Callicoon,172,0,8,8,0,14,30
New York,Calverton,6380,22,33,220,78,245,598
New York,Cambridge village,1715,28,42,80,87,58,295
New York,Churchville village,1981,60,29,56,103,113,361
New York,Central Square village,1945,28,16,73,115,119,351
New York,Centre Island village,454,0,8,28,30,26,92
New York,Chadwicks,1757,21,0,141,163,95,420
New York,Belfast,907,16,24,74,62,34,210
New York,Bellerose village,1132,32,4,54,70,97,257
New York,Bellerose Terrace,2004,53,39,120,72,80,364
New York,Belle Terre village,783,11,12,61,59,51,194
New York,Belleville,474,33,0,43,101,56,233
New York,Bellmore,15871,231,162,791,890,832,2906
New York,Bellport village,2059,32,5,121,52,45,255
New York,Belmont village,1010,19,5,69,47,49,189
New York,Bemus Point village,192,2,5,10,7,7,31
New York,Bergen village,1312,15,55,64,86,93,313
New York,Bethpage,16315,148,62,903,699,869,2681
New York,Big Flats,5303,38,73,177,337,194,819
New York,Billington Heights,1653,11,0,141,52,22,226
New York,Bedford Hills,3271,79,56,262,166,291,854
New York,Binghamton,46495,481,437,2053,1859,1844,6674
New York,Black River village,1381,17,21,124,94,76,332
New York,Yonkers,199435,2672,2557,9259,9334,9686,33508
New York,Yaphank,5958,65,82,177,279,333,936
New York,Wyoming village,381,2,7,17,20,41,87
New York,Wynantskill,3036,43,31,85,113,143,415
New York,Wyandanch,11558,197,150,619,740,619,2325
New York,Wurtsboro village,1131,22,21,20,24,22,109
New York,Worcester,973,5,0,13,42,60,120
New York,Woodsville,62,0,0,0,0,3,3
New York,Woodstock,1766,29,0,42,0,24,95
New York,Woodsburgh village,740,15,17,40,53,45,170
New York,Woodridge village,732,4,3,34,31,40,112
New York,Woodmere,17217,487,294,1316,1126,1492,4715
New York,Binghamton University,6084,0,0,0,0,0,0
New York,Woodbury,8473,192,91,174,393,480,1330
New York,Bedford,2044,46,44,164,216,92,562
New York,Beacon,14375,316,143,533,510,873,2375
New York,Champlain village,1139,14,24,81,76,74,269
New York,Chappaqua,1287,8,12,94,16,60,190
New York,Chateaugay village,626,2,2,27,30,30,91
New York,Chaumont village,796,12,16,45,10,17,100
New York,Chautauqua,594,0,0,21,7,4,32
New York,Chazy,448,0,19,8,29,46,102
New York,Cheektowaga,74905,805,745,2353,3128,3545,10576
New York,Chenango Bridge,2795,35,0,181,90,122,428
New York,Cherry Creek village,447,2,5,18,49,25,99
New York,Cherry Valley village,562,5,0,26,20,21,72
New York,Chester village,3928,45,13,19,306,283,666
New York,Chestertown,764,11,0,55,73,70,209
New York,Zena,1385,55,8,99,45,93,300
New York,Beaver Dam Lake,1780,16,30,30,158,148,382
New York,Youngstown village,1967,17,30,72,109,171,399
New York,Yorktown Heights,1964,12,27,239,149,37,464
New York,Yorkshire,1093,6,27,6,25,81,145
New York,York Hamlet,459,0,0,44,31,0,75
New York,Barneveld village,221,0,4,14,7,4,29
New York,Barnum Island,2226,98,6,104,85,42,335
New York,Batavia,15188,233,173,766,566,555,2293
New York,Bath village,5720,81,83,306,257,181,908
New York,Baxter Estates village,816,10,14,54,30,46,154
New York,Bay Park,1856,21,0,128,109,162,420
New York,Bayport,8305,150,56,300,543,583,1632
New York,Bay Shore,29670,428,465,1458,1356,1852,5559
New York,Bayville village,6724,120,32,212,382,351,1097
New York,Baywood,7249,105,73,398,495,428,1499
New York,Yorkville village,2642,44,10,129,84,52,319
New York,Witherbee,333,0,0,52,0,35,87
New York,South Glens Falls village,3586,51,23,192,121,138,525
New York,West Valley,468,0,6,42,27,17,92
New York,Millerton village,866,15,10,23,38,52,138
New York,Miller Place,11312,207,61,895,924,761,2848
New York,Millbrook village,1542,41,9,74,42,103,269
New York,Milford village,396,7,3,10,23,11,54
New York,Middleville village,533,1,13,16,61,29,120
New York,Middletown,27828,489,481,1682,1516,1870,6038
New York,Mill Neck village,994,6,3,31,44,74,158
New York,Middleport village,1788,20,53,60,92,110,335
New York,Middleburgh village,1448,21,8,48,18,99,194
New York,Rodman,215,0,3,25,16,9,53
New York,Rome,32916,538,389,1557,1003,1689,5176
New York,Romulus,524,8,7,17,39,45,116
New York,Ronkonkoma,18634,218,202,887,955,1158,3420
New York,Roosevelt,16645,297,337,916,985,972,3507
New York,Middle Island,9949,139,111,323,507,433,1513
New York,Roscoe,564,0,18,6,43,32,99
New York,Millport village,355,5,0,8,29,22,64
New York,Milton CDP (Ulster County),1521,8,8,4,42,134,196
New York,Mooers,293,0,0,19,0,23,42
New York,Montrose,2659,40,2,107,217,106,472
New York,Montour Falls village,1821,39,35,77,102,65,318
New York,Monticello village,6685,22,58,459,263,284,1086
New York,Montgomery village,4311,168,55,237,174,151,785
New York,Montebello village,4616,115,241,105,223,327,1011
New York,Milton CDP (Saratoga County),3536,79,14,115,216,225,649
New York,Montauk,3495,54,0,57,65,143,319
New York,Monroe village,8532,261,102,554,530,434,1881
New York,Mohawk village,2571,10,58,142,63,116,389
New York,Minoa village,3514,99,55,261,135,59,609
New York,Mineville,1273,34,8,22,9,90,163
New York,Minetto,933,5,11,54,49,51,170
New York,Mineola village,18980,301,184,693,749,1130,3057
New York,Monsey,21001,1017,659,2681,2112,2391,8860
New York,Moravia village,1521,2,39,46,83,87,257
New York,Rosendale Hamlet,1453,34,36,130,20,0,220
New York,Roslyn Estates village,1159,17,39,65,112,71,304
New York,St. Regis Falls,383,8,0,13,9,31,61
New York,Salamanca,5686,107,166,362,305,350,1290
New York,Salem village,698,12,9,36,17,41,115
New York,Salisbury,12467,142,118,647,380,716,2003
New York,Salisbury Mills,308,0,0,9,10,40,59
New York,Saltaire village,46,0,0,3,4,4,11
New York,St. Johnsville village,1789,12,32,94,94,117,349
New York,Salt Point,195,0,0,0,28,20,48
New York,Sand Ridge,663,0,0,0,0,8,8
New York,Sands Point village,2715,63,60,72,186,192,573
New York,Sandy Creek village,875,13,31,57,33,65,199
New York,Saranac Lake village,5727,38,52,239,316,309,954
New York,Saratoga Springs,27244,500,270,984,999,873,3626
New York,Saugerties village,3940,8,86,120,102,297,613
New York,Sanborn,1361,71,0,59,50,41,221
New York,Roslyn village,2779,23,27,90,171,108,419
New York,St. James,13536,295,25,606,789,951,2666
New York,Sag Harbor village,2075,16,59,37,34,63,209
New York,Roslyn Harbor village,952,32,16,47,40,57,192
New York,Roslyn Heights,6969,154,74,352,366,662,1608
New York,Rotterdam,20949,188,192,922,1091,1225,3618
New York,Round Lake village,693,0,7,39,21,15,82
New York,Rouses Point village,2126,14,18,84,102,130,348
New York,Rushford,327,12,0,31,14,14,71
New York,St. Bonaventure,2052,0,0,12,34,30,76
New York,Rushville village,679,8,2,37,45,24,116
New York,Rye,15944,502,256,1274,1360,1049,4441
New York,Rye Brook village,9510,245,160,532,510,698,2145
New York,Sackets Harbor village,1495,13,19,46,90,83,251
New York,Saddle Rock village,904,31,8,74,36,66,215
New York,Saddle Rock Estates,343,7,7,8,12,26,60
New York,Sagaponack village,208,0,0,8,20,15,43
New York,Russell Gardens village,878,16,10,64,42,57,189
New York,Saugerties South,2119,20,17,68,114,137,356
New York,Moriches,2703,46,46,6,75,193,366
New York,Morrisonville,1444,20,41,132,26,28,247
New York,Rhinebeck village,2629,12,34,132,119,141,438
New York,Rhinecliff,290,0,0,5,52,5,62
New York,Richburg village,615,26,12,43,55,48,184
New York,Richfield Springs village,1229,10,38,55,31,42,176
New York,Richmondville village,918,3,4,92,68,48,215
New York,Richville village,363,13,4,24,22,16,79
New York,Retsof,214,0,0,19,10,20,49
New York,Ridge,12835,67,181,357,648,613,1866
New York,Ripley,966,17,0,60,43,65,185
New York,Riverhead,14258,156,210,755,771,635,2527
New York,Riverside village,589,16,27,35,51,28,157
New York,Riverside,4912,64,26,34,7,0,131
New York,Rochester,210745,3624,3206,11321,11577,10803,40531
New York,Rock Hill,1497,31,7,59,77,65,239
New York,Rifton,609,22,31,83,0,0,136
New York,Rockville Centre village,24155,572,279,996,1554,1546,4947
New York,Rensselaer Falls village,403,14,7,39,25,8,93
New York,Remsenburg-Speonk,1867,0,26,52,112,139,329
New York,Pultneyville,458,10,13,51,25,14,113
New York,Putnam Lake,3877,33,41,163,136,328,701
New York,Quiogue,640,10,0,0,15,12,37
New York,Quogue village,854,22,0,9,50,42,123
New York,Randolph,1179,16,26,66,73,72,253
New York,Ransomville,1668,17,8,55,64,179,323
New York,Rensselaer,9502,244,177,378,407,393,1599
New York,Rapids,1653,0,46,71,14,75,206
New York,Red Creek village,646,27,8,69,66,71,241
New York,Redford,528,0,0,13,106,40,159
New York,Red Hook village,1715,29,13,73,136,62,313
New York,Red Oaks Mill,3671,42,48,195,165,181,631
New York,Redwood,584,7,8,32,22,57,126
New York,Remsen village,506,6,6,25,23,24,84
New York,Ravena village,3289,61,20,76,168,171,496
New York,Morris village,396,6,0,6,19,22,53
New York,Rocky Point,13593,194,291,763,798,952,2998
New York,New Hartford village,1813,11,25,83,113,138,370
New York,Nanuet,18678,332,158,1159,696,805,3150
New York,Myers Corner,6867,76,47,362,416,386,1287
New York,Muttontown village,3626,15,16,131,175,348,685
New York,Munsons Corners,2387,49,65,127,59,27,327
New York,Munsey Park village,2715,89,35,259,184,231,798
New York,Munnsville village,498,4,4,34,26,37,105
New York,Napanoch,1096,0,15,99,50,68,232
New York,Mount Vernon,68221,1404,750,3252,3308,3541,12255
New York,Mount Morris village,2505,20,40,134,161,114,469
New York,Mount Kisco village,11060,166,106,454,455,892,2073
New York,Mount Ivy,7090,105,41,402,503,365,1416
New York,Mountain Lodge Park,1639,0,76,110,30,88,304
New York,Morrisville village,1938,0,3,16,28,22,69
New York,Morristown village,431,7,1,18,10,35,71
New York,Mount Sinai,12451,441,185,626,750,767,2769
New York,New Hempstead village,5265,150,123,362,458,442,1535
New York,Napeague,211,0,10,0,0,0,10
New York,Narrowsburg,382,4,0,6,15,15,40
New York,Newfield Hamlet,699,0,0,0,28,42,70
New York,Newfane,3769,37,100,168,256,144,705
New York,New City,33722,468,468,1700,1623,2149,6408
New York,New Cassel,13903,135,275,879,793,1073,3155
New York,Newburgh,28495,535,717,2202,2341,1836,7631
New York,New Berlin village,1170,13,28,42,50,47,180
New York,Naples village,990,13,1,38,43,51,146
New York,Newark Valley village,1188,17,11,35,89,117,269
New York,Nesconset,13876,173,207,665,945,1034,3024
New York,Nelsonville village,805,6,38,47,71,58,220
New York,Nelliston village,535,9,2,22,18,26,77
New York,Nedrow,2176,11,25,92,80,103,311
New York,Natural Bridge,776,0,0,139,113,0,252
New York,Nassau village,1077,7,19,33,55,65,179
New York,Newark village,8965,165,59,401,360,462,1447
New York,Savannah,405,6,0,6,38,44,94
New York,Savona village,809,11,6,54,23,36,130
New York,Sayville,16621,299,166,901,1026,872,3264
New York,Elmira Heights village,3945,32,72,119,233,185,641
New York,Elmira,28817,404,403,1446,1545,1713,5511
New York,Elma Center,2639,0,52,58,72,157,339
New York,Sharon Springs village,614,9,16,6,23,37,91
New York,Shelter Island,1313,21,0,49,115,87,272
New York,Shelter Island Heights,1493,0,20,58,89,158,325
New York,Elmont,37388,290,451,1871,1736,2147,6495
New York,Shenorock,1874,56,8,127,153,120,464
New York,Sherman village,681,0,12,31,44,51,138
New York,Sherrill,3073,10,20,117,181,172,500
New York,Shinnecock Hills,2152,30,57,28,52,128,295
New York,Shirley,25691,494,526,1080,1199,1394,4693
New York,Shokan,1111,24,0,0,8,103,135
New York,Shoreham village,432,11,0,10,9,15,45
New York,Sherburne village,1359,31,26,62,24,51,194
New York,Shortsville village,1385,17,11,56,54,74,212
New York,Elmsford village,4765,29,106,145,228,335,843
New York,Endicott village,13143,170,208,524,590,687,2179
New York,Hyde Park,2192,49,0,78,180,156,463
New York,Ilion village,8066,109,115,466,395,454,1539
New York,Interlaken village,703,6,7,30,41,32,116
New York,Inwood,10052,311,212,650,454,655,2282
New York,Irondequoit,51337,543,661,1992,2521,2332,8049
New York,Irvington village,6540,181,80,327,533,469,1590
New York,Elwood,10941,198,128,631,648,719,2324
New York,Islandia village,3370,11,50,162,193,192,608
New York,Islip,18433,399,149,640,849,1426,3463
New York,West Winfield village,820,21,2,39,29,26,117
New York,Ithaca,30565,254,118,740,431,487,2030
New York,Jamesport,1355,67,0,0,52,110,229
New York,Jamestown,30546,585,401,1721,1546,1567,5820
New York,Endwell,11445,124,154,555,608,710,2151
New York,Island Park village,4694,16,54,208,108,181,567
New York,Hurley,3452,43,41,220,128,141,573
New York,Shrub Oak,1997,23,0,10,140,36,209
New York,Silver Creek village,2598,36,56,152,119,123,486
New York,South Fallsburg,3571,40,82,258,277,245,902
New York,South Farmingdale,15130,239,196,858,732,936,2961
New York,South Floral Park village,2058,52,46,84,97,111,390
New York,Ellisburg village,256,2,6,30,9,17,64
New York,South Hempstead,3152,62,21,143,162,263,651
New York,South Hill,6501,45,0,56,118,107,326
New York,South Dayton village,756,7,1,68,53,58,187
New York,South Huntington,9724,212,43,277,526,436,1494
New York,South Lockport,7788,111,40,495,453,339,1438
New York,South Nyack village,3549,102,12,148,123,112,497
New York,Southold,6295,73,0,324,125,322,844
New York,Southport,7001,48,53,158,439,329,1027
New York,South Valley Stream,6588,148,55,253,218,453,1127
New York,Spackenkill,4122,93,17,167,237,294,808
New York,South Lima,252,0,0,18,8,0,26
New York,Sidney village,4146,76,17,349,187,206,835
New York,South Corning village,1060,8,16,41,31,23,119
New York,Southampton village,3193,31,28,103,118,136,416
New York,Silver Springs village,951,3,28,48,75,63,217
New York,Sinclairville village,644,19,9,65,44,42,179
New York,Skaneateles village,2553,23,11,200,180,104,518
New York,Sleepy Hollow village,10074,230,82,543,623,651,2129
New York,Sloan village,3624,23,29,118,174,142,486
New York,Sloatsburg village,3106,25,45,202,139,285,696
New York,South Blooming Grove village,3214,39,53,177,169,189,627
New York,Smallwood,269,0,0,0,13,0,13
New York,Smithville Flats,480,0,5,16,52,64,137
New York,Smyrna village,236,0,2,17,8,29,56
New York,Sodus village,2374,29,51,126,158,186,550
New York,Sodus Point village,981,2,26,17,37,53,135
New York,Solvay village,6490,83,98,182,255,283,901
New York,Sound Beach,8071,385,64,479,324,471,1723
New York,Smithtown,25974,618,222,1469,1215,1778,5302
New York,Huntington Station,34088,777,622,1910,2098,2033,7440
New York,Huntington Bay village,1509,18,25,55,93,75,266
New York,Huntington,17917,203,303,731,873,1074,3184
New York,Seneca Knolls,2393,0,20,164,98,93,375
New York,Setauket-East Setauket,14346,300,100,891,796,896,2983
New York,Hartwick,577,10,4,34,14,30,92
New York,Hastings-on-Hudson village,7951,83,64,451,492,738,1828
New York,Hauppauge,20616,479,156,954,1012,1313,3914
New York,Haverstraw village,12094,238,163,691,607,765,2464
New York,Seneca Falls,6493,110,85,296,281,316,1088
New York,Haviland,3470,18,101,87,127,204,537
New York,Head of the Harbor village,1330,16,24,56,68,113,277
New York,Hemlock,401,12,0,0,56,9,77
New York,Hempstead village,55105,995,719,3109,2431,2600,9854
New York,Henderson,170,3,0,11,5,8,27
New York,Heritage Hills,4024,54,0,45,92,35,226
New York,Herkimer village,7731,122,40,232,357,214,965
New York,Hawthorne,4583,94,71,204,244,324,937
New York,Hermon village,404,16,5,25,24,19,89
New York,Selden,20123,360,194,839,1197,1214,3804
New York,Seaford,15656,388,145,817,856,780,2986
New York,Scarsdale village,17621,444,446,1372,1400,1475,5137
New York,Schaghticoke village,564,9,11,21,23,30,94
New York,Schenectady,65735,809,697,3083,3465,3119,11173
New York,Schenevus,537,0,10,14,9,30,63
New York,Schoharie village,859,22,3,12,27,24,88
New York,Schroon Lake,474,6,10,10,2,6,34
New York,Searingtown,4765,72,64,223,203,310,872
New York,Schuylerville village,1621,32,16,110,90,78,326
New York,Scotchtown,9061,105,66,487,431,626,1715
New York,Scotia village,7744,183,192,543,386,209,1513
New York,Scottsburg,116,4,0,3,0,2,9
New York,Scotts Corners,563,0,0,8,25,27,60
New York,Scottsville village,2616,44,59,189,156,172,620
New York,Sea Cliff village,5025,116,35,203,189,404,947
New York,Scio,508,0,0,18,26,40,84
New York,Herricks,4370,95,93,219,168,239,814
New York,Herrings village,78,3,0,1,5,5,14
New York,Heuvelton village,798,14,8,46,30,60,158
New York,Homer village,3224,64,87,261,178,132,722
New York,Honeoye,655,0,24,28,0,0,52
New York,Honeoye Falls village,2720,14,42,168,189,212,625
New York,Hoosick Falls village,3453,34,9,141,191,359,734
New York,Hopewell Junction,362,0,9,9,6,33,57
New York,Hornell,8471,108,144,387,436,557,1632
New York,Holtsville,20081,221,211,923,1356,1222,3933
New York,Horseheads village,6594,62,94,267,288,301,1012
New York,Hortonville,235,0,0,0,10,0,10
New York,Houghton,1747,27,0,47,21,42,137
New York,Hudson,6572,55,95,300,387,173,1010
New York,Hudson Falls village,7239,152,155,440,304,310,1361
New York,Hunt,44,0,0,2,4,0,6
New York,Hunter village,320,0,0,0,0,14,14
New York,Horseheads North,2755,49,35,57,97,91,329
New York,Holley village,2032,36,35,86,102,135,394
New York,Holland Patent village,373,0,5,14,21,29,69
New York,Holland,1236,0,19,116,65,50,250
New York,Hewlett,6032,95,31,358,347,223,1054
New York,Hewlett Bay Park village,354,5,3,7,21,25,61
New York,Hewlett Harbor village,1229,7,5,37,120,126,295
New York,Hewlett Neck village,352,6,2,20,38,38,104
New York,Hicksville,42333,515,233,1839,1811,2421,6819
New York,High Falls,905,2,8,54,1,55,120
New York,Highland,5189,159,45,245,284,146,879
New York,Highland Falls village,3856,0,31,141,110,184,466
New York,Hillburn village,872,8,10,63,56,40,177
New York,Hillcrest,7317,129,145,176,297,305,1052
New York,Hillside,855,8,0,66,32,62,168
New York,Hillside Lake,1070,0,0,66,23,91,180
New York,Hilton village,5936,140,74,426,335,472,1447
New York,Hobart village,481,9,8,21,7,14,59
New York,Holbrook,27533,475,295,1326,1823,1471,5390
New York,Pulaski village,2214,73,44,91,118,78,404
New York,Sparkill,1523,10,51,123,134,72,390
New York,Prospect village,214,7,0,13,12,6,38
New York,Prattsville,263,0,0,5,30,0,35
New York,Groton village,2536,41,38,119,108,133,439
New York,Greigsville,296,9,0,0,0,32,41
New York,Greenwood Lake village,3118,106,36,116,62,88,408
New York,Greenwich village,1885,15,34,126,89,106,370
New York,Greenville CDP (Westchester County),7543,123,112,681,574,566,2056
New York,Greenville CDP (Greene County),505,0,0,17,9,10,36
New York,Groveland Station,283,6,0,31,0,27,64
New York,Greenvale,1003,0,0,33,5,131,169
New York,Greenport village,2234,13,64,62,70,116,325
New York,Greenlawn,14481,156,133,815,1061,998,3163
New York,Green Island village,2629,58,9,136,108,92,403
New York,Greene village,1592,15,11,97,77,111,311
New York,Greece,14568,240,89,662,795,499,2285
New York,Great River,1561,49,14,101,135,91,390
New York,Greenport West,2002,0,0,59,67,96,222
New York,Great Neck Plaza village,6879,138,50,156,170,133,647
New York,Guilford,339,9,10,20,0,0,39
New York,Hagaman village,1414,33,0,28,33,54,148
New York,Harbor Hills,545,9,0,34,9,54,106
New York,Hannibal village,604,3,0,33,50,25,111
New York,Hannawa Falls,925,17,6,41,38,54,156
New York,Hancock village,946,21,7,36,19,50,133
New York,Hampton Manor,2104,61,11,84,69,109,334
New York,Hampton Bays,12866,110,66,737,537,558,2008
New York,Hadley,846,0,13,17,55,26,111
New York,Hammondsport village,592,0,6,19,19,38,82
New York,Hamlin,5587,51,155,348,356,324,1234
New York,Hamilton village,4064,36,19,87,50,62,254
New York,Hamburg village,9521,248,79,495,450,538,1810
New York,Hall,152,0,0,0,0,14,14
New York,Halesite,2810,63,22,95,169,84,433
New York,Hailesboro,686,5,9,13,30,39,96
New York,Hammond village,342,11,10,35,25,10,91
New York,Harbor Isle,1529,25,30,82,87,86,310
New York,Great Neck Gardens,1166,66,13,104,49,57,289
New York,Great Neck village,10095,341,142,663,712,505,2363
New York,Glasco,2464,8,8,130,174,187,507
New York,Gilgo,208,0,0,0,0,26,26
New York,Gilbertsville village,361,3,3,6,17,31,60
New York,Ghent,438,27,20,17,9,23,96
New York,Old Field village,858,13,4,35,46,62,160
New York,Old Brookville village,2307,35,31,109,174,183,532
New York,Glen Aubrey,308,4,4,14,14,19,55
New York,Old Bethpage,5252,72,46,225,400,227,970
New York,Ogdensburg,10996,194,107,666,473,567,2007
New York,Odessa village,661,13,11,17,24,30,95
New York,Oceanside,30371,566,253,1444,1125,1686,5074
New York,Ocean Beach village,32,0,0,0,0,0,0
New York,Oakfield village,1767,32,28,81,81,116,338
New York,Oakdale,7336,133,101,355,372,330,1291
New York,Olcott,1096,0,16,23,39,99,177
New York,Great Neck Estates village,2809,109,55,230,134,229,757
New York,Glen Cove,27245,351,353,1069,1173,1015,3961
New York,Glen Park village,577,19,15,39,30,26,129
New York,Great Bend,854,20,24,42,19,11,116
New York,Granville village,2321,35,50,129,159,89,462
New York,Grandyle Village,4812,81,58,239,279,285,942
New York,Grand View-on-Hudson village,295,7,0,14,11,16,48
New York,Gowanda village,2656,26,58,173,114,128,499
New York,Gouverneur village,3882,0,23,166,230,289,708
New York,Glen Head,4620,85,55,194,335,222,891
New York,Goshen village,5394,58,62,246,261,403,1030
New York,Gordon Heights,3866,15,100,230,353,304,1002
New York,Golden's Bridge,1694,33,18,164,110,144,469
New York,Gloversville,15293,382,196,799,756,762,2895
New York,Glenwood Landing,3767,34,21,124,371,146,696
New York,Glens Falls North,8494,107,103,431,423,341,1405
New York,Glens Falls,14496,139,193,528,603,653,2116
New York,Gorham,601,0,0,39,0,56,95
New York,Oak Beach-Captree,134,0,0,0,0,0,0
New York,Harriman village,2704,59,51,200,148,76,534
New York,Harrison village,27998,258,191,1447,1778,1654,5328
New York,Philadelphia village,1113,21,29,75,48,40,213
New York,Phelps village,1983,32,63,74,80,85,334
New York,Peru,1300,0,18,59,38,146,261
New York,Perrysburg,325,4,1,25,5,3,38
New York,Perry village,3462,32,42,197,209,211,691
New York,Penn Yan village,4815,94,41,257,273,299,964
New York,Philmont village,1373,0,15,131,62,72,280
New York,Pelham Manor village,5567,79,91,356,454,456,1436
New York,Peekskill,23928,502,258,1093,854,1071,3778
New York,Peconic,526,0,0,0,12,0,12
New York,Pearl River,16383,258,120,915,773,853,2919
New York,Peach Lake,1428,10,37,96,104,59,306
New York,Pawling village,2243,29,41,83,82,183,418
New York,Pavilion,549,0,12,42,28,23,105
New York,Pelham village,6993,262,51,490,389,466,1658
New York,Paul Smiths,667,0,0,0,0,0,0
New York,Phoenicia,215,5,0,5,0,0,10
New York,Piermont village,2557,10,0,41,135,135,321
New York,Plattekill,1240,0,23,103,9,130,265
New York,Plandome Manor village,813,22,16,42,65,68,213
New York,Plandome Heights village,988,30,20,36,63,119,268
New York,Plandome village,1278,50,10,78,90,131,359
New York,Plainview,26199,584,306,1627,1451,1391,5359
New York,Plainedge,9343,105,96,531,459,514,1705
New York,Phoenix village,2496,36,0,150,171,107,464
New York,Pittsford village,1516,29,11,102,57,68,267
New York,Pine Plains,1575,48,12,105,72,105,342
New York,Pine Hill,172,0,0,0,5,0,5
New York,Pine Bush,1514,7,21,60,38,49,175
New York,Pike,233,16,0,9,0,8,33
New York,Piffard,260,0,0,0,57,0,57
New York,Pierrepont Manor,143,0,0,0,0,0,0
New York,Pine Valley,774,0,7,11,13,34,65
New York,Harris Hill,5499,67,31,246,350,299,993
New York,Patchogue village,12173,135,136,761,481,491,2004
New York,Parish village,489,18,13,24,14,21,90
New York,Oriskany village,1280,7,22,63,53,58,203
New York,Orient,706,4,0,9,8,30,51
New York,Orchard Park village,3229,28,13,193,183,258,675
New York,Orange Lake,6718,52,32,201,346,383,1014
New York,Orangeburg,4442,26,37,126,199,208,596
New York,Ontario,2190,27,55,98,99,47,326
New York,Oriskany Falls village,857,9,7,74,67,29,186
New York,Oneonta,13862,165,43,292,363,418,1281
New York,Oneida,11252,209,130,540,515,537,1931
New York,Olean,14099,135,148,680,735,822,2520
New York,Old Westbury village,4418,29,44,79,280,242,674
New York,Old Forge,441,0,0,0,0,11,11
New York,Hartsdale,5146,139,38,150,156,226,709
New York,Harrisville village,590,7,6,32,46,36,127
New York,Oneida Castle village,689,11,8,52,32,21,124
New York,Parishville,832,0,33,49,76,15,173
New York,Ossining village,25311,401,432,1292,1236,1392,4753
New York,Otego village,1152,16,4,57,71,53,201
New York,Parc,206,0,0,0,0,0,0
New York,Panama village,503,5,14,31,36,34,120
New York,Pamelia Center,404,0,0,18,9,5,32
New York,Palmyra village,3446,82,89,77,172,87,507
New York,Palenville,760,0,0,11,43,62,116
New York,Palatine Bridge village,814,0,0,32,55,51,138
New York,Oswego,17988,317,160,904,651,755,2787
New York,Painted Post village,1689,28,13,96,106,58,301
New York,Oyster Bay,6562,157,136,251,360,535,1439
New York,Oxford village,1370,17,3,50,87,104,261
New York,Oxbow,96,0,0,6,6,2,14
New York,Owego village,3807,0,49,169,98,243,559
New York,Ovid village,602,10,16,30,20,25,101
New York,Otisville village,1110,12,10,74,78,62,236
New York,Oyster Bay Cove village,2190,21,21,110,157,149,458
New York,Nyack village,6769,133,38,331,263,267,1032
New York,Nunda village,1422,26,11,57,85,78,257
New York,Noyack,3970,73,89,163,234,178,737
New York,Fleischmanns village,386,11,2,20,23,41,97
New York,Flanders,4906,98,50,329,427,173,1077
New York,Fishkill village,2001,37,0,113,102,124,376
New York,Fishers Landing,70,0,0,0,0,0,0
New York,Fishers Island,339,0,0,32,10,5,47
New York,Firthcliffe,4681,32,112,247,202,369,962
New York,Floral Park village,16093,325,192,822,817,688,2844
New York,Fire Island,298,13,6,10,7,8,44
New York,Felts Mills,257,6,5,16,0,0,27
New York,Fayetteville village,4203,47,95,162,288,238,830
New York,Farnham village,405,6,5,12,9,24,56
New York,Farmingville,15690,318,251,897,905,916,3287
New York,Farmingdale village,8399,156,37,432,309,389,1323
New York,Falconer village,2573,62,32,157,181,145,577
New York,Fillmore,596,14,0,22,57,14,107
New York,Fairview CDP (Westchester County),2874,73,7,184,173,141,578
New York,Florida village,2865,22,48,210,167,127,574
New York,Fonda village,737,2,11,41,36,71,161
New York,Franklin Square,31544,561,381,1199,1474,2001,5616
New York,Franklin village,375,2,2,36,34,33,107
New York,Frankfort village,2560,51,7,101,255,167,581
New York,Fowlerville,258,23,30,0,8,13,74
New York,Fort Salonga,9821,120,51,504,869,745,2289
New York,Fort Plain village,1949,38,4,99,45,95,281
New York,Flower Hill village,4772,146,97,287,350,358,1238
New York,Fort Montgomery,1421,0,11,67,36,61,175
New York,Fort Edward village,3318,0,23,122,232,217,594
New York,Fort Drum,13985,248,238,913,685,382,2466
New York,Fort Covington Hamlet,1481,6,35,105,39,140,325
New York,Fort Ann village,545,19,11,36,21,36,123
New York,Forestville village,581,3,0,42,17,36,98
New York,Forest Home,555,13,0,22,7,20,62
New York,Fort Johnson village,582,8,3,16,21,20,68
New York,Franklinville village,1850,29,27,102,124,115,397
New York,Fairview CDP (Dutchess County),5700,61,122,221,319,301,1024
New York,Fairmount,10106,123,145,294,510,628,1700
New York,Port Ewen,3413,68,17,98,242,111,536
New York,Port Gibson,495,0,0,17,27,31,75
New York,Port Henry village,920,46,13,57,26,18,160
New York,Port Jefferson village,7802,60,55,320,462,354,1251
New York,Port Jefferson Station,8582,229,119,699,100,327,1474
New York,Port Jervis,8681,129,149,558,434,604,1874
New York,Port Dickinson village,1648,25,15,71,59,84,254
New York,Port Leyden village,756,15,0,46,67,44,172
New York,Port Washington,16233,486,258,778,981,927,3430
New York,Port Washington North village,3190,38,51,165,228,141,623
New York,Potsdam village,9656,56,55,166,97,245,619
New York,Pottersville,489,45,0,0,78,12,135
New York,Poughkeepsie,30635,375,358,1751,1779,1634,5897
New York,Prattsburgh,753,23,8,22,42,16,111
New York,Portville village,1146,19,15,68,24,50,176
New York,Fairport village,5362,79,33,122,79,227,540
New York,Port Chester village,29406,389,431,1414,1348,1673,5255
New York,Poquott village,856,27,5,35,39,62,168
New York,Fair Haven village,700,9,4,9,30,38,90
New York,Fabius village,310,2,3,17,23,29,74
New York,Evans Mills village,481,8,12,19,21,11,71
New York,Esperance village,357,0,6,36,27,20,89
New York,Erin,357,0,0,11,4,24,39
New York,Plattsburgh,19845,206,154,667,632,831,2490
New York,Port Byron village,1310,7,0,56,107,87,257
New York,Plattsburgh West,1458,9,0,18,109,76,212
New York,Pleasantville village,7125,208,83,356,424,520,1591
New York,Plessis,115,0,0,0,0,0,0
New York,Poestenkill,1010,12,21,57,53,58,201
New York,Point Lookout,1267,19,12,62,55,96,244
New York,Poland village,381,2,4,38,24,17,85
New York,Pomona village,3286,95,55,165,235,131,681
New York,Pleasant Valley,1452,31,13,50,73,49,216
New York,Fredonia village,10881,133,88,197,360,283,1061
New York,Freedom Plains,472,0,0,7,17,61,85
New York,Freeport village,43251,444,342,2289,2204,2274,7553
New York,North Lindenhurst,11679,247,116,773,636,533,2305
New York,North Hornell village,867,2,4,19,51,25,101
New York,North Hills village,5190,26,64,190,204,101,585
New York,North Haven village,846,5,6,34,53,25,123
New York,North Great River,4091,29,34,249,79,281,672
New York,North Gates,9756,30,157,320,455,545,1507
New York,North Lynbrook,496,9,0,20,31,0,60
New York,Northeast Ithaca,3103,80,76,126,180,160,622
New York,North Collins village,1352,18,28,97,132,61,336
New York,North Boston,2749,6,38,84,182,98,408
New York,North Bellport,11623,118,166,636,761,1096,2777
New York,North Bellmore,20153,354,341,1045,1043,1258,4041
New York,North Bay Shore,20127,303,202,1225,1409,1208,4347
New York,North Ballston Spa,1569,31,10,32,55,101,229
New York,North Creek,446,0,5,5,0,0,10
New York,North Babylon,17228,338,249,917,753,933,3190
New York,North Massapequa,18749,354,157,584,1240,1107,3442
New York,North New Hyde Park,15177,182,190,624,742,997,2735
New York,Norwood village,1644,29,26,99,74,72,300
New York,Norwich,7032,128,71,393,367,421,1380
New York,Northwest Ithaca,1193,22,0,35,24,25,106
New York,Northwest Harbor,4004,102,0,164,121,310,697
New York,North Wantagh,11713,199,123,735,554,495,2106
New York,Northville,1685,0,34,47,32,30,143
New York,North Merrick,12077,282,64,495,581,842,2264
New York,Northville village,934,0,16,39,28,49,132
New York,North Tonawanda,31077,557,140,1253,1249,1341,4540
New York,North Syracuse village,6641,61,52,261,267,329,970
New York,North Sea,4441,66,31,165,179,282,723
New York,North Rose,544,0,0,35,22,21,78
New York,Northport village,7412,146,48,490,366,361,1411
New York,North Patchogue,6680,215,15,214,294,628,1366
New York,North Valley Stream,17845,347,254,693,961,920,3175
New York,Northampton,578,0,0,0,30,0,30
New York,North Amityville,19895,303,235,937,1315,1178,3968
New York,Norfolk,1387,20,17,47,103,131,318
New York,Gardnertown,5033,12,15,396,216,295,934
New York,Gardiner,643,0,16,31,48,10,105
New York,Garden City South,4265,46,42,205,202,211,706
New York,Garden City Park,8221,92,60,350,479,433,1414
New York,Garden City village,22575,405,191,1468,1159,1505,4728
New York,Gang Mills,4401,19,38,211,303,154,725
New York,Gasport,1103,0,65,0,39,39,143
New York,Galway village,320,9,2,25,2,14,52
New York,Gainesville village,204,1,1,8,3,19,32
New York,Fultonville village,667,7,0,30,47,62,146
New York,Fulton,11713,164,149,613,745,780,2451
New York,Friendship,1255,21,44,40,125,80,310
New York,Frewsburg,2207,0,0,70,77,121,268
New York,Freeville village,524,6,3,17,35,22,83
New York,Galeville,4821,35,40,268,179,226,748
New York,Gates,5034,150,15,79,297,402,943
New York,Geneseo village,8096,59,28,88,152,191,518
New York,Geneva,13157,128,223,560,551,667,2129
New York,Niverville,1629,0,0,31,23,109,163
New York,Nissequogue village,1692,32,45,52,124,123,376
New York,Niskayuna,4911,124,41,229,456,148,998
New York,Nichols village,594,14,5,25,59,21,124
New York,Niagara Falls,49435,757,607,2571,2371,2436,8742
New York,New York Mills village,3243,13,18,264,188,196,679
New York,New York,8426743,135959,107397,386632,374643,402867,1407498
New York,New Windsor,8691,92,133,333,290,439,1287
New York,New Suffolk,310,0,0,0,3,9,12
New York,New Square village,7540,329,340,1064,960,1004,3697
New York,New Rochelle,79027,1342,1234,3715,3657,3910,13858
New York,Newport village,544,0,5,18,61,59,143
New York,New Paltz village,7055,42,12,141,150,130,475
New York,New Hyde Park village,9788,215,50,583,408,455,1711
New York,Germantown,860,0,14,78,58,45,195
New York,Preston-Potter Hollow,420,0,6,26,18,22,72
New York,Speculator village,362,3,0,0,7,13,23
New York,Islip Terrace,5327,86,29,365,236,405,1121
New York,Spencerport village,3598,45,47,78,150,335,655
New York,Turin village,163,2,0,5,12,9,28
New York,Tuscarora,0,0,0,0,0,0,0
New York,Tuxedo Park village,590,7,10,31,68,22,138
New York,Unadilla village,831,16,6,7,73,53,155
New York,Uniondale,25092,277,186,1361,1347,1465,4636
New York,Union Springs village,1268,0,29,37,79,73,218
New York,Unionville village,596,7,14,30,54,24,129
New York,University at Buffalo,6174,0,0,9,9,9,27
New York,University Gardens,4122,25,56,222,220,275,798
New York,Upper Brookville village,1528,11,8,31,50,60,160
New York,Upper Nyack village,2050,39,20,85,123,171,438
New York,Utica,61628,920,964,3343,3772,3412,12411
New York,Vails Gate,3509,25,40,93,101,330,589
New York,Valatie village,1735,28,4,108,78,122,340
New York,Valhalla,3352,45,8,49,173,241,516
New York,Tupper Lake village,3566,38,83,207,233,196,757
New York,Tully village,1082,6,23,32,54,94,209
New York,Tuckahoe village,6586,153,48,257,360,370,1188
New York,Tuckahoe,1169,19,41,64,19,7,150
New York,Theresa village,903,5,6,64,67,86,228
New York,Thiells,5173,49,47,230,247,411,984
New York,Thomaston village,2624,74,46,208,139,193,660
New York,Thornwood,4054,45,40,157,175,205,622
New York,Thousand Island Park,71,0,0,0,0,0,0
New York,Three Mile Bay,198,0,0,23,0,18,41
New York,Ticonderoga,3123,149,38,173,164,88,612
New York,Valley Cottage,10191,175,257,426,411,411,1680
New York,Spencer village,993,16,22,101,76,30,245
New York,Tivoli village,1184,18,1,25,53,27,124
New York,Tonawanda,15000,170,73,475,529,802,2049
New York,Tonawanda,58149,639,555,2342,2852,2502,8890
New York,Town Line,2270,20,18,76,210,165,489
New York,Tribes Hill,808,12,0,42,82,26,162
New York,Troy,49933,682,637,2280,1995,1869,7463
New York,Trumansburg village,1637,12,30,68,89,64,263
New York,Titusville,561,0,0,33,51,37,121
New York,Valley Falls village,531,0,18,47,21,16,102
New York,Valley Stream village,37838,659,622,1559,1997,2460,7297
New York,Van Etten village,602,4,7,42,32,34,119
New York,Mayville village,1413,10,13,44,44,70,181
New York,Mayfield village,760,16,7,21,25,40,109
New York,Maybrook village,3093,44,26,109,141,163,483
New York,Mattydale,6434,104,68,248,519,472,1411
New York,Mattituck,4435,37,20,226,213,289,785
New York,Matinecock village,813,15,9,56,52,42,174
New York,Mastic Beach village,14883,209,185,896,1052,1125,3467
New York,Mechanicstown,7130,67,40,231,417,435,1190
New York,Mastic,16084,155,195,1182,1101,770,3403
New York,Massapequa Park village,17175,433,185,931,866,1055,3470
New York,Massapequa,22128,531,230,967,1180,1426,4334
New York,Marlboro,3518,56,20,253,188,263,780
New York,Marion,1403,25,0,88,90,148,351
New York,Mariaville Lake,609,0,0,0,16,78,94
New York,Margaretville village,566,8,0,3,3,15,29
New York,Marcellus village,1655,7,38,58,65,88,256
New York,Massena village,11086,93,217,553,646,545,2054
New York,Thendara,183,0,0,0,0,0,0
New York,Mechanicville,5205,66,30,221,236,328,881
New York,Medina village,5936,207,108,325,296,326,1262
New York,Vernon village,1198,8,3,42,68,61,182
New York,Verona,735,32,0,41,15,70,158
New York,Verplanck,1662,28,21,96,94,47,286
New York,Victor village,2768,80,87,195,135,183,680
New York,Victory village,471,13,10,28,32,20,103
New York,Village Green,3527,69,12,130,102,46,359
New York,Village of the Branch village,1986,37,23,156,154,205,575
New York,Medford,24793,431,292,1040,950,1728,4441
New York,Viola,6282,75,176,614,401,760,2026
New York,Voorheesville village,2820,30,47,128,167,169,541
New York,Merritt Park,1720,96,20,155,44,92,407
New York,Merrick,20572,355,211,993,1042,1502,4103
New York,Meridian village,293,12,4,5,19,25,65
New York,Menands village,4004,90,46,175,181,176,668
New York,Melville,18682,220,115,1095,984,1200,3614
New York,Melrose Park,2199,15,11,83,141,191,441
New York,Virgil,344,0,14,9,30,32,85
New York,Terryville,12296,132,108,579,829,900,2548
New York,Tarrytown village,11452,82,152,468,666,568,1936
New York,Tappan,6873,62,84,408,473,398,1425
New York,Crompond,2466,27,0,131,145,224,527
New York,Croghan village,696,2,4,30,44,47,127
New York,Cranberry Lake,187,0,0,2,6,0,8
New York,Cragsmoor,608,0,0,22,50,11,83
New York,Coxsackie village,2753,23,9,25,82,142,281
New York,Cove Neck village,298,6,3,23,29,7,68
New York,Country Knolls,2102,18,65,135,105,100,423
New York,Croton-on-Hudson village,8202,230,140,426,434,589,1819
New York,Cortland West,1289,38,26,70,56,47,237
New York,Cornwall-on-Hudson village,2984,37,66,230,149,246,728
New York,Corning,11059,231,90,543,543,404,1811
New York,Corinth village,2545,54,28,131,136,154,503
New York,Corfu village,807,2,0,24,30,70,126
New York,Coram,40685,895,393,1977,2007,2220,7492
New York,Copiague,22772,205,188,796,947,1187,3323
New York,Copenhagen village,716,12,19,12,16,32,91
New York,Cortland,19134,160,168,780,716,636,2460
New York,Copake Lake,518,3,0,46,35,53,137
New York,Crown Heights,2830,25,30,94,202,252,603
New York,Crystal Beach,727,0,0,10,94,7,111
New York,Depauville,961,0,87,181,48,29,345
New York,Delhi village,3078,11,5,55,58,59,188
New York,Delevan village,1076,22,30,38,56,47,193
New York,Delanson village,390,14,8,13,14,31,80
New York,DeKalb Junction,576,21,0,16,61,25,123
New York,Deferiet village,276,4,9,16,13,22,64
New York,Deer Park,27346,539,329,1463,1445,1679,5455
New York,Crugers,1720,13,0,48,19,66,146
New York,Davenport Center,417,0,0,35,5,10,50
New York,Dannemora village,3894,0,9,37,56,63,165
New York,Dalton,306,0,6,7,2,20,35
New York,Cuylerville,344,0,0,5,8,0,13
New York,Cutchogue,3192,65,36,77,191,187,556
New York,Cumminsville,146,0,0,0,0,0,0
New York,Cumberland Head,1564,51,35,69,42,61,258
New York,Cuba village,1654,53,18,56,75,94,296
New York,Dansville village,4537,43,32,241,133,465,914
New York,Marathon village,939,18,5,50,59,49,181
New York,Copake Hamlet,352,0,0,0,77,0,77
New York,Cooperstown village,2185,19,16,46,71,102,254
New York,Clayville village,328,7,0,23,9,10,49
New York,Clayton village,1917,13,8,70,109,117,317
New York,Claverack-Red Mills,735,0,0,41,28,34,103
New York,Mexico village,1702,25,6,136,96,130,393
New York,Stony Brook University,9101,0,0,4,20,8,32
New York,Stony Point,12882,164,165,521,850,817,2517
New York,Stottville,1355,18,19,38,36,76,187
New York,Cleveland village,776,12,8,65,49,26,160
New York,Strykersville,719,41,10,43,36,57,187
New York,Sunset Bay,781,27,23,47,22,0,119
New York,SUNY Oswego,3559,0,0,0,0,0,0
New York,Sylvan Beach village,856,0,0,24,25,39,88
New York,Syosset,19157,329,198,1104,1464,1310,4405
New York,Syracuse,144564,1975,1989,6654,6771,7467,24856
New York,Taconic Shores,639,0,0,12,0,61,73
New York,Tannersville village,714,0,21,45,71,11,148
New York,Suffern village,10914,200,62,492,619,526,1899
New York,Copake Falls,184,0,0,0,33,8,41
New York,Clifton Springs village,2180,26,15,164,109,82,396
New York,Clintondale,1391,0,0,53,12,53,118
New York,Coopers Plains,407,16,0,0,6,5,27
New York,Constantia,837,0,0,17,16,17,50
New York,Constableville village,239,3,5,6,6,7,27
New York,Congers,8698,148,56,390,466,599,1659
New York,Conesus Lake,2584,5,28,26,126,90,275
New York,Conesus Hamlet,512,12,0,59,42,15,128
New York,Commack,35914,466,422,1551,1939,2802,7180
New York,Clinton village,1850,26,24,96,81,83,310
New York,Colton,428,3,3,40,5,6,57
New York,Cold Spring Harbor,5076,109,48,289,370,303,1119
New York,Cold Spring village,1790,33,26,97,56,59,271
New York,Cold Brook village,336,10,1,12,21,28,72
New York,Cohoes,16281,111,191,765,507,648,2222
New York,Cohocton village,1016,21,16,62,74,102,275
New York,Cobleskill village,4602,42,72,97,110,100,421
New York,Clyde village,2012,33,25,186,167,126,537
New York,Colonie village,7898,208,39,347,233,360,1187
New York,Depew village,15227,176,136,710,671,682,2375
New York,Manorville,14501,344,249,852,973,989,3407
New York,Mannsville village,375,6,7,20,22,31,86
New York,Walton Park,2281,33,50,78,137,214,512
New York,Wampsville village,577,0,0,3,13,36,52
New York,Wanakah,2836,19,0,71,167,168,425
New York,Wantagh,18939,312,148,972,1075,1576,4083
New York,Wappingers Falls village,5424,52,104,286,185,321,948
New York,Warrensburg,3170,123,0,148,194,165,630
New York,Warsaw village,3519,61,16,108,221,140,546
New York,Warwick village,6797,69,54,256,420,520,1319
New York,Washington Heights,2149,62,26,209,54,135,486
New York,Washington Mills,1360,0,0,0,14,22,36
New York,Washingtonville village,5814,100,0,259,360,332,1051
New York,Watchtower,2603,0,0,0,39,0,39
New York,Waterford village,2233,6,13,50,62,128,259
New York,Waterloo village,5048,33,7,232,321,279,872
New York,Water Mill,2273,0,0,53,61,47,161
New York,Walton village,3026,17,10,289,146,192,654
New York,Wallkill,2227,10,20,60,232,181,503
New York,Walker Valley,829,13,0,99,231,32,375
New York,Walden village,6886,33,54,234,378,664,1363
New York,Avoca village,1033,15,21,58,47,74,215
New York,Avon village,3343,115,63,58,205,145,586
New York,Babylon village,12186,293,89,621,554,642,2199
New York,Bainbridge village,1237,20,14,128,51,51,264
New York,Baiting Hollow,1542,0,26,59,67,88,240
New York,Baldwin,24481,506,384,1315,1397,1325,4927
New York,Baldwin Harbor,7724,121,54,411,452,360,1398
New York,Watertown,27250,568,401,1297,1316,983,4565
New York,Baldwinsville village,7692,87,105,365,398,499,1454
New York,Balmville,2741,61,34,120,100,155,470
New York,Bardonia,3551,45,33,50,166,354,648
New York,Barker village,738,36,4,45,78,44,207
New York,Waddington village,953,2,3,55,37,35,132
New York,Wading River,7762,224,101,453,333,316,1427
New York,Wadsworth,350,0,0,10,73,23,106
New York,Wainscott,753,0,13,15,19,12,59
New York,Ballston Spa village,5256,63,52,140,369,222,846
New York,Waterville village,1574,19,24,51,40,68,202
New York,Watervliet,10241,131,78,556,585,502,1852
New York,Watkins Glen village,1912,24,33,54,83,108,302
New York,West Hampton Dunes village,53,0,0,2,0,0,2
New York,West Haverstraw village,10347,101,143,478,703,608,2033
New York,West Hempstead,19012,305,157,969,1245,1045,3721
New York,West Hills,5098,133,29,225,220,233,840
New York,West Hurley,2034,0,0,51,73,96,220
New York,West Islip,27224,419,262,1329,1583,1600,5193
New York,Westmere,6758,48,78,310,303,276,1015
New York,Westhampton Beach village,1918,44,8,61,85,84,282
New York,Westmoreland,584,0,0,0,48,88,136
New York,Weston Mills,1527,7,5,64,85,107,268
New York,West Point,6830,215,104,448,222,158,1147
New York,Westport,427,4,10,14,33,20,81
New York,West Sand Lake,2845,34,70,54,106,111,375
New York,West Sayville,4712,50,42,233,330,218,873
New York,West Seneca,45089,521,572,2008,2060,1995,7156
New York,Westvale,5210,87,41,196,312,268,904
New York,West Nyack,3939,165,0,275,257,182,879
New York,Averill Park,1413,0,0,113,55,51,219
New York,Westhampton,2935,85,37,111,147,168,548
New York,Westfield village,3466,11,82,166,170,188,617
New York,Waverly village,4328,67,79,112,172,181,611
New York,Wayland village,1750,40,19,76,109,110,354
New York,Webster village,5524,81,85,258,250,343,1017
New York,Websters Crossing,22,0,0,0,0,0,0
New York,Weedsport village,1847,9,9,116,104,89,327
New York,Wells,970,4,5,53,67,17,146
New York,Wellsburg village,573,4,4,43,18,29,98
New York,West Glens Falls,7670,117,225,553,405,340,1640
New York,Wellsville village,4589,63,59,239,169,199,729
New York,West Babylon,42664,581,425,2016,2074,2390,7486
New York,West Bay Shore,4684,113,72,240,218,115,758
New York,Westbury village,15273,171,366,674,755,676,2642
New York,West Carthage village,2019,14,39,76,63,106,298
New York,West Chazy,986,47,35,71,60,58,271
New York,West Elmira,5160,55,88,303,243,281,970
New York,West End,1482,0,22,75,33,38,168
New York,Wesley Hills village,5820,260,204,469,404,501,1838
New York,Au Sable Forks,472,7,7,3,47,27,91
New York,Aurora village,740,0,0,8,7,9,24
New York,Auburn,27264,337,341,1084,939,1217,3918
New York,Lynbrook village,19556,236,313,891,984,1080,3504
New York,Lowville village,3506,4,69,149,203,236,661
New York,Lorraine,108,0,0,4,4,4,12
New York,Lorenz Park,2265,0,0,225,192,94,511
New York,Long Lake,302,0,4,0,7,49,60
New York,Long Beach,33470,481,336,986,1195,1371,4369
New York,Lodi village,404,10,3,12,12,13,50
New York,Lyncourt,4098,79,35,229,107,155,605
New York,Locust Valley,3270,35,7,172,173,234,621
New York,Loch Sheldrake,1187,0,32,24,21,116,193
New York,Lloyd Harbor village,3684,34,55,225,327,441,1082
New York,Livonia Center,236,0,0,7,15,25,47
New York,Livonia village,1196,19,16,80,72,43,230
New York,Livingston Manor,1104,0,0,31,12,28,71
New York,Accord,762,0,60,0,135,113,308
New York,Adams village,1717,20,31,116,132,90,389
New York,Lockport,20857,190,243,1060,1034,1134,3661
New York,Adams Center,1865,83,13,136,0,98,330
New York,Lyndonville village,789,3,3,49,61,47,163
New York,Lyons village,3241,0,25,204,163,186,578
New York,Manlius village,4670,79,32,249,389,282,1031
New York,Manhasset Hills,3755,89,32,237,220,138,716
New York,Manhasset,8248,121,106,562,365,442,1596
New York,Manchester village,1712,18,26,73,95,47,259
New York,Mamaroneck village,19219,339,176,1101,1190,1222,4028
New York,Malverne Park Oaks,557,0,0,14,11,58,83
New York,Malverne village,8552,165,48,384,406,416,1419
New York,Lyon Mountain,279,0,0,3,28,0,31
New York,Malone village,5830,113,204,353,213,205,1088
New York,Mahopac,8083,119,116,302,359,663,1559
New York,Madrid,659,10,11,26,22,15,84
New York,Madison village,327,5,15,9,14,8,51
New York,Machias,500,20,3,28,26,28,105
New York,McGraw village,936,11,17,35,47,55,165
New York,Macedon village,1591,38,31,40,114,138,361
New York,Lyons Falls village,741,11,6,23,60,24,124
New York,Malden-on-Hudson,202,0,0,0,23,16,39
New York,Manorhaven village,6684,95,92,262,220,422,1091
New York,Addison village,1788,0,29,131,118,149,427
New York,Airmont village,8808,159,165,670,594,575,2163
New York,Angelica village,831,18,13,45,37,33,146
New York,Angola village,1858,24,35,81,185,75,400
New York,Angola on the Lake,1720,19,27,67,17,109,239
New York,Antwerp village,511,1,2,35,20,31,89
New York,Apalachin,1508,8,24,56,48,114,250
New York,Aquebogue,1958,0,38,48,54,90,230
New York,Arcade village,2214,17,24,167,177,186,571
New York,Andover village,829,17,7,43,61,37,165
New York,Ardsley village,4542,50,4,288,212,521,1075
New York,Arkport village,760,9,14,52,39,46,160
New York,Arlington,3888,62,0,46,149,242,499
New York,Armonk,4541,130,16,352,387,465,1350
New York,Asharoken village,532,9,0,10,22,36,77
New York,Athens village,1420,6,11,29,40,49,135
New York,Atlantic Beach village,1511,14,2,47,80,95,238
New York,Attica village,2643,56,31,180,133,177,577
New York,Argyle village,379,3,7,24,26,24,84
New York,Afton village,1086,12,32,54,40,67,205
New York,Andes,230,5,0,32,12,10,59
New York,Amityville village,9515,72,99,363,342,507,1383
New York,Akron village,2860,21,0,88,105,260,474
New York,Albany,98468,1290,606,3695,3754,3885,13230
New York,Albertson,5146,90,51,205,256,253,855
New York,Albion village,5631,125,0,221,211,253,810
New York,Alden village,2590,13,49,114,196,132,504
New York,Alexander village,516,9,3,39,39,52,142
New York,Alexandria Bay village,965,23,10,35,30,21,119
New York,Amsterdam,18157,421,260,1027,868,1054,3630
New York,Alfred village,4314,10,2,10,20,20,62
New York,Almond village,480,7,6,46,19,37,115
New York,Altamont village,1610,43,16,56,76,85,276
New York,Altmar village,412,4,6,41,26,37,114
New York,Altona,789,0,0,34,6,20,60
New York,Amagansett,1211,43,0,40,44,61,188
New York,Amenia,1060,22,5,41,26,63,157
New York,Ames village,165,0,0,8,8,12,28
New York,Allegany village,1839,28,18,59,77,52,234
New York,Deposit village,1832,44,37,61,74,101,317
New York,Tillson,1597,0,0,20,73,74,167
New York,East Ithaca,2322,35,15,74,44,11,179
New York,Eden,3271,72,21,146,238,219,696
New York,Eatons Neck,1469,30,7,39,90,107,273
New York,East Williston village,2585,80,23,118,190,206,617
New York,East Syracuse village,3043,41,78,178,222,99,618
New York,East Shoreham,6455,143,85,553,485,245,1511
New York,East Rockaway village,9871,197,75,390,522,636,1820
New York,East Rochester village,6678,70,34,324,407,336,1171
New York,Edmeston,794,26,10,35,44,42,157
New York,East Randolph,588,7,1,19,50,44,121
New York,Eastport,1869,35,15,51,0,91,192
New York,East Patchogue,22452,402,341,1002,1013,1066,3824
New York,East Norwich,2751,48,12,180,141,193,574
New York,East Northport,19682,382,242,914,1149,1371,4058
New York,East Nassau village,624,5,13,22,61,47,148
New York,East Moriches,5428,76,24,192,240,403,935
New York,East Meadow,37836,637,496,1036,1789,1788,5746
New York,East Quogue,4589,58,15,209,371,329,982
New York,East Marion,915,9,0,4,14,20,47
New York,Edwards,380,3,4,7,13,47,74
New York,Elba village,713,9,16,45,17,61,148
New York,Springs,6065,143,57,326,141,274,941
New York,Spring Valley village,32221,632,732,2566,2089,2422,8441
New York,Springville village,4328,135,33,162,220,219,769
New York,Springwater Hamlet,484,0,13,14,34,28,89
New York,Staatsburg,183,0,0,0,9,0,9
New York,Stamford village,1455,8,10,52,67,59,196
New York,Stannards,841,0,4,29,50,16,99
New York,Eggertsville,15675,336,228,667,639,782,2652
New York,Star Lake,719,2,18,40,35,33,128
New York,Stillwater village,1812,37,57,103,119,162,478
New York,Stone Ridge,1256,0,47,54,61,117,279
New York,Stony Brook,13889,276,213,663,873,872,2897
New York,Ellicottville village,273,0,0,1,6,12,19
New York,Ellenville village,4131,58,66,284,297,351,1056
New York,Elizabethtown,763,0,11,14,39,31,95
New York,Elbridge village,1080,3,18,20,44,52,137
New York,Stewart Manor village,2113,49,23,111,140,95,418
New York,East Kingston,391,28,37,0,51,14,130
New York,East Massapequa,19843,344,182,951,837,920,3234
New York,East Islip,13802,218,73,748,920,1139,3098
New York,Dering Harbor village,6,0,0,0,0,0,0
New York,DeRuyter village,545,8,0,15,38,31,92
New York,Dexter village,1359,19,59,72,59,71,280
New York,Dix Hills,27374,314,317,1576,1439,1833,5479
New York,Dobbs Ferry village,11055,307,93,360,441,717,1918
New York,Dolgeville village,2349,60,30,185,129,134,538
New York,Dover Plains,919,10,0,28,22,54,114
New York,Downsville,648,0,0,32,56,59,147
New York,Dresden village,452,7,0,17,28,26,78
New York,Duane Lake,361,0,0,0,40,0,40
New York,Duanesburg,359,0,0,19,17,63,99
New York,Dundee village,1448,22,30,79,17,60,208
New York,Dunkirk,12308,184,112,568,517,736,2117
New York,Dryden village,2014,15,6,123,143,120,407
New York,Earlville village,1102,3,26,81,76,63,249
New York,East Hills village,7066,229,115,508,545,584,1981
New York,Durhamville,806,26,0,131,45,43,245
New York,East Hampton village,1148,3,3,40,35,25,106
New York,East Greenbush,4752,45,125,295,236,336,1037
New York,East Glenville,6621,68,71,312,369,445,1265
New York,East Garden City,6470,4,0,70,71,45,190
New York,East Farmingdale,6414,96,41,478,227,308,1150
New York,East Hampton North,3979,59,67,197,219,271,813
New York,East Avon,619,16,0,71,68,26,181
New York,East Aurora village,6251,105,86,267,461,386,1305
New York,East Atlantic Beach,2126,8,0,76,68,109,261
New York,Eastchester,19885,453,189,1030,1086,1194,3952
North Carolina,Hertford,2197,34,44,179,64,110,431
North Carolina,Henderson,15311,274,434,948,696,866,3218
North Carolina,Hendersonville,13457,172,221,669,582,508,2152
North Carolina,Henrietta,456,0,11,16,0,28,55
North Carolina,Hobgood,384,2,2,16,18,7,45
North Carolina,Hillsborough,6316,96,37,374,544,353,1404
North Carolina,Hildebran,2173,28,28,74,102,130,362
North Carolina,High Shoals,580,0,5,35,18,42,100
North Carolina,High Point,108031,1424,1418,5837,6413,6127,21219
North Carolina,Highlands,1059,8,14,39,11,29,101
North Carolina,Hemby Bridge,1307,5,20,60,61,65,211
North Carolina,Hickory,40172,431,433,2238,1934,2358,7394
North Carolina,Hiddenite,605,0,0,19,0,20,39
North Carolina,Hightsville,828,0,0,0,0,41,41
North Carolina,Hays,1896,30,0,88,186,81,385
North Carolina,Dillsboro,295,10,0,4,2,2,18
North Carolina,Haw River,2585,12,97,139,128,122,498
North Carolina,Elroy,3635,0,63,135,176,185,559
North Carolina,Emerald Isle,3708,26,43,57,169,222,517
North Carolina,Enfield,2426,22,29,90,144,66,351
North Carolina,Engelhard,805,0,0,29,173,84,286
North Carolina,Enochville,2788,29,105,128,125,76,463
North Carolina,Erwin,4601,55,62,209,215,317,858
North Carolina,Etowah,6797,46,55,230,398,384,1113
North Carolina,Eureka,144,0,1,14,0,4,19
North Carolina,Everetts,157,1,0,6,24,1,32
North Carolina,Evergreen,400,18,0,0,13,38,69
North Carolina,Fair Bluff,859,3,0,9,23,3,38
North Carolina,Fairfield,306,0,0,0,0,27,27
North Carolina,Fairfield Harbour,2749,10,7,25,58,61,161
North Carolina,Fairmont,2684,27,22,111,135,177,472
North Carolina,Fairplains,2181,81,58,165,36,101,441
North Carolina,Fairview,2815,0,59,239,193,112,603
North Carolina,Fairview,3530,0,43,237,166,230,676
North Carolina,Lake Santeetlah,36,0,0,2,0,0,2
North Carolina,Lake Royale,3162,12,65,61,95,114,347
North Carolina,Lake Park village,3636,14,34,169,255,389,861
North Carolina,Lake Norman of Catawba,7274,92,62,304,293,338,1089
North Carolina,Lake Lure,1409,0,13,24,47,39,123
North Carolina,Lake Junaluska,2682,0,32,55,86,129,302
North Carolina,Elrod,502,0,18,104,8,55,185
North Carolina,La Grange,2842,0,99,110,112,199,520
North Carolina,Kure Beach,2286,0,25,39,109,71,244
North Carolina,Fallston,667,9,0,36,43,42,130
North Carolina,Falkland,59,0,0,0,8,15,23
North Carolina,Falcon,226,0,6,8,25,29,68
North Carolina,Faith,875,11,19,41,48,44,163
North Carolina,Faison,1107,12,14,82,35,102,245
North Carolina,Knightdale,13243,260,127,717,881,1114,3099
North Carolina,Elon,9698,106,34,324,211,288,963
North Carolina,Elm City,1630,0,13,70,104,156,343
North Carolina,Ellerbe,1137,25,17,75,62,53,232
North Carolina,Dunn,9654,68,94,477,505,562,1706
North Carolina,Dundarrach,60,0,0,0,0,0,0
North Carolina,Duck,534,0,0,5,20,2,27
North Carolina,Dublin,411,4,0,31,69,15,119
North Carolina,Drexel,1869,0,33,88,86,80,287
North Carolina,Dover,284,0,2,14,13,17,46
North Carolina,Durham,246084,4282,3882,11448,11151,10341,41104
North Carolina,Dortches,1000,6,11,68,64,35,184
North Carolina,Dobbins Heights,858,0,0,30,48,19,97
North Carolina,Hobucken,64,0,0,0,0,0,0
North Carolina,Harrisburg,13883,324,235,1197,1279,1013,4048
North Carolina,Hassell,38,0,0,4,0,0,4
North Carolina,Hatteras,466,0,0,23,0,17,40
North Carolina,Havelock,20729,334,351,952,996,994,3627
North Carolina,Dobson,1569,7,13,42,49,57,168
North Carolina,Hayesville,404,6,3,17,5,21,52
North Carolina,Earl,303,3,4,21,25,13,66
North Carolina,East Bend,473,0,6,21,13,16,56
North Carolina,Ellenboro,1250,10,22,35,119,154,340
North Carolina,Elk Park,411,0,2,4,10,14,30
North Carolina,Elkin,4217,73,27,225,323,131,779
North Carolina,Elizabethtown,3610,51,88,138,209,159,645
North Carolina,Elizabeth City,18111,288,246,738,700,916,2888
North Carolina,Efland,837,21,8,25,22,77,153
North Carolina,East Arcadia,440,6,6,21,34,38,105
North Carolina,Edneyville,2069,25,11,163,76,62,337
North Carolina,Eden,15483,75,189,703,1090,1015,3072
North Carolina,East Spencer,1453,22,21,80,127,123,373
North Carolina,East Rockingham,3921,22,78,315,215,173,803
North Carolina,Eastover,3681,87,31,187,154,174,633
North Carolina,East Laurinburg,367,6,2,23,11,18,60
North Carolina,East Flat Rock,3500,30,89,58,100,107,384
North Carolina,Edenton,4942,96,48,443,315,200,1102
North Carolina,Hoffman,572,0,16,24,8,33,81
North Carolina,Canton,4156,214,166,227,165,139,911
North Carolina,Denton,1766,33,34,107,108,58,340
North Carolina,Mount Gilead,1282,3,15,90,68,119,295
North Carolina,Mount Airy,10391,128,107,551,498,391,1675
North Carolina,Mountain View,3276,0,4,77,106,179,366
North Carolina,Mountain Home,3603,47,18,151,89,86,391
North Carolina,Morven,510,5,0,20,43,43,111
North Carolina,Morrisville,21726,622,402,1597,1203,781,4605
North Carolina,Morganton,16748,221,235,775,854,903,2988
North Carolina,Morehead City,9162,209,72,452,459,368,1560
North Carolina,Moravian Falls,1564,37,89,8,12,61,207
North Carolina,Mooresville,34930,467,448,2258,2745,2341,8259
North Carolina,Mooresboro,486,3,13,16,50,22,104
North Carolina,Montreat,677,0,0,0,26,11,37
North Carolina,Monroe,33951,669,501,2320,1857,2272,7619
North Carolina,Moncure,506,0,0,12,64,14,90
North Carolina,Momeyer,250,12,0,3,8,7,30
North Carolina,Mocksville,5090,65,48,231,344,267,955
North Carolina,Misenheimer village,711,3,2,3,0,3,11
North Carolina,Mint Hill,24545,346,325,1058,1085,1189,4003
North Carolina,Minnesott Beach,385,0,2,1,0,9,12
North Carolina,Mineral Springs,2797,22,10,118,151,110,411
North Carolina,Milton,176,5,0,9,5,6,25
North Carolina,Mount Holly,13924,242,150,580,623,736,2331
North Carolina,Mount Olive,4756,65,48,135,141,188,577
North Carolina,Mount Pleasant,1825,11,43,89,103,112,358
North Carolina,Moyock,3456,0,33,386,246,224,889
North Carolina,North Wilkesboro,4250,49,0,318,183,253,803
North Carolina,Northwest,959,4,24,51,63,67,209
North Carolina,North Topsail Beach,1047,14,9,26,21,7,77
North Carolina,Northlakes,1681,22,47,51,68,71,259
North Carolina,Northchase,3386,39,22,221,80,58,420
North Carolina,Norman,151,0,0,14,25,6,45
North Carolina,Norlina,1131,31,8,44,45,47,175
North Carolina,Newton Grove,526,0,1,16,20,20,57
North Carolina,Newton,12980,134,147,845,387,633,2146
North Carolina,Newport,4598,20,51,111,206,332,720
North Carolina,Mills River,6964,159,22,126,344,524,1175
North Carolina,New London,596,3,2,25,45,28,103
North Carolina,New Bern,30218,599,352,1637,1600,1238,5426
North Carolina,Neuse Forest,2244,21,60,135,157,157,530
North Carolina,Navassa,1887,24,5,125,199,116,469
North Carolina,Nashville,5459,83,47,137,284,172,723
North Carolina,Nags Head,2825,14,0,96,85,72,267
North Carolina,Myrtle Grove,8972,120,115,323,444,580,1582
North Carolina,Murraysville,14844,308,230,1041,540,517,2636
North Carolina,Murphy,2095,38,20,117,84,68,327
North Carolina,Murfreesboro,2920,110,30,38,86,128,392
North Carolina,Mulberry,2122,0,47,77,38,115,277
North Carolina,Newland,844,1,6,21,62,47,137
North Carolina,Denver,1994,0,0,169,57,219,445
North Carolina,Millingport,368,0,0,26,20,10,56
North Carolina,Midway,4716,118,0,265,367,191,941
North Carolina,Hudson,3732,31,88,93,197,360,769
North Carolina,Hot Springs,573,11,3,20,19,29,82
North Carolina,Horse Shoe,2509,45,9,47,202,148,451
North Carolina,Hope Mills,16123,168,318,927,1165,1215,3793
North Carolina,Hoopers Creek,1399,0,8,84,110,60,262
North Carolina,Hookerton,318,4,2,18,8,10,42
North Carolina,Holly Springs,28640,727,443,2319,2034,1896,7419
North Carolina,Holly Ridge,1785,35,7,33,51,36,162
North Carolina,Hollister,854,20,10,85,26,60,201
North Carolina,Holden Beach,955,3,9,26,45,43,126
North Carolina,Lake Waccamaw,1465,13,10,56,81,125,285
North Carolina,Dallas,4540,80,23,279,165,240,787
North Carolina,Dana,2486,13,24,91,139,65,332
North Carolina,Danbury,175,2,0,2,2,6,12
North Carolina,Davidson,11765,250,195,646,756,648,2495
North Carolina,Davis,352,0,0,9,19,11,39
North Carolina,Deercroft,289,0,0,26,0,0,26
North Carolina,Delco,249,0,0,0,0,22,22
North Carolina,Dellview,5,0,0,0,0,0,0
North Carolina,Norwood,2881,25,26,128,177,197,553
North Carolina,Delway,53,0,0,0,0,0,0
North Carolina,Huntersville,50433,1195,1011,2955,3340,2615,11116
North Carolina,Icard,2971,15,19,91,167,26,318
North Carolina,Indian Beach,179,0,0,5,0,23,28
North Carolina,Indian Trail,35602,720,712,2655,3515,1982,9584
North Carolina,Midland,3243,0,0,53,125,96,274
North Carolina,Middlesex,1058,2,25,97,61,27,212
North Carolina,Middleburg,154,2,2,0,25,28,57
North Carolina,Micro,603,6,10,43,25,14,98
North Carolina,Mesic,215,1,0,5,7,14,27
North Carolina,Mebane,13309,237,278,1055,518,782,2870
North Carolina,Maysville,915,2,0,23,39,43,107
North Carolina,Mayodan,2762,60,0,104,124,132,420
North Carolina,Maxton,2598,55,40,117,176,209,597
North Carolina,Maury,1563,23,16,51,0,53,143
North Carolina,Millers Creek,1842,30,21,71,114,53,289
North Carolina,Jonesville,2496,16,109,96,173,101,495
North Carolina,Jamesville,547,5,6,41,21,34,107
North Carolina,Jamestown,3638,9,17,157,184,308,675
North Carolina,James City,5513,90,83,300,94,196,763
North Carolina,Jacksonville,68315,1049,756,3431,2803,2859,10898
North Carolina,Jackson Heights,838,9,0,0,77,104,190
North Carolina,Jackson,511,7,6,8,5,12,38
North Carolina,JAARS,335,0,0,0,0,27,27
North Carolina,Ivanhoe,182,27,0,0,0,16,43
North Carolina,Iron Station,620,0,0,20,25,75,120
North Carolina,Ingold,525,0,0,129,102,41,272
North Carolina,Jefferson,1374,16,19,63,69,61,228
North Carolina,Landis,3097,56,28,67,181,155,487
North Carolina,Lansing,194,6,4,9,9,7,35
North Carolina,Lasker,124,0,0,2,12,5,19
North Carolina,Brookford,402,4,2,22,18,15,61
North Carolina,Brunswick,988,2,6,11,20,52,91
North Carolina,Bryson City,1748,30,12,105,122,90,359
North Carolina,Buies Creek,2668,0,0,97,62,19,178
North Carolina,Bunn,365,0,5,16,25,5,51
North Carolina,Bunnlevel,770,10,26,0,43,21,100
North Carolina,Burgaw,4011,62,65,207,135,240,709
North Carolina,Burlington,52241,690,507,2302,2638,2921,9058
North Carolina,Burnsville,1653,29,2,40,23,33,127
North Carolina,Butner,7672,72,296,489,425,327,1609
North Carolina,Butters,201,0,0,0,0,0,0
North Carolina,McFarlan,162,0,2,4,10,7,23
North Carolina,McLeansville,897,0,0,0,41,125,166
North Carolina,Brogden,2364,32,0,163,47,128,370
North Carolina,Macon,143,0,2,0,0,6,8
North Carolina,Maggie Valley,1533,45,0,106,57,19,227
North Carolina,Magnolia,1211,5,35,68,99,93,300
North Carolina,Maiden,3346,14,46,319,218,326,923
North Carolina,Mamers,1029,13,0,110,101,74,298
North Carolina,Manns Harbor,1282,58,16,51,43,177,345
North Carolina,Manteo,1522,6,15,66,71,65,223
North Carolina,Marble,202,0,0,9,1,5,15
North Carolina,Marietta,127,5,4,9,4,0,22
North Carolina,Marion,7914,128,307,411,383,301,1530
North Carolina,Mar-Mac,3924,3,348,169,314,202,1036
North Carolina,Marshall,764,16,0,59,22,22,119
North Carolina,Marshallberg,312,9,0,10,0,0,19
North Carolina,Mars Hill,2410,34,16,69,104,104,327
North Carolina,Madison,2278,18,30,67,103,92,310
North Carolina,Marshville,2538,9,64,164,231,185,653
North Carolina,Broadway,1242,0,17,56,42,37,152
North Carolina,Bridgeton,304,9,0,2,7,2,20
North Carolina,Benson,3478,97,58,248,184,144,731
North Carolina,Bent Creek,1431,16,34,79,1,21,151
North Carolina,Bermuda Run,2532,27,42,21,47,122,259
North Carolina,Bessemer City,5455,53,87,298,331,421,1190
North Carolina,Bethania,359,0,7,2,2,22,33
North Carolina,Bethel,1849,8,18,98,112,76,312
North Carolina,Bethlehem,4620,95,0,194,137,220,646
North Carolina,Beulaville,1570,15,21,63,76,106,281
North Carolina,Biltmore Forest,1474,26,9,72,70,93,270
North Carolina,Biscoe,1874,28,0,132,157,188,505
North Carolina,Black Creek,642,6,8,69,54,33,170
North Carolina,Black Mountain,8079,119,116,279,218,438,1170
North Carolina,Bladenboro,1875,40,6,157,89,66,358
North Carolina,Broad Creek,2525,26,9,232,166,117,550
North Carolina,Blowing Rock,1206,13,2,62,16,33,126
North Carolina,Boardman,199,2,0,2,8,4,16
North Carolina,Bogue,662,17,2,21,49,28,117
North Carolina,Boiling Spring Lakes,5610,69,133,137,399,444,1182
North Carolina,Boiling Springs,4636,34,108,213,337,233,925
North Carolina,Bolivia,310,3,22,21,66,21,133
North Carolina,Bolton,796,12,16,59,25,15,127
North Carolina,Bonnetsville,425,0,33,74,14,32,153
North Carolina,Boone,17966,74,13,175,126,149,537
North Carolina,Boonville,1370,13,20,62,152,55,302
North Carolina,Bostic,360,8,2,12,24,19,65
North Carolina,Bowmore,26,0,0,0,0,0,0
North Carolina,Brevard,7656,146,46,259,413,390,1254
North Carolina,Brices Creek,3921,116,0,271,404,254,1045
North Carolina,Blue Clay Farms,12,0,0,0,0,0,0
North Carolina,Marvin village,5938,133,109,650,767,517,2176
North Carolina,Matthews,29352,505,392,1774,1622,1856,6149
North Carolina,Cullowhee,5534,15,13,74,118,47,267
North Carolina,Cherryville,5868,111,6,378,326,200,1021
North Carolina,Cherokee,2157,60,51,281,5,80,477
North Carolina,Charlotte,792137,15593,11533,43449,42362,40492,153429
North Carolina,Chapel Hill,58766,735,756,1958,2589,2370,8408
North Carolina,Chadbourn,2169,19,52,100,188,48,407
North Carolina,Cerro Gordo,154,0,0,18,17,17,52
North Carolina,Centerville,91,0,0,0,4,3,7
North Carolina,Cedar Rock village,326,0,2,11,14,19,46
North Carolina,Cedar Point,1429,19,13,69,120,67,288
North Carolina,Catawba,688,20,8,77,12,12,129
North Carolina,Caswell Beach,387,0,0,0,6,30,36
North Carolina,Castle Hayne,953,0,9,36,42,57,144
North Carolina,Castalia,363,0,8,13,15,13,49
North Carolina,Chimney Rock Village village,68,0,0,0,0,5,5
North Carolina,Cashiers,109,0,0,0,0,0,0
North Carolina,Cary,151186,3153,2130,8986,9856,9107,33232
North Carolina,Carthage,2531,13,41,134,199,108,495
North Carolina,Carrboro,20639,410,208,1363,1070,971,4022
North Carolina,Carolina Shores,3549,57,0,0,61,18,136
North Carolina,Carolina Beach,5970,163,34,288,158,369,1012
North Carolina,Caroleen,502,0,0,0,76,20,96
North Carolina,Buxton,1250,59,50,9,132,24,274
North Carolina,Cajah's Mountain,2752,22,3,170,104,121,420
North Carolina,Calabash,1775,10,30,79,63,72,254
North Carolina,Calypso,545,2,13,9,41,52,117
North Carolina,Camden,577,0,14,61,27,30,132
North Carolina,Cameron,287,2,3,29,11,4,49
North Carolina,Candor,759,0,9,28,34,63,134
North Carolina,Casar,269,7,6,19,6,13,51
North Carolina,China Grove,4164,22,39,517,204,230,1012
North Carolina,Chocowinity,936,13,12,43,65,70,203
North Carolina,Claremont,1394,11,22,107,105,95,340
North Carolina,Crossnore,237,0,13,20,11,47,91
North Carolina,Cricket,1712,6,36,170,53,44,309
North Carolina,Creswell,294,12,6,7,20,25,70
North Carolina,Creedmoor,4289,86,120,25,223,236,690
North Carolina,Cramerton,4245,63,49,145,277,245,779
North Carolina,Cove Creek,1072,9,34,55,33,40,171
North Carolina,Cove City,457,5,5,16,15,25,66
North Carolina,Cornelius,26866,559,314,1816,1522,1469,5680
North Carolina,Cordova,1875,14,37,96,52,109,308
North Carolina,Cooleemee,839,22,2,38,36,85,183
North Carolina,Conway,728,9,28,78,50,47,212
North Carolina,Conover,8221,134,166,290,405,604,1599
North Carolina,Connelly Springs,1854,15,21,123,163,124,446
North Carolina,Conetoe,352,0,7,25,15,13,60
North Carolina,Concord,83903,1475,1604,5457,5304,5326,19166
North Carolina,Como,82,0,0,4,5,1,10
North Carolina,Columbus,1161,33,4,65,109,31,242
North Carolina,Columbia,795,0,18,52,30,64,164
North Carolina,Colerain,191,1,8,4,10,3,26
North Carolina,Coinjock,235,0,7,0,6,7,20
North Carolina,Cofield village,301,5,0,8,10,13,36
North Carolina,Coats,2628,12,55,188,167,100,522
North Carolina,Clyde,1311,19,6,72,106,60,263
North Carolina,Clinton,8750,123,142,531,479,463,1738
North Carolina,Cliffside,327,0,0,35,24,0,59
North Carolina,Cleveland,930,6,15,54,29,57,161
North Carolina,Clemmons village,19340,324,167,1128,1109,1308,4036
North Carolina,Clayton,17869,327,247,1258,1381,1271,4484
North Carolina,Clarkton,671,0,11,27,20,52,110
North Carolina,Bennett,190,0,0,0,0,0,0
North Carolina,Cape Carteret,2223,10,10,111,148,132,411
North Carolina,Belwood,994,14,30,82,57,27,210
North Carolina,Belville,2437,48,41,204,188,140,621
North Carolina,Bakersville,487,4,4,25,19,26,78
North Carolina,Bald Head Island village,205,0,0,1,0,0,1
North Carolina,Balfour,1556,7,0,31,107,51,196
North Carolina,Banner Elk,1183,35,3,3,25,23,89
North Carolina,Barker Heights,1530,0,111,96,63,86,356
North Carolina,Barker Ten Mile,853,0,6,17,40,46,109
North Carolina,Bath,270,0,4,0,3,7,14
North Carolina,Bayboro,1389,6,12,43,79,88,228
North Carolina,Bayshore,3283,106,5,91,124,275,601
North Carolina,Bayview,241,0,0,0,0,35,35
North Carolina,Bear Grass,137,3,0,18,10,3,34
North Carolina,Beaufort,4153,56,24,46,153,218,497
North Carolina,Beech Mountain,571,1,0,21,15,5,42
North Carolina,Bailey,530,11,13,27,44,33,128
North Carolina,Belhaven,2000,17,5,91,128,143,384
North Carolina,Belmont,10387,128,156,503,508,499,1794
North Carolina,Kelford,215,5,0,9,27,17,58
North Carolina,Kelly,496,0,0,75,33,24,132
North Carolina,Kenansville,926,18,16,37,36,15,122
North Carolina,Kenly,1674,29,11,155,49,42,286
North Carolina,Kernersville,23617,400,208,1201,1282,1206,4297
North Carolina,Kill Devil Hills,6881,39,84,312,433,341,1209
North Carolina,King,6697,44,78,408,331,356,1217
North Carolina,Kings Grant,8913,145,87,318,470,454,1474
North Carolina,Kings Mountain,10792,110,134,711,501,729,2185
North Carolina,Kingstown,742,4,7,27,48,56,142
North Carolina,Kinston,21540,367,306,864,1185,1318,4040
North Carolina,Kittrell,284,13,0,5,5,21,44
North Carolina,Bell Arthur,334,0,45,0,0,0,45
North Carolina,Kitty Hawk,3362,49,14,106,135,236,540
North Carolina,McDonald,99,0,0,5,3,2,10
North Carolina,McAdenville,660,14,9,8,15,11,57
North Carolina,Lattimore,469,2,0,22,16,22,62
North Carolina,Laurel Hill,931,26,9,0,63,57,155
North Carolina,Laurel Park,2765,68,6,186,125,41,426
North Carolina,Laurinburg,15694,233,194,1033,949,723,3132
North Carolina,Lawndale,709,0,11,20,50,89,170
North Carolina,Leggett,38,0,0,4,2,6,12
North Carolina,Leland,16122,372,219,644,572,394,2201
North Carolina,Lenoir,17978,208,177,1182,1002,593,3162
North Carolina,Lewiston Woodville,846,10,5,174,49,42,280
North Carolina,Lewisville,13212,259,182,705,826,760,2732
North Carolina,Lexington,19129,293,376,1106,1244,1262,4281
North Carolina,Liberty,2674,27,10,158,132,197,524
North Carolina,Light Oak,763,9,0,59,0,25,93
North Carolina,Macclesfield,513,5,4,24,12,22,67
North Carolina,Lilesville,464,4,0,14,25,50,93
North Carolina,Lincolnton,10696,172,93,791,467,652,2175
North Carolina,Linden,169,1,5,19,4,8,37
North Carolina,Littleton,533,0,5,10,45,9,69
North Carolina,Locust,2956,64,45,134,194,69,506
North Carolina,Long View,5050,32,12,372,284,116,816
North Carolina,Louisburg,3499,20,23,148,186,290,667
North Carolina,Love Valley,112,2,0,10,9,8,29
North Carolina,Lowell,3594,107,26,140,115,106,494
North Carolina,Lowesville,3266,57,25,207,175,68,532
North Carolina,Lowgap,350,0,0,0,11,50,61
North Carolina,Lucama,930,12,12,92,18,40,174
North Carolina,Lumber Bridge,82,0,0,2,2,3,7
North Carolina,Lumberton,21721,310,299,1111,893,1226,3839
North Carolina,Lillington,3388,70,2,76,97,204,449
North Carolina,Harrellsville,177,4,0,15,21,9,49
North Carolina,Harrells,153,1,1,2,10,6,20
North Carolina,Harmony,602,3,0,31,45,42,121
North Carolina,Gastonia,73211,1065,1222,3972,4303,4345,14907
North Carolina,Gaston,1038,20,12,63,15,66,176
North Carolina,Garysburg,1033,0,3,51,40,22,116
North Carolina,Garner,27160,389,334,1123,1786,1726,5358
North Carolina,Garland,674,2,0,14,34,41,91
North Carolina,Gamewell,3986,0,120,147,206,122,595
North Carolina,Fuquay-Varina,21399,484,601,1413,1136,1166,4800
North Carolina,Fruitland,2637,0,23,93,70,128,314
North Carolina,Frisco,111,0,0,0,0,0,0
North Carolina,Fremont,1147,14,0,57,70,90,231
North Carolina,Franklinville,1064,17,28,47,58,66,216
North Carolina,Franklinton,2319,17,24,110,149,72,372
North Carolina,Franklin,3910,45,14,155,124,277,615
North Carolina,Gatesville,403,15,8,25,23,15,86
North Carolina,Foxfire village,1344,29,17,70,34,36,186
North Carolina,Fountain,450,9,9,41,26,35,120
North Carolina,Foscoe,1465,30,8,59,67,80,244
North Carolina,Forest Oaks,3342,46,33,118,107,150,454
North Carolina,Forest Hills village,405,3,7,11,10,12,43
North Carolina,Forest City,7359,32,142,471,565,607,1817
North Carolina,Fontana Dam,0,0,0,0,0,0,0
North Carolina,Fletcher,7394,96,120,364,322,434,1336
North Carolina,Flat Rock,1466,0,19,24,18,106,167
North Carolina,Flat Rock village,3211,52,0,81,59,39,231
North Carolina,Five Points,979,6,18,30,48,44,146
North Carolina,Fearrington Village,2797,0,15,19,35,0,69
North Carolina,Fayetteville,202521,3237,3269,10595,9902,9656,36659
North Carolina,Farmville,4755,13,53,322,199,249,836
North Carolina,Four Oaks,1900,34,31,89,105,87,346
North Carolina,Germanton,838,0,11,20,46,0,77
North Carolina,Gerton,255,0,0,21,0,25,46
North Carolina,Gibson,516,7,19,34,26,32,118
North Carolina,Harkers Island,1637,0,16,41,71,38,166
North Carolina,Hampstead,4528,65,53,315,366,244,1043
North Carolina,Hamlet,6525,134,135,412,473,589,1743
North Carolina,Hamilton,384,0,2,17,14,39,72
North Carolina,Hallsboro,421,0,0,10,60,0,70
North Carolina,Halifax,271,0,4,7,12,14,37
North Carolina,Half Moon,7915,144,244,304,490,559,1741
North Carolina,Gulf,401,0,0,0,0,0,0
North Carolina,Grover,1037,12,0,50,106,91,259
North Carolina,Grimesland,421,5,6,14,38,12,75
North Carolina,Grifton,2576,11,0,143,251,238,643
North Carolina,Greenville,88598,834,1136,3251,3539,3097,11857
North Carolina,Greensboro,279427,3986,3435,12742,12982,13879,47024
North Carolina,Green Level,1977,8,66,82,110,160,426
North Carolina,Greenevers,847,15,28,58,51,75,227
North Carolina,Grantsboro,822,20,7,28,25,21,101
North Carolina,Granite Quarry,2963,84,27,244,286,213,854
North Carolina,Granite Falls,4683,55,80,271,288,231,925
North Carolina,Grandfather village,61,0,0,0,2,0,2
North Carolina,Graham,14468,329,285,911,1135,711,3371
North Carolina,Gorman,1310,18,0,90,33,0,141
North Carolina,Goldston,285,0,7,16,0,2,25
North Carolina,Goldsboro,35952,459,399,2033,1589,1724,6204
North Carolina,Godwin,140,0,0,6,9,2,17
North Carolina,Gloucester,681,0,0,42,11,28,81
North Carolina,Glenville,48,0,0,0,0,0,0
North Carolina,Glen Raven,2607,37,92,117,148,53,447
North Carolina,Glen Alpine,1513,3,20,67,82,84,256
North Carolina,Gibsonville,6634,82,96,335,261,291,1065
North Carolina,Belvoir,463,0,0,31,51,34,116
North Carolina,Oakboro,1924,36,20,111,123,104,394
North Carolina,Keener,836,34,23,0,84,64,205
North Carolina,Oriental,926,0,0,30,15,35,80
North Carolina,Ogden,6802,235,87,358,261,263,1204
North Carolina,Ocracoke,486,0,0,71,0,0,71
North Carolina,Ocean Isle Beach,678,0,3,13,15,9,40
North Carolina,Oak Ridge,6513,144,56,463,410,392,1465
North Carolina,Oak Island,7199,71,114,183,149,303,820
North Carolina,Oak City,371,3,4,23,13,52,95
North Carolina,Tobaccoville village,2537,34,32,108,183,184,541
North Carolina,Toast,1293,13,0,13,32,48,106
North Carolina,Thomasville,27084,488,383,1691,1351,1419,5332
North Carolina,Teachey,345,7,2,30,12,29,80
North Carolina,Taylortown,1100,0,25,45,84,74,228
North Carolina,Taylorsville,2183,51,37,171,98,135,492
North Carolina,Tar Heel,173,0,0,13,4,0,17
North Carolina,Tarboro,11292,232,75,380,380,441,1508
North Carolina,Tabor City,3946,7,59,171,166,127,530
North Carolina,Old Fort,1033,8,0,31,53,47,139
North Carolina,Old Hundred,371,0,0,96,0,31,127
North Carolina,Orrum,52,0,1,2,0,0,3
North Carolina,Ossipee,692,5,0,24,28,37,94
North Carolina,Pinetown,71,0,0,0,0,0,0
North Carolina,Pinetops,1161,9,7,54,85,90,245
North Carolina,Pine Level,1991,19,31,112,104,185,451
North Carolina,Pine Knoll Shores,1515,36,28,51,35,17,167
North Carolina,Pinehurst village,15313,240,100,449,519,388,1696
North Carolina,Pinebluff,1255,21,0,63,63,44,191
North Carolina,Pilot Mountain,1725,26,13,128,86,126,379
North Carolina,Sylva,2597,57,22,131,132,100,442
North Carolina,Pikeville,751,0,16,28,47,32,123
North Carolina,Peletier,866,5,13,34,42,70,164
North Carolina,Peachland,396,2,4,12,22,22,62
North Carolina,Patterson Springs,662,12,12,85,32,42,183
North Carolina,Parmele,334,6,0,3,10,7,26
North Carolina,Parkton,560,11,7,35,26,27,106
North Carolina,Pantego,222,3,5,15,10,16,49
North Carolina,Oxford,8650,39,70,423,532,451,1515
North Carolina,Pembroke,3002,43,44,180,85,100,452
North Carolina,Swepsonville,1275,51,14,56,70,66,257
North Carolina,Swansboro,2956,30,49,98,127,198,502
North Carolina,Swan Quarter,344,0,0,0,51,28,79
North Carolina,Staley,363,4,6,41,27,17,95
North Carolina,Spruce Pine,2444,96,36,131,116,115,494
North Carolina,Spring Lake,13336,406,283,906,733,517,2845
North Carolina,Spring Hope,1289,12,2,28,65,85,192
North Carolina,Spivey's Corner,492,0,12,0,41,20,73
North Carolina,Spindale,4279,23,0,220,97,215,555
North Carolina,Aberdeen,6914,79,101,290,349,439,1258
North Carolina,Stallings,14495,275,192,845,825,1273,3410
North Carolina,Advance,951,0,20,24,153,19,216
North Carolina,Alamance village,871,3,13,41,36,50,143
North Carolina,Sims,333,2,6,9,27,6,50
North Carolina,Alliance,696,3,11,37,30,74,155
North Carolina,Altamahaw,465,0,0,11,44,22,77
North Carolina,Andrews,2050,30,94,108,163,23,418
North Carolina,Angier,4855,75,12,300,408,233,1028
North Carolina,Ansonville,720,5,5,28,42,62,142
North Carolina,Ahoskie,4976,67,126,298,244,211,946
North Carolina,Pineville,8066,119,184,514,215,199,1231
North Carolina,Stanfield,1612,19,31,116,94,102,362
North Carolina,Stantonsburg,814,6,8,44,51,31,140
North Carolina,Swannanoa,4685,53,66,96,147,321,683
North Carolina,Surf City,2481,101,5,125,54,63,348
North Carolina,Sunset Beach,3695,4,25,17,23,17,86
North Carolina,Sunbury,284,0,0,28,8,30,66
North Carolina,Summerfield,10622,294,226,616,611,919,2666
North Carolina,Sugar Mountain village,465,0,4,25,18,10,57
North Carolina,Stovall,388,0,12,14,13,10,49
North Carolina,Stanley,3615,48,23,177,279,202,729
North Carolina,Stony Point,1770,21,0,102,122,92,337
North Carolina,Stoneville,1295,8,0,106,47,45,206
North Carolina,Stokesdale,5221,69,8,325,347,331,1080
North Carolina,Stokes,361,0,0,0,0,0,0
North Carolina,Stem,859,1,20,71,23,60,175
North Carolina,Stedman,1313,4,21,99,124,111,359
North Carolina,Statesville,25443,340,440,1441,1502,1484,5207
North Carolina,Star,870,0,12,22,10,37,81
North Carolina,Stonewall,215,0,8,8,14,18,48
North Carolina,Piney Green,13738,154,208,832,768,796,2758
North Carolina,Kannapolis,44520,577,839,2560,2711,2414,9101
North Carolina,Pink Hill,466,1,6,19,37,44,107
North Carolina,Sawmills,5130,55,79,249,254,291,928
North Carolina,Saratoga,493,5,0,27,51,27,110
North Carolina,Sanford,28988,399,569,1762,1742,1579,6051
North Carolina,Sandyfield,473,15,12,19,15,15,76
North Carolina,Sandy Creek,304,6,5,31,19,7,68
North Carolina,Salvo,240,23,0,80,0,0,103
North Carolina,Saluda,656,5,30,14,23,19,91
North Carolina,Saxapahaw,1430,0,55,84,14,26,179
North Carolina,Salisbury,33653,345,458,1576,1315,1542,5236
North Carolina,Salem,2182,51,51,179,40,46,367
North Carolina,St. Stephens,8954,183,165,752,367,383,1850
North Carolina,St. Pauls,2223,33,42,111,75,171,432
North Carolina,St. James,4050,0,0,0,0,0,0
North Carolina,St. Helena village,393,0,2,35,23,14,74
North Carolina,Rutherfordton,4193,25,0,150,167,262,604
North Carolina,Rutherford College,1420,6,20,31,33,81,171
North Carolina,Salemburg,374,10,0,0,4,29,43
North Carolina,Ruth,439,2,7,14,17,15,55
North Carolina,Scotch Meadows,572,13,0,16,12,24,65
North Carolina,Seaboard,736,18,0,36,39,20,113
North Carolina,Simpson village,383,8,1,10,20,34,73
North Carolina,Silver Lake,5874,79,44,247,292,491,1153
North Carolina,Silver City,914,0,15,0,20,0,35
North Carolina,Siler City,8193,82,153,512,566,337,1650
North Carolina,Shelby,20245,277,492,827,768,881,3245
North Carolina,Sharpsburg,2228,19,34,150,216,109,528
North Carolina,Shannon,345,0,0,46,19,24,89
North Carolina,Scotland Neck,1613,14,13,14,39,17,97
North Carolina,Shallotte,3816,28,0,175,163,113,479
North Carolina,Seven Springs,76,5,0,4,0,0,9
North Carolina,Seven Lakes,4806,0,67,417,193,364,1041
North Carolina,Seven Devils,240,1,0,2,4,3,10
North Carolina,Selma,6220,114,238,320,379,412,1463
North Carolina,Sedalia,563,11,5,12,3,24,55
North Carolina,Seagrove,308,0,0,28,15,17,60
North Carolina,Sea Breeze,1971,0,63,33,143,82,321
North Carolina,Severn,233,0,0,0,7,2,9
North Carolina,Apex,42220,1053,896,2764,3371,3142,11226
North Carolina,Rural Hall,3046,42,3,73,99,170,387
North Carolina,Tyro,3525,43,55,174,225,183,680
North Carolina,Prospect,921,15,0,25,74,52,166
North Carolina,Proctorville,176,2,0,5,8,19,34
North Carolina,Princeville,2188,49,33,145,153,116,496
North Carolina,Princeton,1310,3,21,101,77,47,249
North Carolina,Powellsville,279,25,0,37,0,10,72
North Carolina,Potters Hill,523,0,0,72,0,28,100
North Carolina,Porters Neck,6500,131,106,442,275,123,1077
North Carolina,Pumpkin Center,1869,0,14,39,48,141,242
North Carolina,Pollocksville,463,58,9,23,2,9,101
North Carolina,Polkton,3372,14,60,113,110,216,513
North Carolina,Plymouth,3736,60,173,193,115,312,853
North Carolina,Pleasant Hill,621,13,0,0,13,69,95
North Carolina,Pleasant Garden,4632,21,20,307,240,203,791
North Carolina,Plain View,2450,30,23,259,55,67,434
North Carolina,Pittsboro,3992,95,44,223,106,81,549
North Carolina,Pinnacle,690,0,0,47,0,51,98
North Carolina,Polkville,496,4,5,16,23,19,67
North Carolina,Ruffin,286,0,6,18,6,0,30
North Carolina,Raeford,4830,90,61,425,269,324,1169
North Carolina,Raleigh,432520,8201,5828,22891,20083,20384,77387
North Carolina,Unionville,6295,105,42,373,379,498,1397
North Carolina,Valdese,4471,0,26,145,182,164,517
North Carolina,Rich Square,927,1,18,10,38,64,131
North Carolina,Richlands,2394,35,41,201,238,93,608
North Carolina,Richfield,653,4,9,60,32,43,148
North Carolina,Rhodhiss,846,6,2,35,26,43,112
North Carolina,Rex,65,0,0,0,0,0,0
North Carolina,Raemon,135,0,18,24,9,0,51
North Carolina,Rennert,369,6,5,5,13,22,51
North Carolina,Red Springs,3451,0,37,270,310,346,963
North Carolina,Red Oak,3428,52,46,159,234,217,708
North Carolina,Red Cross,706,0,13,39,35,28,115
North Carolina,Raynham,59,0,0,4,8,3,15
North Carolina,Ranlo,3496,32,42,185,130,291,680
North Carolina,Randleman,4136,170,15,281,133,230,829
North Carolina,Ramseur,1926,12,12,96,166,110,396
North Carolina,Reidsville,14191,269,146,571,721,692,2399
North Carolina,Zebulon,4690,29,30,359,521,452,1391
North Carolina,Albemarle,15969,275,225,721,952,943,3116
North Carolina,Yanceyville,2080,34,4,81,95,83,297
North Carolina,Wilson's Mills,2662,38,55,200,164,135,592
North Carolina,Windsor,3652,41,11,119,104,222,497
North Carolina,Winfall,624,2,0,41,22,43,108
North Carolina,Wingate,3742,17,31,100,254,225,627
North Carolina,Winston-Salem,236642,3572,3486,12892,11873,11264,43087
North Carolina,Winterville,9464,189,122,493,611,509,1924
North Carolina,Wilson,49478,588,728,2767,2796,2366,9245
North Carolina,Winton,842,9,8,52,35,29,133
North Carolina,Woodland,867,17,8,68,32,27,152
North Carolina,Aquadale,298,0,0,9,11,12,32
North Carolina,Arapahoe,498,2,7,6,9,19,43
North Carolina,Archdale,11396,74,135,495,627,603,1934
North Carolina,Archer Lodge,4521,0,85,227,567,290,1169
North Carolina,Asheboro,25897,279,289,1890,1516,1094,5068
North Carolina,Woodfin,6204,25,102,328,325,243,1023
North Carolina,Skippers Corner,2883,50,47,154,96,98,445
North Carolina,Wilmington,111998,1543,1191,4696,4567,4045,16042
North Carolina,Wilkesboro,3548,89,12,301,263,130,795
North Carolina,Wendell,6169,65,90,568,395,422,1540
North Carolina,Wentworth,2762,14,37,133,182,202,568
North Carolina,Wesley Chapel village,8010,164,79,537,800,735,2315
North Carolina,West Canton,1346,8,10,75,58,52,203
North Carolina,West Jefferson,1232,3,20,37,16,47,123
North Carolina,West Marion,1413,15,18,62,99,92,286
North Carolina,Williamston,5569,126,84,264,254,255,983
North Carolina,Westport,3708,98,28,145,262,160,693
North Carolina,Whitakers,898,2,8,41,37,47,135
North Carolina,White Lake,1248,6,2,68,77,31,184
North Carolina,Youngsville,1394,6,37,86,76,80,285
North Carolina,White Plains,1075,0,3,73,31,3,110
North Carolina,Whiteville,5512,116,35,258,251,302,962
North Carolina,Whitsett,756,2,6,26,47,38,119
North Carolina,Whispering Pines village,3067,109,29,268,293,118,817
North Carolina,Smithfield,11562,96,180,472,372,520,1640
North Carolina,Sneads Ferry,3714,17,51,271,304,172,815
North Carolina,Snow Hill,1847,29,25,97,78,114,343
North Carolina,Autryville,426,0,0,13,2,13,28
North Carolina,Avery Creek,2493,48,17,78,151,114,408
North Carolina,Avon,926,38,20,0,41,27,126
North Carolina,Ayden,5035,60,90,240,375,360,1125
North Carolina,Badin,1895,0,8,14,46,52,120
North Carolina,Spencer Mountain,21,0,0,4,0,0,4
North Carolina,Aurora,505,2,23,33,11,8,77
North Carolina,Topsail Beach,356,4,3,11,3,0,21
North Carolina,Trent Woods,4212,38,47,139,228,178,630
North Carolina,Trinity,6652,54,13,315,562,315,1259
North Carolina,Troutman,2476,47,59,164,113,191,574
North Carolina,Troy,3446,78,64,139,156,107,544
North Carolina,Tryon,1624,0,27,27,60,108,222
North Carolina,Turkey,280,5,1,6,28,7,47
North Carolina,Trenton,363,2,2,44,21,15,84
North Carolina,Aulander,785,46,21,63,45,32,207
North Carolina,Atlantic Beach,1596,0,16,4,36,44,100
North Carolina,Atlantic,417,16,4,0,16,4,40
North Carolina,Southern Pines,13018,280,90,421,604,510,1905
North Carolina,Southern Shores,2789,3,37,70,139,117,366
North Carolina,South Henderson,735,0,5,15,33,55,108
North Carolina,South Mills,196,0,0,0,0,0,0
North Carolina,Southmont,1422,0,0,16,109,74,199
North Carolina,Southport,3154,167,18,132,57,72,446
North Carolina,South Rosemary,2736,35,15,111,215,110,486
North Carolina,South Weldon,696,31,8,23,65,75,202
North Carolina,Sparta,1802,8,10,107,41,48,214
North Carolina,Speed,95,0,0,0,0,4,4
North Carolina,Spencer,3276,22,0,147,182,119,470
North Carolina,Asheville,86789,1343,989,3731,3263,3174,12500
North Carolina,Ashley Heights,394,0,21,13,33,43,110
North Carolina,Askewville,231,1,0,9,8,8,26
North Carolina,Atkinson,378,2,0,25,23,27,77
North Carolina,Weldon,1623,25,29,98,79,78,309
North Carolina,Welcome,4743,136,15,311,255,243,960
North Carolina,White Oak,309,0,0,22,0,18,40
North Carolina,Webster,409,9,20,16,13,20,78
North Carolina,Roper,445,0,9,44,44,34,131
North Carolina,Roseboro,1655,21,16,75,172,129,413
North Carolina,Weddington,10091,311,84,532,476,911,2314
North Carolina,Rosman,721,4,5,36,42,42,129
North Carolina,Rougemont,838,0,18,64,13,28,123
North Carolina,Rowland,1227,4,14,79,38,54,189
North Carolina,Ronda,461,3,5,27,14,31,80
North Carolina,Roxboro,8316,113,92,298,536,442,1481
North Carolina,Royal Pines,5084,95,127,111,236,527,1096
North Carolina,Valle Crucis,226,7,0,0,8,0,15
North Carolina,Valley Hill,2269,26,0,135,55,17,233
North Carolina,Vanceboro,1199,15,55,59,53,78,260
North Carolina,Vandemere,271,2,1,11,2,4,20
North Carolina,Vander,1097,23,18,55,6,61,163
North Carolina,Roxobel,290,0,1,2,21,19,43
North Carolina,Rolesville,5006,86,119,409,269,209,1092
North Carolina,Rodanthe,270,0,0,0,18,32,50
North Carolina,Rocky Point,1967,34,40,28,219,197,518
North Carolina,Yadkinville,2946,32,29,185,138,88,472
North Carolina,Wrightsville Beach,2540,24,13,79,64,103,283
North Carolina,Wrightsboro,5525,55,30,296,295,169,845
North Carolina,Woodlawn,726,13,6,31,16,72,138
North Carolina,Riegelwood,390,12,0,0,7,6,25
North Carolina,River Bend,3161,0,60,72,75,89,296
North Carolina,River Road,4124,0,29,100,202,180,511
North Carolina,Roanoke Rapids,15557,216,237,829,1173,1325,3780
North Carolina,Robbins,1201,11,12,98,107,114,342
North Carolina,Robbinsville,575,0,6,26,11,44,87
North Carolina,Robersonville,1501,9,28,36,74,46,193
North Carolina,Rockfish,3810,131,0,364,171,206,872
North Carolina,Rockingham,9376,95,122,543,584,493,1837
North Carolina,Rockwell,1932,10,3,151,104,111,379
North Carolina,Rocky Mount,56642,599,909,2971,3148,3635,11262
North Carolina,Vann Crossroads,406,0,0,9,47,35,91
North Carolina,Varnamtown,576,18,0,22,19,44,103
North Carolina,Rose Hill,1844,28,19,149,98,174,468
North Carolina,Waco,322,0,7,21,13,9,50
North Carolina,Vass,637,11,6,25,50,33,125
North Carolina,Washington,9777,229,184,470,433,419,1735
North Carolina,Washington Park,563,3,4,17,36,41,101
North Carolina,Watha,216,0,1,16,17,13,47
North Carolina,Waves,65,0,0,0,0,0,0
North Carolina,Waxhaw,11586,424,123,898,941,675,3061
North Carolina,Waynesville,9748,63,125,403,212,258,1061
North Carolina,Weaverville,3834,25,41,224,119,253,662
North Carolina,Warrenton,932,0,22,33,50,55,160
North Carolina,Wanchese,1475,17,21,137,54,49,278
North Carolina,Warsaw,3168,106,64,90,123,173,556
North Carolina,Walnut Creek village,870,4,9,14,70,52,149
North Carolina,Walnut Cove,1751,12,18,80,70,81,261
North Carolina,Wallburg,3067,15,13,156,186,181,551
North Carolina,Wallace,3962,0,40,116,0,254,410
North Carolina,Walkertown,4839,38,17,186,278,297,816
North Carolina,Wakulla,200,0,0,14,13,13,40
North Carolina,Wake Forest,34786,859,630,2520,2480,2262,8751
North Carolina,Wagram,897,16,11,34,52,63,176
North Carolina,Wadesboro,5664,78,175,289,152,282,976
North Carolina,Wade,562,21,9,40,36,13,119
North Carolina,Walstonburg,317,5,2,16,11,26,60
North Dakota,New Town,2306,43,40,146,225,165,619
North Dakota,Niagara,61,2,0,1,0,15,18
North Dakota,Nome,62,5,6,3,0,1,15
North Dakota,Noonan,188,0,9,7,0,0,16
North Dakota,New Salem,831,8,20,52,21,40,141
North Dakota,Lakota,588,2,12,32,19,22,87
North Dakota,Northwood,740,14,3,36,37,28,118
North Dakota,Oakes,1975,39,34,105,46,90,314
North Dakota,New Rockford,1428,45,21,87,60,60,273
North Dakota,Oberon,173,7,0,19,20,16,62
North Dakota,Oriska,80,0,3,6,3,10,22
North Dakota,Orrin,0,0,0,0,0,0,0
North Dakota,Osnabrock,114,4,0,4,0,0,8
North Dakota,North River,59,2,2,4,0,1,9
North Dakota,New Leipzig,248,0,1,5,12,3,21
North Dakota,Munich,249,7,3,23,10,2,45
North Dakota,Newburg,134,2,7,16,14,0,39
North Dakota,Jud,62,2,2,8,0,4,16
North Dakota,Karlsruhe,84,4,0,6,3,6,19
North Dakota,Kathryn,72,1,0,0,1,0,2
North Dakota,LaMoure,931,10,12,49,63,57,191
North Dakota,Landa,54,0,1,2,2,2,7
North Dakota,Kenmare,975,10,12,37,53,51,163
North Dakota,Kensal,201,0,0,4,1,9,14
North Dakota,Kief,9,0,0,0,0,0,0
North Dakota,Killdeer,851,5,32,28,33,47,145
North Dakota,New England,579,4,2,11,7,28,52
North Dakota,Kindred,709,20,16,62,34,45,177
North Dakota,Kramer,40,0,0,0,0,0,0
North Dakota,Kulm,333,4,1,27,11,11,54
North Dakota,Mooreton,231,0,0,15,11,30,56
North Dakota,Mott,760,8,9,37,54,39,147
North Dakota,Mylo,10,0,0,0,0,0,0
North Dakota,Napoleon,767,2,3,39,21,44,109
North Dakota,Nash,6,0,0,0,0,0,0
North Dakota,Neche,361,1,8,24,29,15,77
North Dakota,Nekoma,34,0,0,0,3,5,8
North Dakota,Knox,34,0,0,0,0,0,0
North Dakota,Langdon,1833,29,27,78,90,61,285
North Dakota,Mountain,85,2,0,0,0,0,2
North Dakota,Lansford,358,17,1,48,23,2,91
North Dakota,McVille,321,0,5,9,8,3,25
North Dakota,McLeod,14,0,0,0,0,0,0
North Dakota,McHenry,111,0,3,6,3,8,20
North Dakota,McClusky,302,0,19,0,12,12,43
North Dakota,Luverne,56,0,0,0,0,0,0
North Dakota,Ludden,36,1,1,3,0,0,5
North Dakota,Loraine,3,0,0,0,0,1,1
North Dakota,Loma,10,0,0,0,0,5,5
North Dakota,Wishek,947,8,11,24,34,19,96
North Dakota,Wing,127,0,0,3,5,4,12
North Dakota,Wimbledon,274,7,5,27,23,11,73
North Dakota,Wilton,921,0,26,61,41,75,203
North Dakota,Willow City,178,0,0,6,20,2,28
North Dakota,Williston,22051,502,376,997,826,916,3617
North Dakota,Wildrose,87,0,2,7,0,0,9
North Dakota,White Shield,384,5,2,45,22,22,96
North Dakota,White Earth,149,0,7,12,15,18,52
North Dakota,Wheatland,57,0,0,0,0,0,0
North Dakota,Westhope,450,6,0,16,3,20,45
North Dakota,West Fargo,29892,556,531,1535,1627,1628,5877
North Dakota,Watford City,3728,113,44,193,252,249,851
North Dakota,Washburn,1421,39,35,103,39,61,277
North Dakota,Warwick,44,0,0,0,5,4,9
North Dakota,Walhalla,1084,11,17,45,66,79,218
North Dakota,Wales,37,0,3,0,0,2,5
North Dakota,Walcott,223,5,7,14,6,4,36
North Dakota,Wahpeton,7835,89,40,264,253,252,898
North Dakota,Maddock,372,0,4,31,34,13,82
North Dakota,Makoti,165,8,0,16,4,5,33
North Dakota,Mandan,19962,586,207,984,738,807,3322
North Dakota,Mandaree,806,24,7,90,98,66,285
North Dakota,Erie,149,0,0,9,30,20,59
North Dakota,Esmond,81,0,0,0,3,2,5
North Dakota,Fairdale,32,0,0,1,3,4,8
North Dakota,Fairmount,363,4,0,24,21,36,85
North Dakota,Montpelier,98,0,0,5,7,12,24
North Dakota,Monango,54,6,0,1,16,7,30
North Dakota,Mohall,703,8,12,29,21,45,115
North Dakota,Minto,573,0,9,33,51,11,104
North Dakota,Minot AFB,5890,113,90,176,308,206,893
North Dakota,Minot,46194,363,787,2465,1844,1969,7428
North Dakota,Minnewaukan,226,0,7,5,5,5,22
North Dakota,Milton,60,0,0,0,3,3,6
North Dakota,Milnor,591,5,5,25,29,26,90
North Dakota,Voltaire,45,0,1,0,0,5,6
North Dakota,Michigan City,203,7,0,9,1,4,21
North Dakota,Menoken,82,0,0,0,9,6,15
North Dakota,Medora,184,4,0,2,2,5,13
North Dakota,Medina,297,19,2,22,9,21,73
North Dakota,Mayville,1787,0,45,84,34,65,228
North Dakota,Maxbass,94,0,0,6,1,21,28
North Dakota,Max,327,3,3,20,20,38,84
North Dakota,Martin,96,0,2,4,8,8,22
North Dakota,Marmarth,154,0,0,9,3,12,24
North Dakota,Marion,139,0,0,1,3,11,15
North Dakota,Mapleton,798,15,4,77,61,44,201
North Dakota,Manvel,405,24,4,18,21,13,80
North Dakota,Mantador,82,0,0,5,5,0,10
North Dakota,Manning,22,0,0,0,0,0,0
North Dakota,Mercer,57,0,3,4,2,0,9
North Dakota,Lankin,129,2,2,4,2,3,13
North Dakota,Verona,77,6,0,0,1,2,9
North Dakota,Velva,1132,15,18,99,81,33,246
North Dakota,Sheldon,80,1,1,0,3,1,6
North Dakota,Sharon,83,0,2,3,0,4,9
North Dakota,Sentinel Butte,90,0,10,11,0,0,21
North Dakota,Selz,7,0,0,0,0,0,0
North Dakota,Selfridge,216,8,7,24,29,16,84
North Dakota,Scranton,317,2,12,13,17,16,60
North Dakota,Sawyer,336,6,1,9,9,20,45
North Dakota,Sarles,17,0,0,0,0,0,0
North Dakota,Sanborn,149,0,0,7,4,8,19
North Dakota,St. Thomas,310,2,1,17,15,9,44
North Dakota,St. John,291,8,9,8,32,8,65
North Dakota,Logan,204,13,0,13,0,8,34
North Dakota,Litchville,152,1,1,6,2,7,17
North Dakota,Lisbon,2081,25,35,76,137,118,391
North Dakota,Linton,1042,6,19,33,35,76,169
North Dakota,Lincoln,3093,57,36,176,127,147,543
North Dakota,Lignite,91,0,0,1,1,2,4
North Dakota,Lidgerwood,706,8,10,21,21,51,111
North Dakota,Leonard,317,9,3,33,22,6,73
North Dakota,Leith,22,0,0,3,0,0,3
North Dakota,Lehr,76,0,0,0,0,0,0
North Dakota,Leeds,505,5,14,40,40,23,122
North Dakota,Leal,19,0,0,0,0,2,2
North Dakota,Lawton,20,0,0,0,0,0,0
North Dakota,Overly,23,1,2,2,0,0,5
North Dakota,Larson,6,0,0,0,0,0,0
North Dakota,Larimore,1513,45,28,75,129,81,358
North Dakota,Shell Valley,1396,41,13,162,74,30,320
North Dakota,Sherwood,226,1,0,17,15,11,44
North Dakota,Sheyenne,192,0,5,5,7,5,22
North Dakota,Sibley,33,0,0,5,0,2,7
North Dakota,Valley City,6626,47,107,160,229,150,693
North Dakota,Upham,225,8,5,11,7,22,53
North Dakota,Underwood,791,8,12,40,26,31,117
North Dakota,Tuttle,89,0,5,0,0,0,5
North Dakota,Turtle Lake,476,3,0,7,15,12,37
North Dakota,Towner,493,4,2,16,21,15,58
North Dakota,Tower City,288,2,3,16,6,26,53
North Dakota,Tolna,170,2,2,0,6,5,15
North Dakota,Tolley,29,0,0,1,1,0,2
North Dakota,Tioga,1072,0,13,53,48,50,164
North Dakota,Thompson,1067,12,6,70,78,72,238
North Dakota,Taylor,221,0,0,8,20,4,32
North Dakota,Tappen,265,0,0,17,17,3,37
North Dakota,Venturia,35,0,0,0,0,0,0
North Dakota,Sykeston,116,0,0,4,9,1,14
North Dakota,Surrey,1054,7,7,66,38,18,136
North Dakota,Streeter,83,0,0,0,0,4,4
North Dakota,Strasburg,439,4,1,6,37,22,70
North Dakota,Steele,781,7,5,56,51,40,159
North Dakota,Starkweather,123,0,4,9,11,2,26
North Dakota,Stanton,380,0,3,32,12,19,66
North Dakota,Stanley,2118,12,10,111,96,176,405
North Dakota,Springbrook,10,0,0,0,0,0,0
North Dakota,Spiritwood Lake,106,0,0,0,12,4,16
North Dakota,Spiritwood,7,0,0,0,0,0,0
North Dakota,South Heart,295,11,6,20,17,7,61
North Dakota,Souris,68,0,0,14,8,1,23
North Dakota,Solen,75,4,5,7,2,1,19
North Dakota,Sutton,9,0,0,0,0,0,0
North Dakota,Oxbow,411,8,5,48,48,43,152
North Dakota,Conway,9,0,0,2,0,0,2
North Dakota,Palermo,130,0,2,3,0,0,5
North Dakota,Balta,150,8,14,22,0,17,61
North Dakota,Balfour,9,0,0,0,0,0,0
North Dakota,Ayr,20,0,0,0,0,0,0
North Dakota,Auburn,24,0,0,0,5,0,5
North Dakota,Ashley,771,7,12,21,43,28,111
North Dakota,Arthur,385,11,9,19,33,18,90
North Dakota,Arnegard,88,5,0,0,0,0,5
North Dakota,Argusville,449,9,10,42,54,43,158
North Dakota,Ardoch,98,0,0,9,8,2,19
North Dakota,Antler,10,0,0,0,0,0,0
North Dakota,Aneta,263,3,0,4,8,2,17
North Dakota,Anamoose,286,12,0,12,11,5,40
North Dakota,Bantry,18,0,0,0,0,1,1
North Dakota,Amidon,32,0,0,0,0,0,0
North Dakota,Ambrose,19,0,0,0,0,0,0
North Dakota,Alsen,63,2,0,5,9,7,23
North Dakota,Almont,132,0,0,8,5,7,20
North Dakota,Alice,33,1,0,0,2,0,3
North Dakota,Alexander,225,0,12,21,3,8,44
North Dakota,Alamo,72,0,3,4,1,9,17
North Dakota,Adams,142,0,1,1,1,7,10
North Dakota,Abercrombie,251,0,1,33,17,24,75
North Dakota,Forman,560,6,8,54,16,31,115
North Dakota,Fort Ransom,107,0,0,1,0,1,2
North Dakota,Fort Totten,1284,48,42,211,108,110,519
North Dakota,Fortuna,47,0,0,7,10,0,17
North Dakota,Amenia,83,3,0,8,4,0,15
North Dakota,Fort Yates,212,1,4,22,19,15,61
North Dakota,Barney,55,0,2,2,2,2,8
North Dakota,Bathgate,52,0,0,0,0,0,0
North Dakota,Butte,51,0,0,3,4,2,9
North Dakota,Burlington,1234,17,27,90,58,21,213
North Dakota,Buffalo,173,3,5,5,4,5,22
North Dakota,Bucyrus,19,0,0,0,3,0,3
North Dakota,Buchanan,43,0,0,0,4,0,4
North Dakota,Brooktree Park,18,0,0,0,0,0,0
North Dakota,Brocket,89,0,5,4,7,11,27
North Dakota,Brinsmade,81,0,0,4,8,5,17
North Dakota,Briarwood,67,0,1,3,9,11,24
North Dakota,Braddock,8,0,0,0,0,0,0
North Dakota,Bowman,1677,10,35,91,54,47,237
North Dakota,Bowdon,123,0,2,4,4,0,10
North Dakota,Barton,10,0,0,0,0,0,0
North Dakota,Bowbells,402,0,8,10,19,21,58
North Dakota,Blanchard,11,0,0,0,0,0,0
North Dakota,Bismarck,66980,911,1066,3213,2808,2786,10784
North Dakota,Bisbee,159,0,4,0,8,5,17
North Dakota,Binford,157,6,5,4,6,4,25
North Dakota,Beulah,3286,85,48,115,233,176,657
North Dakota,Berthold,372,8,1,34,28,34,105
North Dakota,Berlin,31,0,0,0,4,0,4
North Dakota,Bergen,12,0,0,0,0,0,0
North Dakota,Benedict,71,3,5,2,0,3,13
North Dakota,Belfield,969,13,0,62,29,39,143
North Dakota,Belcourt,1904,37,41,167,121,70,436
North Dakota,Beach,955,16,11,48,49,28,152
North Dakota,Bottineau,2273,18,34,38,91,98,279
North Dakota,Four Bears Village,702,26,17,109,37,54,243
North Dakota,Foxholm,58,0,4,4,4,5,17
North Dakota,Fredonia,46,0,0,0,2,0,2
North Dakota,Hampden,36,0,0,1,1,2,4
North Dakota,Hankinson,997,0,12,53,66,47,178
North Dakota,Hannaford,106,0,0,0,1,2,3
North Dakota,Hannah,10,0,0,0,0,0,0
North Dakota,Hansboro,15,0,0,0,0,1,1
North Dakota,Harmon,212,9,9,8,11,15,52
North Dakota,Harvey,1920,10,21,153,40,58,282
North Dakota,Harwood,869,22,19,51,30,60,182
North Dakota,Hatton,653,18,4,21,38,35,116
North Dakota,Havana,69,0,0,0,0,0,0
North Dakota,Haynes,12,0,0,0,0,0,0
North Dakota,Hazelton,223,4,2,29,13,5,53
North Dakota,Hamilton,61,0,0,0,0,3,3
North Dakota,Hazen,2578,12,32,53,152,124,373
North Dakota,Heil,17,0,0,0,0,0,0
North Dakota,Heimdal,5,0,0,0,0,0,0
North Dakota,Hettinger,1233,14,25,53,62,43,197
North Dakota,Hillsboro,1673,28,19,68,83,121,319
North Dakota,Hoople,301,5,0,8,25,16,54
North Dakota,Hope,372,4,0,3,17,27,51
North Dakota,Horace,2523,43,35,181,179,149,587
North Dakota,Hunter,353,7,0,34,33,27,101
North Dakota,Hurdsfield,58,5,0,5,0,0,10
North Dakota,Inkster,30,0,0,1,1,2,4
North Dakota,Jamestown,15418,175,168,658,645,690,2336
North Dakota,Jessie,35,0,0,0,7,0,7
North Dakota,Hebron,831,15,4,60,58,47,184
North Dakota,Hamberg,16,0,0,0,0,0,0
North Dakota,Halliday,305,0,10,30,15,6,61
North Dakota,Hague,57,2,0,3,0,3,8
North Dakota,Frontier,219,3,3,6,8,7,27
North Dakota,Fullerton,64,0,0,0,4,2,6
North Dakota,Gackle,371,6,7,15,11,19,58
North Dakota,Galesburg,131,0,0,5,0,6,11
North Dakota,Gardena,11,0,0,0,0,0,0
North Dakota,Gardner,88,3,0,10,3,0,16
North Dakota,Garrison,1377,12,10,81,39,82,224
North Dakota,Gascoyne,11,0,0,0,0,0,0
North Dakota,Gilby,215,4,6,5,4,12,31
North Dakota,Gladstone,366,2,4,36,10,9,61
North Dakota,Glenburn,529,4,15,49,23,21,112
North Dakota,Glenfield,99,0,2,7,3,0,12
North Dakota,Glen Ullin,716,4,3,19,34,45,105
North Dakota,Golden Valley,277,5,4,10,13,13,45
North Dakota,Golva,103,0,0,0,0,8,8
North Dakota,Goodrich,149,0,4,2,4,9,19
North Dakota,Grace City,58,0,0,4,7,1,12
North Dakota,Grafton,4282,68,115,174,180,227,764
North Dakota,Grand Forks,54944,704,682,2056,2117,1938,7497
North Dakota,Grand Forks AFB,2663,33,88,210,114,51,496
North Dakota,Grandin,211,3,5,14,12,11,45
North Dakota,Grano,3,0,0,0,0,0,0
North Dakota,Granville,279,0,0,5,21,17,43
North Dakota,Great Bend,69,0,2,3,4,4,13
North Dakota,Green Acres,784,29,14,82,39,55,219
North Dakota,Grenora,236,0,11,12,14,18,55
North Dakota,Gwinner,862,12,10,13,71,51,157
North Dakota,Buxton,346,9,15,24,19,21,88
North Dakota,Page,283,0,4,27,21,20,72
North Dakota,Caledonia,20,0,0,0,0,0,0
North Dakota,Calvin,8,0,0,0,2,0,2
North Dakota,Rolette,679,6,9,40,49,15,119
North Dakota,Rolla,1316,41,24,77,28,57,227
North Dakota,Ross,88,0,0,0,0,0,0
North Dakota,Rugby,3112,38,116,123,61,102,440
North Dakota,Ruso,8,0,0,2,1,2,5
North Dakota,Ruthville,220,0,2,15,30,18,65
North Dakota,Rutland,181,1,0,7,13,12,33
North Dakota,Ryder,122,2,0,4,7,21,34
North Dakota,Zeeland,100,0,3,0,10,7,20
North Dakota,Zap,209,1,10,4,10,5,30
North Dakota,Ypsilanti,80,0,0,0,0,0,0
North Dakota,York,43,0,0,0,0,0,0
North Dakota,Rogers,46,3,0,5,5,2,15
North Dakota,Wyndmere,479,6,11,50,17,20,104
North Dakota,Wolford,26,0,0,3,1,2,6
North Dakota,Fargo,113464,1700,1306,5139,4374,4057,16576
North Dakota,Fessenden,464,4,19,29,15,23,90
North Dakota,Fingal,94,0,1,1,1,2,5
North Dakota,Finley,421,1,4,14,20,18,57
North Dakota,Flasher,308,1,12,15,15,30,73
North Dakota,Flaxton,59,0,4,3,0,5,12
North Dakota,Forbes,33,1,1,2,2,1,7
North Dakota,Fordville,247,0,8,8,11,15,42
North Dakota,Enderlin,950,4,10,21,49,51,135
North Dakota,Emerado,360,3,3,15,5,3,29
North Dakota,Embden,67,0,0,0,0,0,0
North Dakota,Woodworth,28,0,0,0,0,0,0
North Dakota,Elliott,15,0,0,0,0,0,0
North Dakota,Rocklake,138,4,2,5,2,4,17
North Dakota,Riverdale,212,0,0,1,11,8,20
North Dakota,Park River,1480,41,0,75,62,74,252
North Dakota,Parshall,1071,3,19,77,79,49,227
North Dakota,Pekin,78,0,0,10,11,1,22
North Dakota,Pembina,570,1,7,37,47,33,125
North Dakota,Perth,7,0,0,0,0,1,1
North Dakota,Petersburg,196,3,0,10,14,7,34
North Dakota,Pettibone,63,0,1,2,1,4,8
North Dakota,Pick City,125,0,0,3,3,5,11
North Dakota,Pillsbury,18,0,0,0,0,0,0
North Dakota,Pingree,58,3,0,2,3,10,18
North Dakota,Pisek,112,5,2,7,6,8,28
North Dakota,Plaza,239,21,8,16,9,0,54
North Dakota,Robinson,33,2,0,0,0,0,2
North Dakota,Porcupine,222,15,0,40,24,17,96
North Dakota,Portland,583,2,6,52,22,18,100
North Dakota,Powers Lake,426,16,9,28,20,32,105
North Dakota,Prairie Rose,87,1,9,8,10,0,28
North Dakota,Raleigh,3,0,0,0,0,0,0
North Dakota,Ray,527,0,6,26,15,16,63
North Dakota,Reeder,159,0,0,7,1,10,18
North Dakota,Regan,57,0,0,9,3,0,12
North Dakota,Regent,205,4,0,4,11,4,23
North Dakota,Reile's Acres,511,9,9,62,44,46,170
North Dakota,Reynolds,302,2,3,17,20,22,64
North Dakota,Rhame,176,4,2,3,12,3,24
North Dakota,Richardton,662,12,19,35,26,26,118
North Dakota,Portal,114,2,2,6,10,5,25
North Dakota,Calio,6,0,0,0,0,0,0
North Dakota,Ellendale,1466,22,10,64,56,86,238
North Dakota,Egeland,25,0,0,0,0,0,0
North Dakota,Courtenay,47,0,0,2,2,6,10
North Dakota,Elgin,600,8,7,8,15,30,68
North Dakota,Epping,97,2,0,3,1,13,19
North Dakota,Columbus,219,0,5,10,29,24,68
North Dakota,Colfax,121,2,3,15,9,13,42
North Dakota,Coleharbor,63,1,0,1,0,2,4
North Dakota,Cogswell,78,0,0,0,0,0,0
North Dakota,Clifford,19,0,0,0,0,0,0
North Dakota,Cleveland,113,6,0,2,7,25,40
North Dakota,Churchs Ferry,5,0,0,0,0,0,0
North Dakota,Christine,140,0,1,3,10,7,21
North Dakota,Center,605,0,9,33,29,20,91
North Dakota,Cayuga,43,0,0,0,3,0,3
North Dakota,Cavalier,1230,25,8,58,85,47,223
North Dakota,Cathay,53,3,0,2,2,2,9
North Dakota,Casselton,2466,39,33,232,135,146,585
North Dakota,Carson,238,7,2,6,9,11,35
North Dakota,Carrington,2011,16,24,46,66,115,267
North Dakota,Forest River,126,1,2,13,4,9,29
North Dakota,Carpio,140,5,0,15,21,6,47
North Dakota,Canton City,14,0,0,0,0,0,0
North Dakota,Cannon Ball,908,15,5,83,97,82,282
North Dakota,Cando,1089,0,26,56,35,42,159
North Dakota,Crary,158,2,5,10,9,19,45
North Dakota,Crosby,1064,0,0,18,30,29,77
North Dakota,Cooperstown,1091,41,0,50,33,68,192
North Dakota,Dahlen,79,0,0,13,0,0,13
North Dakota,Edmore,171,0,0,6,14,0,20
North Dakota,Edinburg,170,2,0,3,3,2,10
North Dakota,Edgeley,590,13,0,36,34,13,96
North Dakota,East Fairview,56,0,0,10,0,1,11
North Dakota,East Dunseith,587,0,23,40,21,40,124
North Dakota,Dwight,81,0,0,4,4,2,10
North Dakota,Dunseith,822,12,17,37,17,14,97
North Dakota,Dunn Center,235,3,0,13,12,7,35
North Dakota,Crystal,142,1,1,1,3,7,13
North Dakota,Drayton,714,15,2,19,17,12,65
North Dakota,Drake,361,6,7,25,24,23,85
North Dakota,Douglas,53,0,2,1,5,4,12
North Dakota,Driscoll,74,7,0,3,0,7,17
North Dakota,Dodge,133,1,3,5,3,2,14
North Dakota,Davenport,244,6,3,12,16,10,47
North Dakota,Dawson,74,0,0,0,0,9,9
North Dakota,Dazey,118,0,4,15,0,13,32
North Dakota,Deering,122,0,2,0,2,0,4
North Dakota,De Lamere,30,3,0,4,0,0,7
North Dakota,Donnybrook,85,0,0,5,2,9,16
North Dakota,Englevale,130,0,0,0,37,29,66
North Dakota,Denhoff,14,0,0,0,0,0,0
North Dakota,Des Lacs,228,4,3,7,16,8,38
North Dakota,Devils Lake,7275,153,96,429,230,350,1258
North Dakota,Dickey,32,2,0,0,0,0,2
North Dakota,Dickinson,21097,412,163,1171,912,898,3556
Ohio,Englewood,13456,193,80,839,644,742,2498
Ohio,Elyria,54050,1153,631,2653,2639,2977,10053
Ohio,Etna,1113,12,32,0,93,58,195
Ohio,Euclid,48105,810,581,2350,2497,2280,8518
Ohio,Evendale village,2762,37,10,100,134,164,445
Ohio,Empire village,263,0,1,20,7,11,39
Ohio,Enon village,2606,9,50,82,114,80,335
Ohio,Edon village,823,17,26,63,52,33,191
Ohio,Elmore village,1361,50,12,94,95,69,320
Ohio,Dover,12869,197,133,793,585,672,2380
Ohio,Donnelsville village,467,16,7,28,30,44,125
Ohio,Dola,131,0,0,0,0,21,21
Ohio,Dillonvale village,756,9,19,52,16,27,123
Ohio,Dillonvale,3603,35,25,234,159,190,643
Ohio,Dexter City village,128,5,1,1,6,11,24
Ohio,Devola,2708,23,40,166,216,145,590
Ohio,Deshler village,1780,11,75,117,88,118,409
Ohio,Derby,324,0,0,29,0,16,45
Ohio,Dent,11043,280,135,484,451,553,1903
Ohio,Dennison village,2690,105,31,190,209,128,663
Ohio,Delta village,3350,70,31,211,192,343,847
Ohio,Delshire,2975,93,7,169,239,210,718
Ohio,Delphos,7261,209,69,282,346,441,1347
Ohio,Dellroy village,315,4,0,24,26,12,66
Ohio,Delhi Hills,5172,40,102,175,229,268,814
Ohio,Delaware,36794,794,542,2312,1853,1857,7358
Ohio,De Graff village,1501,43,32,78,119,102,374
Ohio,Defiance,16571,257,206,868,964,762,3057
Ohio,Deersville village,57,0,0,8,0,6,14
Ohio,Deer Park,5701,101,106,162,306,179,854
Ohio,Dayton,141368,1872,1734,6646,6676,7380,24308
Ohio,Day Heights,2366,41,58,140,103,249,591
Ohio,Darrtown,316,0,0,5,14,18,37
Ohio,Darbyville village,221,0,0,17,12,8,37
Ohio,Darbydale,946,0,0,55,131,120,306
Ohio,Danville village,1094,7,28,63,56,61,215
Ohio,Doylestown village,3064,25,90,188,102,133,538
Ohio,Elmwood Place village,1951,6,0,81,163,177,427
Ohio,Dresden village,1707,6,35,118,89,110,358
Ohio,Dry Ridge,2534,9,42,90,82,78,301
Ohio,Elizabethtown,234,5,0,6,11,19,41
Ohio,Elida village,1962,37,35,91,122,167,452
Ohio,Elgin village,32,0,0,2,0,2,4
Ohio,Eldorado village,633,7,23,27,40,42,139
Ohio,Fairborn,33251,601,354,1596,1414,1030,4995
Ohio,Edison village,389,2,7,30,20,14,73
Ohio,Edgewood,4418,82,13,248,187,281,811
Ohio,Edgerton village,2166,25,35,149,89,82,380
Ohio,Eaton Estates,1032,5,11,70,49,72,207
Ohio,Eaton,8294,134,83,555,488,405,1665
Ohio,East Springfield,554,31,0,23,71,0,125
Ohio,East Sparta village,956,22,12,53,43,71,201
Ohio,East Rochester,283,0,13,30,0,0,43
Ohio,East Palestine village,4634,115,83,194,328,280,1000
Ohio,East Liverpool,10999,217,127,581,709,527,2161
Ohio,East Liberty,248,0,0,15,0,0,15
Ohio,Eastlake,18380,151,245,911,782,1037,3126
Ohio,East Fultonham,371,0,0,73,21,32,126
Ohio,East Cleveland,17519,238,236,788,703,932,2897
Ohio,East Canton village,1424,23,17,68,93,100,301
Ohio,Dupont village,270,11,6,13,18,13,61
Ohio,Dunlap,2040,40,7,109,60,91,307
Ohio,Dunkirk village,969,23,21,58,36,50,188
Ohio,Dundee,516,20,0,7,31,21,79
Ohio,Duncan Falls,1008,6,7,27,42,60,142
Ohio,Dublin,43224,1358,808,2812,3237,3128,11343
Ohio,Dry Run,7887,143,181,614,630,669,2237
Ohio,Drexel,1805,36,0,143,81,197,457
Ohio,Fairfax village,1633,24,31,104,84,71,314
Ohio,Farmersville village,923,13,15,51,41,68,188
Ohio,Wayne Lakes village,703,13,14,28,33,40,128
Ohio,Adamsville village,117,5,0,15,7,4,31
Ohio,Ada village,6050,82,33,344,110,287,856
Ohio,Aberdeen village,1487,18,22,63,76,60,239
Ohio,Hilltop,486,9,0,16,26,30,81
Ohio,Hillsboro,6556,53,90,350,277,362,1132
Ohio,Hills and Dales village,282,12,4,11,23,24,74
Ohio,Hilliard,31803,619,571,2303,2265,2045,7803
Ohio,Highpoint,1262,58,65,61,30,48,262
Ohio,Highland Holiday,461,29,11,17,32,12,101
Ohio,Highland Hills village,950,0,3,11,12,148,174
Ohio,Highland Heights,8337,119,30,419,416,591,1575
Ohio,Highland village,289,8,11,36,23,19,97
Ohio,Higginsport village,278,0,0,17,21,14,52
Ohio,Hide-A-Way Hills,670,0,0,0,0,0,0
Ohio,Hicksville village,3252,19,60,179,204,136,598
Ohio,Hessville,332,0,0,0,32,0,32
Ohio,Hemlock village,186,7,2,4,7,9,29
Ohio,Helena village,242,18,2,14,0,8,42
Ohio,Hebron village,2395,79,40,52,155,179,505
Ohio,Heath,10411,152,133,512,612,655,2064
Ohio,Hayesville village,483,4,10,22,28,33,97
Ohio,Addyston village,936,14,22,58,27,26,147
Ohio,Haydenville,134,0,0,0,0,0,0
Ohio,Adelphi village,364,4,25,14,16,21,80
Ohio,Akron,198329,3562,2227,9637,9159,10140,34725
Ohio,Aquilla village,301,8,3,13,21,12,57
Ohio,Apple Valley,5466,88,22,162,428,234,934
Ohio,Apple Creek village,1092,23,11,82,38,64,218
Ohio,Antwerp village,1540,33,22,75,65,101,296
Ohio,Antioch village,147,1,4,5,14,7,31
Ohio,Ansonia village,1160,33,14,52,59,69,227
Ohio,Anna village,1557,21,38,131,126,87,403
Ohio,Andover village,1143,18,8,74,42,64,206
Ohio,Andersonville,798,0,4,48,23,41,116
Ohio,Amsterdam village,527,26,5,15,32,19,97
Ohio,Amherst,12114,173,128,429,708,835,2273
Ohio,Amesville village,109,0,0,6,8,8,22
Ohio,Damascus,385,26,9,0,7,22,64
Ohio,Amelia village,5319,92,59,303,319,220,993
Ohio,Amberley village,3590,122,69,186,209,136,722
Ohio,Amanda village,702,5,2,35,68,42,152
Ohio,Alvordton,209,0,0,0,0,21,21
Ohio,Alliance,22137,240,273,1032,1362,1083,3990
Ohio,Alger village,686,13,2,29,50,68,162
Ohio,Alexandria village,590,1,17,38,21,12,89
Ohio,Albany village,1116,9,5,55,75,28,172
Ohio,Adena village,737,6,18,18,31,42,115
Ohio,Arcadia village,678,26,10,47,56,32,171
Ohio,Haviland village,192,2,0,9,8,15,34
Ohio,Harveysburg village,601,2,0,39,67,68,176
Ohio,Green Meadows,2578,0,49,119,87,108,363
Ohio,Greenhills village,3590,62,4,199,139,175,579
Ohio,Greenfield village,4761,117,69,244,291,156,877
Ohio,Green Camp village,368,7,4,9,28,23,71
Ohio,Green,25868,338,291,1267,1461,1357,4714
Ohio,Graysville village,79,0,0,4,10,12,26
Ohio,Gratis village,1013,18,4,53,37,32,144
Ohio,Gratiot village,381,0,18,29,46,23,116
Ohio,Granville South,1479,0,0,147,228,112,487
Ohio,Granville village,5706,88,26,326,145,222,807
Ohio,Grandview Heights,7014,69,68,342,346,261,1086
Ohio,Grandview,1452,29,0,25,166,116,336
Ohio,Grand River village,387,0,6,8,24,30,68
Ohio,Grand Rapids village,1057,9,14,49,85,80,237
Ohio,Grafton village,6090,24,33,105,135,640,937
Ohio,Goshen,616,0,0,20,19,12,51
Ohio,Gordon village,207,0,0,13,21,5,39
Ohio,Good Hope,342,24,12,37,0,8,81
Ohio,Golf Manor village,3608,148,55,152,184,211,750
Ohio,Gnadenhutten village,1462,25,24,79,111,76,315
Ohio,Northwood,5316,44,47,233,338,129,791
Ohio,Green Springs village,1530,0,20,133,141,49,343
Ohio,Haskins village,1302,25,50,110,64,93,342
Ohio,Greentown,4414,62,27,247,285,156,777
Ohio,Greenwich village,1296,10,9,58,63,62,202
Ohio,Hartville village,2963,43,82,100,67,132,424
Ohio,Hartford village,320,5,8,19,12,25,69
Ohio,Harrod village,440,10,4,21,43,22,100
Ohio,Harrisville village,261,2,4,17,14,2,39
Ohio,Harrison,10366,293,58,795,405,548,2099
Ohio,Harrisburg village,394,9,6,23,7,15,60
Ohio,Harpster village,231,0,1,10,12,13,36
Ohio,Harbor View village,128,0,0,15,17,21,53
Ohio,Harbor Hills,1553,30,11,141,0,55,237
Ohio,Hanoverton village,370,4,3,26,13,18,64
Ohio,Hanover village,1158,34,16,99,78,96,323
Ohio,Hannibal,346,0,8,7,0,25,40
Ohio,Hanging Rock village,196,0,0,3,9,8,20
Ohio,Hamler village,745,28,18,40,32,39,157
Ohio,Hamilton,62359,664,747,3561,3664,3077,11713
Ohio,Hamersville village,611,7,1,53,31,41,133
Ohio,Hamden village,945,5,10,67,57,29,168
Ohio,Grover Hill village,374,12,5,21,23,25,86
Ohio,Groveport,5604,60,60,260,378,178,936
Ohio,Grove City,37751,526,439,1945,2140,2247,7297
Ohio,Groesbeck,7026,88,68,471,397,408,1432
Ohio,Greenville,13081,271,232,715,572,756,2546
Ohio,Arcanum village,2161,16,59,147,81,126,429
Ohio,Archbold village,4304,97,94,258,298,287,1034
Ohio,Arlington village,1471,53,21,73,70,137,354
Ohio,Venedocia village,153,9,1,7,13,2,32
Ohio,Vaughnsville,227,7,26,14,0,6,53
Ohio,Midvale village,799,13,18,53,46,66,196
Ohio,Vanlue village,304,9,5,32,11,18,75
Ohio,Vandalia,15168,336,85,1011,743,955,3130
Ohio,Van Buren village,391,0,6,19,42,20,87
Ohio,Valleyview village,729,1,1,44,58,26,130
Ohio,Valley View village,1956,13,7,85,96,128,329
Ohio,Valley Hi village,320,2,19,14,9,3,47
Ohio,Valley City,553,13,0,12,20,21,66
Ohio,Utica village,2224,53,18,104,106,108,389
Ohio,Urbancrest village,995,0,14,47,43,50,154
Ohio,Urbana,11618,206,230,728,530,596,2290
Ohio,Upper Sandusky,6790,122,121,253,246,292,1034
Ohio,Upper Arlington,34465,777,401,1897,2270,2130,7475
Ohio,University Heights,13331,379,137,520,466,519,2021
Ohio,Uniopolis village,193,6,2,8,3,3,22
Ohio,Unionville Center village,268,0,3,15,22,31,71
Ohio,Uniontown,3428,66,40,277,167,176,726
Ohio,Union City village,1717,37,19,119,109,122,406
Ohio,Union,6430,84,92,540,430,242,1388
Ohio,Vermilion,10462,56,50,372,394,549,1421
Ohio,Uhrichsville,5410,136,103,206,261,240,946
Ohio,Verona village,449,2,8,29,20,23,82
Ohio,Vickery,92,0,0,0,0,0,0
Ohio,Wayne village,1077,9,13,71,81,93,267
Ohio,Waverly village,4323,69,26,187,133,208,623
Ohio,Wauseon,7179,171,235,360,422,386,1574
Ohio,Waterville,5505,158,104,342,421,396,1421
Ohio,Waterford,400,7,0,33,36,0,76
Ohio,Washingtonville village,847,16,9,58,39,19,141
Ohio,Washington Court House,14057,393,217,1006,549,734,2899
Ohio,Warsaw village,679,22,0,57,56,45,180
Ohio,Warrensville Heights,13336,217,183,722,532,775,2429
Ohio,Warren,40705,373,447,2206,2243,2190,7459
Ohio,Wapakoneta,9776,172,52,546,605,585,1960
Ohio,Walton Hills village,2288,31,0,59,52,64,206
Ohio,Walnut Creek,1058,0,9,115,61,11,196
Ohio,Waldo village,377,8,1,34,16,18,77
Ohio,Walbridge village,3070,24,68,106,26,164,388
Ohio,Wakeman village,978,13,2,36,48,61,160
Ohio,Waite Hill village,460,0,8,17,16,29,70
Ohio,Wadsworth,21777,296,247,1504,1368,1130,4545
Ohio,Vinton village,246,3,0,17,30,12,62
Ohio,Vincent,282,0,0,17,0,0,17
Ohio,Vienna Center,651,7,19,17,42,23,108
Ohio,Versailles village,2724,48,64,163,130,157,562
Ohio,Twinsburg Heights,932,33,24,64,57,109,287
Ohio,Twinsburg,18820,457,272,1030,924,1213,3896
Ohio,Tuscarawas village,1311,18,22,69,86,64,259
Ohio,Baltimore village,2970,20,48,261,238,224,791
Ohio,Baltic village,748,7,11,51,27,44,140
Ohio,Ballville,2901,25,25,169,133,85,437
Ohio,Bairdstown village,183,0,7,11,21,9,48
Ohio,Bainbridge village,810,0,5,37,43,37,122
Ohio,Bainbridge,2659,42,0,86,135,226,489
Ohio,Bailey Lakes village,543,7,10,17,45,17,96
Ohio,Avon Lake,23052,457,268,1485,1362,1524,5096
Ohio,Avon,22046,631,261,1461,1821,1768,5942
Ohio,Austintown,28759,670,458,1122,1291,1361,4902
Ohio,Austinburg,410,0,0,8,9,31,48
Ohio,Aurora,15663,132,270,758,1007,1039,3206
Ohio,Atwater,938,9,0,8,81,108,206
Ohio,Attica village,1033,14,0,67,38,58,177
Ohio,Athens,24220,109,79,172,318,215,893
Ohio,Athalia village,273,2,7,7,11,11,38
Ohio,Ashville village,4144,41,73,338,295,270,1017
Ohio,Ashtabula,18663,236,239,1017,1002,935,3429
Ohio,Ashley village,1186,8,4,64,77,60,213
Ohio,Ashland,20392,300,277,901,779,717,2974
Ohio,Arlington Heights village,947,2,8,28,67,55,160
Ohio,Bannock,253,0,0,10,0,28,38
Ohio,Barberton,26340,326,219,1412,1084,1659,4700
Ohio,Barnesville village,3832,37,37,79,165,76,394
Ohio,Barnhill village,390,3,4,30,29,42,108
Ohio,Turpin Hills,4741,108,71,282,381,406,1248
Ohio,Tuppers Plains,593,13,29,40,37,45,164
Ohio,Troy,25411,373,230,1573,1477,1416,5069
Ohio,Trotwood,24258,380,231,1303,1121,1715,4750
Ohio,Trinway,194,0,0,0,0,0,0
Ohio,Trimble village,437,0,8,33,21,14,76
Ohio,Trenton,12176,150,224,945,669,806,2794
Ohio,Tremont City village,440,0,0,34,19,25,78
Ohio,Toronto,4980,101,62,205,126,310,804
Ohio,Tontogany village,488,3,3,29,30,49,114
Ohio,Waynesburg village,899,19,13,33,54,25,144
Ohio,Toledo,282275,4366,4273,15412,12948,14238,51237
Ohio,Tippecanoe,63,0,0,0,9,0,9
Ohio,Tipp City,9812,153,169,582,559,421,1884
Ohio,Timberlake village,704,11,0,24,29,35,99
Ohio,Tiltonsville village,1327,25,22,42,65,45,199
Ohio,Beach City village,920,9,6,45,62,31,153
Ohio,Bay Village,15469,399,252,874,767,810,3102
Ohio,Bay View village,566,5,0,5,22,25,57
Ohio,Batesville village,87,1,1,2,4,6,14
Ohio,Batavia village,1720,13,27,71,63,89,263
Ohio,Bascom,470,13,0,36,61,15,125
Ohio,Tiro village,203,6,3,16,26,8,59
Ohio,Fayette village,1384,8,30,110,102,112,362
Ohio,Beckett Ridge,8825,78,156,378,537,470,1619
Ohio,North Royalton,30321,306,367,1141,1458,1709,4981
Ohio,Hubbard,7745,41,37,350,629,498,1555
Ohio,Huber Heights,38897,611,774,2383,2008,1974,7750
Ohio,Huber Ridge,4710,31,98,356,274,276,1035
Ohio,Hudson,22389,398,385,1410,1616,1895,5704
Ohio,Hunter,2131,0,14,35,105,159,313
Ohio,Hunting Valley village,837,44,8,49,44,58,203
Ohio,Huntsville village,550,8,1,23,42,61,135
Ohio,Huron,7077,197,93,343,314,242,1189
Ohio,Iberia,533,0,10,12,32,16,70
Ohio,Independence,7144,174,122,315,353,460,1424
Ohio,Irondale village,349,14,7,19,27,16,83
Ohio,Ironton,11172,155,117,517,518,535,1842
Ohio,Ithaca village,146,0,0,6,19,24,49
Ohio,Jackson,6324,80,112,224,221,493,1130
Ohio,Jacksonburg village,45,0,0,2,7,2,11
Ohio,Jackson Center village,1675,53,37,103,102,91,386
Ohio,Jacksonville village,610,18,2,41,25,33,119
Ohio,Jamestown village,2044,36,66,167,191,75,535
Ohio,Jefferson village,3199,48,51,161,110,179,549
Ohio,Jeffersonville village,1233,22,21,106,43,55,247
Ohio,Jenera village,221,4,2,10,28,17,61
Ohio,Jeromesville village,578,12,20,78,29,34,173
Ohio,Jerry City village,472,13,4,22,28,35,102
Ohio,Jerusalem village,153,3,0,5,8,5,21
Ohio,Jewett village,616,28,11,34,53,32,158
Ohio,Hoytville village,301,6,5,23,20,24,78
Ohio,Howland Center,6812,70,93,395,326,335,1219
Ohio,Howard,238,0,0,0,0,0,0
Ohio,Hopedale village,1059,16,8,47,48,72,191
Ohio,Napoleon,8851,81,61,384,512,546,1584
Ohio,Nashville village,233,4,10,10,13,19,56
Ohio,Navarre village,1914,45,16,80,102,49,292
Ohio,Neapolis,388,0,8,11,31,12,62
Ohio,Neffs,963,0,30,21,0,83,134
Ohio,Negley,198,0,0,0,18,0,18
Ohio,Nellie village,109,6,7,5,8,0,26
Ohio,Nelsonville,5184,33,20,186,191,259,689
Ohio,Nettle Lake,408,0,0,0,15,14,29
Ohio,Nevada village,848,10,24,79,95,46,254
Ohio,Neville village,60,0,0,1,4,6,11
Ohio,New Albany,9136,168,215,907,1046,792,3128
Ohio,Johnstown village,5373,193,75,414,296,264,1242
Ohio,New Alexandria village,205,0,1,16,7,13,37
Ohio,Hiram village,1279,17,0,17,26,50,110
Ohio,Hockingport,165,13,0,21,0,9,43
Ohio,Holgate village,1193,9,13,66,91,35,214
Ohio,Holiday City village,37,2,0,3,2,2,9
Ohio,Holiday Lakes,741,17,0,34,47,22,120
Ohio,Holiday Valley,1386,14,0,11,84,54,163
Ohio,Holland village,1744,37,16,95,87,112,347
Ohio,Hollansburg village,311,11,0,42,14,22,89
Ohio,Holloway village,293,2,0,20,16,23,61
Ohio,Holmesville village,481,27,11,14,25,33,110
Ohio,Homeworth,304,0,0,12,0,0,12
Ohio,Hooven,680,0,0,21,42,66,129
Ohio,Newark,47829,667,622,2526,2582,2837,9234
Ohio,Junction City village,834,35,16,36,43,27,157
Ohio,Kalida village,1389,19,0,87,35,88,229
Ohio,Kanauga,176,0,0,0,9,35,44
Ohio,Broughton village,106,5,3,5,9,2,24
Ohio,Brownsville,135,0,0,0,0,0,0
Ohio,Brunswick,34512,596,405,1855,1691,1944,6491
Ohio,Bryan,8493,117,36,513,488,477,1631
Ohio,Buchtel village,567,0,1,21,41,28,91
Ohio,Buckeye Lake village,2724,18,46,185,134,125,508
Ohio,Buckland village,304,6,12,15,17,12,62
Ohio,Bucyrus,12045,204,136,688,576,617,2221
Ohio,Buffalo,287,0,0,0,0,47,47
Ohio,Buford,275,0,0,0,0,0,0
Ohio,Burbank village,227,4,0,6,12,10,32
Ohio,Burgoon village,161,2,3,14,15,8,42
Ohio,Brookville,6077,66,92,222,371,303,1054
Ohio,Burkettsville village,237,0,4,18,11,10,43
Ohio,Burton village,1226,14,6,72,57,70,219
Ohio,Butler village,999,33,13,32,81,56,215
Ohio,Butlerville village,99,0,3,10,8,2,23
Ohio,Byesville village,2248,33,16,57,132,127,365
Ohio,Cadiz village,3258,76,20,205,116,123,540
Ohio,Cairo village,410,6,4,19,19,15,63
Ohio,Calcutta,3516,52,38,80,145,173,488
Ohio,Caldwell village,1747,10,20,59,32,11,132
Ohio,Caledonia village,617,6,4,12,28,37,87
Ohio,Cambridge,10511,263,124,533,644,544,2108
Ohio,Camden village,2229,15,27,132,124,92,390
Ohio,Wright-Patterson AFB,2621,88,38,142,143,15,426
Ohio,Burlington,2243,0,0,144,44,49,237
Ohio,Mutual village,137,0,0,18,17,0,35
Ohio,Brookside village,654,0,0,19,35,44,98
Ohio,Brooklyn Heights village,1526,21,11,92,71,105,300
Ohio,Kansas,51,0,0,0,0,0,0
Ohio,Kelleys Island village,138,0,0,0,0,0,0
Ohio,Kent,29563,438,188,845,958,983,3412
Ohio,Kenton,7849,163,79,363,377,364,1346
Ohio,Kenwood,6906,89,45,298,442,471,1345
Ohio,Kettering,55944,851,816,2808,2579,2636,9690
Ohio,Kettlersville village,184,13,1,23,18,13,68
Ohio,Kidron,1032,4,15,84,104,76,283
Ohio,Kilbourne,159,0,0,23,0,0,23
Ohio,Killbuck village,903,17,12,56,45,59,189
Ohio,Kimbolton,68,0,0,0,0,0,0
Ohio,Kings Mills,1313,16,0,96,111,98,321
Ohio,Brook Park,18956,266,277,877,910,1175,3505
Ohio,Kingston village,1085,18,33,45,46,44,186
Ohio,Kipton village,245,7,0,12,8,8,35
Ohio,Kirby village,76,0,2,1,2,3,8
Ohio,Kirkersville village,590,9,0,12,46,41,108
Ohio,Kirtland,6836,105,94,362,267,470,1298
Ohio,Kirtland Hills village,686,13,3,20,53,42,131
Ohio,Kunkle,129,0,0,0,0,0,0
Ohio,La Croft,1138,0,23,68,55,67,213
Ohio,Lafayette village,386,1,3,18,19,11,52
Ohio,Lafayette,382,14,12,30,0,5,61
Ohio,Broadview Heights,19268,369,179,969,1219,1245,3981
Ohio,Brookfield Center,1274,0,9,53,67,85,214
Ohio,Brooklyn,11002,212,63,356,515,674,1820
Ohio,Kinsman Center,440,0,0,44,24,3,71
Ohio,Wren village,200,0,0,6,4,3,13
Ohio,Murray City village,369,3,3,13,13,36,68
Ohio,Mulberry,3572,29,20,170,254,175,648
Ohio,Martinsburg village,260,1,0,13,18,19,51
Ohio,Marshallville village,702,8,8,52,25,41,134
Ohio,Marseilles village,124,0,3,9,10,4,26
Ohio,Marne,698,0,0,14,39,132,185
Ohio,Marlboro,278,0,0,0,64,0,64
Ohio,Marion,36701,451,471,1774,1594,2118,6408
Ohio,Marietta,13996,231,139,536,509,513,1928
Ohio,Mariemont village,3397,94,74,232,181,190,771
Ohio,Marengo village,281,5,5,27,13,25,75
Ohio,Marblehead village,933,18,0,25,20,20,83
Ohio,Marble Cliff village,640,11,0,25,36,43,115
Ohio,Maplewood Park,372,0,0,8,0,17,25
Ohio,Maple Ridge,893,0,0,8,115,38,161
Ohio,Maple Heights,22792,296,236,1144,1432,1345,4453
Ohio,Mantua village,1248,14,10,48,40,79,191
Ohio,Mansfield,46998,911,483,1972,2383,2671,8420
Ohio,Manchester village,2129,8,11,69,91,163,342
Ohio,Malvern village,1169,7,6,87,69,62,231
Ohio,Malta village,802,10,3,75,75,64,227
Ohio,Malinta village,318,6,12,3,17,26,64
Ohio,Maineville village,1003,43,14,43,36,47,183
Ohio,Magnolia village,989,14,8,64,54,54,194
Ohio,Magnetic Springs village,260,3,3,7,16,10,39
Ohio,Madison village,3183,26,39,198,183,261,707
Ohio,Madeira,8858,203,163,571,430,432,1799
Ohio,Martins Ferry,6829,119,42,325,406,324,1216
Ohio,Martinsville village,406,10,13,22,21,36,102
Ohio,Marysville,22732,452,145,1209,1416,1404,4626
Ohio,Mason,31654,684,490,1984,2495,2753,8406
Ohio,Midway village,196,6,4,6,18,18,52
Ohio,Mifflin village,144,0,2,2,8,22,34
Ohio,Middletown,48563,601,537,2461,2844,2197,8640
Ohio,Middleport village,2111,35,20,116,82,57,310
Ohio,Middle Point village,534,13,6,33,31,34,117
Ohio,Middlefield village,2690,4,19,83,165,166,437
Ohio,Middleburg Heights,15790,198,252,564,594,737,2345
Ohio,Miamiville,152,0,0,26,0,22,48
Ohio,Miamitown,1315,0,17,77,124,102,320
Ohio,Miamisburg,20119,381,199,863,936,1045,3424
Ohio,Miami Heights,5154,64,131,302,335,274,1106
Ohio,Meyers Lake village,622,0,0,0,2,23,25
Ohio,Macksburg village,150,0,1,5,9,8,23
Ohio,Metamora village,673,0,2,20,76,58,156
Ohio,Mentor,46952,621,559,2154,2020,2544,7898
Ohio,Mendon village,557,5,6,31,21,48,111
Ohio,Melrose village,127,4,4,4,7,8,27
Ohio,Melmore,88,0,11,10,0,0,21
Ohio,Medina,26529,496,349,1738,1703,2058,6344
Ohio,Mechanicsburg village,1875,22,31,140,143,112,448
Ohio,Mayfield Heights,18918,345,379,817,633,743,2917
Ohio,Mayfield village,3421,29,55,144,156,99,483
Ohio,Maumee,14083,251,202,606,815,784,2658
Ohio,Matamoras village,867,14,2,26,16,23,81
Ohio,Masury,2096,24,9,165,40,179,417
Ohio,Massillon,32215,591,384,1562,1293,1960,5790
Ohio,Mentor-on-the-Lake,7432,63,70,315,219,374,1041
Ohio,McKinley Heights,748,0,5,22,104,0,131
Ohio,Mack,11213,189,133,657,678,721,2378
Ohio,McGuffey village,451,1,4,20,25,20,70
Ohio,Monroeville village,1382,43,35,116,110,44,348
Ohio,Montezuma village,208,7,0,10,9,4,30
Ohio,Montgomery,10363,336,191,644,594,571,2336
Ohio,Montpelier village,4026,129,21,209,254,260,873
Ohio,Montrose-Ghent,4520,118,53,200,458,216,1045
Ohio,Moraine,6332,113,107,297,345,335,1197
Ohio,Moreland Hills village,3305,68,24,154,213,220,679
Ohio,Morgandale,809,20,0,15,45,23,103
Ohio,Morral village,436,3,3,27,17,31,81
Ohio,Morristown village,288,0,6,3,16,33,58
Ohio,Morrow village,1581,47,37,113,80,72,349
Ohio,Moscow village,124,0,0,3,0,2,5
Ohio,Monroe,13666,354,298,895,852,663,3062
Ohio,Mount Blanchard village,486,8,4,46,56,28,142
Ohio,Mount Cory village,223,7,5,25,15,23,75
Ohio,Mount Eaton village,215,0,11,11,5,9,36
Ohio,Mount Gilead village,3624,31,90,152,16,148,437
Ohio,Mount Healthy,6071,224,94,299,330,318,1265
Ohio,Mount Healthy Heights,3276,56,124,77,237,160,654
Ohio,Mount Orab village,4018,32,36,270,182,178,698
Ohio,Mount Pleasant village,534,1,12,20,27,32,92
Ohio,Mount Repose,4393,60,33,244,345,339,1021
Ohio,Mount Sterling village,1816,34,32,169,49,143,427
Ohio,Mount Vernon,16882,341,365,732,482,636,2556
Ohio,Mount Victory village,561,24,12,26,19,18,99
Ohio,Mowrystown village,293,5,1,19,11,19,55
Ohio,Mount Carmel,4706,60,61,243,188,288,840
Ohio,Munroe Falls,5025,71,24,124,251,181,651
Ohio,Monfort Heights,12454,194,123,556,452,828,2153
Ohio,Mitiwanga,195,0,0,0,12,17,29
Ohio,Macedonia,11469,159,115,418,715,749,2156
Ohio,McDonald village,3196,56,16,142,249,184,647
Ohio,McDermott,739,0,0,21,58,55,134
Ohio,McCutchenville,349,0,0,8,38,34,80
Ohio,McConnelsville village,1871,14,8,56,87,88,253
Ohio,McComb village,1645,13,24,129,91,80,337
Ohio,McClure village,656,21,4,56,27,28,136
Ohio,Milan village,1317,25,17,36,61,133,272
Ohio,Milford,6767,139,249,173,217,281,1059
Ohio,Milford Center village,821,11,24,55,36,71,197
Ohio,Millbury village,1325,10,29,61,57,80,237
Ohio,Milledgeville village,178,16,0,5,16,24,61
Ohio,Mogadore village,3792,51,25,203,255,332,866
Ohio,Miller City village,103,0,0,0,2,3,5
Ohio,Millersport village,1338,21,0,66,140,113,340
Ohio,Millfield,295,0,0,9,0,9,18
Ohio,Millville village,782,14,17,47,40,31,149
Ohio,Milton Center village,208,2,4,27,7,12,52
Ohio,Miltonsburg village,60,0,0,0,4,5,9
Ohio,Mineral City village,679,3,2,8,27,68,108
Ohio,Mineral Ridge,3698,54,26,207,288,150,725
Ohio,Minerva village,3829,75,26,179,202,194,676
Ohio,Minerva Park village,1500,24,3,122,112,63,324
Ohio,Minford,676,0,0,26,22,53,101
Ohio,Mingo Junction village,3212,56,26,93,100,133,408
Ohio,Minster village,2905,39,23,158,227,248,695
Ohio,Millersburg village,3116,63,19,121,132,158,493
Ohio,Worthington,13867,343,192,876,747,655,2813
Ohio,Wooster,26551,602,449,1248,1007,768,4074
Ohio,Woodville village,2166,76,39,144,126,132,517
Ohio,Centerburg village,1844,35,78,75,116,145,449
Ohio,Centerville village,69,0,2,0,0,0,2
Ohio,Centerville,23952,502,372,1126,918,1125,4043
Ohio,Chagrin Falls village,4083,74,27,251,221,198,771
Ohio,Champion Heights,6494,55,48,448,367,344,1262
Ohio,Chardon,5170,160,50,277,223,265,975
Ohio,Chatfield village,260,6,1,0,9,17,33
Ohio,Chauncey village,1220,29,4,61,117,75,286
Ohio,Cherry Fork village,221,0,2,7,3,35,47
Ohio,Cherry Grove,4624,248,33,204,362,258,1105
Ohio,Chesapeake village,891,3,11,41,65,52,172
Ohio,Cheshire village,226,5,2,11,3,10,31
Ohio,Chesterhill village,382,11,4,34,16,11,76
Ohio,Wyoming,8407,263,109,539,594,737,2242
Ohio,Xenia,26002,500,367,1776,1462,1316,5421
Ohio,Yankee Lake village,90,0,2,3,9,0,14
Ohio,Yellow Springs village,3683,24,21,140,229,112,526
Ohio,Yorkshire village,71,0,1,1,7,7,16
Ohio,Yorkville village,1084,21,11,22,30,33,117
Ohio,Youngstown,65573,1046,878,3456,3132,3470,11982
Ohio,Zaleski village,373,0,0,11,13,39,63
Ohio,Zanesfield village,227,0,2,12,5,15,34
Ohio,Zanesville,25470,445,655,1230,1154,1046,4530
Ohio,Zoar village,199,4,1,2,0,6,13
Ohio,New Athens village,223,4,2,9,18,6,39
Ohio,Celina,10373,118,38,378,646,675,1855
Ohio,Celeryville,380,49,28,44,0,0,121
Ohio,Cedarville village,4004,25,16,53,49,58,201
Ohio,Cecil village,166,1,0,6,10,22,39
Ohio,Bedford Heights,10665,111,215,388,377,588,1679
Ohio,Bedford,12868,286,133,577,732,535,2263
Ohio,North Zanesville,3133,49,0,178,137,99,463
Ohio,Beaverdam village,468,10,4,29,11,18,72
Ohio,Beavercreek,45999,692,465,2221,2045,2536,7959
Ohio,Beaver village,531,9,17,64,47,52,189
Ohio,Beallsville village,394,4,6,17,24,28,79
Ohio,Beachwood,11801,238,136,507,571,604,2056
Ohio,Campbell,8075,140,58,294,395,440,1327
Ohio,Camp Dennison,252,0,0,0,0,13,13
Ohio,Canal Fulton,5483,115,62,198,218,455,1048
Ohio,Canal Lewisville,246,0,11,13,5,6,35
Ohio,New Baltimore,656,33,9,81,0,6,129
Ohio,Canal Winchester,7621,126,89,360,393,577,1545
Ohio,Canfield,7424,153,131,215,385,447,1331
Ohio,Canton,72463,1202,1010,3726,4254,3925,14117
Ohio,Carbon Hill,265,0,0,0,0,12,12
Ohio,Cardington village,2352,42,10,208,268,157,685
Ohio,Carey village,3513,65,45,221,166,244,741
Ohio,Carlisle village,5024,47,59,254,271,378,1009
Ohio,Carroll village,411,0,13,14,9,18,54
Ohio,Carrollton village,3020,29,41,119,119,150,458
Ohio,Casstown village,275,2,8,14,21,28,73
Ohio,Castalia village,808,18,5,56,24,38,141
Ohio,Castine village,152,6,0,14,0,2,22
Ohio,Catawba village,371,8,10,46,5,17,86
Ohio,Candlewood Lake,1155,0,0,66,85,49,200
Ohio,New Bavaria village,107,2,0,2,18,8,30
Ohio,New Bloomington village,455,7,16,11,19,47,100
Ohio,New Boston village,2125,66,41,73,118,113,411
Ohio,Newtown village,2668,39,30,142,159,177,547
Ohio,New Vienna village,1424,2,24,121,147,48,342
Ohio,New Washington village,991,39,51,54,49,29,222
Ohio,New Waterford village,1270,26,28,68,58,39,219
Ohio,New Weston village,115,2,1,7,3,2,15
Ohio,Ney village,313,1,3,24,23,17,68
Ohio,Niles,18886,255,277,859,816,886,3093
Ohio,North Baltimore village,3460,50,34,178,279,277,818
Ohio,North Bend village,790,10,5,16,14,31,76
Ohio,Northbrook,10545,140,189,639,840,535,2343
Ohio,North Canton,17431,251,197,550,615,759,2372
Ohio,North College Hill,9361,172,182,392,414,432,1592
Ohio,Newtonsville village,398,1,4,32,12,25,74
Ohio,North Fairfield village,605,13,14,32,48,32,139
Ohio,Northgate,7677,66,106,412,342,575,1501
Ohio,North Hampton village,398,1,4,40,35,14,94
Ohio,North Kingsville village,2871,12,18,112,168,195,505
Ohio,North Lawrence,195,0,0,25,0,20,45
Ohio,North Lewisburg village,1522,23,15,79,119,115,351
Ohio,North Madison,8961,225,200,489,526,558,1998
Ohio,North Olmsted,32248,461,352,1068,1750,1639,5270
Ohio,North Perry village,776,11,18,27,10,37,103
Ohio,North Randall village,998,13,0,13,15,33,74
Ohio,Northridge,7161,115,73,394,359,342,1283
Ohio,North Ridgeville,31240,719,491,1790,1370,1360,5730
Ohio,North Robinson village,241,1,0,15,1,7,24
Ohio,Northfield village,3649,11,39,96,136,263,545
Ohio,Beechwood Trails,2889,34,22,140,44,185,425
Ohio,Newton Falls village,4707,29,82,182,210,121,624
Ohio,New Riegel village,258,0,0,15,13,5,33
Ohio,New Bremen village,3127,54,47,186,163,180,630
Ohio,Newburgh Heights village,2012,11,41,117,146,159,474
Ohio,New Burlington,4881,136,135,292,186,272,1021
Ohio,New California,1761,26,48,224,180,84,562
Ohio,New Carlisle,5727,45,42,401,397,362,1247
Ohio,Newcomerstown village,3748,65,63,223,165,180,696
Ohio,New Concord village,2670,42,39,40,82,50,253
Ohio,New Franklin,14258,194,137,518,706,680,2235
Ohio,New Hampshire,202,0,0,46,0,4,50
Ohio,New Haven CDP (Hamilton County),523,0,0,22,4,52,78
Ohio,New Haven CDP (Huron County),394,11,11,0,0,35,57
Ohio,New Holland village,732,6,13,39,43,22,123
Ohio,New Straitsville village,757,9,0,38,39,61,147
Ohio,New Knoxville village,927,30,5,49,48,52,184
Ohio,New Lexington village,4795,147,86,237,304,516,1290
Ohio,New London village,2606,77,27,210,150,172,636
Ohio,New Madison village,929,21,12,61,44,22,160
Ohio,New Marshfield,386,16,0,0,16,46,78
Ohio,New Miami village,2169,5,26,65,112,111,319
Ohio,New Middletown village,1666,26,19,56,42,119,262
Ohio,New Paris village,1593,45,45,102,96,86,374
Ohio,New Philadelphia,17397,240,246,999,686,1122,3293
Ohio,New Pittsburg,285,0,0,0,0,22,22
Ohio,Newport CDP (Shelby County),152,0,8,0,8,15,31
Ohio,Newport CDP (Washington County),782,15,0,33,73,54,175
Ohio,New Richmond village,2624,22,89,105,195,166,577
Ohio,New Lebanon village,4310,36,48,152,143,192,571
Ohio,Bellaire village,4215,55,24,278,241,208,806
Ohio,Bellbrook,7063,93,72,306,437,332,1240
Ohio,Belle Center village,807,6,1,44,35,74,160
Ohio,Wheelersburg,6181,138,120,322,129,186,895
Ohio,Wharton village,363,6,1,45,19,25,96
Ohio,Wetherington,1305,15,17,0,15,136,183
Ohio,West Unity village,1775,54,30,118,88,61,351
Ohio,West Union village,3180,58,10,273,129,106,576
Ohio,West Salem village,1653,19,15,52,82,133,301
Ohio,West Rushville village,217,0,7,24,12,20,63
Ohio,West Portsmouth,2978,16,46,144,189,181,576
Ohio,Weston village,1688,31,30,99,91,148,399
Ohio,Westminster,340,5,0,6,19,80,110
Ohio,West Milton village,4679,25,31,121,372,359,908
Ohio,West Millgrove village,140,0,0,2,23,14,39
Ohio,Whitehall,18521,413,302,1058,1315,897,3985
Ohio,West Mansfield village,754,2,9,33,56,33,133
Ohio,West Liberty village,1699,8,31,67,96,169,371
Ohio,West Leipsic village,167,0,1,6,7,8,22
Ohio,Westlake,32469,566,419,1414,1596,1757,5752
Ohio,West Lafayette village,2312,18,9,141,158,159,485
Ohio,West Jefferson village,4235,45,44,202,201,251,743
Ohio,West Hill,1898,28,41,99,78,129,375
Ohio,Westfield Center village,1159,16,0,40,54,96,206
Ohio,West Farmington village,550,6,10,42,60,37,155
Ohio,Westerville,37540,761,424,1855,2042,1998,7080
Ohio,West Elkton village,243,4,6,16,13,26,65
Ohio,West Carrollton,13051,199,136,597,599,678,2209
Ohio,West Alexandria village,1726,19,23,116,80,156,394
Ohio,West Manchester village,591,6,4,21,34,39,104
Ohio,Wellsville village,3461,59,118,335,238,178,928
Ohio,Whitehouse village,4219,103,18,289,283,206,899
Ohio,Whites Landing,342,0,0,22,22,0,44
Ohio,Woodstock village,326,3,7,28,26,34,98
Ohio,Woodsfield village,2412,13,7,122,120,144,406
Ohio,Woodmere village,925,13,26,65,57,57,218
Ohio,Woodlawn village,3284,41,55,105,152,249,602
Ohio,Wolfhurst,1211,0,36,7,48,62,153
Ohio,Withamsville,7116,48,103,177,262,269,859
Ohio,Wintersville village,4113,39,0,256,174,152,621
Ohio,Winesburg,256,0,0,36,0,6,42
Ohio,Windham village,1852,44,38,79,119,169,449
Ohio,Winchester village,1120,16,3,85,96,46,246
Ohio,Wilson village,130,5,0,13,9,3,30
Ohio,Wilmot village,295,0,9,24,11,16,60
Ohio,White Oak,18664,234,65,1093,1009,902,3303
Ohio,Wilmington,12428,148,234,577,460,685,2104
Ohio,Willowick,14051,183,157,718,715,684,2457
Ohio,Willoughby Hills,9428,26,148,257,336,403,1170
Ohio,Willoughby,22433,316,348,930,999,1079,3672
Ohio,Williston,645,0,23,36,11,0,70
Ohio,Williamsport village,1225,18,40,73,140,98,369
Ohio,Williamsdale,691,0,0,79,7,32,118
Ohio,Williamsburg village,2536,38,35,115,168,194,550
Ohio,Willard,6135,46,107,518,316,392,1379
Ohio,Wilkesville village,182,6,3,17,4,26,56
Ohio,Wilberforce,2278,15,41,47,12,43,158
Ohio,Wightmans Grove,0,0,0,0,0,0,0
Ohio,Wickliffe,12629,126,137,555,615,505,1938
Ohio,Willshire village,399,0,5,15,26,24,70
Ohio,North Star village,272,1,6,13,17,25,62
Ohio,Wellston,5569,0,48,282,202,234,766
Ohio,Waynesville village,2924,40,64,191,102,230,627
Ohio,Blanchester village,4244,36,62,167,307,273,845
Ohio,Blakeslee village,66,0,0,3,2,1,6
Ohio,Bladensburg,103,0,0,0,18,0,18
Ohio,Blacklick Estates,8960,147,61,633,542,665,2048
Ohio,Bexley,13442,437,208,762,695,774,2876
Ohio,Beverly village,1139,4,19,40,57,40,160
Ohio,Beulah Beach,71,0,0,0,0,0,0
Ohio,Bettsville village,642,14,10,60,26,24,134
Ohio,Bethesda village,1382,39,4,65,54,88,250
Ohio,Bethel village,2756,34,26,111,176,132,479
Ohio,Berlin Heights village,531,9,2,18,16,39,84
Ohio,Berlin,1445,4,19,54,63,7,147
Ohio,Bloomdale village,676,4,8,62,38,31,143
Ohio,Berkey village,338,1,0,12,27,39,79
Ohio,Berea,19001,204,271,846,702,832,2855
Ohio,Bentonville,198,0,0,15,0,0,15
Ohio,Benton Ridge village,361,2,0,27,16,8,53
Ohio,Bentleyville village,938,8,9,56,74,83,230
Ohio,Belpre,6448,42,71,292,199,229,833
Ohio,Beloit village,1039,20,20,23,39,68,170
Ohio,Belmore village,119,0,8,5,15,14,42
Ohio,Belmont village,521,2,2,13,13,33,63
Ohio,Bellville village,1841,54,18,77,111,72,332
Ohio,Bellevue,8109,141,121,364,357,453,1436
Ohio,Belle Valley village,220,0,1,3,11,15,30
Ohio,Bellefontaine,13279,208,123,753,881,832,2797
Ohio,Bergholz village,765,4,22,52,40,29,147
Ohio,Wellington village,4981,102,50,166,346,363,1027
Ohio,Bloomingburg village,1079,12,18,71,67,95,263
Ohio,Bloomville village,909,6,7,40,48,60,161
Ohio,Waynesfield village,739,7,11,36,32,57,143
Ohio,Brimfield,3614,105,70,230,130,194,729
Ohio,Brilliant,1690,24,0,136,47,97,304
Ohio,Bridgetown,13628,206,121,557,745,843,2472
Ohio,Bridgeport village,1799,11,35,59,26,99,230
Ohio,Brice village,110,0,1,12,7,4,24
Ohio,Brewster village,2308,43,6,149,94,88,380
Ohio,Bremen village,1669,34,30,73,110,92,339
Ohio,Brecon,425,0,0,38,0,44,82
Ohio,Brecksville,13516,292,124,647,676,1045,2784
Ohio,Bratenahl village,1153,13,3,32,6,10,64
Ohio,Brady Lake village,458,0,0,14,19,21,54
Ohio,Bloomingdale village,189,12,4,12,10,6,44
Ohio,Bradner village,957,6,22,40,53,45,166
Ohio,Bowling Green,31506,426,136,887,712,752,2913
Ohio,Bowersville village,279,10,5,27,26,20,88
Ohio,Bowerston village,387,5,7,22,15,21,70
Ohio,Bourneville,253,42,0,42,26,0,110
Ohio,Botkins village,1320,81,17,89,43,69,299
Ohio,Boston Heights village,1252,23,17,37,65,106,248
Ohio,Bolivar village,1030,11,5,55,57,65,193
Ohio,Bolindale,2003,24,0,64,70,83,241
Ohio,Boardman,34794,569,363,1359,1624,1506,5421
Ohio,Bluffton village,4210,101,57,201,240,235,834
Ohio,Blue Jay,1182,18,0,68,58,101,245
Ohio,Blue Ash,12102,170,162,600,638,482,2052
Ohio,Bradford village,1716,28,43,88,110,84,353
Ohio,Norton,12054,125,82,593,804,628,2232
Ohio,Van Wert,10769,169,177,701,514,496,2057
Ohio,Norwich village,96,0,0,2,5,1,8
Ohio,Sulphur Springs,102,0,0,0,0,0,0
Ohio,Sugar Grove village,509,0,4,29,41,59,133
Ohio,Sugarcreek village,2235,13,36,63,91,85,288
Ohio,Sugar Bush Knolls village,172,0,0,4,5,17,26
Ohio,Stryker village,1195,40,19,59,98,50,266
Ohio,Struthers,10515,135,27,402,714,757,2035
Ohio,Summerfield village,213,4,2,2,5,9,22
Ohio,Strongsville,44649,752,436,2221,2303,2633,8345
Ohio,Stratton village,318,1,14,15,13,9,52
Ohio,Strasburg village,3132,26,12,116,144,181,479
Ohio,Stow,34765,551,340,1473,1928,1956,6248
Ohio,Stoutsville village,467,5,8,14,15,22,64
Ohio,Stony Ridge,321,0,0,0,0,0,0
Ohio,Stony Prairie,1328,0,24,73,40,50,187
Ohio,Streetsboro,16222,205,142,758,1004,1043,3152
Ohio,Summerside,5167,228,70,222,265,98,883
Ohio,Summitville village,110,3,2,4,3,2,14
Ohio,Sunbury village,4771,158,75,375,372,207,1187
Ohio,Tiffin,17793,252,167,815,935,990,3159
Ohio,Thurston village,539,3,9,22,68,24,126
Ohio,Thornville village,1244,26,16,76,86,105,309
Ohio,Thornport,1058,14,0,0,15,41,70
Ohio,The Village of Indian Hill,5793,148,113,485,309,527,1582
Ohio,The Plains,3230,71,118,191,142,168,690
Ohio,Terrace Park village,2330,60,47,196,249,227,779
Ohio,Tedrow,227,0,0,0,0,25,25
Ohio,Taylor Creek,3451,156,18,173,131,238,716
Ohio,Tarlton village,276,4,4,15,7,12,42
Ohio,Tallmadge,17459,274,228,876,953,905,3236
Ohio,Syracuse village,719,13,5,21,24,42,105
Ohio,Sylvania,18943,325,125,842,1066,1378,3736
Ohio,Sycamore village,980,42,11,47,34,57,191
Ohio,Swanton village,4040,15,10,244,223,211,703
Ohio,Stone Creek village,157,1,3,6,8,6,24
Ohio,Stockport village,529,3,6,18,38,17,82
Ohio,Stockdale,12,0,0,0,0,0,0
Ohio,Stewart,298,0,10,0,0,6,16
Ohio,South Charleston village,1818,20,51,99,113,102,385
Ohio,South Canal,1190,0,0,50,14,45,109
Ohio,South Bloomfield village,2225,31,25,122,200,125,503
Ohio,South Amherst village,1807,20,13,80,73,95,281
Ohio,Somerville village,269,2,2,2,17,18,41
Ohio,Somerset village,1564,34,28,99,131,102,394
Ohio,Solon,23114,462,361,1516,1573,1776,5688
Ohio,Smithville village,1157,21,14,40,80,63,218
Ohio,Smithfield village,852,23,13,48,63,51,198
Ohio,Skyline Acres,1829,82,48,70,92,242,534
Ohio,Lockland village,3426,28,35,130,217,175,585
Ohio,Lodi village,2780,21,35,130,83,136,405
Ohio,Logan,7292,184,87,495,259,516,1541
Ohio,Logan Elm Village,1086,0,6,37,59,90,192
Ohio,London,9961,160,199,639,544,398,1940
Ohio,South Euclid,21971,444,174,896,980,1462,3956
Ohio,Lockington village,135,0,0,8,9,9,26
Ohio,South Lebanon village,4992,74,184,316,379,185,1138
Ohio,South Russell village,3838,97,31,274,285,287,974
Ohio,Steubenville,18381,415,151,605,821,702,2694
Ohio,Sterling,593,21,0,6,5,29,61
Ohio,Stafford village,119,3,1,16,4,3,27
Ohio,Spring Valley village,508,7,3,15,23,32,80
Ohio,Springfield,60007,937,862,3178,3406,2820,11203
Ohio,Springdale,11194,183,202,656,575,650,2266
Ohio,Springboro,17585,338,256,1346,1132,1344,4416
Ohio,Spencerville village,2090,25,26,129,146,135,461
Ohio,Spencer village,686,0,8,35,48,36,127
Ohio,Sparta village,166,0,2,10,22,7,41
Ohio,South Zanesville village,2233,38,56,105,193,162,554
Ohio,South Webster village,666,10,4,41,25,44,124
Ohio,South Vienna village,387,0,0,6,5,31,42
Ohio,South Solon village,317,1,0,7,15,24,47
Ohio,South Salem village,256,5,8,8,17,17,55
Ohio,South Point village,3671,20,72,130,204,201,627
Ohio,Lockbourne village,219,1,7,11,13,15,47
Ohio,Little Hocking,267,0,0,0,0,0,0
Ohio,Lithopolis village,1446,34,3,100,143,55,335
Ohio,Rittman,6520,130,117,284,319,341,1191
Ohio,Riverlea village,636,15,13,58,40,23,149
Ohio,Riverside,25075,474,404,1038,1445,1212,4573
Ohio,Roaming Shores village,1678,23,16,154,92,90,375
Ohio,Robertsville,391,21,0,56,17,0,94
Ohio,Rochester village,179,4,0,5,3,15,27
Ohio,Rockbridge,218,0,0,7,33,37,77
Ohio,Rock Creek village,393,3,2,5,17,23,50
Ohio,Rockford village,1199,41,26,73,78,74,292
Ohio,Rocky Fork Point,656,0,0,16,49,64,129
Ohio,Rocky Ridge village,485,16,0,44,42,46,148
Ohio,Norwalk,16892,300,323,978,998,1068,3667
Ohio,Lafferty,370,0,0,0,11,11,22
Ohio,LaGrange village,2265,23,23,112,120,186,464
Ohio,Lake Buckhorn,900,10,10,30,62,52,164
Ohio,Risingsun village,583,14,6,30,38,44,132
Ohio,Lake Darby,4481,77,68,333,370,178,1026
Ohio,Ripley village,1980,12,35,85,143,75,350
Ohio,Ridgeway village,295,4,6,25,22,15,72
Ohio,Raymond,83,0,0,0,0,0,0
Ohio,Reading,10349,213,134,557,424,466,1794
Ohio,Reminderville village,3743,37,169,207,351,182,946
Ohio,Remington,114,0,0,0,0,0,0
Ohio,Rendville village,32,8,0,0,0,0,8
Ohio,Reno,1156,16,26,40,92,50,224
Ohio,Republic village,611,10,3,29,39,30,111
Ohio,Reynoldsburg,36899,510,408,2170,2028,2615,7731
Ohio,Richfield village,3665,116,23,159,166,237,701
Ohio,Richmond village,364,0,2,11,7,12,32
Ohio,Richmond Dale,312,4,0,5,17,37,63
Ohio,Richmond Heights,10485,86,86,282,355,509,1318
Ohio,Richville,3329,31,11,176,200,160,578
Ohio,Richwood village,2268,35,36,180,160,92,503
Ohio,Ridgeville Corners,354,6,0,0,17,15,38
Ohio,Rio Grande village,977,24,17,32,39,35,147
Ohio,Lorain,63778,753,1017,4011,3654,3788,13223
Ohio,Lake Lakengren,3379,52,67,165,148,106,538
Ohio,Lake Lorelei,1095,0,7,66,46,56,175
Ohio,Leesville village,156,7,0,5,6,1,19
Ohio,Leetonia village,1925,27,28,102,116,108,381
Ohio,Leipsic village,2089,69,76,126,84,100,455
Ohio,Lewisburg village,1605,49,28,99,98,106,380
Ohio,Lewistown,95,0,0,0,10,0,10
Ohio,Lewisville village,222,11,4,4,2,7,28
Ohio,Lexington village,5712,81,23,331,455,342,1232
Ohio,Liberty Center village,1125,25,29,66,64,56,240
Ohio,Lima,38232,681,628,2522,2220,1896,7947
Ohio,Limaville village,139,0,0,5,9,5,19
Ohio,Lincoln Heights village,3365,28,53,126,144,251,602
Ohio,Lincoln Village,9417,227,58,423,400,488,1596
Ohio,Lindsey village,557,9,11,29,18,21,88
Ohio,Linndale village,159,7,0,18,11,3,39
Ohio,Lisbon village,2738,10,16,103,131,227,487
Ohio,Leesburg village,1377,12,25,73,66,86,262
Ohio,Lakeline village,271,2,8,10,10,10,40
Ohio,Lebanon,20450,390,238,1295,1404,1413,4740
Ohio,Laurelville village,506,0,18,18,17,33,86
Ohio,Lake Milton,666,0,0,12,68,42,122
Ohio,Lake Mohawk,1571,15,52,72,118,89,346
Ohio,Lakemore village,3051,78,0,43,176,181,478
Ohio,Lake Seneca,587,27,27,48,21,0,123
Ohio,Lakeside,615,0,0,0,0,0,0
Ohio,Lake Tomahawk,697,0,0,58,23,74,155
Ohio,Lakeview village,1148,13,10,67,31,84,205
Ohio,Lake Waynoka,1043,13,0,12,37,56,118
Ohio,Lakewood,51155,761,400,2010,2181,1983,7335
Ohio,Lancaster,39312,655,616,1877,2024,2035,7207
Ohio,Landen,6985,176,93,447,387,565,1668
Ohio,Lansing,772,0,0,65,37,12,114
Ohio,La Rue village,669,6,13,24,65,47,155
Ohio,Latty village,186,1,0,2,6,16,25
Ohio,Laura village,425,1,7,31,46,17,102
Ohio,Leavittsburg,1616,39,0,85,64,127,315
Ohio,Rayland village,403,6,5,19,15,22,67
Ohio,Lordstown village,3346,30,52,97,141,150,470
Ohio,Loudonville village,2749,28,27,105,92,135,387
Ohio,Germantown,5521,101,106,287,304,178,976
Ohio,Georgetown village,4792,126,49,276,365,109,925
Ohio,Genoa village,2405,23,92,220,92,126,553
Ohio,Geneva-on-the-Lake village,1390,7,10,80,119,69,285
Ohio,Geneva,6101,103,110,284,339,299,1135
Ohio,Gates Mills village,2179,43,8,51,113,74,289
Ohio,Gettysburg village,598,11,11,22,50,37,131
Ohio,Garrettsville village,2937,5,41,191,243,259,739
Ohio,Gann village,133,5,6,4,5,6,26
Ohio,Gambier village,2482,7,4,18,28,0,57
Ohio,Gallipolis village,3674,9,68,126,340,205,748
Ohio,Galion,10227,115,68,431,706,573,1893
Ohio,Galena village,745,18,17,41,42,62,180
Ohio,Gahanna,34095,508,453,1737,1967,2427,7092
Ohio,Garfield Heights,28365,446,294,1400,1382,1721,5243
Ohio,Gibsonburg village,2732,47,59,214,206,218,744
Ohio,Gilboa village,213,0,0,4,7,7,18
Ohio,Girard,9716,202,93,582,571,391,1839
Ohio,Shreve village,1521,44,18,110,74,106,352
Ohio,Sidney,20981,279,278,1212,1080,1395,4244
Ohio,Silver Lake village,2518,18,11,71,152,224,476
Ohio,Silverton village,4769,46,52,271,182,179,730
Ohio,Sinking Spring village,107,3,0,2,3,5,13
Ohio,Sixteen Mile Stand,3443,39,15,106,252,188,600
Ohio,Glouster village,1656,12,40,114,137,102,405
Ohio,Gloria Glens Park village,485,1,3,4,44,58,110
Ohio,Glenwillow village,1010,33,25,63,89,66,276
Ohio,Glenmoor,1943,29,0,109,171,119,428
Ohio,Glenmont village,222,8,4,14,11,12,49
Ohio,Glenford village,184,3,4,7,15,27,56
Ohio,Glendale village,2128,15,25,89,105,114,348
Ohio,Glencoe,285,0,27,0,35,14,76
Ohio,Glandorf village,892,24,17,48,58,55,202
Ohio,Fultonham village,164,9,0,9,23,0,41
Ohio,Fulton village,338,13,11,54,23,29,130
Ohio,Fruit Hill,3574,84,50,162,314,166,776
Ohio,Friendship,289,0,17,0,0,0,17
Ohio,Flushing village,818,19,10,34,14,27,104
Ohio,Florida village,267,5,0,16,13,28,62
Ohio,Fletcher village,430,6,0,17,41,29,93
Ohio,Flat Rock,57,0,0,0,5,17,22
Ohio,Five Points,1778,50,0,121,104,152,427
Ohio,Finneytown,12366,164,104,657,746,761,2432
Ohio,Findlay,41278,568,578,1642,1970,1793,6551
Ohio,Felicity village,871,0,6,30,62,55,153
Ohio,Fayetteville village,370,1,5,23,23,17,69
Ohio,Fairfield,42678,643,229,1769,2133,2390,7164
Ohio,Fairfield Beach,809,0,0,0,54,62,116
Ohio,Fairlawn,7429,69,14,286,262,532,1163
Ohio,Fairport Harbor village,3100,23,13,231,152,152,571
Ohio,Fairview village,94,0,0,2,6,7,15
Ohio,Fairview Park,16552,281,223,656,689,841,2690
Ohio,Forest village,1609,27,19,86,140,112,384
Ohio,Shiloh village,694,5,4,68,41,23,141
Ohio,Forest Park,18667,417,225,1074,1185,1099,4000
Ohio,Fort Jennings village,448,11,5,16,30,25,87
Ohio,Fresno,149,0,0,8,14,0,22
Ohio,Fremont,16484,337,286,844,1059,964,3490
Ohio,Freeport village,382,0,4,11,17,10,42
Ohio,Fredericktown village,3018,42,80,206,203,68,599
Ohio,Fredericksburg village,413,11,8,13,7,29,68
Ohio,Frazeysburg village,1620,30,21,105,123,163,442
Ohio,Franklin Furnace,1741,22,44,60,70,182,378
Ohio,Franklin,11840,276,196,523,618,728,2341
Ohio,Frankfort village,847,17,0,20,35,40,112
Ohio,Four Bridges,3462,102,51,199,276,247,875
Ohio,Fostoria,13187,383,190,795,677,634,2679
Ohio,Fort Shawnee,6143,185,35,175,323,293,1011
Ohio,Fort Seneca,269,0,5,4,8,4,21
Ohio,Fort Recovery village,1570,18,21,94,140,108,381
Ohio,Fort Loramie village,1317,25,18,80,89,111,323
Ohio,Forestville,10535,204,219,483,646,596,2148
Ohio,Sherwood,3635,112,40,242,95,254,743
Ohio,Sherwood village,737,3,6,82,29,31,151
Ohio,Sherrodsville village,257,4,1,10,14,23,52
Ohio,Roseville village,2185,73,56,202,135,200,666
Ohio,Rosewood,423,0,26,60,51,0,137
Ohio,Ross,3850,39,0,254,240,426,959
Ohio,Rossburg village,231,1,0,10,12,11,34
Ohio,Rossford,6458,163,175,216,307,380,1241
Ohio,Rossmoyne,2242,43,0,114,151,243,551
Ohio,Roswell village,210,8,6,8,13,8,43
Ohio,Rudolph,341,0,6,5,0,18,29
Ohio,Rushsylvania village,638,9,5,24,62,45,145
Ohio,Rushville village,381,6,6,24,26,48,110
Ohio,Russells Point village,1118,13,30,79,62,50,234
Ohio,Russellville village,650,17,6,18,16,45,102
Ohio,Russia village,664,40,9,32,37,58,176
Ohio,Rutland village,452,0,10,8,22,45,85
Ohio,Sabina village,2352,0,25,146,148,159,478
Ohio,Rosemount,1995,16,11,89,35,145,296
Ohio,St. Bernard village,4358,44,68,201,274,305,892
Ohio,Rose Farm,356,0,0,0,0,0,0
Ohio,Rogers village,224,0,0,13,5,12,30
Ohio,Louisville,9132,157,158,442,583,334,1674
Ohio,Loveland,12451,263,120,612,819,708,2522
Ohio,Loveland Park,1272,0,0,29,141,39,209
Ohio,Lowell village,492,6,2,50,10,28,96
Ohio,Lowellville village,1150,20,17,53,57,135,282
Ohio,Lower Salem village,59,1,0,2,6,9,18
Ohio,Lucas village,577,6,4,44,53,47,154
Ohio,Lucasville,2333,0,55,166,121,85,427
Ohio,Luckey village,1005,17,17,58,70,61,223
Ohio,Ludlow Falls village,255,3,4,22,24,18,71
Ohio,Lynchburg village,1350,19,12,82,177,141,431
Ohio,Lyndhurst,13792,160,113,545,561,428,1807
Ohio,Lyons village,492,6,0,24,19,49,98
Ohio,McArthur village,1925,27,39,96,117,123,402
Ohio,Rocky River,20187,287,173,1043,968,1209,3680
Ohio,Rome village,71,0,0,6,0,2,8
Ohio,Lore City village,300,1,9,7,5,17,39
Ohio,St. Clairsville,5133,44,82,158,320,213,817
Ohio,St. Johns,179,0,0,0,18,53,71
Ohio,Sebring village,4320,60,42,246,118,240,706
Ohio,Senecaville village,432,11,5,29,16,22,83
Ohio,Seven Hills,11716,168,107,413,450,371,1509
Ohio,Seven Mile village,802,4,16,7,49,37,113
Ohio,Seville village,2357,15,23,89,104,197,428
Ohio,Shadyside village,3752,52,33,51,171,164,471
Ohio,Shaker Heights,27934,611,399,1543,1894,1729,6176
Ohio,Sharonville,13872,241,354,836,551,562,2544
Ohio,Shawnee,834,0,14,13,35,50,112
Ohio,Shawnee village,670,11,24,44,24,46,149
Ohio,Shawnee Hills village,826,20,16,49,71,63,219
Ohio,Shawnee Hills,2151,69,18,45,178,217,527
Ohio,Sheffield village,4004,94,40,177,130,244,685
Ohio,Sheffield Lake,9063,46,111,512,458,402,1529
Ohio,Shelby,8910,202,130,466,595,318,1711
Ohio,Seaman village,928,16,13,75,73,42,219
Ohio,St. Henry village,2529,44,47,174,178,187,630
Ohio,Scott village,313,3,12,5,22,34,76
Ohio,Scio village,868,3,21,35,49,43,151
Ohio,St. Louisville village,396,7,1,21,34,33,96
Ohio,St. Martin,357,0,1,2,24,25,52
Ohio,St. Marys,8117,171,102,584,406,324,1587
Ohio,St. Paris village,2186,27,32,123,169,162,513
Ohio,Salem,12115,241,232,524,361,572,1930
Ohio,Salem Heights,3200,28,43,152,287,193,703
Ohio,Salesville village,123,4,3,1,1,12,21
Ohio,Salineville village,1239,4,31,75,92,98,300
Ohio,Sandusky,25488,495,389,1304,1063,1267,4518
Ohio,Sandyville,277,0,0,46,10,0,56
Ohio,Sarahsville village,149,1,1,4,7,8,21
Ohio,Sardinia village,1503,13,35,184,145,56,433
Ohio,Sardis,479,21,22,7,6,10,66
Ohio,Savannah village,410,13,7,31,14,16,81
Ohio,Sawyerwood,1249,0,0,52,113,44,209
Ohio,Sciotodale,1246,18,7,58,83,44,210
Ohio,Rawson village,544,9,19,68,28,27,151
Ohio,Midland village,422,2,0,63,35,25,125
Ohio,Rarden village,157,0,0,7,7,0,14
Ohio,Perry Heights,8553,147,36,353,550,392,1478
Ohio,Perrysburg,21243,289,230,1309,1527,1159,4514
Ohio,Perrysville village,768,21,15,46,13,67,162
Ohio,Pettisville,529,3,9,21,29,68,130
Ohio,Pheasant Run,1620,78,22,56,172,103,431
Ohio,Phillipsburg village,493,8,2,4,15,22,51
Ohio,Philo village,866,29,16,33,76,83,237
Ohio,Pickerington,19157,552,254,1194,1387,1740,5127
Ohio,Pigeon Creek,1041,65,11,91,44,64,275
Ohio,Piketon village,2050,56,49,63,118,151,437
Ohio,Pioneer village,1653,30,24,73,98,53,278
Ohio,Piqua,20681,379,286,1082,1096,1199,4042
Ohio,Pitsburg village,410,6,4,21,22,22,75
Ohio,Plain City village,4330,120,108,389,195,152,964
Ohio,Plainfield village,164,5,4,11,6,8,34
Ohio,Pleasant City village,423,8,8,28,19,15,78
Ohio,Plainville,22,0,0,0,0,0,0
Ohio,Chesterland,2035,32,0,126,69,90,317
Ohio,Chesterville village,228,12,0,17,21,20,70
Ohio,Cheviot,8327,164,98,488,241,195,1186
Ohio,Chickasaw village,363,5,9,12,9,21,56
Ohio,Chillicothe,21765,392,241,1167,1035,852,3687
Ohio,Chilo village,89,0,0,6,0,15,21
Ohio,Chippewa Lake village,711,9,5,12,15,57,98
Ohio,Chippewa Park,838,11,15,36,20,59,141
Ohio,Perry village,1636,38,10,117,130,104,399
Ohio,Pepper Pike,6115,93,65,405,294,447,1304
Ohio,Peninsula village,590,13,10,21,25,21,90
Ohio,Pemberville village,1625,57,42,95,102,129,425
Ohio,Oregon,20207,156,286,893,990,1247,3572
Ohio,Orient,303,0,1,18,18,28,65
Ohio,Orrville,8329,143,201,339,463,272,1418
Ohio,Orwell village,1615,19,16,90,74,99,298
Ohio,Osgood village,314,3,8,28,19,12,70
Ohio,Ostrander village,1025,13,9,63,133,107,325
Ohio,Ottawa village,4424,148,50,44,299,300,841
Ohio,Ottawa Hills village,4487,115,97,238,279,290,1019
Ohio,Ottoville village,900,27,23,68,44,70,232
Ohio,Otway village,98,0,4,7,6,0,17
Ohio,Owensville village,854,10,10,35,43,26,124
Ohio,Oxford,21762,102,76,382,261,284,1105
Ohio,Choctaw Lake,1510,0,27,64,68,137,296
Ohio,Painesville,19694,245,324,1065,1150,1062,3846
Ohio,Pancoastburg,124,0,0,8,0,0,8
Ohio,Pandora village,1202,12,17,70,55,50,204
Ohio,Park Layne,4612,139,83,277,272,183,954
Ohio,Parkman,129,0,0,0,0,0,0
Ohio,Parma,80380,1016,784,3333,3676,4417,13226
Ohio,Parma Heights,20409,236,184,856,1028,666,2970
Ohio,Parral village,222,4,0,8,9,10,31
Ohio,Pataskala,15120,366,125,904,889,942,3226
Ohio,Patterson village,144,2,6,16,8,7,39
Ohio,Paulding village,3699,80,63,185,115,130,573
Ohio,Payne village,1109,18,16,72,36,40,182
Ohio,Peebles village,1857,26,20,72,102,106,326
Ohio,Palestine village,205,8,0,25,9,17,59
Ohio,Orangeville village,216,8,6,25,19,16,74
Ohio,Christiansburg village,564,4,6,26,46,33,115
Ohio,Cincinnati,297397,4864,4055,14083,13262,13222,49486
Ohio,Continental village,998,11,21,53,41,24,150
Ohio,Convoy village,1285,60,14,53,102,114,343
Ohio,Coolville village,649,8,7,28,67,73,183
Ohio,Corning village,452,11,2,16,25,16,70
Ohio,Cortland,7001,67,84,268,247,540,1206
Ohio,Corwin village,539,3,6,34,26,27,96
Ohio,Coshocton,11153,118,85,497,583,499,1782
Ohio,Covedale,6623,93,30,533,304,380,1340
Ohio,Covington village,2606,42,54,171,173,103,543
Ohio,Craig Beach village,1174,29,18,80,89,63,279
Ohio,Crestline village,4472,96,53,164,213,182,708
Ohio,Creston village,2235,15,68,95,117,164,459
Ohio,Cridersville village,1785,31,42,52,61,67,253
Ohio,Crooksville village,2399,28,24,66,115,172,405
Ohio,Crown City village,382,13,0,10,20,27,70
Ohio,Crystal Lakes,1377,6,31,154,97,20,308
Ohio,Crystal Rock,126,0,0,12,0,0,12
Ohio,Cumberland village,479,5,10,31,31,43,120
Ohio,Curtice,1842,0,9,24,143,144,320
Ohio,Custar village,135,0,0,3,4,0,7
Ohio,Cuyahoga Falls,49287,908,555,2563,2098,1857,7981
Ohio,Cuyahoga Heights village,616,2,9,47,39,38,135
Ohio,Cygnet village,746,19,18,49,42,41,169
Ohio,Cynthiana,0,0,0,0,0,0,0
Ohio,Dalton village,1717,30,23,76,79,119,327
Ohio,Connorville,160,0,0,0,16,12,28
Ohio,Conneaut,12806,129,102,511,617,711,2070
Ohio,Congress village,162,0,6,25,4,22,57
Ohio,Conesville village,345,1,0,9,17,33,60
Ohio,Cinnamon Lake,923,0,22,69,36,38,165
Ohio,Clarington village,424,6,1,25,17,14,63
Ohio,Clarksburg village,537,31,10,19,44,15,119
Ohio,Clarksville village,592,0,6,57,51,75,189
Ohio,Clarktown,555,12,0,25,11,10,58
Ohio,Ravenna,11642,93,112,505,597,420,1727
Ohio,Clay Center village,307,7,0,22,31,17,77
Ohio,Clayton,13196,274,144,696,691,776,2581
Ohio,Cleveland,390584,5709,4764,19805,19641,22776,72695
Ohio,Cleveland Heights,45388,932,674,2049,2181,2491,8327
Ohio,Cleves village,3365,119,87,261,337,230,1034
Ohio,Clifton village,152,1,0,5,17,10,33
Ohio,Churchill,2002,0,0,3,0,129,132
Ohio,Clinton village,1160,26,10,29,56,94,215
Ohio,Clyde,6305,85,134,398,218,280,1115
Ohio,Coal Grove village,2066,7,17,107,97,98,326
Ohio,Coalton village,642,14,7,23,47,24,115
Ohio,Coldstream,1271,27,0,46,88,90,251
Ohio,Coldwater village,4327,48,39,297,218,270,872
Ohio,College Corner village,401,0,0,11,7,22,40
Ohio,Collins,482,0,20,29,8,0,57
Ohio,Columbiana,6393,73,30,201,288,195,787
Ohio,Columbus,824663,11931,11387,41263,35681,36510,136772
Ohio,Columbus Grove village,1971,11,37,98,95,91,332
Ohio,Commercial Point village,1643,37,37,197,122,103,496
Ohio,Concorde Hills,663,0,0,16,41,64,121
Ohio,Cloverdale village,158,0,0,15,1,4,20
Ohio,Orange village,3288,45,33,143,330,141,692
Ohio,Circleville,13706,140,72,553,819,874,2458
Ohio,Olmsted Falls,8923,261,78,427,516,617,1899
Ohio,Ontario,6142,19,14,356,300,229,918
Ohio,Pleasant Hills,541,0,11,11,29,35,86
Ohio,Pleasant Plain village,147,0,0,4,0,5,9
Ohio,Pleasant Run,4898,70,0,209,318,317,914
Ohio,Pleasant Run Farm,4789,58,38,334,405,227,1062
Ohio,Pleasantville village,1175,17,37,112,95,51,312
Ohio,Plumwood,257,5,0,20,15,20,60
Ohio,Plymouth village,1719,14,48,92,107,125,386
Ohio,Poland village,2846,52,36,124,194,159,565
Ohio,Polk village,301,5,6,18,10,23,62
Ohio,Pomeroy village,1953,36,22,130,111,81,380
Ohio,Portage village,388,1,11,20,14,28,74
Ohio,Portage Lakes,7038,62,70,116,181,476,905
Ohio,Port Clinton,6025,101,41,299,290,365,1096
Ohio,Norwood,19316,252,196,552,658,878,2536
Ohio,Port Jefferson village,425,7,2,22,33,15,79
Ohio,Port Washington village,610,0,11,14,54,45,124
Ohio,Port William village,249,0,2,12,16,13,43
Ohio,Potsdam village,326,0,8,9,30,8,55
Ohio,Pottery Addition,355,0,0,0,37,137,174
Ohio,Powell,12298,420,163,1191,1024,901,3699
Ohio,Powhatan Point village,1474,18,23,51,40,71,203
Ohio,Proctorville village,554,0,2,55,4,22,83
Ohio,Prospect village,1118,19,39,40,63,47,208
Ohio,Pulaski,70,0,0,0,0,0,0
Ohio,Put-in-Bay village,117,3,0,0,1,0,4
Ohio,Quaker City village,501,2,5,41,33,7,88
Ohio,Quincy village,667,7,15,68,51,49,190
Ohio,Racine village,616,12,6,14,21,51,104
Ohio,Radnor,248,0,0,19,0,0,19
Ohio,Portsmouth,20376,372,146,944,1041,810,3313
Ohio,Oak Harbor village,2740,43,53,215,188,145,644
Ohio,Pleasant Hill village,1167,23,34,77,38,70,242
Ohio,Oak Hill village,1684,39,52,117,136,71,415
Ohio,Pleasant Grove,1794,40,16,39,164,81,340
Ohio,Old Washington village,357,1,8,17,6,30,62
Ohio,Old Fort,200,13,15,0,0,0,28
Ohio,Olde West Chester,97,0,0,0,7,5,12
Ohio,Ohio City village,753,21,12,46,29,26,134
Ohio,Oakwood village (Cuyahoga County),3689,29,55,189,139,21,433
Ohio,Oceola,123,0,26,20,0,0,46
Ohio,Obetz village,4558,157,110,312,291,255,1125
Ohio,Oberlin,8356,91,33,325,280,306,1035
Ohio,Oakwood village (Paulding County),568,2,19,59,26,23,129
Ohio,Oakwood,9118,161,142,725,768,727,2523
Ohio,Octa village,41,0,0,3,4,2,9
Oklahoma,Brush Creek,73,0,0,0,0,22,22
Oklahoma,Brushy,945,26,23,60,50,58,217
Oklahoma,Buffalo,1408,22,19,87,73,91,292
Oklahoma,Bull Hollow,54,0,0,0,0,0,0
Oklahoma,Burbank,115,1,0,10,6,8,25
Oklahoma,Burlington,149,2,5,16,7,11,41
Oklahoma,Burneyville,562,8,7,36,32,23,106
Oklahoma,Burns Flat,2271,40,71,157,127,154,549
Oklahoma,Bushyhead,1359,14,8,102,89,94,307
Oklahoma,McAlester,18324,399,260,1173,826,811,3469
Oklahoma,McCord,1593,38,5,104,55,72,274
Oklahoma,McCurtain,469,7,10,38,32,29,116
Oklahoma,McLoud,4587,97,64,181,234,288,864
Oklahoma,Macomb,30,0,0,2,2,5,9
Oklahoma,Madill,3839,90,45,237,167,298,837
Oklahoma,Manchester,66,5,0,11,1,0,17
Oklahoma,Mangum,2937,105,47,199,137,151,639
Oklahoma,Manitou,228,7,0,0,42,19,68
Oklahoma,Mannford,3105,28,69,170,213,180,660
Oklahoma,Butler,322,8,0,13,13,16,50
Oklahoma,Brooksville,54,0,0,2,0,8,10
Oklahoma,Broken Arrow,103437,2010,1523,6467,6104,6145,22249
Oklahoma,Broken Bow,4127,123,36,254,220,340,973
Oklahoma,Blue,194,0,0,0,12,0,12
Oklahoma,Bluejacket,316,8,2,13,24,29,76
Oklahoma,Boise City,1140,45,24,60,44,68,241
Oklahoma,Bokchito,638,2,10,32,48,28,120
Oklahoma,Bokoshe,484,2,29,18,26,16,91
Oklahoma,Boley,1098,3,5,10,10,19,47
Oklahoma,Boswell,707,20,6,37,24,16,103
Oklahoma,Bowlegs,391,4,2,24,40,14,84
Oklahoma,Box,125,0,0,0,0,0,0
Oklahoma,Bromide,118,1,0,5,5,4,15
Oklahoma,Boynton,193,6,4,6,19,15,50
Oklahoma,Braggs,270,9,6,13,8,13,49
Oklahoma,Braman,178,5,2,11,9,10,37
Oklahoma,Bray,1291,23,22,61,61,63,230
Oklahoma,Breckenridge,290,26,10,18,4,20,78
Oklahoma,Brent,808,4,0,10,52,100,166
Oklahoma,Mannsville,828,7,19,53,46,37,162
Oklahoma,Bridgeport,115,2,0,3,14,6,25
Oklahoma,Briggs,287,29,13,36,31,19,128
Oklahoma,Bristow,4263,91,83,264,273,136,847
Oklahoma,Bradley,107,0,1,1,4,6,12
Oklahoma,Bridge Creek,271,7,4,31,18,15,75
Oklahoma,Tecumseh,6583,76,90,359,627,286,1438
Oklahoma,Marietta,144,0,4,9,4,8,25
Oklahoma,Mountain Park,477,14,8,36,19,38,115
Oklahoma,Mountain View,777,0,30,22,37,28,117
Oklahoma,Mulberry,139,0,0,4,8,17,29
Oklahoma,Muldrow,3331,23,56,175,190,230,674
Oklahoma,Mulhall,273,0,4,17,22,8,51
Oklahoma,Zion,35,0,3,3,0,0,6
Oklahoma,Zena,204,0,10,0,15,16,41
Oklahoma,Zeb,673,29,8,40,21,10,108
Oklahoma,Yukon,24746,466,337,1436,1472,1194,4905
Oklahoma,Yeager,71,0,0,0,8,11,19
Oklahoma,Yale,1145,0,3,39,77,67,186
Oklahoma,Wynona,474,8,11,26,31,21,97
Oklahoma,Wynnewood,2235,44,32,62,117,67,322
Oklahoma,Wyandotte,342,8,7,24,13,17,69
Oklahoma,Kinta,257,11,4,21,12,27,75
Oklahoma,Kingston,1537,20,31,60,85,85,281
Oklahoma,Kingfisher,4755,181,56,218,254,195,904
Oklahoma,Kildare,71,0,2,2,9,2,15
Oklahoma,Kiefer,2055,56,47,136,89,103,431
Oklahoma,Keys,578,7,0,0,64,13,84
Oklahoma,Keyes,238,3,0,12,7,10,32
Oklahoma,Ketchum,439,3,3,37,34,24,101
Oklahoma,Keota,651,14,24,53,36,51,178
Oklahoma,Kenwood,1011,20,18,67,61,51,217
Oklahoma,Kenton,59,0,0,4,5,0,9
Oklahoma,Mounds,1192,6,0,78,45,126,255
Oklahoma,Marble City,225,3,2,16,9,16,46
Oklahoma,Morrison,773,12,11,46,103,56,228
Oklahoma,Mooreland,1724,93,28,134,111,130,496
Oklahoma,Marietta,2683,44,28,152,234,212,670
Oklahoma,Marland,282,6,5,26,20,15,72
Oklahoma,Marlow,4632,54,93,224,222,312,905
Oklahoma,Marshall,309,7,4,21,9,12,53
Oklahoma,Martha,141,0,0,0,4,17,21
Oklahoma,Maud,917,2,15,80,88,49,234
Oklahoma,May,49,0,0,0,6,4,10
Oklahoma,Maysville,1288,12,40,56,66,60,234
Oklahoma,Mazie,207,0,0,0,0,0,0
Oklahoma,Mead,78,0,0,4,1,1,6
Oklahoma,Medford,1015,23,3,18,56,60,160
Oklahoma,Medicine Park,233,0,0,6,5,4,15
Oklahoma,Meeker,1158,33,14,76,59,53,235
Oklahoma,Meno,239,15,0,12,18,22,67
Oklahoma,Meridian,52,0,0,0,0,4,4
Oklahoma,Meridian,1085,31,0,69,28,40,168
Oklahoma,Miami,13666,194,230,702,677,675,2478
Oklahoma,Midwest City,56507,865,762,2907,3239,2732,10505
Oklahoma,Milburn,320,4,5,22,13,13,57
Oklahoma,Mill Creek,312,2,5,17,16,21,61
Oklahoma,Millerton,287,4,0,18,23,17,62
Oklahoma,Minco,1364,22,15,72,45,78,232
Oklahoma,Moffett,128,3,1,7,8,11,30
Oklahoma,Monroe,199,10,0,2,3,11,26
Oklahoma,Moore,58615,914,1106,3355,2912,2864,11151
Oklahoma,Morris,1511,31,15,110,96,131,383
Oklahoma,Maramec,95,3,3,0,10,3,19
Oklahoma,Stoney Point,284,9,7,38,44,10,108
Oklahoma,Strang,65,0,0,4,3,0,7
Oklahoma,Tribbey,370,3,2,11,24,27,67
Oklahoma,Tryon,527,0,5,52,20,23,100
Oklahoma,Tullahassee,284,2,2,4,5,14,27
Oklahoma,Tulsa,398082,7566,6525,21326,20620,19148,75185
Oklahoma,Tupelo,345,10,12,18,29,19,88
Oklahoma,Turley,2291,41,15,71,97,88,312
Oklahoma,Turpin,577,26,9,44,19,53,151
Oklahoma,Tushka,286,12,3,8,6,20,49
Oklahoma,Tuskahoma,132,0,4,10,8,3,25
Oklahoma,Tuttle,6411,97,58,381,533,474,1543
Oklahoma,Kenefic,201,1,6,17,16,28,68
Oklahoma,Twin Oaks,227,3,0,0,14,27,44
Oklahoma,Tyrone,965,9,11,119,63,120,322
Oklahoma,Union City,1511,8,9,57,50,107,231
Oklahoma,Valley Brook,718,9,6,20,42,20,97
Oklahoma,Valley Park,58,3,0,6,4,5,18
Oklahoma,Arpelar,281,0,3,13,8,13,37
Oklahoma,Arnett,498,14,11,14,24,23,86
Oklahoma,Armstrong,185,4,0,5,48,1,58
Oklahoma,Arkoma,1915,49,26,103,120,59,357
Oklahoma,Ardmore,24955,661,310,1568,1351,1467,5357
Oklahoma,Arcadia,175,2,0,10,4,11,27
Oklahoma,Arapaho,550,3,3,3,38,26,73
Oklahoma,Apache,1282,63,12,81,78,50,284
Oklahoma,Antlers,2471,33,55,108,144,129,469
Oklahoma,Tonkawa,3149,51,43,155,163,221,633
Oklahoma,Anadarko,6777,172,81,445,452,385,1535
Oklahoma,Titanic,252,19,0,10,17,15,61
Oklahoma,Tipton,867,13,17,59,18,46,153
Oklahoma,Temple,1091,60,34,61,39,55,249
Oklahoma,Tenkiller,523,16,8,6,4,35,69
Oklahoma,Teresita,147,0,4,2,6,3,15
Oklahoma,Terlton,107,3,2,11,8,2,26
Oklahoma,Terral,390,11,5,33,32,14,95
Oklahoma,Texanna,2273,7,10,43,113,108,281
Oklahoma,Texhoma,851,7,21,75,68,70,241
Oklahoma,Texola,54,0,0,0,0,0,0
Oklahoma,Thackerville,471,17,17,21,40,15,110
Oklahoma,The Village,9223,74,88,349,378,394,1283
Oklahoma,Thomas,1220,17,25,45,47,80,214
Oklahoma,Stonewall,384,5,5,20,9,17,56
Oklahoma,Stilwell,4007,205,96,298,185,185,969
Oklahoma,Stillwater,47523,854,471,1544,1814,1520,6203
Oklahoma,Stigler,2725,50,41,158,97,110,456
Oklahoma,Stidham,45,2,0,4,2,0,8
Oklahoma,Sterling,620,9,4,18,27,34,92
Oklahoma,Steely Hollow,157,0,0,0,14,15,29
Oklahoma,Springer,639,14,13,26,26,27,106
Oklahoma,Sportsmen Acres,371,2,5,24,35,26,92
Oklahoma,Spiro,2640,32,52,138,140,127,489
Oklahoma,Sperry,1140,5,30,50,55,64,204
Oklahoma,Spencer,4004,8,13,191,218,255,685
Oklahoma,Spavinaw,350,1,1,5,12,24,43
Oklahoma,Tiawah,223,0,0,12,0,51,63
Oklahoma,Tishomingo,3075,15,54,121,103,98,391
Oklahoma,Amorita,6,0,0,0,0,2,2
Oklahoma,Ames,239,0,4,13,7,7,31
Oklahoma,Amber,370,10,5,26,37,24,102
Oklahoma,Beggs,1189,19,12,85,88,48,252
Oklahoma,Belfonte,269,0,13,36,15,7,71
Oklahoma,Goltry,183,7,0,6,6,7,26
Oklahoma,Goldsby,1982,40,32,137,159,89,457
Oklahoma,Glenpool,11982,201,184,824,823,580,2612
Oklahoma,Glencoe,574,3,12,47,50,45,157
Oklahoma,Gideon,15,0,0,0,0,0,0
Oklahoma,Gerty,85,0,1,5,8,6,20
Oklahoma,Taloga,388,17,14,16,7,5,59
Oklahoma,Talihina,1087,18,26,62,54,63,223
Oklahoma,Talala,324,7,7,15,36,31,96
Oklahoma,Tahlequah,16354,303,331,734,743,570,2681
Oklahoma,Tagg Flats,107,0,8,10,9,29,56
Oklahoma,Taft,176,10,0,6,8,7,31
Oklahoma,Sycamore,358,8,0,32,30,14,84
Oklahoma,Swink,83,0,2,3,6,1,12
Oklahoma,Sweetwater,186,5,0,13,18,12,48
Oklahoma,Summit,135,2,3,4,4,9,22
Oklahoma,Sulphur,5032,42,108,245,261,243,899
Oklahoma,Sugden,38,1,0,1,1,0,3
Oklahoma,Stuart,184,2,3,8,7,21,41
Oklahoma,Stroud,2710,59,67,144,64,159,493
Oklahoma,Strong City,62,4,3,2,0,0,9
Oklahoma,Stringtown,340,4,6,9,10,23,52
Oklahoma,Stratford,1503,21,25,78,81,71,276
Oklahoma,Bee,137,0,0,0,0,0,0
Oklahoma,Beaver,1592,44,26,118,84,56,328
Oklahoma,Bearden,142,2,2,11,5,22,42
Oklahoma,Bartlesville,36360,475,608,1843,2047,1862,6835
Oklahoma,Alva,5023,107,31,226,218,193,775
Oklahoma,Altus,19549,382,295,1096,988,768,3529
Oklahoma,Allen,831,10,12,51,44,39,156
Oklahoma,Aline,245,0,0,4,12,27,43
Oklahoma,Alex,536,5,11,31,40,35,122
Oklahoma,Alderson,309,6,6,31,16,14,73
Oklahoma,Albion,59,0,0,8,2,1,11
Oklahoma,Albany,102,0,0,6,15,3,24
Oklahoma,Akins,610,3,0,45,78,43,169
Oklahoma,Agra,300,10,3,22,17,17,69
Oklahoma,Afton,1063,12,21,85,81,71,270
Oklahoma,Addington,101,0,1,5,6,9,21
Oklahoma,Tatums,111,0,0,0,6,12,18
Oklahoma,Adair,868,24,19,38,41,52,174
Oklahoma,Achille,467,9,7,16,40,28,100
Oklahoma,Valliant,843,7,15,39,64,70,195
Oklahoma,Velma,697,25,11,41,28,64,169
Oklahoma,Vera,164,6,2,4,9,9,30
Oklahoma,Asher,413,7,4,14,25,32,82
Oklahoma,Ashland,39,0,0,1,2,0,3
Oklahoma,Atoka,3077,115,36,155,141,202,649
Oklahoma,Atwood,47,0,0,0,0,3,3
Oklahoma,Avant,343,5,4,33,37,19,98
Oklahoma,Badger Lee,96,0,0,6,5,14,25
Oklahoma,Ballou,107,5,0,0,0,15,20
Oklahoma,Barnsdall,1085,24,12,68,50,46,200
Oklahoma,Ada,17149,347,202,757,785,626,2717
Oklahoma,Kendrick,83,1,1,8,9,7,26
Oklahoma,Washington,689,15,8,43,61,51,178
Oklahoma,Kellyville,1367,30,7,109,87,143,376
Oklahoma,Elk City,12424,316,453,767,402,430,2368
Oklahoma,Elmer,113,5,0,5,8,9,27
Oklahoma,Elm Grove,167,0,0,0,10,10,20
Oklahoma,Elmore City,756,13,12,79,26,54,184
Oklahoma,El Reno,17852,306,449,999,806,1043,3603
Oklahoma,Empire City,810,16,13,43,20,34,126
Oklahoma,Elgin,2702,42,32,162,177,185,598
Oklahoma,Enid,50685,916,643,2991,2575,2433,9558
Oklahoma,Erin Springs,191,0,0,10,0,0,10
Oklahoma,Etowah,85,0,0,3,6,4,13
Oklahoma,Eufaula,2899,52,44,120,128,138,482
Oklahoma,Evening Shade,305,0,0,6,6,15,27
Oklahoma,Fairfax,1491,47,28,112,84,62,333
Oklahoma,Fairfield,580,24,8,30,13,44,119
Oklahoma,Erick,1105,4,0,63,5,82,154
Oklahoma,Fairland,1123,28,23,61,67,47,226
Oklahoma,Eldorado,449,10,8,17,31,37,103
Oklahoma,Edmond,86739,1881,1228,5558,4613,4412,17692
Oklahoma,Dripping Springs,29,0,2,6,0,0,8
Oklahoma,Drowning Creek,185,0,0,10,10,0,20
Oklahoma,Drummond,433,0,0,54,36,37,127
Oklahoma,Drumright,2929,44,32,154,146,192,568
Oklahoma,Dry Creek,314,9,5,14,9,35,72
Oklahoma,Duchess Landing,258,16,0,39,33,0,88
Oklahoma,Eldon,240,0,4,10,15,0,29
Oklahoma,Duncan,23317,379,273,1378,1318,1334,4682
Oklahoma,Dustin,295,5,2,19,14,15,55
Oklahoma,Dwight Mission,0,0,0,0,0,0,0
Oklahoma,Eagletown,642,5,9,48,51,51,164
Oklahoma,Eakly,384,4,4,17,25,41,91
Oklahoma,Earlsboro,487,3,12,25,20,32,92
Oklahoma,East Duke,349,1,12,11,30,20,74
Oklahoma,Durant,16767,298,305,772,751,616,2742
Oklahoma,Fairmont,221,2,4,15,4,4,29
Oklahoma,Fair Oaks,56,0,1,1,2,0,4
Oklahoma,Fairview,2629,69,24,129,127,123,472
Oklahoma,Foyil,281,3,10,15,20,22,70
Oklahoma,Francis,323,6,14,24,12,15,71
Oklahoma,Frederick,3804,102,58,217,259,192,828
Oklahoma,Freedom,247,1,6,8,18,21,54
Oklahoma,Friendship,16,0,0,0,0,0,0
Oklahoma,Gage,473,7,0,37,32,13,89
Oklahoma,Foster,117,1,1,5,1,4,12
Oklahoma,Gans,331,7,6,37,22,18,90
Oklahoma,Garvin,197,3,2,20,21,4,50
Oklahoma,Gate,132,0,0,10,20,9,39
Oklahoma,Geary,1147,38,16,107,67,37,265
Oklahoma,Gene Autry,135,1,5,5,5,4,20
Oklahoma,Geronimo,983,31,23,41,43,57,195
Oklahoma,Norman,117353,1979,1486,5082,5001,4403,17951
Oklahoma,Garber,683,5,12,41,29,39,126
Oklahoma,Foss,174,0,0,12,6,13,31
Oklahoma,Fort Towson,620,4,4,31,38,28,105
Oklahoma,Fort Supply,447,23,8,33,16,36,116
Oklahoma,Fallis,20,0,0,0,0,0,0
Oklahoma,Fanshawe,347,13,5,14,21,14,67
Oklahoma,Fargo,335,15,2,8,13,32,70
Oklahoma,Faxon,67,0,0,0,0,8,8
Oklahoma,Felt,91,0,0,3,4,7,14
Oklahoma,Fitzhugh,285,6,9,20,21,20,76
Oklahoma,Fletcher,1140,38,48,85,31,60,262
Oklahoma,Flint Creek,810,0,0,38,0,63,101
Oklahoma,Flute Springs,62,2,3,2,2,0,9
Oklahoma,Foraker,6,0,0,0,0,0,0
Oklahoma,Forest Park,1105,0,37,21,19,40,117
Oklahoma,Forgan,382,5,10,14,13,11,53
Oklahoma,Fort Cobb,625,23,8,26,46,23,126
Oklahoma,Fort Coffee,518,2,1,28,34,46,111
Oklahoma,Fort Gibson,4121,103,45,251,200,331,930
Oklahoma,Dover,306,11,5,15,27,20,78
Oklahoma,Norge,165,0,10,2,5,9,26
Oklahoma,Verdigris,4203,41,32,291,323,257,944
Oklahoma,Ratliff City,131,0,0,4,10,4,18
Oklahoma,Old Eucha,13,0,0,0,1,0,1
Oklahoma,Old Green,582,0,25,49,42,49,165
Oklahoma,Olustee,537,0,21,47,42,40,150
Oklahoma,Oologah,1135,35,18,48,78,41,220
Oklahoma,Optima,501,7,5,59,44,27,142
Oklahoma,Orlando,153,5,0,13,22,9,49
Oklahoma,Oktaha,376,7,5,19,27,28,86
Oklahoma,Osage,113,2,0,1,1,5,9
Oklahoma,Paden,585,18,25,49,28,18,138
Oklahoma,Panama,1284,11,18,37,55,59,180
Oklahoma,Panola,94,2,0,0,4,3,9
Oklahoma,Paoli,573,5,0,17,46,36,104
Oklahoma,Paradise Hill,56,0,0,0,1,1,2
Oklahoma,Park Hill,3667,56,63,278,274,288,959
Oklahoma,Owasso,32650,515,580,2140,2084,2292,7611
Oklahoma,Pauls Valley,6073,115,107,253,279,295,1049
Oklahoma,Okmulgee,12350,217,291,649,428,576,2161
Oklahoma,Okemah,3276,53,50,201,202,236,742
Oklahoma,North Enid,880,23,4,55,65,67,214
Oklahoma,North Miami,358,0,5,6,12,16,39
Oklahoma,Notchietown,291,0,0,6,23,33,62
Oklahoma,Nowata,3746,122,35,240,208,241,846
Oklahoma,Oak Grove,10,0,0,0,0,0,0
Oklahoma,Oakhurst,2312,47,44,145,125,121,482
Oklahoma,Oklahoma City,610672,10688,9957,36013,33113,29799,119570
Oklahoma,Oakland,1089,51,41,52,65,41,250
Oklahoma,Oakwood,48,6,0,6,5,0,17
Oklahoma,Ochelata,380,2,1,13,14,34,64
Oklahoma,Oilton,1082,28,4,41,56,89,218
Oklahoma,Okarche,1255,47,17,65,52,50,231
Oklahoma,Okay,581,12,9,25,19,36,101
Oklahoma,Okeene,1014,55,19,74,53,31,232
Oklahoma,Oaks,336,4,7,36,34,39,120
Oklahoma,Pawhuska,3663,50,32,168,247,267,764
Oklahoma,Pawnee,2228,48,42,72,93,155,410
Oklahoma,Peavine,360,3,9,10,36,29,87
Oklahoma,Porum,660,13,17,71,44,22,167
Oklahoma,Poteau,8624,171,128,589,448,467,1803
Oklahoma,Prague,2389,11,34,161,104,140,450
Oklahoma,Proctor,196,0,15,15,13,12,55
Oklahoma,Prue,508,9,11,34,23,29,106
Oklahoma,Pryor Creek,9484,241,143,582,562,604,2132
Oklahoma,Porter,625,4,23,33,42,31,133
Oklahoma,Pump Back,218,0,0,10,12,24,46
Oklahoma,Putnam,15,0,0,0,0,0,0
Oklahoma,Quapaw,887,28,9,58,62,41,198
Oklahoma,Quinton,1026,26,25,25,70,86,232
Oklahoma,Ralston,347,8,6,19,4,17,54
Oklahoma,Ramona,530,18,13,48,27,11,117
Oklahoma,Randlett,362,2,0,10,6,35,53
Oklahoma,Purcell,6292,93,69,412,257,318,1149
Oklahoma,Pond Creek,941,22,39,70,52,26,209
Oklahoma,Ponca City,24846,389,300,1575,1299,1593,5156
Oklahoma,Pocola,4026,96,30,273,242,217,858
Oklahoma,Peggs,753,25,17,22,24,35,123
Oklahoma,Pensacola,134,0,1,4,8,21,34
Oklahoma,Peoria,107,2,2,2,9,3,18
Oklahoma,Perkins,2861,40,9,178,179,100,506
Oklahoma,Perry,5082,81,60,254,352,328,1075
Oklahoma,Pettit,916,0,0,96,85,52,233
Oklahoma,Phillips,110,1,2,7,8,7,25
Oklahoma,Piedmont,6502,217,168,419,406,448,1658
Oklahoma,Piney,233,0,0,0,53,24,77
Oklahoma,Pinhook Corner,169,0,0,8,16,15,39
Oklahoma,Pink,2281,24,13,126,162,135,460
Oklahoma,Pin Oak Acres,409,0,0,9,8,38,55
Oklahoma,Pittsburg,183,2,1,4,9,11,27
Oklahoma,Platter,158,0,0,0,0,15,15
Oklahoma,Pocasset,151,2,0,11,13,9,35
Oklahoma,Verden,582,8,2,43,30,51,134
Oklahoma,Noble,6626,171,129,205,423,466,1394
Oklahoma,Ninnekah,1018,25,7,72,91,44,239
Oklahoma,Nicut,244,0,5,12,12,7,36
Oklahoma,Wann,191,3,4,14,7,5,33
Oklahoma,Wapanucka,376,3,3,28,32,31,97
Oklahoma,Wardville,47,0,0,6,6,0,12
Oklahoma,Warner,1844,16,34,109,75,63,297
Oklahoma,Warr Acres,10342,152,80,500,405,656,1793
Oklahoma,Warwick,125,0,0,7,3,0,10
Oklahoma,Wanette,279,7,8,18,24,8,65
Oklahoma,Bell,445,10,12,40,15,32,109
Oklahoma,Watts,309,9,7,30,21,13,80
Oklahoma,Wauhillau,448,14,2,56,31,15,118
Oklahoma,Waukomis,1477,21,0,93,117,172,403
Oklahoma,Waurika,2062,15,13,86,141,117,372
Oklahoma,Wayne,683,4,9,48,38,34,133
Oklahoma,Waynoka,1187,43,21,56,47,65,232
Oklahoma,Watonga,4110,62,63,172,165,176,638
Oklahoma,Weatherford,11663,292,126,410,472,528,1828
Oklahoma,Walters,2554,55,21,186,132,137,531
Oklahoma,Wainwright,175,4,0,9,12,15,40
Oklahoma,Slick,93,0,1,1,11,5,18
Oklahoma,Smith Village,73,0,0,1,1,0,2
Oklahoma,Smithville,103,0,7,7,4,0,18
Oklahoma,Snake Creek,178,0,0,0,27,14,41
Oklahoma,Snyder,1549,16,64,96,83,76,335
Oklahoma,Soper,202,5,4,7,8,11,35
Oklahoma,Wakita,313,4,0,4,20,10,38
Oklahoma,Sour John,41,0,0,0,0,0,0
Oklahoma,Sparks,180,3,1,6,12,6,28
Oklahoma,Spaulding,129,0,0,4,9,12,25
Oklahoma,Vian,1270,8,17,95,80,105,305
Oklahoma,Vici,813,0,25,39,20,22,106
Oklahoma,Vinita,5610,41,103,303,269,260,976
Oklahoma,Wagoner,8583,109,115,524,622,540,1910
Oklahoma,South Coffeyville,781,16,7,49,44,51,167
Oklahoma,Webb City,77,0,5,5,10,4,24
Oklahoma,Webbers Falls,544,7,6,35,37,27,112
Oklahoma,Welch,644,4,10,46,24,61,145
Oklahoma,Woodall,884,25,17,53,43,58,196
Oklahoma,Woodlawn Park,160,0,0,6,4,0,10
Oklahoma,Woodward,12591,378,323,750,665,713,2829
Oklahoma,Wright City,635,13,12,48,19,25,117
Oklahoma,Jefferson,13,0,0,0,0,0,0
Oklahoma,Jenks,19030,557,355,1509,1294,1163,4878
Oklahoma,Wister,1009,18,10,57,31,67,183
Oklahoma,Jennings,250,2,2,7,10,15,36
Oklahoma,Johnson,191,3,0,4,9,6,22
Oklahoma,Jones,2860,21,34,179,174,214,622
Oklahoma,Justice,1294,0,27,80,65,101,273
Oklahoma,Kansas,857,26,12,63,48,84,233
Oklahoma,Katie,259,0,7,11,12,13,43
Oklahoma,Kaw City,314,1,1,9,13,8,32
Oklahoma,Jet,227,3,0,22,6,10,41
Oklahoma,Winchester,522,9,2,19,21,24,75
Oklahoma,Wilson,1581,16,29,78,92,80,295
Oklahoma,Willow,128,0,0,5,1,0,6
Oklahoma,Weleetka,946,24,15,53,17,30,139
Oklahoma,Welling,841,3,0,52,54,45,154
Oklahoma,Wellston,778,10,15,28,41,49,143
Oklahoma,West Peavine,213,0,5,11,5,21,42
Oklahoma,Westport,440,8,15,11,12,6,52
Oklahoma,West Siloam Springs,982,5,26,37,30,33,131
Oklahoma,Westville,1701,34,51,142,113,124,464
Oklahoma,Wetumka,1288,37,13,81,82,94,307
Oklahoma,Wewoka,3436,72,34,194,182,166,648
Oklahoma,Whitefield,463,7,5,25,38,26,101
Oklahoma,White Oak,276,4,5,22,10,6,47
Oklahoma,Whitesboro,201,0,2,6,22,13,43
Oklahoma,White Water,26,0,0,0,0,0,0
Oklahoma,Wickliffe,14,0,0,0,0,0,0
Oklahoma,Wilburton,2765,48,10,117,155,175,505
Oklahoma,Slaughterville,4226,53,7,298,305,367,1030
Oklahoma,Skiatook,7827,188,149,532,512,644,2025
Oklahoma,Skedee,57,0,0,3,1,1,5
Oklahoma,Simms,296,0,5,5,9,19,38
Oklahoma,Redbird Smith,351,0,9,0,9,0,18
Oklahoma,Red Oak,598,17,2,43,17,26,105
Oklahoma,Red Rock,344,8,19,23,29,13,92
Oklahoma,Remy,548,4,0,59,5,14,82
Oklahoma,Renfrow,13,0,0,0,0,0,0
Oklahoma,Rentiesville,141,0,2,7,3,3,15
Oklahoma,Redbird,71,1,1,7,3,7,19
Oklahoma,Reydon,155,2,2,10,1,3,18
Oklahoma,Ringwood,615,24,13,58,40,24,159
Oklahoma,Ripley,315,1,2,27,15,17,62
Oklahoma,River Bottom,164,0,3,3,3,4,13
Oklahoma,Rock Island,774,20,3,38,30,43,134
Oklahoma,Rocky,156,2,4,5,1,8,20
Oklahoma,Rocky Ford,54,0,0,4,5,2,11
Oklahoma,Ringling,1026,21,28,82,36,50,217
Oklahoma,Ravia,452,16,6,21,23,16,82
Oklahoma,Rattan,289,9,2,15,10,7,43
Oklahoma,Murphy,170,0,0,0,0,7,7
Oklahoma,Nicoma Park,2440,16,28,149,176,109,478
Oklahoma,Nichols Hills,3839,92,103,143,100,228,666
Oklahoma,New Woodville,156,7,5,20,0,6,38
Oklahoma,Newkirk,2283,42,24,124,161,114,465
Oklahoma,New Eucha,554,8,12,28,32,75,155
Oklahoma,New Cordell,2920,33,46,145,244,147,615
Oklahoma,Newcastle,8712,136,179,628,432,596,1971
Oklahoma,New Alluwe,83,0,2,1,6,0,9
Oklahoma,Nescatunga,93,0,0,0,6,8,14
Oklahoma,Nash,219,6,5,20,10,2,43
Oklahoma,Nardin,92,0,0,0,0,0,0
Oklahoma,Narcissa,73,0,0,0,0,9,9
Oklahoma,Mutual,114,3,0,4,5,3,15
Oklahoma,Mustang,19112,258,289,1180,1115,1266,4108
Oklahoma,Muskogee,38776,728,531,2440,2182,2036,7917
Oklahoma,Rocky Mountain,379,5,6,25,19,29,84
Oklahoma,Kemp,122,0,1,3,6,5,15
Oklahoma,Roff,658,23,10,50,30,50,163
Oklahoma,Roosevelt,302,17,3,5,15,11,51
Oklahoma,Seiling,833,7,11,78,65,97,258
Oklahoma,Seminole,7508,238,112,424,695,423,1892
Oklahoma,Sentinel,865,22,15,50,63,55,205
Oklahoma,Sequoyah,664,8,0,23,54,35,120
Oklahoma,Shady Grove CDP (Cherokee County),465,11,12,31,12,39,105
Oklahoma,Shady Grove CDP (McIntosh County),252,0,0,0,27,24,51
Oklahoma,Scraper,197,0,0,0,0,32,32
Oklahoma,Shady Point,1090,21,20,53,64,67,225
Oklahoma,Sharon,65,0,0,8,6,3,17
Oklahoma,Shattuck,1264,0,32,118,96,17,263
Oklahoma,Shawnee,30866,552,549,1714,1581,1303,5699
Oklahoma,Shidler,415,11,12,27,14,24,88
Oklahoma,Short,455,38,25,22,19,11,115
Oklahoma,Silo,334,5,5,15,21,19,65
Oklahoma,Shamrock,61,0,0,1,3,8,12
Oklahoma,Schulter,457,14,6,21,33,5,79
Oklahoma,Sayre,4603,97,20,117,266,106,606
Oklahoma,Sawyer,354,5,0,20,9,21,55
Oklahoma,Rose,149,0,0,8,14,17,39
Oklahoma,Rosedale,76,0,0,0,3,9,12
Oklahoma,Rosston,44,0,0,5,0,0,5
Oklahoma,Rush Springs,1312,27,30,64,47,103,271
Oklahoma,Ryan,795,12,9,42,69,45,177
Oklahoma,St. Louis,115,1,0,5,6,2,14
Oklahoma,Salem,133,0,0,4,0,8,12
Oklahoma,Salina,1304,25,9,49,88,98,269
Oklahoma,Sallisaw,8698,144,119,550,402,372,1587
Oklahoma,Sams Corner,135,0,4,0,0,12,16
Oklahoma,Sand Hill,368,10,0,12,5,20,47
Oklahoma,Sand Springs,19397,394,177,1044,1167,1141,3923
Oklahoma,Sapulpa,20399,345,398,870,1218,1228,4059
Oklahoma,Sasakwa,126,5,8,7,9,2,31
Oklahoma,Savanna,668,18,7,27,54,31,137
Oklahoma,Roland,3339,72,37,239,203,235,786
Oklahoma,Bennington,316,8,7,23,12,18,68
Oklahoma,Tamaha,142,5,2,9,1,3,20
Oklahoma,Bessie,165,7,2,3,6,8,26
Oklahoma,Indianola,0,0,0,0,0,0,0
Oklahoma,Indiahoma,346,5,3,44,11,9,72
Oklahoma,Idabel,7026,148,169,477,507,317,1618
Oklahoma,Hydro,976,9,19,75,57,70,230
Oklahoma,Hunter,218,1,3,10,25,5,44
Oklahoma,Hulbert,679,5,18,42,40,48,153
Oklahoma,Indianola,171,3,3,13,4,15,38
Oklahoma,Hugo,5277,98,110,379,318,152,1057
Oklahoma,Horntown,102,0,3,6,8,2,19
Oklahoma,Hoot Owl,0,0,0,0,0,0,0
Oklahoma,Hooker,1950,24,41,89,118,86,358
Oklahoma,Hominy,3556,52,27,194,114,106,493
Oklahoma,Hollister,13,0,0,0,2,0,2
Oklahoma,Hollis,2061,46,40,148,78,80,392
Oklahoma,Howe,916,2,12,33,26,42,115
Oklahoma,Holdenville,5748,81,76,290,222,218,887
Oklahoma,Inola,1934,30,20,135,110,118,413
Oklahoma,Isabella,199,20,0,15,34,9,78
Oklahoma,Leon,88,0,0,2,3,2,7
Oklahoma,Lequire,160,0,6,0,3,15,24
Oklahoma,Lexington,2397,15,48,193,114,119,489
Oklahoma,Liberty,331,0,6,11,24,8,49
Oklahoma,Liberty,200,0,5,7,11,13,36
Oklahoma,Lima,62,0,0,3,3,4,10
Oklahoma,Iron Post,82,0,0,0,6,0,6
Oklahoma,Limestone,579,6,0,40,37,44,127
Oklahoma,Loco,118,0,1,6,3,5,15
Oklahoma,Locust Grove,1386,11,22,67,120,83,303
Oklahoma,Lone Grove,5173,87,143,420,386,344,1380
Oklahoma,Lone Wolf,450,15,0,27,19,5,66
Oklahoma,Jay,2572,46,57,178,169,132,582
Oklahoma,IXL,39,0,0,2,0,4,6
Oklahoma,Lindsay,2815,31,27,160,90,93,401
Oklahoma,Hoffman,135,2,4,8,5,3,22
Oklahoma,Hobart,3685,127,97,218,199,186,827
Oklahoma,Hitchita,107,2,1,5,2,10,20
Oklahoma,Devol,151,6,7,8,15,2,38
Oklahoma,Dewar,898,8,16,62,80,64,230
Oklahoma,Dewey,3497,58,11,199,221,122,611
Oklahoma,Dibble,912,16,15,32,49,47,159
Oklahoma,Dickson,1411,32,25,73,78,86,294
Oklahoma,Dill City,605,8,7,48,54,23,140
Oklahoma,Depew,408,2,8,26,27,34,97
Oklahoma,Disney,197,0,1,2,0,5,8
Oklahoma,Dotyville,97,9,0,8,8,0,25
Oklahoma,Dougherty,244,6,9,28,19,4,66
Oklahoma,Douglas,17,2,0,0,2,0,4
Oklahoma,Long,287,0,11,23,17,17,68
Oklahoma,Longdale,203,8,3,7,7,17,42
Oklahoma,Longtown,2925,0,0,79,80,120,279
Oklahoma,Dodge,118,0,0,0,8,0,8
Oklahoma,Dennis,137,0,10,21,0,6,37
Oklahoma,Del City,21898,447,423,1472,1001,962,4305
Oklahoma,Delaware,349,5,4,17,17,25,68
Oklahoma,Hitchcock,78,0,0,4,2,7,13
Oklahoma,Hinton,3219,33,39,137,94,174,477
Oklahoma,Hillsdale,133,0,0,4,13,10,27
Oklahoma,Hickory,86,1,0,3,11,12,27
Oklahoma,Henryetta,5812,80,84,363,281,290,1098
Oklahoma,Hennessey,2297,53,18,110,212,198,591
Oklahoma,Hendrix,63,1,1,5,0,2,9
Oklahoma,Helena,1452,14,7,36,25,53,135
Oklahoma,Heavener,3394,58,66,184,220,181,709
Oklahoma,Healdton,2784,43,32,138,152,79,444
Oklahoma,Davenport,849,14,8,53,79,73,227
Oklahoma,Davidson,343,2,2,13,16,70,103
Oklahoma,Davis,2738,68,53,230,163,186,700
Oklahoma,Deer Creek,143,0,0,19,4,12,35
Oklahoma,Deer Lick,30,0,0,0,0,0,0
Oklahoma,Lenapah,258,1,2,14,28,20,65
Oklahoma,Lost City,852,16,10,59,55,46,186
Oklahoma,Lehigh,328,4,2,25,26,24,81
Oklahoma,Leedey,440,8,5,58,43,23,137
Oklahoma,Christie,150,6,0,10,0,0,16
Oklahoma,Cimarron City,153,0,0,5,6,18,29
Oklahoma,Claremore,18922,350,232,1059,871,1008,3520
Oklahoma,Clarita,101,0,4,11,0,11,26
Oklahoma,Clayton,729,25,8,48,17,32,130
Oklahoma,Clearview,32,3,0,0,0,10,13
Oklahoma,Chouteau,2011,41,33,95,78,161,408
Oklahoma,Cleora,1338,4,16,51,29,46,146
Oklahoma,Cleveland,3238,57,34,214,147,209,661
Oklahoma,Clinton,9397,129,144,738,596,543,2150
Oklahoma,Cloud Creek,94,0,0,0,0,8,8
Oklahoma,Coalgate,1998,42,62,102,90,112,408
Oklahoma,Colbert,1420,25,23,98,108,87,341
Oklahoma,Colcord,923,24,26,70,67,53,240
Oklahoma,Cleo Springs,359,2,26,33,10,9,80
Oklahoma,Cole,621,6,14,36,34,33,123
Oklahoma,Choctaw,11828,163,245,680,553,560,2201
Oklahoma,Cheyenne,917,10,19,74,70,59,232
Oklahoma,Bernice,518,5,7,29,19,16,76
Oklahoma,Kiowa,616,25,6,36,37,25,129
Oklahoma,Knowles,17,0,0,0,0,0,0
Oklahoma,Konawa,1379,30,9,40,75,103,257
Oklahoma,Krebs,2105,34,63,136,95,77,405
Oklahoma,Kremlin,193,0,5,7,20,18,50
Oklahoma,Chickasha,16284,316,255,865,868,674,2978
Oklahoma,Lahoma,735,10,21,149,40,40,260
Oklahoma,Checotah,3324,32,38,165,205,248,688
Oklahoma,Chelsea,1948,26,56,116,90,76,364
Oklahoma,Cherokee,1564,36,4,83,78,50,251
Oklahoma,Cherry Tree,866,13,23,57,52,53,198
Oklahoma,Chester,137,0,0,2,4,12,18
Oklahoma,Chewey,84,0,4,0,2,3,9
Oklahoma,Lake Aluma,75,0,0,3,0,5,8
Oklahoma,Coleman,309,7,0,42,38,2,89
Oklahoma,Collinsville,6103,188,152,357,288,321,1306
Oklahoma,Colony,133,0,5,5,5,1,16
Oklahoma,Dacoma,93,0,2,0,1,2,5
Oklahoma,Dale,185,0,4,4,18,15,41
Oklahoma,Lamar,140,2,1,10,7,12,32
Oklahoma,Lambert,9,0,0,0,0,0,0
Oklahoma,Lamont,298,0,0,17,21,35,73
Oklahoma,Lane,371,6,12,19,18,9,64
Oklahoma,Cyril,1171,33,38,56,91,57,275
Oklahoma,Langley,768,8,9,37,37,51,142
Oklahoma,Latta,1180,49,33,127,139,55,403
Oklahoma,Laverne,1348,64,52,95,69,41,321
Oklahoma,Lawrence Creek,231,0,13,7,3,3,26
Oklahoma,Lawton,97589,1546,1428,5666,4564,4727,17931
Oklahoma,Leach,259,0,2,20,26,18,66
Oklahoma,Lebanon,206,14,8,0,6,0,28
Oklahoma,Langston,1434,13,0,23,22,48,106
Oklahoma,Custer City,332,2,2,10,14,10,38
Oklahoma,Cushing,7879,62,103,405,423,371,1364
Oklahoma,Crowder,372,5,0,14,23,27,69
Oklahoma,Comanche,1590,27,14,98,102,98,339
Oklahoma,Commerce,2475,49,63,150,174,94,530
Oklahoma,Connerville,44,0,0,0,0,0,0
Oklahoma,Cooperton,0,0,0,0,0,0,0
Oklahoma,Copan,768,9,24,40,18,17,108
Oklahoma,Copeland,1490,19,0,51,53,80,203
Oklahoma,Corn,518,6,5,11,21,20,63
Oklahoma,Cornish,213,2,4,11,22,11,50
Oklahoma,Council Hill,116,1,4,6,7,4,22
Oklahoma,Covington,483,9,5,62,26,8,110
Oklahoma,Coweta,9517,357,133,659,473,570,2192
Oklahoma,Cowlington,142,4,4,6,8,4,26
Oklahoma,Coyle,282,0,0,11,5,7,23
Oklahoma,Crescent,1277,14,3,81,35,39,172
Oklahoma,Cromwell,270,4,4,16,20,19,63
Oklahoma,Le Flore,177,5,2,5,20,11,43
Oklahoma,Lotsee,3,0,0,0,0,0,0
Oklahoma,Lookeba,154,0,0,9,8,6,23
Oklahoma,Loyal,80,5,5,6,3,3,22
Oklahoma,Greenfield,96,5,0,3,0,3,11
Oklahoma,Gregory,156,0,12,0,14,22,48
Oklahoma,Grove,6685,80,103,199,323,327,1032
Oklahoma,Guthrie,10871,152,190,666,389,731,2128
Oklahoma,Guymon,11978,290,310,672,536,568,2376
Oklahoma,Haileyville,734,21,13,33,48,20,135
Oklahoma,Hallett,115,0,1,6,11,7,25
Oklahoma,Butler,144,0,0,0,0,16,16
Oklahoma,Byars,198,3,2,3,8,7,23
Oklahoma,Byng,1297,17,26,50,66,63,222
Oklahoma,Byron,39,0,0,0,0,0,0
Oklahoma,Cache,2919,25,38,249,179,212,703
Oklahoma,Caddo,1145,5,16,91,94,34,240
Oklahoma,Calera,2576,76,71,118,201,134,600
Oklahoma,Calumet,691,15,16,56,14,48,149
Oklahoma,Calvin,288,8,3,17,34,15,77
Oklahoma,Camargo,204,11,10,5,8,33,67
Oklahoma,Greasy,310,2,18,9,14,24,67
Oklahoma,Grayson,139,2,4,15,4,9,34
Oklahoma,Grant,268,3,0,12,23,17,55
Oklahoma,Granite,1835,7,25,54,74,81,241
Oklahoma,Blanco,127,0,3,12,12,5,32
Oklahoma,Blanchard,8000,220,63,486,508,532,1809
Oklahoma,Blair,665,10,31,55,29,5,130
Oklahoma,Blackwell,6932,147,157,295,423,244,1266
Oklahoma,Blackgum,60,17,0,0,0,0,17
Oklahoma,Blackburn,76,0,0,3,2,0,5
Oklahoma,Bixby,23171,693,394,1639,1626,1295,5647
Oklahoma,Bison,66,0,0,9,0,0,9
Oklahoma,Cameron,304,3,4,20,12,27,66
Oklahoma,Binger,586,11,5,39,36,34,125
Oklahoma,Big Cabin,258,5,2,21,20,14,62
Oklahoma,Bethel Acres,3021,40,45,131,186,230,632
Oklahoma,Loveland,6,0,0,0,0,0,0
Oklahoma,Bethany,19478,399,215,1013,1136,1023,3786
Oklahoma,Grainola,40,0,3,2,3,0,8
Oklahoma,Grandfield,915,13,19,53,69,26,180
Oklahoma,Grand Lake Towne,137,5,0,3,2,8,18
Oklahoma,Grandview,450,0,0,0,56,58,114
Oklahoma,Billings,519,13,0,20,12,21,66
Oklahoma,Canadian,175,6,2,5,10,12,35
Oklahoma,Hammon,523,19,9,22,38,6,94
Oklahoma,Canton,478,17,19,33,31,30,130
Oklahoma,Goodwell,1287,14,19,41,52,26,152
Oklahoma,Gore,1024,7,3,60,77,53,200
Oklahoma,Gotebo,167,0,2,5,8,4,19
Oklahoma,Gould,171,0,2,13,20,8,43
Oklahoma,Gowen,295,0,0,8,14,0,22
Oklahoma,Gracemont,220,5,2,15,14,13,49
Oklahoma,Caney,212,6,4,11,13,10,44
Oklahoma,Hardesty,289,2,6,23,31,9,71
Oklahoma,Harrah,5551,98,149,325,437,326,1335
Oklahoma,Hartshorne,2125,48,32,118,174,70,442
Oklahoma,Haskell,1904,44,28,64,88,87,311
Oklahoma,Hastings,51,0,0,0,0,0,0
Oklahoma,Haworth,262,2,2,11,12,17,44
Oklahoma,Headrick,126,5,4,8,14,7,38
Oklahoma,Lyons Switch,355,9,5,34,22,4,74
Oklahoma,Luther,1122,29,31,73,57,59,249
Oklahoma,Lucien,100,0,13,7,6,15,41
Oklahoma,Chattanooga,435,18,1,32,25,29,105
Oklahoma,Chandler,3121,33,64,201,196,163,657
Oklahoma,Hanna,121,5,0,10,5,8,28
Oklahoma,Centrahoma,71,3,1,7,7,4,22
Oklahoma,Canute,390,2,6,22,21,24,75
Oklahoma,Central High,982,10,0,21,38,70,139
Oklahoma,Capron,3,0,0,0,0,0,0
Oklahoma,Carlisle,451,0,0,42,34,35,111
Oklahoma,Carlton Landing,9,0,0,0,1,0,1
Oklahoma,Carmen,509,14,22,37,27,31,131
Oklahoma,Carnegie,2072,49,33,155,128,78,443
Oklahoma,Carney,621,21,6,17,31,55,130
Oklahoma,Carter,338,11,23,19,20,2,75
Oklahoma,Cartwright,588,12,16,27,28,4,87
Oklahoma,Carrier,56,0,0,1,4,0,5
Oklahoma,Cedar Crest,166,12,0,0,0,0,12
Oklahoma,Castle,137,2,2,8,15,7,34
Oklahoma,Cement,507,0,9,41,33,15,98
Oklahoma,Catoosa,7406,170,143,425,322,391,1451
Oklahoma,Cayuga,95,0,0,4,10,5,19
Oklahoma,Cashion,747,6,18,37,43,53,157
Oklahoma,Cedar Valley,419,3,0,30,26,10,69
Oregon,Ukiah,187,4,0,14,0,6,24
Oregon,Umapine,266,0,0,7,8,20,35
Oregon,Umatilla,6999,87,94,281,354,387,1203
Oregon,Union,2109,22,29,99,128,129,407
Oregon,Vale,1850,42,17,169,164,131,523
Oregon,Wallowa,733,9,21,31,52,23,136
Oregon,Waldport,1943,23,21,59,106,51,260
Oregon,Vernonia,1903,14,28,91,67,174,374
Oregon,Tygh Valley,221,0,0,0,0,0,0
Oregon,Veneta,4687,56,100,326,254,243,979
Oregon,Unity,50,0,0,0,0,0,0
Oregon,Tutuilla,497,6,0,28,10,23,67
Oregon,Brookings,6376,37,0,308,283,279,907
Oregon,Tumalo,537,0,0,0,12,0,12
Oregon,Tualatin,26806,637,303,1427,1510,1379,5256
Oregon,Troutdale,16479,375,280,1002,894,1033,3584
Oregon,Tri-City,3645,37,69,110,137,261,614
Oregon,Trail,478,0,0,0,28,15,43
Oregon,Toledo,3469,39,29,206,177,148,599
Oregon,Tillamook,4958,42,97,215,358,194,906
Oregon,Wallowa Lake,78,0,0,0,0,0,0
Oregon,Bunker Hill,1342,46,44,165,28,23,306
Oregon,Bull Mountain,9188,226,96,522,544,649,2037
Oregon,Brownsville,1561,19,16,62,50,46,193
Oregon,Brooks,977,33,0,0,184,55,272
Oregon,Turner,2525,17,36,90,154,139,436
Oregon,Wamic,61,0,0,0,0,0,0
Oregon,Cannon Beach,1549,9,6,26,51,39,131
Oregon,Warren,1776,47,12,72,147,47,325
Oregon,Alpine,84,0,0,0,0,0,0
Oregon,Aloha,53879,746,858,3264,3096,3463,11427
Oregon,Albany,51511,714,957,3298,2750,2867,10586
Oregon,Adrian,154,0,2,0,5,13,20
Oregon,Adams,370,10,2,22,9,20,63
Oregon,Adair Village,828,20,28,42,85,81,256
Oregon,Cascade Locks,1052,4,4,51,37,29,125
Oregon,Carlton,1869,23,22,190,154,105,494
Oregon,Cape Meares,143,0,0,0,0,0,0
Oregon,Canyonville,2361,43,65,90,107,92,397
Oregon,Canyon City,801,0,12,42,30,54,138
Oregon,Canby,16951,229,314,931,1091,964,3529
Oregon,Camp Sherman,323,0,0,2,2,5,9
Oregon,Butteville,150,12,19,12,9,0,52
Oregon,Butte Falls,391,16,1,5,17,52,91
Oregon,Burns,2763,32,0,89,85,150,356
Oregon,Brogan,220,17,0,7,8,0,32
Oregon,Alsea,146,4,9,20,0,3,36
Oregon,Warm Springs,3433,63,73,251,291,219,897
Oregon,Altamont,19502,249,267,1009,1216,1244,3985
Oregon,Annex,230,0,6,11,13,19,49
Oregon,Warrenton,5143,103,157,276,302,289,1127
Oregon,Wasco,431,7,1,19,20,4,51
Oregon,Waterloo,264,1,1,10,8,21,41
Oregon,Westfir,279,3,5,5,12,30,55
Oregon,Condon,561,7,6,13,15,5,46
Oregon,Columbia City,2419,36,20,110,123,108,397
Oregon,Coburg,1149,10,26,37,72,75,220
Oregon,Cloverdale,305,0,13,14,10,0,37
Oregon,Clatskanie,1782,27,6,56,107,80,276
Oregon,Chiloquin,815,23,4,32,67,24,150
Oregon,Chenoweth,1722,6,17,75,17,142,257
Oregon,Central Point,17604,166,227,1175,1217,903,3688
Oregon,Cedar Mill,15638,344,219,1253,829,824,3469
Oregon,Cedar Hills,8811,169,174,257,317,338,1255
Oregon,Cayuse,64,0,0,8,4,5,17
Oregon,Cave Junction,2002,0,51,136,82,138,407
Oregon,Cascadia,199,0,0,0,28,16,44
Oregon,Amity,1558,4,34,66,104,92,300
Oregon,Bonanza,506,7,17,35,35,14,108
Oregon,Dayville,150,1,1,7,2,7,18
Oregon,Blodgett,56,0,0,0,0,0,0
Oregon,Prescott,54,0,0,0,0,0,0
Oregon,Prairie City,813,27,14,44,52,67,204
Oregon,Powers,760,0,10,52,12,81,155
Oregon,Port Orford,1312,18,29,50,52,37,186
Oregon,Portland,612206,10046,6930,25611,22428,22564,87579
Oregon,Plush,45,0,0,4,0,0,4
Oregon,Pistol River,112,0,0,0,0,0,0
Oregon,Prineville,9266,154,123,264,389,625,1555
Oregon,Pine Hollow,544,0,8,14,18,6,46
Oregon,Pilot Rock,1476,6,34,76,111,129,356
Oregon,Phoenix,4500,34,21,99,195,315,664
Oregon,Philomath,4597,33,23,190,289,214,749
Oregon,Peoria,130,0,0,0,24,0,24
Oregon,Pendleton,16882,245,231,673,854,879,2882
Oregon,Parkdale,378,0,0,51,58,0,109
Oregon,Paisley,345,0,20,0,23,47,90
Oregon,Pine Grove,89,0,0,0,0,0,0
Oregon,Pronghorn,31,0,0,0,0,0,0
Oregon,Prospect,459,0,0,4,14,8,26
Oregon,Rainier,1961,45,50,52,94,108,349
Oregon,Ruch,913,0,33,8,0,76,117
Oregon,Rowena,207,0,7,21,0,0,28
Oregon,Rose Lodge,1955,51,9,38,89,114,301
Oregon,Roseburg North,6439,53,29,391,320,227,1020
Oregon,Roseburg,21937,181,188,1087,788,1117,3361
Oregon,Rogue River,2442,27,29,102,70,97,325
Oregon,Rockcreek,9245,142,128,514,417,578,1779
Oregon,Rockaway Beach,1227,12,0,57,74,72,215
Oregon,Riverside,148,0,2,5,8,4,19
Oregon,Rivergrove,355,15,1,5,29,27,77
Oregon,Riddle,1164,14,0,34,74,113,235
Oregon,Rickreall,75,0,0,0,0,0,0
Oregon,Richland,173,0,0,6,10,5,21
Oregon,Reedsport,4111,8,44,140,216,172,580
Oregon,Redwood,2766,22,0,165,186,116,489
Oregon,Redmond,27450,474,605,1424,1800,1640,5943
Oregon,Raleigh Hills,5751,86,27,291,162,200,766
Oregon,Pacific City,963,0,0,8,42,21,71
Oregon,Hood River,7412,95,171,402,330,331,1329
Oregon,Oregon City,34480,555,522,2187,1822,1783,6869
Oregon,Odell,2525,34,0,219,258,260,771
Oregon,Myrtle Creek,3422,30,100,147,156,182,615
Oregon,Mulino,2661,44,35,82,297,226,684
Oregon,Mount Vernon,625,5,8,46,8,59,126
Oregon,Mount Hood Village,5497,9,42,143,280,299,773
Oregon,Mount Hood,235,0,9,0,0,23,32
Oregon,Mount Angel,3389,64,8,246,78,245,641
Oregon,Mosier,476,9,14,18,10,26,77
Oregon,Myrtle Point,2495,31,24,107,132,109,403
Oregon,Bandon,3070,0,0,161,61,56,278
Oregon,Aurora,1192,12,31,58,65,69,235
Oregon,Aumsville,3823,99,139,322,271,122,953
Oregon,Athena,1069,12,34,65,30,68,209
Oregon,Astoria,9537,134,74,456,326,378,1368
Oregon,Ashland,20556,106,110,869,847,845,2777
Oregon,Arlington,596,0,0,48,54,40,142
Oregon,Antelope,12,0,0,0,0,0,0
Oregon,Baker City,9777,146,97,527,476,551,1797
Oregon,Neahkahnie,80,0,0,0,0,0,0
Oregon,Nehalem,254,12,5,4,4,5,30
Oregon,Nesika Beach,430,0,0,0,0,0,0
Oregon,Oceanside,338,0,0,0,0,3,3
Oregon,O'Brien,116,0,0,0,0,0,0
Oregon,Oatfield,13852,196,84,637,641,520,2078
Oregon,Oakridge,3205,38,0,71,147,141,397
Oregon,Oakland,691,0,0,21,28,39,88
Oregon,Oak Hills,11916,348,237,926,590,641,2742
Oregon,Oak Grove,17149,189,161,715,744,869,2678
Oregon,Nyssa,3189,28,79,294,220,224,845
Oregon,North Powder,515,12,0,56,59,37,164
Oregon,North Plains,1945,55,23,78,105,114,375
Oregon,North Bend,9583,217,127,586,603,389,1922
Oregon,Newport,10101,112,80,549,431,445,1617
Oregon,New Pine Creek,151,0,0,7,16,8,31
Oregon,New Hope,1342,16,32,26,32,122,228
Oregon,Newberg,22566,407,345,830,879,1517,3978
Oregon,Netarts,958,0,0,28,14,51,93
Oregon,Neskowin,156,0,0,0,0,0,0
Oregon,Ontario,11089,227,184,771,683,594,2459
Oregon,Holley,285,0,0,19,0,0,19
Oregon,Hines,1402,28,31,71,91,107,328
Oregon,Hillsboro,97751,1645,1240,5087,5476,5230,18678
Oregon,Donald,1115,15,17,29,95,40,196
Oregon,Drain,1194,7,0,33,42,71,153
Oregon,Dufur,640,10,10,54,56,19,149
Oregon,Dundee,3184,54,38,176,176,148,592
Oregon,Dunes City,1263,19,8,45,16,32,120
Oregon,Durham,1459,15,10,102,65,57,249
Oregon,Eagle Crest,1685,14,0,0,41,32,87
Oregon,Dillard,434,0,0,0,74,0,74
Oregon,Eagle Point,8701,152,152,563,405,546,1818
Oregon,Elgin,1527,17,34,59,42,67,219
Oregon,Elkton,225,6,6,17,32,2,63
Oregon,Enterprise,1915,43,24,123,61,61,312
Oregon,Eola,0,0,0,0,0,0,0
Oregon,Estacada,2968,61,84,77,144,145,511
Oregon,Eugene,159615,2026,1848,6587,6228,7110,23799
Oregon,Fair Oaks,327,0,7,0,0,8,15
Oregon,Echo,734,15,0,53,18,19,105
Oregon,Detroit,119,0,0,0,0,6,6
Oregon,Deschutes River Woods,5328,39,139,278,284,175,915
Oregon,Depoe Bay,1877,5,9,52,0,81,147
Oregon,Black Butte Ranch,260,0,0,0,0,0,0
Oregon,Biggs Junction,22,0,0,0,0,0,0
Oregon,Bethany,22346,550,717,1583,2077,1378,6305
Oregon,Bend,81780,1381,734,4654,4122,3732,14623
Oregon,Bellfountain,101,0,13,13,25,0,51
Oregon,Beaverton,93919,1425,1100,5017,4994,4375,16911
Oregon,Beaver,193,24,0,0,20,11,55
Oregon,Beatty,0,0,0,0,0,0,0
Oregon,Bayside Gardens,618,0,0,0,17,0,17
Oregon,Bay City,1466,43,14,132,35,48,272
Oregon,Barview,1719,0,0,101,92,118,311
Oregon,Barlow,147,1,0,10,6,22,39
Oregon,Banks,1580,19,24,116,136,109,404
Oregon,Days Creek,316,0,0,23,15,0,38
Oregon,Dayton,2539,14,48,246,187,159,654
Oregon,Tigard,50276,815,541,2351,2150,2582,8439
Oregon,Deer Island,383,0,0,6,4,34,44
Oregon,Fairview,9181,174,174,519,435,264,1566
Oregon,Falls City,994,14,22,31,35,71,173
Oregon,Florence,8545,120,44,245,273,133,815
Oregon,Foots Creek,623,0,0,23,33,23,79
Oregon,Grants Pass,36378,268,216,2039,2194,1819,6536
Oregon,Grass Valley,176,0,0,8,16,9,33
Oregon,Green,7895,0,102,342,582,444,1470
Oregon,Greenhorn,9,0,0,0,0,0,0
Oregon,Gresham,109308,1771,1523,6128,5749,6006,21177
Oregon,Haines,406,3,2,10,6,7,28
Oregon,Halfway,314,12,0,20,7,1,40
Oregon,Halsey,1128,28,17,108,67,49,269
Oregon,Happy Valley,16462,265,194,1078,981,1129,3647
Oregon,Harbor,1978,0,0,14,39,0,53
Oregon,Harper,99,1,1,3,7,8,20
Oregon,Harrisburg,3660,30,27,192,321,347,917
Oregon,Hayesville,19296,239,340,1246,1089,1128,4042
Oregon,Hebo,218,1,0,0,0,0,1
Oregon,Helix,204,6,8,11,39,16,80
Oregon,Heppner,1151,0,0,19,98,68,185
Oregon,Hermiston,17121,172,291,1120,1281,859,3723
Oregon,Granite,23,0,0,0,0,0,0
Oregon,Boardman,3320,39,100,241,175,232,787
Oregon,Grand Ronde,1636,23,27,92,80,103,325
Oregon,Gopher Flats,371,0,3,19,17,11,50
Oregon,Forest Grove,22823,367,350,1142,1552,1489,4900
Oregon,Fort Hill,123,0,0,0,0,0,0
Oregon,Fossil,401,0,0,0,5,10,15
Oregon,Four Corners,16483,230,198,825,883,1128,3264
Oregon,Garden Home-Whitford,6138,88,56,166,222,225,757
Oregon,Gardiner,207,0,0,0,0,56,56
Oregon,Garibaldi,782,0,3,40,26,23,92
Oregon,Gaston,616,8,12,23,13,17,73
Oregon,Gates,464,1,3,12,14,11,41
Oregon,Gearhart,1462,34,13,91,47,112,297
Oregon,Gervais,2562,9,52,230,177,206,674
Oregon,Gladstone,11741,95,207,347,576,723,1948
Oregon,Glasgow,596,17,28,36,0,45,126
Oregon,Glendale,801,5,8,55,2,45,115
Oregon,Glide,1916,0,79,204,13,56,352
Oregon,Gold Beach,2346,68,18,96,60,63,305
Oregon,Gold Hill,1194,0,0,82,68,69,219
Oregon,Government Camp,120,0,0,13,0,0,13
Oregon,Three Rivers,4232,12,66,178,130,211,597
Oregon,Beavercreek,3945,32,12,232,148,317,741
Oregon,Tetherow,128,0,0,0,0,0,0
Oregon,Lakeview,2561,34,64,112,75,101,386
Oregon,Langlois,162,0,0,0,19,28,47
Oregon,La Pine,1664,15,19,50,68,58,210
Oregon,Lebanon,15962,200,196,774,741,664,2575
Oregon,Lexington,189,0,0,6,27,13,46
Oregon,Lincoln Beach,1198,0,0,9,0,7,16
Oregon,Lincoln City,8386,97,88,243,398,333,1159
Oregon,Lakeside,1539,17,0,42,44,50,153
Oregon,Lonerock,18,0,0,0,0,0,0
Oregon,Lookingglass,989,70,0,0,107,83,260
Oregon,Lostine,316,2,3,19,32,13,69
Oregon,Lowell,1089,37,26,55,46,41,205
Oregon,Lyons,1174,11,13,76,66,43,209
Oregon,McMinnville,33185,424,483,1748,2195,1789,6639
Oregon,Madras,6487,81,89,432,348,465,1415
Oregon,Malin,731,18,8,43,26,24,119
Oregon,Long Creek,173,5,1,5,4,2,17
Oregon,Manzanita,426,12,0,13,17,18,60
Oregon,Lake Oswego,37628,727,563,1715,2122,2422,7549
Oregon,Lafayette,3824,51,42,292,260,301,946
Oregon,Jefferson,3174,28,72,153,172,237,662
Oregon,Jennings Lodge,7691,121,174,367,391,388,1441
Oregon,John Day,1717,13,9,120,86,66,294
Oregon,Johnson City,573,9,6,23,42,13,93
Oregon,Jordan Valley,153,0,0,3,13,7,23
Oregon,Joseph,1053,8,34,38,41,29,150
Oregon,Junction City,5673,114,18,380,291,358,1161
Oregon,La Grande,13088,221,101,598,645,480,2045
Oregon,Juntura,37,0,4,3,0,3,10
Oregon,Kerby,709,77,0,0,0,85,162
Oregon,King City,3464,152,15,183,156,130,636
Oregon,Kings Valley,72,0,0,0,0,0,0
Oregon,Kirkpatrick,145,3,0,7,6,21,37
Oregon,Klamath Falls,21261,255,293,803,761,1181,3293
Oregon,Labish Village,218,0,0,14,0,16,30
Oregon,Lacomb,633,0,0,4,6,22,32
Oregon,Keizer,37115,350,632,1905,2273,2245,7405
Oregon,Marion,232,0,0,0,23,0,23
Oregon,Maupin,593,4,2,10,37,22,75
Oregon,Maywood Park,872,9,11,40,22,64,146
Oregon,Wood Village,3971,48,50,301,310,277,986
Oregon,Woodburn,24496,292,529,1970,1671,1579,6041
Oregon,Winston,5363,116,89,311,463,251,1230
Oregon,Winchester Bay,316,0,0,0,0,4,4
Oregon,Wimer,647,0,0,17,0,42,59
Oregon,Wilsonville,20837,239,285,1000,869,974,3367
Oregon,Williams,1037,0,0,36,0,22,58
Oregon,Yachats,658,14,0,15,13,12,54
Oregon,Willamina,1811,45,23,76,123,102,369
Oregon,Wheeler,397,0,7,14,6,15,42
Oregon,West Slope,7536,193,91,496,362,401,1543
Oregon,West Scio,127,0,0,0,10,0,10
Oregon,Westport,309,0,0,12,12,0,24
Oregon,Weston,723,18,2,27,43,75,165
Oregon,West Linn,25963,280,325,1636,1605,1588,5434
Oregon,West Haven-Sylvan,7991,28,48,220,267,361,924
Oregon,White City,9296,146,140,516,452,350,1604
Oregon,Yamhill,1132,30,15,63,62,145,315
Oregon,Yoncalla,1155,0,10,30,58,33,131
Oregon,The Dalles,15136,200,348,591,870,924,2933
Oregon,Medford,77579,1265,861,4283,3947,3831,14187
Oregon,Mehama,196,0,0,19,8,0,27
Oregon,Melrose,809,0,0,15,0,65,80
Oregon,Merlin,1481,0,0,19,7,40,66
Oregon,Merrill,885,10,12,67,51,49,189
Oregon,Metolius,1131,21,29,97,72,71,290
Oregon,Metzger,4035,131,0,150,245,34,560
Oregon,Mill City,1781,8,7,103,121,128,367
Oregon,Millersburg,1661,43,21,69,137,96,366
Oregon,Milton-Freewater,7089,117,47,340,687,711,1902
Oregon,Milwaukie,20566,137,107,604,967,1121,2936
Oregon,Mission,970,42,33,78,86,65,304
Oregon,Mitchell,122,0,0,0,5,3,8
Oregon,Molalla,8726,101,157,542,446,575,1821
Oregon,Monmouth,9869,197,121,524,305,120,1267
Oregon,Monument,89,0,0,0,10,11,21
Oregon,Moro,372,20,6,20,7,8,61
Oregon,Jeffers Gardens,344,0,0,7,7,8,22
Oregon,Jacksonville,2827,22,0,72,71,93,258
Oregon,Monroe,677,14,19,36,24,15,108
Oregon,Irrigon,2217,40,62,201,204,260,767
Oregon,Cove,606,9,24,22,44,18,117
Oregon,Cottage Grove,9819,188,145,678,528,409,1948
Oregon,Corvallis,54981,614,445,1621,1638,1934,6252
Oregon,Cornelius,12186,205,265,724,818,774,2786
Oregon,Coquille,3846,0,0,36,42,220,298
Oregon,Coos Bay,16062,248,252,790,581,611,2482
Oregon,Rufus,242,0,0,0,8,9,17
Oregon,St. Helens,13055,172,140,1019,660,1035,3026
Oregon,St. Paul,386,11,16,18,31,16,92
Oregon,Salem,160008,2198,2355,8938,8400,8458,30349
Oregon,Sandy,10134,339,195,524,629,220,1907
Oregon,Scappoose,6839,122,48,474,339,323,1306
Oregon,Sodaville,367,1,0,8,21,32,62
Oregon,Crabtree,526,0,8,59,53,59,179
Oregon,Sisters,2596,22,46,110,177,211,566
Oregon,Scio,832,10,14,45,54,76,199
Oregon,Scotts Mills,459,1,6,19,39,36,101
Oregon,Seaside,6483,131,161,197,229,320,1038
Oregon,Selma,675,0,2,9,5,3,19
Oregon,Seneca,188,0,0,4,4,8,16
Oregon,Seventh Mountain,203,0,0,0,0,0,0
Oregon,Shady Cove,2960,17,23,43,81,7,171
Oregon,Shaniko,6,0,0,0,0,0,0
Oregon,Shedd,161,0,0,22,12,16,50
Oregon,Sheridan,6048,58,18,190,352,176,794
Oregon,Sherwood,18880,615,575,1570,1382,1262,5404
Oregon,Siletz,1736,42,21,115,65,114,357
Oregon,Silverton,9436,117,136,742,676,325,1996
Oregon,Island City,1186,19,15,97,67,52,250
Oregon,Crane,136,0,0,13,0,13,26
Oregon,Silver Lake,93,0,0,7,0,0,7
Oregon,Creswell,5085,117,86,232,331,308,1074
Oregon,Crawfordsville,269,0,0,0,0,28,28
Oregon,Independence,8772,94,214,530,472,358,1668
Oregon,Imbler,315,0,7,11,20,19,57
Oregon,Idaville,389,0,0,7,9,0,16
Oregon,Idanha,198,0,0,0,16,25,41
Oregon,Huntington,323,1,2,6,8,22,39
Oregon,Hubbard,3219,132,55,264,293,205,949
Oregon,Terrebonne,1182,17,0,17,67,84,185
Oregon,Tangent,1022,6,9,68,60,72,215
Oregon,Talent,6244,103,67,363,380,214,1127
Oregon,Takilma,266,0,0,39,0,23,62
Oregon,Ione,255,0,9,11,6,2,28
Oregon,Sutherlin,7821,56,63,535,327,272,1253
Oregon,Sweet Home,9140,123,143,380,655,591,1892
Oregon,Springfield,60235,736,673,2641,3434,3013,10497
Oregon,Damascus,10748,179,78,485,587,639,1968
Oregon,South Lebanon,1148,0,0,85,72,59,216
Oregon,Spray,148,2,7,1,3,1,14
Oregon,Sunriver,1022,0,0,0,0,0,0
Oregon,Stafford,1892,3,0,133,122,99,357
Oregon,Stanfield,2241,6,25,81,151,124,387
Oregon,Stayton,7809,65,147,635,375,738,1960
Oregon,Sublimity,2796,26,49,145,136,143,499
Oregon,Summerville,78,4,0,7,5,7,23
Oregon,Summit,98,0,0,0,0,0,0
Oregon,Sumpter,175,0,0,2,2,2,6
Oregon,Dallas,14896,120,191,983,656,664,2614
Oregon,Culver,1414,51,19,122,88,102,382
Pennsylvania,Bellwood borough,1811,13,38,119,81,90,341
Pennsylvania,New Berlinville,1453,0,0,42,62,68,172
Pennsylvania,New Berlin borough,964,14,20,68,53,43,198
Pennsylvania,New Bedford,934,8,0,7,28,44,87
Pennsylvania,New Beaver borough,1554,15,16,49,43,84,207
Pennsylvania,New Baltimore borough,167,1,0,1,13,18,33
Pennsylvania,Beaver Springs,575,19,13,20,52,21,125
Pennsylvania,New Alexandria borough,635,2,2,9,11,20,44
Pennsylvania,Benson borough,177,4,0,4,7,9,24
Pennsylvania,Bendersville borough,738,4,18,71,67,58,218
Pennsylvania,Ben Avon Heights borough,362,10,1,28,28,25,92
Pennsylvania,Ben Avon borough,1692,49,22,101,85,66,323
Pennsylvania,Beavertown borough,957,6,5,43,35,64,153
Pennsylvania,Bechtelsville borough,878,8,8,38,37,50,141
Pennsylvania,Bedford borough,2778,20,0,68,103,101,292
Pennsylvania,Beech Creek borough,715,2,12,28,15,25,82
Pennsylvania,Beech Mountain Lakes,1723,14,47,74,12,43,190
Pennsylvania,Belfast,1083,0,0,22,130,42,194
Pennsylvania,Beaver Meadows borough,644,13,8,21,26,37,105
Pennsylvania,Bellefonte borough,6285,73,138,421,189,94,915
Pennsylvania,Belle Vernon borough,1100,12,3,37,36,82,170
Pennsylvania,Belleville,1853,7,6,104,41,66,224
Pennsylvania,Bellevue borough,8329,85,69,231,232,358,975
Pennsylvania,Belmont,2665,62,40,45,55,118,320
Pennsylvania,Bell Acres borough,1444,20,24,40,124,108,316
Pennsylvania,Avonia,1087,31,0,67,50,80,228
Pennsylvania,Beaverdale,1144,0,7,21,109,52,189
Pennsylvania,Avonmore borough,985,19,2,59,35,64,179
Pennsylvania,Baden borough,4075,72,115,66,104,208,565
Pennsylvania,Baidland,1637,16,18,63,67,60,224
Pennsylvania,Baileyville,378,0,0,0,0,45,45
Pennsylvania,Roulette,782,5,27,28,29,40,129
Pennsylvania,Rouseville borough,560,15,10,15,30,17,87
Pennsylvania,Rouzerville,922,0,11,43,22,30,106
Pennsylvania,Rowes Run,456,0,0,0,29,38,67
Pennsylvania,Royalton borough,1031,12,6,62,83,24,187
Pennsylvania,Royersford borough,4782,50,18,258,226,247,799
Pennsylvania,Bainbridge,1623,10,0,119,64,158,351
Pennsylvania,Bairdford,1101,0,19,16,126,21,182
Pennsylvania,Bakerstown,2328,55,66,130,78,168,497
Pennsylvania,Baldwin borough,19803,204,198,986,774,1015,3177
Pennsylvania,Bally borough,1273,50,5,80,41,56,232
Pennsylvania,Bangor borough,5233,113,23,357,122,353,968
Pennsylvania,Barkeyville borough,245,0,2,4,13,14,33
Pennsylvania,Barrville,269,0,0,45,5,18,68
Pennsylvania,Bath borough,2680,28,25,209,265,126,653
Pennsylvania,Baumstown,521,24,21,40,46,40,171
Pennsylvania,Beallsville borough,483,18,1,15,26,24,84
Pennsylvania,Bear Creek Village borough,316,13,3,28,16,19,79
Pennsylvania,Bear Lake borough,148,0,5,5,13,12,35
Pennsylvania,Bear Rocks,944,0,19,52,20,43,134
Pennsylvania,Beaver borough,4467,79,56,201,140,175,651
Pennsylvania,Beaver Falls,8768,101,266,478,469,273,1587
Pennsylvania,New Bethlehem borough,858,4,11,32,40,42,129
Pennsylvania,New Florence borough,806,8,17,41,68,37,171
Pennsylvania,New Britain borough,3026,68,42,126,61,100,397
Pennsylvania,Sheffield,1132,24,19,18,105,25,191
Pennsylvania,Sheatown,720,0,0,0,17,10,27
Pennsylvania,Sheakleyville borough,175,4,2,4,12,6,28
Pennsylvania,Shavertown,2392,33,58,96,131,80,398
Pennsylvania,Shartlesville,519,0,0,5,13,14,32
Pennsylvania,Sharpsville borough,4320,101,63,204,303,294,965
Pennsylvania,Sharpsburg borough,3426,48,69,104,99,212,532
Pennsylvania,Sharon Hill borough,5693,77,108,229,512,323,1249
Pennsylvania,Sharon,13754,232,228,588,546,629,2223
Pennsylvania,Shanor-Northvue,5028,67,71,288,200,233,859
Pennsylvania,Shanksville borough,240,0,0,16,14,12,42
Pennsylvania,Shamokin Dam borough,1664,12,6,55,57,20,150
Pennsylvania,Shamokin,7253,88,101,241,310,347,1087
Pennsylvania,Shade Gap borough,133,0,0,17,23,10,50
Pennsylvania,Sewickley Hills borough,607,15,6,41,27,46,135
Pennsylvania,Sewickley Heights borough,722,17,8,30,52,56,163
Pennsylvania,Sewickley borough,3837,160,81,214,135,196,786
Pennsylvania,Seward borough,420,2,0,8,14,29,53
Pennsylvania,Seven Valleys borough,485,11,2,6,38,8,65
Pennsylvania,Seven Springs borough,11,0,0,0,0,0,0
Pennsylvania,Seven Fields borough,2888,37,44,146,190,209,626
Pennsylvania,Seneca,1278,70,17,84,9,88,268
Pennsylvania,Seltzer,266,0,0,0,22,0,22
Pennsylvania,Sellersville borough,4233,43,61,200,139,253,696
Pennsylvania,Selinsgrove borough,5720,8,13,179,246,91,537
Pennsylvania,Scranton,76064,1279,981,3222,3188,3484,12154
Pennsylvania,New Brighton borough,5958,88,44,274,306,349,1061
Pennsylvania,Shelocta borough,157,2,0,6,6,1,15
Pennsylvania,Shenandoah borough,4964,42,18,243,226,228,757
Pennsylvania,New Buffalo borough,111,2,0,0,1,16,19
Pennsylvania,Newburg borough (Clearfield County),89,6,0,5,3,0,14
Pennsylvania,Newburg borough (Cumberland County),280,2,0,20,26,8,56
Pennsylvania,New Castle,22682,292,281,1100,993,1204,3870
Pennsylvania,New Castle Northwest,1194,0,20,34,6,33,93
Pennsylvania,New Centerville borough,148,5,0,11,13,7,36
Pennsylvania,New Columbia,737,21,26,26,0,14,87
Pennsylvania,New Columbus borough,225,3,2,11,9,9,34
Pennsylvania,New Cumberland borough,7274,47,121,267,389,369,1193
Pennsylvania,New Eagle borough,2049,48,27,104,73,85,337
Pennsylvania,Newell borough,586,4,5,23,30,29,91
Pennsylvania,Shrewsbury borough,3841,18,108,73,262,209,670
Pennsylvania,Shoemakersville borough,1435,14,20,51,83,73,241
Pennsylvania,Shirleysburg borough,122,2,2,2,7,9,22
Pennsylvania,Shiremanstown borough,1533,11,19,71,65,69,235
Pennsylvania,Shippingport borough,172,0,5,7,6,14,32
Pennsylvania,Shippenville borough,583,9,13,45,31,29,127
Pennsylvania,Shippensburg University,2281,12,0,0,0,0,12
Pennsylvania,Shippensburg borough,5527,74,0,191,274,56,595
Pennsylvania,Shinglehouse borough,935,3,4,48,48,64,167
Pennsylvania,Shiloh,11652,186,142,401,394,727,1850
Pennsylvania,Shillington borough,5268,72,40,361,128,263,864
Pennsylvania,Shickshinny borough,791,11,24,17,24,37,113
Pennsylvania,Sheppton,184,0,0,0,19,25,44
Pennsylvania,Shenandoah Heights,1208,12,12,45,67,33,169
Pennsylvania,Avondale borough,1506,15,13,39,113,107,287
Pennsylvania,Avon,1787,0,0,39,116,103,258
Pennsylvania,Ronks,288,0,0,0,0,0,0
Pennsylvania,Avis borough,1650,24,35,133,65,47,304
Pennsylvania,Altamont,688,17,0,33,34,0,84
Pennsylvania,Altoona,45814,1062,484,2228,2333,2151,8258
Pennsylvania,Ambler borough,6513,99,114,291,294,227,1025
Pennsylvania,Ambridge borough,6931,80,143,352,240,389,1204
Pennsylvania,Amity Gardens,3100,32,100,174,94,243,643
Pennsylvania,Ancient Oaks,7359,253,253,482,455,392,1835
Pennsylvania,Annville,4828,38,16,156,139,175,524
Pennsylvania,Apollo borough,1566,18,24,61,54,120,277
Pennsylvania,Applewold borough,323,0,4,11,9,19,43
Pennsylvania,Arcadia University,627,0,0,0,0,0,0
Pennsylvania,Archbald borough,7049,132,67,375,367,301,1242
Pennsylvania,Ardmore,12698,244,159,548,676,475,2102
Pennsylvania,Arendtsville borough,910,13,31,67,77,50,238
Pennsylvania,Aristes,311,6,0,28,11,13,58
Pennsylvania,Arlington Heights,5371,55,53,219,222,203,752
Pennsylvania,Armagh borough,121,0,0,0,0,9,9
Pennsylvania,Arnold,5053,73,47,276,351,194,941
Pennsylvania,Arnold City,540,0,18,0,0,45,63
Pennsylvania,Mohnton borough,3041,50,50,132,176,203,611
Pennsylvania,Mohrsville,618,0,40,36,0,41,117
Pennsylvania,Monaca borough,5706,5,114,275,330,155,879
Pennsylvania,Monessen,7584,124,56,312,328,187,1007
Pennsylvania,Monongahela,4235,33,56,185,162,169,605
Pennsylvania,Davidsville,1208,0,42,0,41,74,157
Pennsylvania,Dawson borough,470,9,6,24,24,7,70
Pennsylvania,Alsace Manor,402,18,0,36,0,18,72
Pennsylvania,Dayton borough,457,3,7,13,32,14,69
Pennsylvania,Almedia,1024,0,5,34,51,18,108
Pennsylvania,Allison Park,21864,396,246,1013,1113,1156,3924
Pennsylvania,Dauphin borough,1045,17,18,107,37,53,232
Pennsylvania,Aaronsburg CDP (Centre County),523,5,7,38,16,4,70
Pennsylvania,Aaronsburg CDP (Washington County),281,0,0,0,5,4,9
Pennsylvania,Abbottstown borough,943,8,20,35,56,56,175
Pennsylvania,Ackermanville,900,27,11,116,58,68,280
Pennsylvania,Adamsburg borough,203,0,1,13,10,18,42
Pennsylvania,Adamstown borough,1987,13,14,85,61,77,250
Pennsylvania,Adamsville,52,0,2,1,0,0,3
Pennsylvania,Addison borough,214,1,0,13,21,18,53
Pennsylvania,Akron borough,3949,34,63,158,214,163,632
Pennsylvania,Alba borough,118,0,3,1,1,20,25
Pennsylvania,Albion borough,1522,12,18,55,68,97,250
Pennsylvania,Albrightsville,159,0,0,22,0,19,41
Pennsylvania,Alburtis borough,2411,57,22,121,154,205,559
Pennsylvania,Aldan borough,4158,28,8,137,75,216,464
Pennsylvania,Alexandria borough,406,4,0,21,23,23,71
Pennsylvania,Alfarata,159,16,7,0,0,4,27
Pennsylvania,Aliquippa,9296,170,91,503,344,528,1636
Pennsylvania,Alleghenyville,1137,25,17,65,52,87,246
Pennsylvania,Allenport,728,13,5,39,55,32,144
Pennsylvania,Allenport borough,496,7,0,19,31,31,88
Pennsylvania,Allensville,448,2,0,41,26,21,90
Pennsylvania,Allentown,119261,1317,1678,7014,6378,6586,22973
Pennsylvania,Allenwood,466,0,15,13,30,29,87
Pennsylvania,Allison,662,0,0,0,30,32,62
Pennsylvania,Allport,282,0,0,0,63,49,112
Pennsylvania,Deemston borough,737,10,10,16,49,37,122
Pennsylvania,Deer Lake,428,0,0,74,13,19,106
Pennsylvania,Deer Lake borough,750,24,16,52,42,43,177
Pennsylvania,Rose Valley borough,921,17,13,29,69,64,192
Pennsylvania,Roseville borough,159,0,0,7,2,10,19
Pennsylvania,Rossiter,621,11,4,30,17,39,101
Pennsylvania,Rosslyn Farms borough,438,4,5,15,25,21,70
Pennsylvania,Rote,674,5,0,21,40,61,127
Pennsylvania,Rothsville,2681,12,13,103,201,347,676
Pennsylvania,Arnot,469,15,13,39,19,11,97
Pennsylvania,Arona borough,332,1,0,17,19,12,49
Pennsylvania,Ashland borough,2772,17,9,109,90,114,339
Pennsylvania,Ashley borough,2753,44,32,134,159,77,446
Pennsylvania,Ashville borough,199,5,4,13,11,6,39
Pennsylvania,Aspers,447,0,0,0,56,28,84
Pennsylvania,Aspinwall borough,2795,63,67,153,124,59,466
Pennsylvania,Atglen borough,1469,47,21,123,118,139,448
Pennsylvania,Athens borough,3326,50,52,168,131,165,566
Pennsylvania,Atkinson Mills,236,0,0,26,14,16,56
Pennsylvania,Atlantic,49,0,0,0,5,3,8
Pennsylvania,Atlas,969,0,0,27,1,97,125
Pennsylvania,Atlasburg,310,21,0,28,0,0,49
Pennsylvania,Atwood borough,108,1,0,4,6,3,14
Pennsylvania,Auburn borough,811,9,16,30,38,47,140
Pennsylvania,Audubon,8801,187,65,493,420,735,1900
Pennsylvania,Austin borough,518,9,0,29,15,25,78
Pennsylvania,Avalon borough,4681,62,0,87,96,158,403
Pennsylvania,Avella,915,20,23,54,44,47,188
Pennsylvania,Roseto borough,1675,58,31,65,109,105,368
Pennsylvania,Roscoe borough,797,3,2,26,35,59,125
Pennsylvania,Scottdale borough,4305,77,101,131,166,200,675
Pennsylvania,Ronco,60,0,0,0,0,0,0
Pennsylvania,Defiance,229,13,23,29,10,10,85
Pennsylvania,Delano,380,6,0,24,11,12,53
Pennsylvania,Rices Landing borough,460,12,4,24,22,23,85
Pennsylvania,Riceville,59,0,0,0,3,3,6
Pennsylvania,Richboro,6322,60,23,240,343,433,1099
Pennsylvania,Richfield,448,7,0,3,1,7,18
Pennsylvania,Richland borough,1796,13,19,90,47,80,249
Pennsylvania,Richlandtown borough,1268,25,23,66,38,67,219
Pennsylvania,Ridgway borough,3986,54,75,152,161,152,594
Pennsylvania,Ridley Park borough,7020,81,38,331,280,432,1162
Pennsylvania,Riegelsville borough,838,13,12,22,36,17,100
Pennsylvania,Rimersburg borough,927,13,10,56,26,62,167
Pennsylvania,Avoca borough,2659,20,19,66,120,196,421
Pennsylvania,Ringtown borough,686,4,10,16,21,26,77
Pennsylvania,Riverside borough,2049,52,6,91,95,95,339
Pennsylvania,Riverview Park,2549,0,0,78,146,147,371
Pennsylvania,Roaring Spring borough,2560,58,42,174,103,129,506
Pennsylvania,Robesonia borough,2057,4,18,70,71,179,342
Pennsylvania,Robinson,595,0,0,9,38,36,83
Pennsylvania,Rochester borough,3610,37,47,143,266,104,597
Pennsylvania,Rockhill borough,344,4,4,20,6,6,40
Pennsylvania,Rockledge borough,2542,67,65,149,114,129,524
Pennsylvania,Rockwood borough,862,7,7,44,44,40,142
Pennsylvania,Rogersville,187,4,3,3,10,6,26
Pennsylvania,Rohrsburg,132,0,0,2,0,6,8
Pennsylvania,Rome borough,345,2,0,14,30,35,81
Pennsylvania,Riverside,302,11,0,13,30,6,60
Pennsylvania,Scotland,1119,70,0,42,35,66,213
Pennsylvania,Easton,26996,343,428,1331,1163,1232,4497
Pennsylvania,Schuylkill Haven borough,5321,80,153,245,246,445,1169
Pennsylvania,Curwensville borough,2562,26,44,70,122,99,361
Pennsylvania,Curtisville,975,0,0,23,84,59,166
Pennsylvania,Cumbola,401,12,6,19,11,16,64
Pennsylvania,Crucible,932,66,0,48,18,63,195
Pennsylvania,Croydon,9853,79,76,362,376,436,1329
Pennsylvania,Crown,212,0,0,15,0,0,15
Pennsylvania,Cross Roads borough,556,5,2,18,44,48,117
Pennsylvania,Cross Creek,139,0,0,6,10,5,21
Pennsylvania,Cressona borough,1841,30,16,87,150,124,407
Pennsylvania,Cresson borough,1675,39,14,77,51,51,232
Pennsylvania,Crenshaw,469,0,0,46,29,3,78
Pennsylvania,Creekside borough,320,2,0,7,18,4,31
Pennsylvania,Cranesville borough,546,4,3,27,31,41,106
Pennsylvania,Crafton borough,5920,52,88,268,171,124,703
Pennsylvania,Crabtree,332,31,0,6,51,12,100
Pennsylvania,Courtdale borough,695,2,12,36,16,23,89
Pennsylvania,Coudersport borough,2489,40,64,137,76,115,432
Pennsylvania,Corsica borough,302,5,12,15,18,17,67
Pennsylvania,Corry,6509,148,43,282,340,323,1136
Pennsylvania,Cornwells Heights,1415,0,23,13,44,81,161
Pennsylvania,Cornwall borough,4177,45,27,170,144,72,458
Pennsylvania,Coraopolis borough,5642,58,41,187,207,251,744
Pennsylvania,Coral,578,4,0,26,60,0,90
Pennsylvania,Coplay borough,3216,46,22,183,168,104,523
Pennsylvania,Cooperstown borough,519,15,8,20,21,18,82
Pennsylvania,Mont Alto borough,1880,0,7,103,128,81,319
Pennsylvania,Montandon,935,3,56,46,44,52,201
Pennsylvania,Monroeville municipal,28346,278,557,1001,1178,1122,4136
Pennsylvania,Montgomery borough,1515,30,19,128,62,106,345
Pennsylvania,Monroe borough,658,4,7,38,44,56,149
Pennsylvania,Sand Hill,2321,24,41,57,170,191,483
Pennsylvania,Connellsville,7550,152,63,374,309,342,1240
Pennsylvania,Conneautville borough,931,14,12,72,49,52,199
Pennsylvania,Conneaut Lakeshore,2788,0,0,107,237,160,504
Pennsylvania,Conneaut Lake borough,601,9,2,33,35,29,108
Pennsylvania,Confluence borough,716,12,1,11,26,35,85
Pennsylvania,Conestoga,1109,0,0,32,51,61,144
Pennsylvania,Conashaugh Lakes,1350,24,0,121,142,159,446
Pennsylvania,Commodore,397,12,0,12,23,15,62
Pennsylvania,Colwyn borough,2559,9,57,174,270,119,629
Pennsylvania,Colver,717,0,0,29,26,46,101
Pennsylvania,Columbus,724,0,0,19,35,69,123
Pennsylvania,Columbia borough,10394,269,239,466,502,467,1943
Pennsylvania,Colony Park,1419,60,26,64,133,122,405
Pennsylvania,Colonial Park,13196,225,265,555,508,828,2381
Pennsylvania,St. Clairsville borough,74,0,0,9,0,9,18
Pennsylvania,St. Lawrence borough,1915,21,12,90,96,115,334
Pennsylvania,St. Marys,12845,329,177,562,378,583,2029
Pennsylvania,St. Michael,577,42,0,0,0,0,42
Pennsylvania,St. Petersburg borough,280,5,2,25,6,22,60
Pennsylvania,St. Vincent College,1266,0,0,0,12,7,19
Pennsylvania,Salisbury borough,805,4,3,18,29,60,114
Pennsylvania,Salix,1167,0,16,64,92,17,189
Pennsylvania,Salladasburg borough,254,0,0,14,6,6,26
Pennsylvania,Saltillo borough,297,5,1,20,23,18,67
Pennsylvania,Saltsburg borough,799,25,8,35,55,30,153
Pennsylvania,Salunga,2850,70,0,203,152,115,540
Pennsylvania,Sanatoga,8480,125,113,595,388,460,1681
Pennsylvania,Sandy,1205,0,0,40,40,93,173
Pennsylvania,Montgomeryville,13104,241,132,610,715,852,2550
Pennsylvania,Montoursville borough,4591,129,59,184,173,247,792
Pennsylvania,Montrose borough,1716,14,9,37,67,130,257
Pennsylvania,Muir,519,15,11,25,5,9,65
Pennsylvania,Muncy borough,2476,37,42,99,129,113,420
Pennsylvania,Mundys Corner,1896,11,26,93,121,101,352
Pennsylvania,Munhall borough,11351,109,51,488,440,520,1608
Pennsylvania,Murrysville municipal,20181,341,303,782,920,1026,3372
Pennsylvania,Muse,2622,89,61,110,172,249,681
Pennsylvania,Myerstown borough,3111,91,59,171,140,190,651
Pennsylvania,Nanticoke,10356,149,132,510,472,489,1752
Pennsylvania,Nanty-Glo borough,2657,22,81,111,148,81,443
Pennsylvania,Daisytown borough,352,10,0,22,25,28,85
Pennsylvania,Dale borough,1138,17,3,56,65,59,200
Pennsylvania,Dallas borough,2793,40,28,106,171,173,518
Pennsylvania,Dallastown borough,4019,141,58,193,220,238,850
Pennsylvania,Dalmatia,467,0,3,20,37,33,93
Pennsylvania,Dalton borough,1318,8,4,48,93,100,253
Pennsylvania,Danville borough,4686,9,83,191,293,114,690
Pennsylvania,Darby borough,10693,169,118,966,842,807,2902
Pennsylvania,Darlington borough,398,9,3,41,43,39,135
Pennsylvania,Dauberville,928,32,0,61,41,76,210
Pennsylvania,New Albany borough,320,6,6,14,6,5,37
Pennsylvania,Nesquehoning borough,3295,40,31,135,125,152,483
Pennsylvania,Nescopeck borough,1744,28,20,66,40,87,241
Pennsylvania,Nemacolin,728,0,15,0,0,13,28
Pennsylvania,Needmore,102,0,3,3,0,8,14
Pennsylvania,Nazareth borough,5701,72,56,133,288,328,877
Pennsylvania,Narberth borough,4292,154,37,212,142,311,856
Pennsylvania,Naomi,32,0,0,0,0,0,0
Pennsylvania,Muhlenberg Park,2052,18,33,59,87,71,268
Pennsylvania,Mount Wolf borough,1790,25,15,99,76,67,282
Pennsylvania,Mountville borough,2837,109,0,70,132,78,389
Pennsylvania,Mount Union borough,2436,57,45,96,78,95,371
Pennsylvania,Montrose Manor,550,0,10,42,11,35,98
Pennsylvania,Monument,204,0,0,3,5,19,27
Pennsylvania,Moosic borough,5718,161,54,270,241,335,1061
Pennsylvania,Morgantown,1111,21,21,41,52,63,198
Pennsylvania,Morrisdale,750,0,0,46,74,14,134
Pennsylvania,Morrisville borough,8666,203,144,478,393,484,1702
Pennsylvania,Morrisville,754,0,18,39,30,40,127
Pennsylvania,Morton borough,2681,39,20,167,136,95,457
Pennsylvania,Moscow borough,2239,48,8,60,130,167,413
Pennsylvania,Moshannon,254,0,0,0,16,13,29
Pennsylvania,Mount Aetna,336,0,4,7,9,9,29
Pennsylvania,Mountainhome,1075,0,13,0,18,155,186
Pennsylvania,Mountain Top,11378,194,90,638,639,750,2311
Pennsylvania,Connoquenessing borough,527,12,7,35,25,25,104
Pennsylvania,Mount Carbon borough,88,0,0,2,2,3,7
Pennsylvania,Mount Cobb,1554,23,31,132,75,43,304
Pennsylvania,Mount Eagle,74,0,0,2,0,7,9
Pennsylvania,Mount Gretna borough,256,1,2,3,13,8,27
Pennsylvania,Mount Gretna Heights,211,7,0,12,0,0,19
Pennsylvania,Mount Holly Springs borough,1794,34,27,69,88,63,281
Pennsylvania,Mount Jewett borough,928,7,14,41,48,60,170
Pennsylvania,Mount Joy borough,7891,81,13,428,494,377,1393
Pennsylvania,Mount Morris,844,4,3,22,47,36,112
Pennsylvania,Mount Oliver borough,3399,28,79,194,163,263,727
Pennsylvania,Mount Penn borough,3160,41,66,212,189,115,623
Pennsylvania,Mount Pleasant borough,4428,74,104,200,135,161,674
Pennsylvania,Mount Pleasant Mills,580,3,17,45,30,19,114
Pennsylvania,Mount Pocono borough,3106,27,13,244,344,218,846
Pennsylvania,Mount Carmel borough,5810,7,58,291,303,314,973
Pennsylvania,Conshohocken borough,7890,85,45,158,249,223,760
Pennsylvania,Conway borough,2198,17,38,41,108,84,288
Pennsylvania,Conyngham borough,1996,6,32,69,70,127,304
Pennsylvania,Eagleville CDP (Centre County),373,0,0,16,16,0,32
Pennsylvania,Eagleview,1824,8,16,58,138,87,307
Pennsylvania,Eagles Mere borough,121,3,0,2,4,0,9
Pennsylvania,Eagle Lake,0,0,0,0,0,0,0
Pennsylvania,Dushore borough,640,4,0,20,26,21,71
Pennsylvania,Duryea borough,4935,70,83,268,194,197,812
Pennsylvania,Duquesne,5556,119,44,410,361,420,1354
Pennsylvania,Dupont borough,2711,0,0,89,80,132,301
Pennsylvania,Dunnstown,1362,0,21,80,68,25,194
Pennsylvania,Dunmore borough,13810,269,116,718,594,517,2214
Pennsylvania,Dunlo,114,0,0,0,19,0,19
Pennsylvania,Dunlevy borough,378,2,2,16,26,11,57
Pennsylvania,Duncansville borough,1283,3,17,61,53,82,216
Pennsylvania,Duncannon borough,1598,14,32,59,99,52,256
Pennsylvania,Dunbar borough,1085,4,11,73,53,57,198
Pennsylvania,Dudley borough,171,0,0,0,6,29,35
Pennsylvania,Duboistown borough,1195,20,15,55,14,41,145
Pennsylvania,DuBois,7672,129,43,388,304,409,1273
Pennsylvania,Dublin borough,2120,32,47,83,101,120,383
Pennsylvania,Dryville,627,13,0,39,36,50,138
Pennsylvania,Dry Tavern,569,24,24,31,4,0,83
Pennsylvania,Driftwood borough,74,0,0,0,2,0,2
Pennsylvania,Drexel Hill,27999,588,403,1295,1216,1477,4979
Pennsylvania,Dravosburg borough,1864,8,24,84,59,113,288
Pennsylvania,Doylestown borough,8344,99,82,299,321,359,1160
Pennsylvania,Downingtown borough,7930,119,46,246,216,489,1116
Pennsylvania,Douglassville,780,0,0,0,106,80,186
Pennsylvania,Eagleville CDP (Montgomery County),4726,53,33,149,138,201,574
Pennsylvania,Earlston,1021,0,0,33,69,27,129
Pennsylvania,East Bangor borough,1182,14,14,70,57,56,211
Pennsylvania,East Berlin borough,1418,17,15,65,61,88,246
Pennsylvania,Schubert,104,0,0,0,0,0,0
Pennsylvania,Schoeneck,806,0,32,12,41,46,131
Pennsylvania,Schnecksville,2774,44,0,195,197,184,620
Pennsylvania,Schlusser,5228,84,74,229,286,241,914
Pennsylvania,Schellsburg borough,325,3,0,7,10,35,55
Pennsylvania,Schaefferstown,1137,0,41,74,27,16,158
Pennsylvania,Scalp Level borough,801,5,16,20,40,44,125
Pennsylvania,Sayre borough,5513,30,103,346,277,243,999
Pennsylvania,Saylorsburg,334,0,0,17,0,0,17
Pennsylvania,Saxton borough,738,31,2,30,51,47,161
Pennsylvania,Saxonburg borough,1477,37,21,65,26,35,184
Pennsylvania,Saw Creek,3455,0,0,137,236,364,737
Pennsylvania,Sankertown borough,659,25,13,24,28,20,110
Pennsylvania,Dorneyville,4530,78,19,131,174,226,628
Pennsylvania,Sandy Ridge,237,0,0,0,0,10,10
Pennsylvania,East Prospect borough,1139,25,53,116,127,56,377
Pennsylvania,East Pittsburgh borough,1827,26,7,170,129,66,398
Pennsylvania,East Petersburg borough,4518,135,0,327,162,156,780
Pennsylvania,East McKeesport borough,2140,22,20,86,93,94,315
Pennsylvania,Eastlawn Gardens,3275,19,0,151,222,236,628
Pennsylvania,East Lansdowne borough,2672,20,60,135,127,86,428
Pennsylvania,East Greenville borough,2968,30,52,150,154,168,554
Pennsylvania,East Freedom,1027,33,59,24,79,18,213
Pennsylvania,East Earl,952,18,12,112,110,16,268
Pennsylvania,East Conemaugh borough,1141,0,13,69,97,40,219
Pennsylvania,East Butler borough,699,10,5,56,61,17,149
Pennsylvania,East Brady borough,1053,8,26,54,26,66,180
Pennsylvania,East Berwick,1922,22,7,51,47,83,210
Pennsylvania,Sandy Lake borough,642,5,7,31,47,34,124
Pennsylvania,Schwenksville borough,1376,19,23,66,65,41,214
Pennsylvania,Dormont borough,8555,189,46,142,212,289,878
Pennsylvania,Donegal borough,173,0,2,6,2,3,13
Pennsylvania,Rupert,179,0,2,5,2,3,12
Pennsylvania,Rural Valley borough,866,24,10,37,43,34,148
Pennsylvania,Russell,1242,32,8,29,65,37,171
Pennsylvania,Russellton,1661,16,0,126,9,75,226
Pennsylvania,Rutherford,4817,69,101,271,244,222,907
Pennsylvania,Rutledge borough,771,22,5,36,54,61,178
Pennsylvania,Saegertown borough,993,9,2,35,47,75,168
Pennsylvania,St. Clair borough,2950,22,26,153,96,235,532
Pennsylvania,New Schaefferstown,268,3,0,10,8,16,37
Pennsylvania,New Stanton borough,2414,70,20,120,81,87,378
Pennsylvania,Newton Hamilton borough,212,6,0,19,16,21,62
Pennsylvania,Newtown borough,2110,28,4,91,109,189,421
Pennsylvania,Newtown,214,2,0,2,22,15,41
Pennsylvania,Newtown Grant,3709,61,42,142,147,237,629
Pennsylvania,New Tripoli,719,17,13,70,56,26,182
Pennsylvania,Newville borough,1358,16,15,57,57,55,200
Pennsylvania,New Washington borough,49,0,0,2,1,7,10
Pennsylvania,New Wilmington borough,2377,13,13,58,79,47,210
Pennsylvania,Nicholson borough,736,2,12,30,45,28,117
Pennsylvania,Nittany,568,0,0,20,17,44,81
Pennsylvania,Nixon,1313,32,15,37,72,144,300
Pennsylvania,Noblestown,494,18,20,0,30,11,79
Pennsylvania,Norristown borough,34500,570,537,1967,1833,1580,6487
Pennsylvania,Northampton borough,9895,134,236,479,408,576,1833
Pennsylvania,North Apollo borough,1419,17,9,66,36,102,230
Pennsylvania,North Belle Vernon borough,1989,19,4,63,94,132,312
Pennsylvania,Coopersburg borough,2309,62,11,72,68,87,300
Pennsylvania,New Salem borough,835,11,13,45,35,40,144
Pennsylvania,New Salem,410,0,24,29,9,0,62
Pennsylvania,Newry borough,317,4,1,7,39,22,73
Pennsylvania,New Ringgold borough,287,2,1,20,11,8,42
Pennsylvania,Donaldson,289,0,3,13,10,30,56
Pennsylvania,Dillsburg borough,2572,35,27,135,115,112,424
Pennsylvania,Dicksonville,445,35,0,62,28,33,158
Pennsylvania,Dewart,1463,56,40,47,72,99,314
Pennsylvania,Devon,1930,112,16,157,132,93,510
Pennsylvania,DeSales University,937,0,0,0,0,0,0
Pennsylvania,Derry borough,2629,33,6,154,147,94,434
Pennsylvania,Denver borough,3864,83,20,165,218,143,629
Pennsylvania,Delta borough,632,7,9,42,29,62,149
Pennsylvania,Delmont borough,2657,59,37,109,130,161,496
Pennsylvania,Delaware Water Gap borough,678,8,17,44,15,21,105
Pennsylvania,New Freedom borough,4542,71,42,326,395,299,1133
Pennsylvania,New Freeport,84,0,0,0,4,11,15
Pennsylvania,Donora borough,4697,98,23,289,119,267,796
Pennsylvania,New Galilee borough,451,11,6,32,18,13,80
Pennsylvania,New Hope borough,2519,36,29,117,154,114,450
Pennsylvania,New Jerusalem,624,73,15,100,13,0,201
Pennsylvania,New Kensington,12874,199,148,550,559,518,1974
Pennsylvania,New Kingstown,342,0,0,0,0,36,36
Pennsylvania,New Lebanon borough,174,11,2,11,6,8,38
Pennsylvania,Newmanstown,2658,39,38,141,197,59,474
Pennsylvania,New Market,623,0,24,63,17,0,104
Pennsylvania,New Milford borough,891,14,11,53,48,47,173
Pennsylvania,New Morgan borough,67,0,0,1,10,31,42
Pennsylvania,New Oxford borough,2286,31,22,205,126,115,499
Pennsylvania,New Paris borough,199,1,0,1,7,12,21
Pennsylvania,New Philadelphia borough,1035,9,18,46,67,42,182
Pennsylvania,Newport borough,1450,12,19,70,73,48,222
Pennsylvania,New Holland borough,5408,33,81,249,144,387,894
Pennsylvania,Dover borough,1992,32,21,103,114,107,377
Pennsylvania,Gilbertsville,4926,15,38,303,221,305,882
Pennsylvania,East Salem,243,3,0,27,28,5,63
Pennsylvania,Wellersburg borough,232,0,2,14,21,11,48
Pennsylvania,Weissport East,1388,47,13,39,59,37,195
Pennsylvania,Weissport borough,368,8,1,17,24,17,67
Pennsylvania,Weigelstown,12684,370,274,429,471,501,2045
Pennsylvania,Weedville,611,10,7,35,31,24,107
Pennsylvania,Webster,318,25,0,11,15,0,51
Pennsylvania,Weatherly borough,2472,22,8,104,97,122,353
Pennsylvania,Wellsboro borough,3313,33,23,176,84,87,403
Pennsylvania,Waynesburg borough,4109,12,43,118,154,137,464
Pennsylvania,Wayne Heights,2912,71,43,226,176,99,615
Pennsylvania,Waymart borough,1369,36,17,72,59,103,287
Pennsylvania,Waverly,568,0,4,4,14,52,74
Pennsylvania,Wattsburg borough,508,20,6,15,23,50,114
Pennsylvania,Watsontown borough,2222,9,39,93,88,77,306
Pennsylvania,Waterford borough,1374,25,4,37,95,104,265
Pennsylvania,Washingtonville borough,213,0,4,10,6,8,28
Pennsylvania,Waynesboro borough,10731,102,182,509,446,555,1794
Pennsylvania,Washington Boro,704,0,0,58,21,78,157
Pennsylvania,Wellsville borough,282,2,0,11,17,16,46
Pennsylvania,Wescosville,5807,103,44,325,353,398,1223
Pennsylvania,Hollidaysburg borough,5812,78,56,162,235,167,698
Pennsylvania,Holiday Pocono,510,0,0,49,29,24,102
Pennsylvania,Hokendauqua,3191,0,14,97,89,180,380
Pennsylvania,Hiller,1066,0,0,26,19,9,54
Pennsylvania,West Grove borough,2860,41,16,196,143,173,569
Pennsylvania,Westfield borough,1143,8,17,44,35,45,149
Pennsylvania,West Falls,395,0,0,13,8,22,43
Pennsylvania,Wernersville borough,2515,35,4,112,127,187,465
Pennsylvania,West Fairview,1380,24,9,91,49,16,189
Pennsylvania,West Easton borough,1304,9,14,88,42,84,237
Pennsylvania,West Decatur,468,11,3,26,25,22,87
Pennsylvania,West Conshohocken borough,1306,15,10,3,20,11,59
Pennsylvania,West Chester borough,19181,224,218,391,361,368,1562
Pennsylvania,West Brownsville borough,861,6,5,19,20,21,71
Pennsylvania,West Alexander,447,6,0,12,15,34,67
Pennsylvania,Wesleyville borough,3270,51,72,146,166,144,579
Pennsylvania,West Elizabeth borough,565,10,0,49,26,37,122
Pennsylvania,Homeacre-Lyndora,6979,83,22,288,313,335,1041
Pennsylvania,Washington,13642,194,101,474,415,436,1620
Pennsylvania,Warren,9478,221,118,480,501,417,1737
Pennsylvania,Verona borough,2560,7,7,116,109,200,439
Pennsylvania,Venango borough,272,0,10,14,8,11,43
Pennsylvania,Van Voorhis,151,0,0,0,0,0,0
Pennsylvania,Vandling borough,786,12,4,24,57,47,144
Pennsylvania,Vandergrift borough,5095,92,60,301,284,260,997
Pennsylvania,Vanderbilt borough,527,22,0,10,17,12,61
Pennsylvania,Hilldale,1005,0,0,0,0,0,0
Pennsylvania,Versailles borough,1682,29,22,38,60,70,219
Pennsylvania,Highspire borough,2249,20,34,79,100,61,294
Pennsylvania,Hickory Hills,644,0,0,62,58,6,126
Pennsylvania,Hickory,776,15,15,85,43,52,210
Pennsylvania,Hershey,14469,132,58,451,834,647,2122
Pennsylvania,Herndon borough,377,4,4,20,30,17,75
Pennsylvania,Hermitage,16185,191,139,604,650,767,2351
Pennsylvania,Herminie,860,0,23,83,77,23,206
Pennsylvania,Hereford,658,3,3,24,3,30,63
Pennsylvania,Highland Park,1139,0,0,97,16,40,153
Pennsylvania,Warrior Run borough,546,3,3,16,19,20,61
Pennsylvania,Vicksburg,420,14,0,48,41,0,103
Pennsylvania,Village Shires,4066,61,58,82,302,291,794
Pennsylvania,Warminster Heights,4164,67,88,203,338,190,886
Pennsylvania,Wanamie,744,0,13,54,63,26,156
Pennsylvania,Wampum borough,578,0,0,15,20,35,70
Pennsylvania,Walnuttown,416,16,0,0,0,15,31
Pennsylvania,Walnutport borough,2164,18,21,125,102,84,350
Pennsylvania,Waller,105,0,0,0,3,0,3
Pennsylvania,Wallenpaupack Lake Estates,1315,20,32,166,27,90,335
Pennsylvania,Village Green-Green Ridge,7569,140,82,371,449,421,1463
Pennsylvania,Wallaceton borough,333,2,4,13,23,12,54
Pennsylvania,Wakefield,657,5,12,58,55,13,143
Pennsylvania,Wagner,221,0,0,12,7,5,24
Pennsylvania,Vowinckel,151,0,7,0,15,21,43
Pennsylvania,Volant borough,108,2,0,4,8,13,27
Pennsylvania,Virginville,264,0,0,10,24,0,34
Pennsylvania,Vintondale borough,395,14,0,13,4,13,44
Pennsylvania,Vinco,1192,32,17,23,59,57,188
Pennsylvania,Wall borough,779,18,6,60,14,35,133
Pennsylvania,Hendersonville,356,0,0,0,23,73,96
Pennsylvania,Homer City borough,1745,25,23,89,92,82,311
Pennsylvania,Hometown,1291,41,0,34,109,58,242
Pennsylvania,West Hazleton borough,4549,34,63,165,378,279,919
Pennsylvania,West Hamburg,2020,68,19,73,42,180,382
Pennsylvania,Jefferson borough (Greene County),257,4,4,3,4,10,25
Pennsylvania,Jeddo borough,138,4,4,4,4,0,16
Pennsylvania,Jeannette,9464,59,50,473,298,520,1400
Pennsylvania,Jamison City,94,3,0,5,2,0,10
Pennsylvania,Jamestown borough,602,6,2,32,18,29,87
Pennsylvania,West Hills,1119,0,0,68,28,26,122
Pennsylvania,James City,206,0,0,5,7,12,24
Pennsylvania,Jacksonwald,3223,103,65,120,220,168,676
Pennsylvania,Jacksonville CDP (Indiana County),623,11,8,41,36,30,126
Pennsylvania,Jacksonville CDP (Centre County),94,2,0,7,10,3,22
Pennsylvania,Jackson Center borough,205,5,3,9,15,12,44
Pennsylvania,Ivyland borough,1026,14,16,76,61,43,210
Pennsylvania,Irwin borough,3906,12,55,208,155,108,538
Pennsylvania,Irvona borough,759,10,0,24,41,50,125
Pennsylvania,Jacobus borough,1813,43,14,182,87,74,400
Pennsylvania,Iola,200,0,0,6,19,7,32
Pennsylvania,West Homestead borough,1784,42,28,21,23,69,183
Pennsylvania,Westland,95,0,0,0,28,0,28
Pennsylvania,West Reading borough,4191,103,74,235,203,255,870
Pennsylvania,West Pittston borough,4814,22,56,226,144,166,614
Pennsylvania,West Pittsburg,953,0,4,47,81,38,170
Pennsylvania,Westover borough,341,0,0,6,18,18,42
Pennsylvania,Weston,357,6,0,5,16,9,36
Pennsylvania,West Newton borough,2585,45,0,127,74,96,342
Pennsylvania,West Nanticoke,711,4,0,41,32,8,85
Pennsylvania,West Kittanning borough,1176,32,0,75,35,39,181
Pennsylvania,Westmont borough,5039,36,39,272,241,383,971
Pennsylvania,West Mifflin borough,20237,147,146,759,1053,1046,3151
Pennsylvania,West Middletown borough,113,2,3,3,2,4,14
Pennsylvania,West Middlesex borough,901,8,24,37,43,76,188
Pennsylvania,West Mayfield borough,1286,8,15,110,80,47,260
Pennsylvania,West Liberty borough,357,7,6,19,14,30,76
Pennsylvania,West Leechburg borough,1303,23,6,42,46,65,182
Pennsylvania,West Lawn,1790,30,49,103,114,101,397
Pennsylvania,West Milton,839,0,21,10,64,0,95
Pennsylvania,Homestead borough,3144,58,46,188,152,203,647
Pennsylvania,Intercourse,1728,0,23,95,138,115,371
Pennsylvania,Ingram borough,3308,59,9,150,66,112,396
Pennsylvania,Hublersburg,58,21,0,0,0,0,21
Pennsylvania,Howard borough,806,3,2,67,26,37,135
Pennsylvania,Houtzdale borough,783,22,16,37,18,26,119
Pennsylvania,Houston borough,1328,7,19,88,49,67,230
Pennsylvania,Houserville,1962,35,50,58,93,137,373
Pennsylvania,Hostetter,952,8,0,25,22,101,156
Pennsylvania,Horsham,14587,215,88,648,780,633,2364
Pennsylvania,Hudson,1571,0,47,49,14,0,110
Pennsylvania,Hopwood,1937,27,0,47,77,212,363
Pennsylvania,Hopeland,562,0,12,13,36,42,103
Pennsylvania,Hop Bottom borough,295,7,1,13,15,13,49
Pennsylvania,Hooversville borough,613,3,0,23,51,34,111
Pennsylvania,Hookstown borough,119,1,1,1,10,5,18
Pennsylvania,Honey Brook borough,1689,28,18,74,109,118,347
Pennsylvania,Honesdale borough,4315,36,121,171,250,176,754
Pennsylvania,Homewood borough,101,0,0,0,0,3,3
Pennsylvania,Hopewell borough,239,9,0,14,14,19,56
Pennsylvania,Inkerman,1802,25,44,21,61,71,222
Pennsylvania,Hughestown borough,1566,7,7,75,56,58,203
Pennsylvania,Hulmeville borough,926,4,19,41,67,20,151
Pennsylvania,Industry borough,1896,13,18,71,86,77,265
Pennsylvania,Indian Mountain Lake,4249,37,120,275,195,318,945
Pennsylvania,Indian Lake borough,403,3,0,5,0,14,22
Pennsylvania,Indiana borough,14050,68,46,311,208,322,955
Pennsylvania,Imperial,2616,61,0,81,122,250,514
Pennsylvania,Idaville,199,0,0,7,8,5,20
Pennsylvania,Hyndman borough,831,0,4,42,61,38,145
Pennsylvania,Hughesville borough,1982,10,13,81,162,144,410
Pennsylvania,Hydetown borough,491,3,4,17,15,15,54
Pennsylvania,Hyde Park,3367,60,97,147,214,268,786
Pennsylvania,Hyde,1228,41,22,50,8,39,160
Pennsylvania,Huntingdon borough,7060,62,87,211,239,230,829
Pennsylvania,Hunterstown,521,27,0,0,0,11,38
Pennsylvania,Hunker borough,318,0,5,6,8,20,39
Pennsylvania,Hummels Wharf,1536,21,15,113,74,74,297
Pennsylvania,Hummelstown borough,4555,54,52,277,335,173,891
Pennsylvania,Hyde Park borough,426,10,4,19,11,17,61
Pennsylvania,West Sunbury borough,146,2,0,9,5,11,27
Pennsylvania,Hemlock Farms,3470,0,24,25,205,230,484
Pennsylvania,Heilwood,601,0,12,39,28,20,99
Pennsylvania,Manor borough,3281,164,16,195,150,172,697
Pennsylvania,Manorville borough,403,13,7,25,24,17,86
Pennsylvania,Mansfield borough,3521,55,35,128,57,121,396
Pennsylvania,Maple Glen,6801,105,102,290,361,459,1317
Pennsylvania,Mapleton borough,472,7,11,32,16,16,82
Pennsylvania,Mapletown,165,3,3,16,25,0,47
Pennsylvania,Marcus Hook borough,2434,61,40,122,185,162,570
Pennsylvania,Manns Choice borough,300,1,3,13,20,35,72
Pennsylvania,Marianna borough,510,9,13,47,19,28,116
Pennsylvania,Marienville,4308,9,0,16,39,105,169
Pennsylvania,Marietta borough,2594,46,12,103,146,95,402
Pennsylvania,Marion,939,0,64,29,98,0,191
Pennsylvania,Marion Center borough,456,7,8,23,36,34,108
Pennsylvania,Park Crest,587,17,3,25,19,7,71
Pennsylvania,Paris,808,0,0,0,27,47,74
Pennsylvania,Pardeesville,371,8,0,18,9,17,52
Pennsylvania,Marianne,1227,21,13,37,55,29,155
Pennsylvania,Paradise,1110,54,0,46,46,50,196
Pennsylvania,Manheim borough,4864,49,19,183,272,277,800
Pennsylvania,Mammoth,472,6,0,29,20,6,61
Pennsylvania,McKean borough,453,4,1,33,9,20,67
Pennsylvania,McKeansburg,159,4,0,10,14,9,37
Pennsylvania,McKeesport,19637,150,285,1073,837,986,3331
Pennsylvania,McKees Rocks borough,6075,68,113,346,198,310,1035
Pennsylvania,McKnightstown,151,0,0,0,0,0,0
Pennsylvania,McMurray,4745,121,72,235,423,265,1116
Pennsylvania,McSherrystown borough,3049,31,50,144,220,177,622
Pennsylvania,Manchester borough,2753,94,60,159,103,182,598
Pennsylvania,Macungie borough,3111,43,26,55,146,220,490
Pennsylvania,Madison borough,377,14,10,7,3,8,42
Pennsylvania,Madisonburg,265,0,0,22,34,12,68
Pennsylvania,Mahaffey borough,330,3,5,16,22,29,75
Pennsylvania,Mahanoy City borough,4089,48,52,342,172,230,844
Pennsylvania,Mainville,122,0,0,6,6,0,12
Pennsylvania,Maitland,247,0,0,0,0,0,0
Pennsylvania,Malvern borough,3263,124,31,138,243,219,755
Pennsylvania,McVeytown borough,341,0,0,6,19,12,37
Pennsylvania,McGovern,2594,32,36,107,165,175,515
Pennsylvania,Paoli,5652,174,70,163,210,207,824
Pennsylvania,Palmyra borough,7432,50,78,371,416,293,1208
Pennsylvania,Oley,1288,17,0,80,93,75,265
Pennsylvania,Old Orchard,2275,23,16,89,124,104,356
Pennsylvania,Old Forge borough,8225,125,135,251,204,396,1111
Pennsylvania,Oklahoma borough,677,6,4,17,17,33,77
Pennsylvania,East Rochester borough,547,6,0,17,33,43,99
Pennsylvania,Oil City,10296,159,114,527,541,600,1941
Pennsylvania,Ohioville borough,3497,27,6,173,212,212,630
Pennsylvania,Oliver,2931,9,21,281,206,108,625
Pennsylvania,Ohiopyle borough,33,0,0,0,5,0,5
Pennsylvania,Oakwood,2168,6,7,43,127,175,358
Pennsylvania,Oakmont borough,6398,62,72,196,271,226,827
Pennsylvania,Oakland borough,636,7,8,30,28,46,119
Pennsylvania,Oakland CDP (Lawrence County),1379,35,53,26,48,48,210
Pennsylvania,Oakland CDP (Cambria County),1464,11,0,31,21,16,79
Pennsylvania,Oak Hills,2280,32,44,46,39,39,200
Pennsylvania,Oakdale borough,1432,14,5,45,76,53,193
Pennsylvania,Oberlin,440,33,0,15,0,34,82
Pennsylvania,Palo Alto borough,1044,17,3,37,56,45,158
Pennsylvania,Olyphant borough,5166,64,17,273,174,139,667
Pennsylvania,Orangeville borough,460,7,6,11,11,21,56
Pennsylvania,Palmerton borough,5352,68,46,334,100,232,780
Pennsylvania,Palmer Heights,3657,24,58,132,177,137,528
Pennsylvania,Palmdale,1153,7,0,140,55,14,216
Pennsylvania,Paint borough,905,6,10,28,15,14,73
Pennsylvania,Oxford borough,5163,66,124,477,361,276,1304
Pennsylvania,Oval,426,11,13,33,9,38,104
Pennsylvania,Oswayo borough,176,0,0,7,8,16,31
Pennsylvania,Oneida,165,0,2,3,3,6,14
Pennsylvania,Osceola Mills borough,1135,11,29,83,45,23,191
Pennsylvania,Orwigsburg borough,3041,38,52,114,109,109,422
Pennsylvania,Orviston,83,0,0,1,4,0,5
Pennsylvania,Orrtanna,196,4,0,7,18,11,40
Pennsylvania,Orrstown borough,252,0,2,10,19,9,40
Pennsylvania,Oreland,5817,121,114,327,237,390,1189
Pennsylvania,Orchard Hills,1891,0,17,100,91,82,290
Pennsylvania,Orbisonia borough,523,0,7,27,25,42,101
Pennsylvania,Orwin,346,0,0,5,23,8,36
Pennsylvania,Hellertown borough,5858,75,64,211,346,351,1047
Pennsylvania,McEwensville borough,367,0,0,17,26,24,67
Pennsylvania,McDonald borough,2159,69,25,76,63,73,306
Pennsylvania,Harrison City,151,0,0,0,0,16,16
Pennsylvania,Harrisburg,49232,734,836,2380,2633,2644,9227
Pennsylvania,Harmony borough,823,8,9,31,40,42,130
Pennsylvania,Harmonsburg,168,0,0,14,6,6,26
Pennsylvania,Harleysville,9285,148,84,468,630,618,1948
Pennsylvania,Harleigh,988,9,39,7,15,33,103
Pennsylvania,Hanover borough,15403,137,214,802,616,472,2241
Pennsylvania,Harrisville borough,910,6,15,38,66,47,172
Pennsylvania,Hannasville,174,4,0,16,17,12,49
Pennsylvania,Hamburg borough,4316,35,48,249,148,126,606
Pennsylvania,Hallstead borough,1114,24,7,31,74,65,201
Pennsylvania,Hallam borough,2670,50,14,87,95,136,382
Pennsylvania,Halifax borough,952,4,13,84,36,85,222
Pennsylvania,Halfway House,2806,51,19,162,160,154,546
Pennsylvania,Guys Mills,119,0,0,8,0,6,14
Pennsylvania,Guilford,2552,42,0,112,112,150,416
Pennsylvania,Hampton,812,13,0,95,43,65,216
Pennsylvania,Grove City borough,8210,106,91,143,227,402,969
Pennsylvania,Hartleton borough,249,0,0,18,23,6,47
Pennsylvania,Harveys Lake borough,2793,18,12,96,176,69,371
Pennsylvania,Heidlersburg,786,3,6,82,34,35,160
Pennsylvania,Heidelberg borough,1324,8,13,77,51,38,187
Pennsylvania,Hegins,871,0,0,18,121,63,202
Pennsylvania,Heckscherville,113,0,0,14,0,4,18
Pennsylvania,Hebron,987,7,12,49,16,24,108
Pennsylvania,Hazleton,25087,329,342,1310,1312,1756,5049
Pennsylvania,Haysville borough,79,0,0,0,0,0,0
Pennsylvania,Hartstown,169,2,0,11,12,10,35
Pennsylvania,Hawthorn borough,449,4,2,25,37,30,98
Pennsylvania,Hawk Run,648,0,0,13,86,67,166
Pennsylvania,Haverford College,1310,0,4,8,18,5,35
Pennsylvania,Hatfield borough,3302,56,17,160,247,166,646
Pennsylvania,Hatboro borough,7405,109,34,283,302,399,1127
Pennsylvania,Hastings borough,1253,19,29,72,53,55,228
Pennsylvania,Hasson Heights,1630,9,21,75,99,136,340
Pennsylvania,Harwick,885,0,0,22,23,33,78
Pennsylvania,Hawley borough,1364,14,3,52,84,84,237
Pennsylvania,McElhattan,593,0,12,19,44,22,97
Pennsylvania,Grindstone,461,8,3,53,30,30,124
Pennsylvania,Grier City,378,0,18,14,33,30,95
Pennsylvania,Loretto borough,1238,1,4,12,8,3,28
Pennsylvania,Lower Allen,6919,100,93,205,329,334,1061
Pennsylvania,Lower Burrell,11593,111,103,557,642,521,1934
Pennsylvania,Loyalhanna,3551,17,14,83,134,169,417
Pennsylvania,Lucerne Mines,617,0,0,0,25,78,103
Pennsylvania,Lumber City borough,78,0,1,2,0,0,3
Pennsylvania,Lumber City,198,0,8,27,0,9,44
Pennsylvania,Lorane,4070,42,27,180,85,178,512
Pennsylvania,Luzerne borough,2853,29,30,79,124,93,355
Pennsylvania,Lynnwood-Pricedale,1976,25,23,74,46,40,208
Pennsylvania,Lyons borough,583,0,0,16,11,15,42
Pennsylvania,McAdoo borough,2522,22,32,166,152,100,472
Pennsylvania,McAlisterville,1148,12,17,46,72,68,215
Pennsylvania,McClure borough,1016,2,7,50,68,34,161
Pennsylvania,McConnellsburg borough,1045,32,9,36,52,77,206
Pennsylvania,McConnellstown,1233,11,13,57,56,73,210
Pennsylvania,Lykens borough,1680,30,26,86,91,61,294
Pennsylvania,Grill,1587,17,17,118,77,49,278
Pennsylvania,Lorain borough,801,8,10,63,57,57,195
Pennsylvania,Long Branch borough,456,8,3,14,15,24,64
Pennsylvania,Greenwood,2151,0,70,71,102,85,328
Pennsylvania,Greenville borough,5892,54,58,208,341,253,914
Pennsylvania,Green Tree borough,4653,75,47,181,170,182,655
Pennsylvania,Greens Landing,817,49,11,42,65,42,209
Pennsylvania,Greensburg,14669,205,153,598,539,569,2064
Pennsylvania,Greensboro borough,222,0,0,23,11,16,50
Pennsylvania,Greenock,1905,0,0,108,158,82,348
Pennsylvania,Longfellow,216,3,0,0,10,6,19
Pennsylvania,Green Lane borough,473,9,0,22,49,15,95
Pennsylvania,Greenfields,1000,16,0,11,12,57,96
Pennsylvania,Littlestown borough,4442,103,33,346,211,255,948
Pennsylvania,Liverpool borough,763,0,14,27,23,52,116
Pennsylvania,Lock Haven,9790,174,143,493,294,221,1325
Pennsylvania,Locustdale,166,0,0,0,6,2,8
Pennsylvania,Loganton borough,559,6,13,45,34,21,119
Pennsylvania,Loganville borough,1147,24,14,70,53,62,223
Pennsylvania,Green Hills borough,41,0,1,0,1,2,4
Pennsylvania,West View borough,6735,63,50,345,219,183,860
Pennsylvania,West Waynesburg,296,0,0,0,0,0,0
Pennsylvania,Westwood,1224,0,40,52,115,0,207
Pennsylvania,Kutztown borough,5018,0,37,131,178,164,510
Pennsylvania,Kulpsville,8864,255,87,529,383,365,1619
Pennsylvania,Kulpmont borough,2894,16,111,114,153,86,480
Pennsylvania,Kreamer,797,0,14,51,16,15,96
Pennsylvania,Kratzerville,448,0,4,34,13,14,65
Pennsylvania,Koppel borough,696,3,39,39,9,23,113
Pennsylvania,Knoxville borough,635,3,5,42,27,26,103
Pennsylvania,Kutztown University,3822,0,0,0,0,0,0
Pennsylvania,Knox borough,1110,20,3,36,51,43,153
Pennsylvania,Kittanning borough,3947,29,25,129,127,173,483
Pennsylvania,Kistler borough,360,12,1,19,37,5,74
Pennsylvania,Kiskimere,67,0,0,4,4,4,12
Pennsylvania,Kirkwood,345,0,0,22,4,16,42
Pennsylvania,Kingston borough,13074,192,96,335,368,757,1748
Pennsylvania,King of Prussia,19761,395,90,784,870,1033,3172
Pennsylvania,Kersey,858,0,0,79,38,9,126
Pennsylvania,Klingerstown,66,0,0,0,0,0,0
Pennsylvania,Kerrtown,271,0,0,0,14,0,14
Pennsylvania,Kylertown,355,0,4,41,17,0,62
Pennsylvania,Laflin borough,1539,10,15,53,71,68,217
Pennsylvania,Woodbury borough,218,0,4,6,5,11,26
Pennsylvania,Lanesboro borough,437,4,4,33,22,28,91
Pennsylvania,Landisville,1810,14,0,116,139,114,383
Pennsylvania,Landisburg borough,241,0,3,28,12,10,53
Pennsylvania,Landingville borough,94,0,0,4,5,6,15
Pennsylvania,Lancaster,59344,907,891,2866,3062,3643,11369
Pennsylvania,Lampeter,1549,0,87,46,84,218,435
Pennsylvania,Laceyville borough,466,2,12,20,36,15,85
Pennsylvania,Lamar,611,0,3,15,28,68,114
Pennsylvania,Lake Winola,705,19,4,7,24,56,110
Pennsylvania,Lakemont,2338,23,6,111,95,129,364
Pennsylvania,Lake Meade,2470,47,22,168,126,146,509
Pennsylvania,Lake Latonka,869,22,5,25,56,32,140
Pennsylvania,Lake Heritage,1646,20,0,38,36,164,258
Pennsylvania,Lake City borough,3001,74,30,166,248,222,740
Pennsylvania,Lake Arthur Estates,713,36,0,22,10,0,68
Pennsylvania,Lake Wynonah,2430,24,0,106,150,160,440
Pennsylvania,Woodcock borough,130,2,1,9,4,2,18
Pennsylvania,Kennett Square borough,6117,79,88,282,417,376,1242
Pennsylvania,Kenmar,4557,125,30,154,187,174,670
Pennsylvania,Jennerstown borough,631,11,9,27,10,29,86
Pennsylvania,Jenkintown borough,4444,84,55,308,226,208,881
Pennsylvania,Jefferson Hills borough,11115,255,103,384,671,763,2176
Pennsylvania,Jefferson borough (York County),571,10,4,27,31,20,92
Pennsylvania,Carrolltown borough,859,3,16,40,51,50,160
Pennsylvania,Carroll Valley borough,3900,72,38,200,306,204,820
Pennsylvania,Cashtown,290,0,0,21,39,0,60
Pennsylvania,Jermyn borough,2251,36,26,63,134,121,380
Pennsylvania,Cassandra borough,155,3,2,5,19,13,42
Pennsylvania,Cassville borough,114,0,0,10,2,13,25
Pennsylvania,Castanea,1195,5,0,39,52,65,161
Pennsylvania,Castle Shannon borough,8293,16,78,275,258,340,967
Pennsylvania,Catasauqua borough,6505,40,84,456,259,317,1156
Pennsylvania,Catawissa borough,1473,31,30,79,69,76,285
Pennsylvania,Cecil-Bishop,2561,0,33,77,180,158,448
Pennsylvania,Cedar Crest,354,0,4,41,24,14,83
Pennsylvania,Casselman borough,92,0,0,8,8,9,25
Pennsylvania,Kennerdell,217,0,0,10,8,4,22
Pennsylvania,Jerome,973,0,0,45,0,55,100
Pennsylvania,Jerseytown,131,3,0,3,9,9,24
Pennsylvania,Kenilworth,1786,57,7,113,101,64,342
Pennsylvania,Kenhorst borough,2870,46,0,98,140,148,432
Pennsylvania,Kempton,103,0,0,0,0,0,0
Pennsylvania,Kelayres,475,23,0,17,15,40,95
Pennsylvania,Karns City borough,204,10,0,13,4,10,37
Pennsylvania,Kapp Heights,1062,12,34,39,40,73,198
Pennsylvania,Kane borough,3658,49,105,179,235,171,739
Pennsylvania,Jersey Shore borough,4333,15,182,282,176,280,935
Pennsylvania,Juniata Terrace borough,730,0,5,50,64,54,173
Pennsylvania,Jonestown borough,1702,37,30,122,125,109,423
Pennsylvania,Jonestown,57,0,0,0,3,0,3
Pennsylvania,Johnstown,20369,390,282,888,935,877,3372
Pennsylvania,Johnsonburg borough,2465,21,4,205,127,160,517
Pennsylvania,Joffre,697,0,0,47,41,7,95
Pennsylvania,Jim Thorpe borough,4712,49,0,278,147,316,790
Pennsylvania,Jessup borough,4609,52,67,282,309,312,1022
Pennsylvania,Julian,193,6,4,4,0,13,27
Pennsylvania,Cementon,1356,19,22,46,16,112,215
Pennsylvania,Woodland Heights,1160,48,32,51,33,40,204
Pennsylvania,Woodside,2485,28,33,171,231,132,595
Pennsylvania,Buck Run,185,0,4,6,8,10,28
Pennsylvania,Buffington,332,0,0,0,1,0,1
Pennsylvania,Bulger,305,0,20,18,0,22,60
Pennsylvania,Burgettstown borough,1388,16,7,86,70,84,263
Pennsylvania,Burlington borough,178,3,4,28,10,11,56
Pennsylvania,Burnham borough,2044,28,29,94,120,78,349
Pennsylvania,Burnside borough,216,3,2,11,7,9,32
Pennsylvania,Buckhorn,404,11,8,23,13,19,74
Pennsylvania,Butler,13517,246,216,711,584,532,2289
Pennsylvania,Cairnbrook,584,0,15,39,14,26,94
Pennsylvania,California borough,6657,37,9,78,218,174,516
Pennsylvania,Callensburg borough,171,9,4,15,15,6,49
Pennsylvania,Callery borough,415,11,3,16,30,13,73
Pennsylvania,Callimont borough,40,1,0,2,0,1,4
Pennsylvania,Caln,1554,147,43,13,63,17,283
Pennsylvania,Calumet,1327,26,26,17,11,82,162
Pennsylvania,Byrnedale,498,3,13,50,49,34,149
Pennsylvania,Cambridge Springs borough,2532,33,13,86,74,134,340
Pennsylvania,Bryn Mawr,3436,38,14,57,45,83,237
Pennsylvania,Bruin borough,446,5,6,16,22,21,70
Pennsylvania,Bridgeport borough,4571,65,10,258,161,172,666
Pennsylvania,Bridgeville borough,5135,55,32,158,244,263,752
Pennsylvania,Bridgewater borough,722,6,10,41,27,20,104
Pennsylvania,Brisbin borough,308,1,0,24,29,22,76
Pennsylvania,Bristol borough,9634,256,93,555,597,444,1945
Pennsylvania,Brittany Farms-The Highlands,3894,65,27,203,200,232,727
Pennsylvania,Broad Top City borough,455,2,0,13,22,22,59
Pennsylvania,Bryn Athyn borough,1360,25,1,36,86,46,194
Pennsylvania,Brockway borough,1975,32,8,99,51,100,290
Pennsylvania,Brookhaven borough,8054,104,33,396,228,302,1063
Pennsylvania,Brookville borough,3888,75,45,212,203,197,732
Pennsylvania,Broomall,10859,207,106,434,356,476,1579
Pennsylvania,Brownstown borough,766,13,10,36,42,44,145
Pennsylvania,Brownstown,2788,11,12,194,191,173,581
Pennsylvania,Brownsville borough,2407,57,16,168,104,84,429
Pennsylvania,Browntown,1451,32,0,50,72,70,224
Pennsylvania,Brodheadsville,1769,0,0,47,110,88,245
Pennsylvania,Woodlyn,10249,187,137,471,617,518,1930
Pennsylvania,Campbelltown,4053,175,91,126,228,204,824
Pennsylvania,Canadohta Lake,536,13,5,11,17,17,63
Pennsylvania,Yeadon borough,11506,202,167,470,486,662,1987
Pennsylvania,Yatesville borough,658,6,2,20,34,40,102
Pennsylvania,Yardley borough,2406,61,32,129,110,113,445
Pennsylvania,Wyomissing borough,10475,228,64,318,482,589,1681
Pennsylvania,Wyoming borough,3066,6,1,94,63,167,331
Pennsylvania,Wyndmoor,5611,89,52,344,251,331,1067
Pennsylvania,Wyncote,3207,60,12,181,142,172,567
Pennsylvania,Yeagertown,1053,0,0,56,19,104,179
Pennsylvania,Wylandville,323,0,0,24,0,11,35
Pennsylvania,Wyalusing borough,472,6,12,17,21,32,88
Pennsylvania,Wrightsville borough,2436,32,10,175,181,68,466
Pennsylvania,Woxall,1288,28,9,73,110,80,300
Pennsylvania,Worthville borough,69,0,0,4,2,0,6
Pennsylvania,Worthington borough,648,5,5,52,24,48,134
Pennsylvania,Wormleysburg borough,3066,19,39,157,133,139,487
Pennsylvania,Woodward,158,12,0,23,6,3,44
Pennsylvania,Wyano,430,0,0,8,8,16,32
Pennsylvania,Camp Hill borough,7886,135,66,421,440,501,1563
Pennsylvania,Yoe borough,1067,20,28,89,50,65,252
Pennsylvania,Yorkana borough,242,2,2,14,5,13,36
Pennsylvania,Canonsburg borough,8944,295,109,351,359,285,1399
Pennsylvania,Canton borough,1984,0,21,165,92,80,358
Pennsylvania,Carbondale,8773,126,69,429,458,474,1556
Pennsylvania,Carlisle borough,18945,296,182,628,747,694,2547
Pennsylvania,Carmichaels borough,360,0,0,14,21,21,56
Pennsylvania,Carnegie borough,7953,112,127,244,273,325,1081
Pennsylvania,Carnot-Moon,12546,241,137,338,473,660,1849
Pennsylvania,York,43853,568,845,2751,2962,2288,9414
Pennsylvania,Zion,1977,0,17,155,130,106,408
Pennsylvania,Yukon,669,0,0,0,0,32,32
Pennsylvania,Youngwood borough,2998,46,22,139,116,259,582
Pennsylvania,Youngsville borough,1818,11,34,98,103,109,355
Pennsylvania,Youngstown borough,338,2,1,20,38,14,75
Pennsylvania,York Springs borough,692,19,17,64,54,49,203
Pennsylvania,Yorklyn,2046,28,19,27,23,163,260
Pennsylvania,York Haven borough,698,6,14,39,47,41,147
Pennsylvania,Zelienople borough,3766,68,46,106,163,175,558
Pennsylvania,Centerport borough,292,7,3,12,10,22,54
Pennsylvania,Centerville borough (Crawford County),188,6,1,9,15,7,38
Pennsylvania,Parker,685,7,5,38,46,50,146
Pennsylvania,Ligonier borough,1483,20,11,36,3,40,110
Pennsylvania,Lilly borough,802,7,8,25,29,25,94
Pennsylvania,Lima,2170,14,0,0,1,237,252
Pennsylvania,Lime Ridge,780,9,6,75,36,14,140
Pennsylvania,Lincoln borough,1021,8,12,33,59,24,136
Pennsylvania,Lincoln Park,1598,52,0,94,60,37,243
Pennsylvania,Lincoln University,1787,0,0,0,7,8,15
Pennsylvania,Lightstreet,919,21,0,42,24,52,139
Pennsylvania,Lincolnville,156,0,0,9,9,21,39
Pennsylvania,Linglestown,6338,142,124,247,204,370,1087
Pennsylvania,Linntown,1303,26,0,58,27,40,151
Pennsylvania,Linwood,3449,54,56,228,96,207,641
Pennsylvania,Lionville,6637,129,60,215,453,258,1115
Pennsylvania,Lititz borough,9208,158,57,444,307,531,1497
Pennsylvania,Little Britain,244,0,0,0,13,20,33
Pennsylvania,Little Meadows borough,218,0,0,0,4,6,10
Pennsylvania,Linesville borough,843,10,0,27,34,24,95
Pennsylvania,Plymouth borough,5895,66,35,312,303,296,1012
Pennsylvania,Liberty borough (Tioga County),200,1,2,22,13,12,50
Pennsylvania,Lewistown borough,8326,146,118,380,288,450,1382
Pennsylvania,Leetsdale borough,1281,12,15,54,64,63,208
Pennsylvania,Lehighton borough,5388,8,50,207,434,248,947
Pennsylvania,Leith-Hatfield,2745,11,39,61,78,210,399
Pennsylvania,Lemont,2346,9,85,115,118,118,445
Pennsylvania,Lemont Furnace,847,0,3,77,102,7,189
Pennsylvania,Lemoyne borough,4614,65,87,257,174,160,743
Pennsylvania,Lenape Heights,1145,0,0,12,72,47,131
Pennsylvania,Liberty borough (Allegheny County),2537,21,23,112,85,113,354
Pennsylvania,Lenhartsville borough,182,4,0,5,18,4,31
Pennsylvania,Leola,7104,106,120,387,446,302,1361
Pennsylvania,Le Raysville borough,275,7,4,15,29,16,71
Pennsylvania,Level Green,4043,52,24,286,235,186,783
Pennsylvania,Levittown,51805,737,598,2649,2418,2935,9337
Pennsylvania,Lewisberry borough,418,3,2,20,16,33,74
Pennsylvania,Lewisburg borough,5781,57,46,58,107,126,394
Pennsylvania,Lewis Run borough,611,3,3,13,17,51,87
Pennsylvania,Lenkerville,550,0,11,22,0,4,37
Pennsylvania,Leesport borough,1844,27,21,130,62,84,324
Pennsylvania,Plymouth Meeting,5796,89,57,204,137,313,800
Pennsylvania,Pocono Mountain Lake Estates,741,6,0,9,24,29,68
Pennsylvania,Wilkes-Barre,41108,486,415,1797,2211,1998,6907
Pennsylvania,Wilcox,407,6,0,33,9,19,67
Pennsylvania,Wilburton Number Two,89,2,6,2,10,2,22
Pennsylvania,Wilburton Number One,178,0,2,7,4,12,25
Pennsylvania,Wiconsico,850,23,11,69,73,31,207
Pennsylvania,Wickerham Manor-Fisher,2223,20,35,111,64,50,280
Pennsylvania,Whitfield,4785,70,54,203,314,188,829
Pennsylvania,Wilkinsburg borough,15866,179,114,778,451,746,2268
Pennsylvania,White Oak borough,7842,54,103,218,274,109,758
Pennsylvania,White Haven borough,1173,7,19,56,43,57,182
Pennsylvania,Whitehall borough,13920,298,122,595,435,502,1952
Pennsylvania,Whitaker borough,1211,25,15,18,58,57,173
Pennsylvania,Wheatland borough,838,28,6,46,29,23,132
Pennsylvania,West York borough,4583,87,68,250,290,317,1012
Pennsylvania,West Wyomissing,3147,45,21,135,59,290,550
Pennsylvania,West Wyoming borough,2706,36,23,40,122,129,350
Pennsylvania,White Mills,738,15,16,66,12,18,127
Pennsylvania,Plymptonville,1087,16,0,20,29,65,130
Pennsylvania,Williamsburg borough,1271,31,34,70,39,47,221
Pennsylvania,Williamstown borough,1279,8,23,67,78,76,252
Pennsylvania,Pocono Pines,942,0,0,59,45,32,136
Pennsylvania,Woodbourne,3768,63,70,109,205,248,695
Pennsylvania,Womelsdorf borough,2850,49,46,210,141,111,557
Pennsylvania,Wolfdale,2958,48,107,76,91,64,386
Pennsylvania,Witmer,617,11,5,10,9,0,35
Pennsylvania,Winterstown borough,520,2,2,16,20,42,82
Pennsylvania,Winfield,805,11,4,45,56,35,151
Pennsylvania,Williamsport,29339,411,363,1489,1270,1093,4626
Pennsylvania,Windsor borough,1401,6,44,76,112,62,300
Pennsylvania,Wind Gap borough,2709,9,0,101,151,113,374
Pennsylvania,Windber borough,4062,42,19,203,209,196,669
Pennsylvania,Wilson borough,7838,57,41,614,280,410,1402
Pennsylvania,Wilmore borough,252,3,4,15,26,20,68
Pennsylvania,Wilmerding borough,1766,20,7,101,70,110,308
Pennsylvania,Willow Street,7562,75,48,204,168,174,669
Pennsylvania,Willow Grove,15545,204,115,758,963,848,2888
Pennsylvania,Wind Ridge,207,0,3,7,7,12,29
Pennsylvania,Leeper,156,0,0,0,0,12,12
Pennsylvania,Leechburg borough,2056,17,25,131,107,68,348
Pennsylvania,Lebanon South,2427,30,89,54,89,63,325
Pennsylvania,Pennside,4094,82,7,249,208,316,862
Pennsylvania,Penn State Erie (Behrend),1651,0,0,0,0,0,0
Pennsylvania,Pennville,1637,0,47,9,8,34,98
Pennsylvania,Pennwyn,714,0,0,43,44,0,87
Pennsylvania,Penn Wynne,5568,126,78,391,280,335,1210
Pennsylvania,Penryn,872,0,0,16,68,13,97
Pennsylvania,Perkasie borough,8498,133,85,395,422,626,1661
Pennsylvania,Penns Creek,586,7,18,3,11,0,39
Pennsylvania,Perryopolis borough,1797,8,22,115,112,122,379
Pennsylvania,Petrolia borough,243,4,7,16,12,21,60
Pennsylvania,Philadelphia,1555072,26799,18323,71432,72374,75981,264909
Pennsylvania,Philipsburg borough,2740,25,43,108,67,98,341
Pennsylvania,Phoenixville borough,16562,153,205,674,674,687,2393
Pennsylvania,Picture Rocks borough,815,6,6,54,75,70,211
Pennsylvania,Pikes Creek,287,15,0,19,29,7,70
Pennsylvania,Pillow borough,280,7,0,14,24,27,72
Pennsylvania,Petersburg borough,541,6,8,46,46,25,131
Pennsylvania,Pine Glen,217,5,5,11,22,12,55
Pennsylvania,Pennsbury Village borough,743,15,3,8,3,15,44
Pennsylvania,Penn Lake Park borough,291,8,1,6,4,3,22
Pennsylvania,Parkesburg borough,3659,44,73,167,258,290,832
Pennsylvania,Park Forest Village,9457,118,147,289,221,298,1073
Pennsylvania,Parkside borough,2280,27,36,140,122,91,416
Pennsylvania,Parkville,7141,38,198,328,219,562,1345
Pennsylvania,Parryville borough,629,7,10,19,27,32,95
Pennsylvania,Patterson Heights borough,630,2,12,15,28,37,94
Pennsylvania,Patton borough,1920,26,37,60,72,78,273
Pennsylvania,Pennsburg borough,3872,65,57,204,168,244,738
Pennsylvania,Paxtang borough,1519,19,11,75,88,78,271
Pennsylvania,Paxtonville,194,4,5,16,0,0,25
Pennsylvania,Pen Argyl borough,3557,52,70,183,282,207,794
Pennsylvania,Penbrook borough,2983,58,40,299,136,178,711
Pennsylvania,Pen Mar,1075,0,0,144,21,64,229
Pennsylvania,Penn borough,545,5,7,32,35,38,117
Pennsylvania,Penndel borough,2785,41,28,111,96,100,376
Pennsylvania,Penn Estates,6318,62,52,325,525,463,1427
Pennsylvania,Paxtonia,4998,79,37,218,130,257,721
Pennsylvania,Pine Grove borough,2081,32,20,148,94,148,442
Pennsylvania,Pine Grove Mills,940,0,0,42,0,0,42
Pennsylvania,Pine Ridge,2652,1,0,62,167,201,431
Pennsylvania,Laporte borough,331,0,0,5,3,11,19
Pennsylvania,Larksville borough,4453,28,24,153,235,170,610
Pennsylvania,Latrobe borough,8191,71,162,335,476,459,1503
Pennsylvania,Lattimer,714,48,9,0,8,16,81
Pennsylvania,Laureldale borough,3884,49,10,189,205,194,647
Pennsylvania,Laurel Mountain borough,208,5,1,7,9,9,31
Pennsylvania,Laurel Run borough,517,2,5,14,19,14,54
Pennsylvania,Lansford borough,3871,79,22,200,168,184,653
Pennsylvania,Laurelton,262,9,9,19,17,8,62
Pennsylvania,Lavelle,529,0,0,0,17,0,17
Pennsylvania,Lawnton,3794,44,35,143,190,151,563
Pennsylvania,Lawrence,343,12,0,13,0,13,38
Pennsylvania,Lawrence Park,3902,25,28,181,162,263,659
Pennsylvania,Lawrenceville borough,565,9,3,33,38,28,111
Pennsylvania,Lawson Heights,2192,0,21,90,84,63,258
Pennsylvania,Lebanon,25555,235,435,1588,1563,1524,5345
Pennsylvania,Laurys Station,1095,0,16,17,32,128,193
Pennsylvania,Lansdowne borough,10614,100,221,626,486,531,1964
Pennsylvania,Lansdale borough,16441,268,191,725,763,795,2742
Pennsylvania,Langhorne Manor borough,1494,19,3,52,35,39,148
Pennsylvania,Pitcairn borough,3270,54,9,150,112,180,505
Pennsylvania,Pittsburgh,305928,4384,2652,10377,10200,10542,38155
Pennsylvania,Pittston,7698,125,86,216,380,411,1218
Pennsylvania,Plainfield,338,0,0,21,6,22,49
Pennsylvania,Plains,3900,93,5,111,185,32,426
Pennsylvania,Platea borough,461,5,3,33,10,29,80
Pennsylvania,Pleasant Gap,2849,12,16,209,71,103,411
Pennsylvania,Pleasant Hill,2648,58,71,181,185,48,543
Pennsylvania,Pleasant Hills borough,8284,90,117,232,405,409,1253
Pennsylvania,Pleasant View,967,37,0,33,26,25,121
Pennsylvania,Pleasantville borough (Bedford County),208,4,2,6,9,5,26
Pennsylvania,Pleasantville borough (Venango County),866,26,2,60,50,42,180
Pennsylvania,Plum borough,27458,382,236,1461,1147,1458,4684
Pennsylvania,Plumsteadville,3256,27,0,262,411,443,1143
Pennsylvania,Plumville borough,305,8,1,27,14,11,61
Pennsylvania,Langeloth,608,7,14,13,0,15,49
Pennsylvania,Langhorne borough,1488,18,8,35,65,107,233
Pennsylvania,Nuremberg,423,3,3,18,25,44,93
Pennsylvania,Numidia,224,3,3,18,25,16,65
Pennsylvania,Oklahoma,1032,7,0,116,50,92,265
Pennsylvania,Noxen,678,11,0,21,23,41,96
Pennsylvania,Sugar Notch borough,944,14,20,25,40,45,144
Pennsylvania,Sugar Grove borough,554,6,12,42,28,27,115
Pennsylvania,Sugarcreek borough,5200,55,83,277,240,259,914
Pennsylvania,Sturgeon,1370,15,49,113,60,47,284
Pennsylvania,Stroudsburg borough,5516,35,96,282,263,246,922
Pennsylvania,Strong,18,0,0,0,0,0,0
Pennsylvania,Strodes Mills,535,15,4,30,13,0,62
Pennsylvania,Summerhill borough,451,9,6,12,14,18,59
Pennsylvania,Strausstown borough,270,0,3,7,14,16,40
Pennsylvania,Strasburg borough,2864,93,30,150,157,116,546
Pennsylvania,Stoystown borough,287,2,0,3,14,15,34
Pennsylvania,Stowe,3763,48,52,212,192,183,687
Pennsylvania,Stouchsburg,537,0,4,12,22,9,47
Pennsylvania,Stormstown,2410,42,51,160,165,182,600
Pennsylvania,Stony Creek Mills,841,8,7,30,50,66,161
Pennsylvania,Stonybrook,1999,58,15,49,99,84,305
Pennsylvania,Strattanville borough,720,2,15,33,45,55,150
Pennsylvania,Stonerstown,499,7,3,17,41,53,121
Pennsylvania,Summerville borough,511,0,0,27,20,10,57
Pennsylvania,Summit Station,163,0,0,0,0,0,0
Pennsylvania,Millville borough,942,9,6,40,80,36,171
Pennsylvania,Millwood,629,0,0,98,81,12,191
Pennsylvania,Milroy,1556,10,0,63,89,33,195
Pennsylvania,Milton borough,6993,112,141,365,152,325,1095
Pennsylvania,Minersville borough,4310,35,23,223,176,217,674
Pennsylvania,Mingoville,707,0,18,34,17,72,141
Pennsylvania,Mocanaqua,717,12,0,35,23,33,103
Pennsylvania,Summit Hill borough,2981,63,48,133,59,82,385
Pennsylvania,Modena borough,625,12,5,18,23,46,104
Pennsylvania,Swarthmore borough,6195,120,32,316,427,240,1135
Pennsylvania,Sutersville borough,610,9,10,35,21,27,102
Pennsylvania,Susquehanna Trails,2910,67,50,265,153,120,655
Pennsylvania,Susquehanna Depot borough,1558,18,14,82,92,49,255
Pennsylvania,Sun Valley,2261,10,16,115,181,132,454
Pennsylvania,Sunrise Lake,1625,0,0,38,176,43,257
Pennsylvania,Sunbury,9758,173,142,424,460,479,1678
Pennsylvania,Swartzville,2038,15,15,104,134,68,336
Pennsylvania,Mill Village borough,422,7,2,23,7,30,69
Pennsylvania,Stoneboro borough,1005,6,21,28,41,30,126
Pennsylvania,Stockdale borough,354,4,0,6,2,12,24
Pennsylvania,Foxburg borough,212,4,0,5,22,9,40
Pennsylvania,Fountain Springs,390,0,0,0,22,26,48
Pennsylvania,Fountain Hill borough,4614,56,33,119,187,213,608
Pennsylvania,Foundryville,108,0,0,0,0,0,0
Pennsylvania,Foster Brook,1052,8,42,19,65,69,203
Pennsylvania,Forty Fort borough,4170,88,21,234,214,125,682
Pennsylvania,Fort Washington,5931,109,42,246,439,392,1228
Pennsylvania,Fox Chapel borough,5413,198,71,426,333,576,1604
Pennsylvania,Fort Loudon,928,11,0,131,35,10,187
Pennsylvania,Forksville borough,97,0,0,0,0,2,2
Pennsylvania,Forestville,363,0,6,0,4,25,35
Pennsylvania,Forest Hills borough,6491,72,95,185,199,261,812
Pennsylvania,Forest City borough,2162,37,21,90,106,74,328
Pennsylvania,Ford Cliff borough,435,2,6,32,13,14,67
Pennsylvania,Ford City borough,2928,63,70,113,194,142,582
Pennsylvania,Force,273,0,10,9,11,10,40
Pennsylvania,Fort Indiantown Gap,39,0,0,0,0,0,0
Pennsylvania,Stockertown borough,1156,25,25,105,43,29,227
Pennsylvania,Fox Chase,1344,0,0,59,48,59,166
Pennsylvania,Frankfort Springs borough,102,0,1,7,3,2,13
Pennsylvania,Stillwater borough,199,1,0,10,4,15,30
Pennsylvania,Stiles,1099,0,0,73,30,89,192
Pennsylvania,Stewartstown borough,2126,56,16,89,141,58,360
Pennsylvania,Stevens,375,0,0,0,0,0,0
Pennsylvania,Steelton borough,5956,81,162,527,436,326,1532
Pennsylvania,State Line,2372,13,0,103,163,277,556
Pennsylvania,State College borough,42129,299,185,421,306,404,1615
Pennsylvania,Frackville borough,3757,89,30,351,133,168,771
Pennsylvania,Starrucca borough,223,1,6,3,10,8,28
Pennsylvania,Starbrick,498,21,0,36,8,0,65
Pennsylvania,Spry,4896,166,28,261,216,247,918
Pennsylvania,Fredericksburg CDP (Crawford County),771,0,0,62,17,0,79
Pennsylvania,Franklintown borough,527,0,10,27,41,29,107
Pennsylvania,Franklin Park borough,14062,179,203,854,1042,1225,3503
Pennsylvania,Franklin,6401,54,45,301,266,299,965
Pennsylvania,Franklin borough,299,0,1,9,8,3,21
Pennsylvania,Star Junction,455,0,0,21,6,14,41
Pennsylvania,Foot of Ten,791,8,9,21,50,28,116
Pennsylvania,Millvale borough,3721,16,59,224,191,86,576
Pennsylvania,Millheim borough,890,4,0,55,33,70,162
Pennsylvania,Sylvania borough,237,2,2,14,8,15,41
Pennsylvania,Sykesville borough,1131,16,26,40,38,40,160
Pennsylvania,Swoyersville borough,5025,86,0,268,84,184,622
Pennsylvania,Swissvale borough,8932,91,133,199,252,451,1126
Pennsylvania,Sweden Valley,200,0,4,20,3,3,30
Pennsylvania,Marion Heights borough,709,17,4,35,50,6,112
Pennsylvania,Marklesburg borough,250,2,4,9,33,7,55
Pennsylvania,Table Rock,56,0,0,8,5,0,13
Pennsylvania,Markleysburg borough,259,3,0,7,8,14,32
Pennsylvania,Mars borough,1276,11,12,44,39,72,178
Pennsylvania,Marshallton,1301,29,33,57,92,44,255
Pennsylvania,Martinsburg borough,1776,16,11,51,48,51,177
Pennsylvania,Martins Creek,504,0,0,0,0,16,16
Pennsylvania,Marysville borough,2525,58,18,123,56,71,326
Pennsylvania,Masontown borough,3416,14,75,242,193,180,704
Pennsylvania,Masthope,682,0,10,28,48,38,124
Pennsylvania,Marlin,491,11,4,23,27,23,88
Pennsylvania,Matamoras borough,2310,31,56,113,118,131,449
Pennsylvania,Tamaqua borough,6949,145,87,420,292,187,1131
Pennsylvania,Tatamy borough,992,34,19,46,55,53,207
Pennsylvania,Republic,1005,5,20,74,85,114,298
Pennsylvania,Revloc,660,15,17,29,25,12,98
Pennsylvania,Rew,67,0,0,0,0,17,17
Pennsylvania,Reynolds Heights,1858,0,0,29,106,152,287
Pennsylvania,Reynoldsville borough,2734,23,21,79,197,124,444
Pennsylvania,Rheems,1610,15,77,145,181,62,480
Pennsylvania,Thompsontown borough,794,1,11,23,41,35,111
Pennsylvania,Tarentum borough,4507,22,44,219,222,296,803
Pennsylvania,Thompson borough,343,0,3,12,22,38,75
Pennsylvania,Tharptown (Uniontown),495,19,0,18,0,5,42
Pennsylvania,Nuangola borough,778,11,5,32,51,31,130
Pennsylvania,Templeton,310,1,7,11,16,32,67
Pennsylvania,Temple,1487,120,6,16,77,30,249
Pennsylvania,Telford borough,4881,150,33,138,267,221,809
Pennsylvania,Taylorstown,151,3,0,9,14,14,40
Pennsylvania,Taylor borough,6176,104,15,187,375,177,858
Pennsylvania,The Hideout,2662,0,18,139,80,137,374
Pennsylvania,Millsboro,542,0,18,23,33,23,97
Pennsylvania,Mather,505,0,5,37,35,15,92
Pennsylvania,Mayfield borough,1764,12,22,121,79,90,324
Pennsylvania,Midway,1880,38,12,64,29,74,217
Pennsylvania,Midway borough,886,0,17,61,48,71,197
Pennsylvania,Mifflin borough,626,2,5,47,20,27,101
Pennsylvania,Mifflinburg borough,3530,14,35,121,262,208,640
Pennsylvania,Mifflintown borough,1084,40,17,70,79,82,288
Pennsylvania,Mifflinville,1377,21,41,49,11,11,133
Pennsylvania,Milesburg borough,855,10,3,41,40,32,126
Pennsylvania,Midland borough,2589,79,37,281,99,71,567
Pennsylvania,Milford borough,1067,5,25,36,49,11,126
Pennsylvania,Millbourne borough,1155,10,17,66,69,70,232
Pennsylvania,Mill Creek borough,373,9,3,19,14,28,73
Pennsylvania,Millersburg borough,2544,24,36,103,162,197,522
Pennsylvania,Millerstown borough,741,8,8,23,54,60,153
Pennsylvania,Millersville borough,8358,25,29,237,149,266,706
Pennsylvania,Millerton,347,3,4,15,14,16,52
Pennsylvania,Mill Hall borough,1565,0,6,66,91,119,282
Pennsylvania,Milford Square,1115,19,0,44,84,37,184
Pennsylvania,Mattawana,399,0,5,36,13,24,78
Pennsylvania,Middletown,7380,45,44,243,396,423,1151
Pennsylvania,Middleport borough,399,1,2,1,12,9,25
Pennsylvania,Maytown,4095,107,48,226,429,239,1049
Pennsylvania,Meadowlands,999,0,0,88,34,0,122
Pennsylvania,Meadowood,2620,42,45,116,33,56,292
Pennsylvania,Meadville,13224,154,104,510,685,594,2047
Pennsylvania,Mechanicsburg borough,8984,124,88,311,492,296,1311
Pennsylvania,Mechanicsville borough,496,8,3,12,17,9,49
Pennsylvania,Media borough,5336,87,45,143,117,219,611
Pennsylvania,Middletown borough,8942,114,100,380,373,486,1453
Pennsylvania,Mercer borough,1964,9,40,108,75,148,380
Pennsylvania,Meridian,3605,94,33,173,182,184,666
Pennsylvania,Mertztown,838,0,44,20,23,23,110
Pennsylvania,Meshoppen borough,450,20,6,45,15,4,90
Pennsylvania,Messiah College,2371,0,0,0,0,0,0
Pennsylvania,Mexico,308,0,0,0,0,6,6
Pennsylvania,Meyersdale borough,1933,33,17,99,100,57,306
Pennsylvania,Middleburg borough,1408,20,21,89,61,71,262
Pennsylvania,Mercersburg borough,1417,13,11,78,70,44,216
Pennsylvania,Renovo borough,1229,44,20,69,46,71,250
Pennsylvania,Folsom,8163,135,93,555,384,309,1476
Pennsylvania,Flying Hills,2356,12,16,80,47,98,253
Pennsylvania,Etna borough,3432,18,81,192,129,170,590
Pennsylvania,Espy,1735,66,0,61,109,105,341
Pennsylvania,Ernest borough,355,10,8,17,28,8,71
Pennsylvania,Erie,100678,1522,1449,5091,4842,5033,17937
Pennsylvania,Ephrata borough,13617,230,183,613,699,481,2206
Pennsylvania,Enon Valley borough,359,9,1,17,12,28,67
Pennsylvania,Enola,6235,36,16,287,446,368,1153
Pennsylvania,Evansburg,2371,81,12,162,193,150,598
Pennsylvania,Enlow,1247,0,18,45,152,10,225
Pennsylvania,Englewood,720,0,71,0,96,45,212
Pennsylvania,Emsworth borough,2429,28,21,95,157,126,427
Pennsylvania,Emporium borough,1917,24,8,90,55,63,240
Pennsylvania,Emmaus borough,11342,187,67,386,503,525,1668
Pennsylvania,Emlenton borough,706,12,23,13,58,49,155
Pennsylvania,Emigsville,2933,32,39,217,75,133,496
Pennsylvania,Emerald Lakes,3822,35,38,313,221,315,922
Pennsylvania,Enhaut,877,0,0,18,82,35,135
Pennsylvania,Elysburg,1892,10,0,103,104,49,266
Pennsylvania,Evans City borough,1760,50,17,69,76,68,280
Pennsylvania,Everson borough,736,2,0,33,49,29,113
Pennsylvania,Sligo borough,620,8,6,31,30,12,87
Pennsylvania,Slickville,313,0,0,4,0,0,4
Pennsylvania,Slatington borough,4263,26,66,209,200,290,791
Pennsylvania,Slatedale,612,13,0,33,40,60,146
Pennsylvania,Slabtown,115,2,0,5,4,2,13
Pennsylvania,Skyline View,3895,15,0,232,204,354,805
Pennsylvania,Skippack,3977,193,62,287,295,171,1008
Pennsylvania,Everett borough,1769,23,4,92,74,99,292
Pennsylvania,Sinking Spring borough,4042,70,67,216,267,276,896
Pennsylvania,Silverdale borough,923,8,8,37,56,60,169
Pennsylvania,Silkworth,979,28,9,65,24,48,174
Pennsylvania,Siglerville,97,0,0,0,0,0,0
Pennsylvania,Sierra View,5088,95,79,249,402,493,1318
Pennsylvania,Sidman,556,0,13,25,81,35,154
Pennsylvania,Export borough,990,25,7,55,71,29,187
Pennsylvania,Exeter borough,5625,74,51,322,240,223,910
Pennsylvania,Simpson,1267,36,0,32,77,11,156
Pennsylvania,Slippery Rock borough,3633,34,36,37,67,41,215
Pennsylvania,Elverson borough,1353,12,12,51,49,69,193
Pennsylvania,Ellwood City borough,7836,114,73,293,333,468,1281
Pennsylvania,Edgewood borough,3093,30,46,64,91,93,324
Pennsylvania,Edenburg,803,12,7,15,71,42,147
Pennsylvania,Edenborn,226,20,0,0,0,17,37
Pennsylvania,Eddystone borough,2521,46,51,128,227,125,577
Pennsylvania,Eddington,1937,25,29,98,206,111,469
Pennsylvania,Economy borough,9189,197,138,279,439,369,1422
Pennsylvania,Ebensburg borough,3265,33,38,171,103,158,503
Pennsylvania,Edgewood,2232,41,0,104,46,80,271
Pennsylvania,Eau Claire borough,353,6,1,7,13,38,65
Pennsylvania,East Waterford,178,0,4,21,3,3,31
Pennsylvania,East Washington borough,2244,28,0,92,91,51,262
Pennsylvania,East Vandergrift borough,742,23,6,10,20,46,105
Pennsylvania,Eastvale borough,237,0,0,10,27,10,47
Pennsylvania,East Uniontown,2532,15,0,98,33,126,272
Pennsylvania,East Stroudsburg borough,9967,94,148,402,407,499,1550
Pennsylvania,East Side borough,247,1,1,3,6,7,18
Pennsylvania,East York,8247,123,107,388,334,329,1281
Pennsylvania,Elrama,290,0,14,21,31,14,80
Pennsylvania,Edgeworth borough,1657,51,36,106,109,132,434
Pennsylvania,Edinboro borough,6443,16,84,218,92,181,591
Pennsylvania,Ellsworth borough,741,23,11,30,38,41,143
Pennsylvania,Ellport borough,1108,5,10,48,56,78,197
Pennsylvania,Elkland borough,1928,36,28,76,88,84,312
Pennsylvania,Elizabethville borough,1736,17,7,100,85,65,274
Pennsylvania,Elizabethtown borough,11591,220,78,355,480,475,1608
Pennsylvania,Elizabeth borough,1391,16,15,77,46,76,230
Pennsylvania,Elim,3760,11,25,89,108,223,456
Pennsylvania,Edie,44,0,0,0,0,0,0
Pennsylvania,Elgin borough,168,4,0,4,8,16,32
Pennsylvania,Elderton borough,342,4,0,11,8,23,46
Pennsylvania,Elco borough,303,7,4,17,18,6,52
Pennsylvania,Eighty Four,764,5,12,53,29,34,133
Pennsylvania,Ehrenfeld borough,211,1,1,11,10,13,36
Pennsylvania,Egypt,2512,0,13,154,100,60,327
Pennsylvania,Effort,2312,123,0,176,167,89,555
Pennsylvania,Edwardsville borough,4773,27,57,222,334,281,921
Pennsylvania,Eldred borough,648,10,8,40,28,22,108
Pennsylvania,Folcroft borough,6630,181,86,354,260,298,1179
Pennsylvania,Slippery Rock University,2138,0,0,0,0,0,0
Pennsylvania,Smethport borough,1587,23,22,74,57,68,244
Pennsylvania,Fallston borough,217,1,0,4,8,14,27
Pennsylvania,Falls Creek borough,1160,22,9,65,72,62,230
Pennsylvania,Fairview-Ferndale,1689,10,18,58,46,64,196
Pennsylvania,Fairview,2668,53,10,193,74,110,440
Pennsylvania,Fairview borough,200,3,7,16,18,17,61
Pennsylvania,Fairless Hills,8789,120,98,394,383,481,1476
Pennsylvania,Fairhope,1258,0,20,19,34,21,94
Pennsylvania,Falmouth,269,10,0,18,0,0,28
Pennsylvania,Fairfield borough,543,0,4,24,14,27,69
Pennsylvania,Fairchance borough,1820,21,8,68,74,122,293
Pennsylvania,Factoryville borough,1119,20,17,38,23,37,135
Pennsylvania,Eyers Grove,82,0,0,4,0,5,9
Pennsylvania,Exton,4772,130,50,210,151,234,775
Pennsylvania,Spring Ridge,844,0,0,0,58,18,76
Pennsylvania,Spring Mount,2361,60,53,88,99,47,347
Pennsylvania,Springmont,620,45,0,53,52,0,150
Pennsylvania,Fairdale,1772,46,15,69,84,97,311
Pennsylvania,Spring Mills,268,5,0,0,0,13,18
Pennsylvania,Farmersville,945,0,15,16,40,73,144
Pennsylvania,Farrell,4852,80,61,249,340,384,1114
Pennsylvania,Flourtown,4845,81,72,287,363,156,959
Pennsylvania,Flora Dale,26,0,0,0,0,0,0
Pennsylvania,Flemington borough,1342,20,8,45,48,64,185
Pennsylvania,Fleetwood borough,4082,30,37,203,256,174,700
Pennsylvania,Fivepointville,1380,0,0,96,76,16,188
Pennsylvania,Finleyville borough,434,7,2,5,11,8,33
Pennsylvania,Fernville,496,0,4,29,41,17,91
Pennsylvania,Farmington,867,22,0,24,83,15,144
Pennsylvania,Ferndale borough,1578,21,17,71,77,97,283
Pennsylvania,Fellsburg,1107,9,0,31,0,31,71
Pennsylvania,Feasterville,3349,16,66,112,117,121,432
Pennsylvania,Fayetteville,3007,0,0,107,237,170,514
Pennsylvania,Fayette City borough,567,12,10,53,21,81,177
Pennsylvania,Faxon,1264,17,10,75,34,32,168
Pennsylvania,Fawn Lake Forest,523,19,0,10,44,0,73
Pennsylvania,Fawn Grove borough,427,8,7,20,20,23,78
Pennsylvania,Felton borough,603,8,11,32,51,38,140
Pennsylvania,Slovan,461,0,0,38,26,16,80
Pennsylvania,Spring House,3541,93,30,92,130,349,694
Pennsylvania,Spring Grove borough,2308,29,31,141,78,189,468
Pennsylvania,South Fork borough,960,18,12,45,54,44,173
Pennsylvania,South Connellsville borough,1819,37,17,64,34,55,207
Pennsylvania,South Coatesville borough,1408,19,18,45,95,66,243
Pennsylvania,South Bethlehem borough,446,6,11,19,21,11,68
Pennsylvania,Souderton borough,6697,110,92,428,276,299,1205
Pennsylvania,Soudersburg,414,0,0,9,0,0,9
Pennsylvania,Somerset borough,6127,82,111,350,200,199,942
Pennsylvania,South Greensburg borough,2067,35,21,43,86,75,260
Pennsylvania,Snydertown borough,335,2,0,5,17,10,34
Pennsylvania,S.N.P.J. borough,18,0,0,0,0,0,0
Pennsylvania,Snow Shoe borough,905,10,14,56,64,69,213
Pennsylvania,Smoketown,395,0,0,12,12,0,24
Pennsylvania,Smock,543,17,0,24,34,11,86
Pennsylvania,Smithton borough,409,6,8,25,26,13,78
Pennsylvania,Smithfield borough,1017,15,21,64,54,39,193
Pennsylvania,Smicksburg borough,41,0,2,2,0,0,4
Pennsylvania,Snydertown,341,19,0,33,16,4,72
Pennsylvania,Spring Hill,891,0,20,83,37,80,220
Pennsylvania,South Heights borough,449,0,3,30,11,5,49
Pennsylvania,South New Castle borough,742,7,2,37,45,50,141
Pennsylvania,Springdale borough,3407,43,49,136,138,116,482
Pennsylvania,Spring City borough,3331,68,7,129,162,197,563
Pennsylvania,Springboro borough,425,4,4,25,24,40,97
Pennsylvania,Spinnerstown,1941,58,20,147,159,105,489
Pennsylvania,Speers borough,1163,25,9,22,39,34,129
Pennsylvania,Spartansburg borough,281,6,0,17,11,6,40
Pennsylvania,South Williamsport borough,6354,76,140,299,317,418,1250
Pennsylvania,Southmont borough,2204,39,42,96,103,90,370
Pennsylvania,Southwest Greensburg borough,2021,55,23,93,57,56,284
Pennsylvania,Southview,110,0,0,0,0,3,3
Pennsylvania,South Uniontown,1200,25,17,36,50,63,191
Pennsylvania,South Temple,1635,17,19,126,69,59,290
Pennsylvania,South Renovo borough,422,7,2,23,15,15,62
Pennsylvania,South Pottstown,1924,26,39,131,114,63,373
Pennsylvania,South Philipsburg,336,0,0,22,9,14,45
Pennsylvania,South Park Township,13504,153,187,591,798,736,2465
Pennsylvania,South Waverly borough,1217,6,27,62,43,36,174
Pennsylvania,Renningers,511,18,0,20,36,31,105
Pennsylvania,Terre Hill borough,1492,16,35,76,107,77,311
Pennsylvania,Reinholds,1914,13,12,41,150,280,496
Pennsylvania,Chevy Chase Heights,1626,8,12,97,35,80,232
Pennsylvania,Chewton,444,0,4,17,12,41,74
Pennsylvania,Cheyney University,866,0,0,0,0,0,0
Pennsylvania,Chicora borough,942,7,8,71,33,46,165
Pennsylvania,Chinchilla,2182,35,11,102,106,139,393
Pennsylvania,Christiana borough,962,14,14,37,39,37,141
Pennsylvania,Church Hill,1415,15,6,15,58,87,181
Pennsylvania,Cheswick borough,1758,23,15,57,67,49,211
Pennsylvania,Churchill borough,3009,23,57,165,78,88,411
Pennsylvania,Churchville,3855,114,21,259,195,272,861
Pennsylvania,Clairton,6752,68,68,226,248,287,897
Pennsylvania,Clarence,625,9,5,31,46,30,121
Pennsylvania,Clarendon borough,506,13,2,32,38,31,116
Pennsylvania,Clarion borough,5298,71,0,133,129,100,433
Pennsylvania,Clark borough,535,16,9,5,14,10,54
Pennsylvania,Clarks Green borough,1450,25,21,65,73,49,233
Pennsylvania,Churchtown,418,0,48,0,63,24,135
Pennsylvania,Clarks Summit borough,5067,119,32,264,217,143,775
Pennsylvania,Chest Springs borough,196,4,6,8,12,24,54
Pennsylvania,Chester Heights borough,2573,47,76,112,140,138,513
Pennsylvania,Central City borough,1018,11,0,29,64,48,152
Pennsylvania,Centralia borough,11,0,0,0,0,0,0
Pennsylvania,Centre Hall borough,1244,12,12,46,91,72,233
Pennsylvania,Cetronia,1684,6,0,0,7,92,105
Pennsylvania,Chalfant borough,897,6,22,24,19,8,79
Pennsylvania,Chalfont borough,4054,62,56,256,298,212,884
Pennsylvania,Chalkhill,153,0,0,0,0,14,14
Pennsylvania,Chester Hill borough,909,19,8,52,51,32,162
Pennsylvania,Chambersburg borough,20519,118,372,1236,874,985,3585
Pennsylvania,Charleroi borough,4062,98,107,188,231,172,796
Pennsylvania,Chase,833,17,8,36,33,63,157
Pennsylvania,Cherry Tree borough,409,10,9,23,23,21,86
Pennsylvania,Cherry Valley borough,53,2,0,8,0,0,10
Pennsylvania,Cherryville,1444,0,0,5,62,50,117
Pennsylvania,Chester,34016,519,642,1847,1841,1892,6741
Pennsylvania,Chesterbrook,4478,224,22,156,77,67,546
Pennsylvania,Chapman borough,172,1,0,8,4,11,24
Pennsylvania,Centerville borough (Washington County),3221,55,47,118,115,164,499
Pennsylvania,Clarksville borough,201,6,0,8,7,13,34
Pennsylvania,Claysburg,1881,13,64,172,52,76,377
Pennsylvania,Pocono Ranch Lands,1073,14,41,46,78,98,277
Pennsylvania,Pocono Springs,1080,9,10,17,55,30,121
Pennsylvania,Pocono Woodland Lakes,3019,36,39,332,309,137,853
Pennsylvania,Point Marion borough,998,4,6,13,44,44,111
Pennsylvania,Polk borough,745,7,0,39,35,24,105
Pennsylvania,Rennerdale,766,11,11,25,26,47,120
Pennsylvania,Portage borough,2561,35,23,142,118,122,440
Pennsylvania,Collinsburg,1128,0,0,33,0,139,172
Pennsylvania,Port Allegany borough,2096,75,38,148,117,105,483
Pennsylvania,Valley View CDP (Schuylkill County),1458,22,11,75,10,50,168
Pennsylvania,Valley-Hi borough,6,0,0,0,0,0,0
Pennsylvania,Valley Green,4171,52,46,181,328,350,957
Pennsylvania,Valencia borough,553,2,0,9,7,18,36
Pennsylvania,Utica borough,166,1,7,7,14,9,38
Pennsylvania,Ursina borough,267,0,6,15,13,10,44
Pennsylvania,Upper St. Clair,19385,440,218,1318,1209,1188,4373
Pennsylvania,Valley View CDP (York County),2547,56,54,74,182,133,499
Pennsylvania,Clay,1976,18,78,66,168,97,427
Pennsylvania,Collingdale borough,8786,120,118,490,728,503,1959
Pennsylvania,Cokeburg borough,588,5,0,21,33,14,73
Pennsylvania,Claysville borough,1035,6,9,55,60,73,203
Pennsylvania,Clearfield borough,6106,125,33,233,302,307,1000
Pennsylvania,Cleona borough,2125,9,37,73,63,119,301
Pennsylvania,Clifton Heights borough,6658,151,55,375,413,392,1386
Pennsylvania,Clinton,524,0,0,39,0,63,102
Pennsylvania,Clintonville borough,435,8,10,15,42,9,84
Pennsylvania,Clymer borough,1237,38,24,45,55,56,218
Pennsylvania,Collegeville borough,5296,86,100,157,181,211,735
Pennsylvania,Coal Center borough,83,0,4,8,0,2,14
Pennsylvania,Coaldale borough (Schuylkill County),2222,20,21,73,143,110,367
Pennsylvania,Coalmont borough,127,1,1,8,3,5,18
Pennsylvania,Coalport borough,495,15,9,14,33,27,98
Pennsylvania,Coatesville,13152,301,298,773,806,847,3025
Pennsylvania,Coburn,142,0,0,13,24,3,40
Pennsylvania,Cochranton borough,1303,11,23,103,124,102,363
Pennsylvania,Cochranville,657,6,0,40,28,27,101
Pennsylvania,Coaldale borough (Bedford County),159,4,5,9,7,4,29
Pennsylvania,Upper Exeter,629,0,5,12,20,27,64
Pennsylvania,Bentleyville borough,2554,51,56,146,123,103,479
Pennsylvania,Berlin borough,1922,13,0,65,105,111,294
Pennsylvania,Breinigsville,5018,114,37,406,334,448,1339
Pennsylvania,Brave,189,0,3,20,3,15,41
Pennsylvania,Brandonville,220,0,4,12,11,17,44
Pennsylvania,Branchdale,434,7,0,32,6,15,60
Pennsylvania,Bradford Woods borough,1202,30,17,60,48,38,193
Pennsylvania,Bradford,8608,80,102,374,442,439,1437
Pennsylvania,Bradenville,767,0,8,73,116,63,260
Pennsylvania,Brentwood borough,9598,107,87,445,482,519,1640
Pennsylvania,Braddock Hills borough,1733,9,0,73,71,48,201
Pennsylvania,Brackenridge borough,3244,35,0,143,177,156,511
Pennsylvania,Boyertown borough,4053,32,96,154,267,278,827
Pennsylvania,Bowmansville,2082,33,20,37,198,181,469
Pennsylvania,Bowmanstown borough,1119,6,24,39,66,39,174
Pennsylvania,Bowers,240,0,0,3,6,0,9
Pennsylvania,Boswell borough,1282,8,10,61,58,48,185
Pennsylvania,Boston,374,0,18,0,0,0,18
Pennsylvania,Braddock borough,1989,6,48,118,49,104,325
Pennsylvania,Boothwyn,5345,81,29,162,266,209,747
Pennsylvania,Bressler,1307,0,30,117,14,21,182
Pennsylvania,Brickerville,1533,7,33,126,77,86,329
Pennsylvania,Norwood borough,5897,43,112,241,261,349,1006
Pennsylvania,Norvelt,1173,9,0,39,17,32,97
Pennsylvania,North York borough,1671,21,8,54,74,104,261
Pennsylvania,Northwood,386,0,8,16,0,60,84
Pennsylvania,Northwest Harborcreek,9216,76,144,596,484,415,1715
Pennsylvania,North Warren,1780,36,5,68,24,63,196
Pennsylvania,North Wales borough,3248,104,97,119,113,142,575
Pennsylvania,Briar Creek borough,704,0,11,16,27,33,87
Pennsylvania,North Vandergrift,426,6,0,8,0,13,27
Pennsylvania,North Philipsburg,778,11,0,14,36,5,66
Pennsylvania,North Irwin borough,801,18,10,46,28,45,147
Pennsylvania,Northern Cambria borough,3716,57,49,157,195,207,665
Pennsylvania,North East borough,4229,80,103,208,214,178,783
Pennsylvania,North Charleroi borough,1305,19,5,43,65,58,190
Pennsylvania,North Catasauqua borough,2833,43,37,102,135,116,433
Pennsylvania,North Braddock borough,4829,151,45,266,234,215,911
Pennsylvania,Northumberland borough,3756,70,36,140,87,139,472
Pennsylvania,Benton borough,1087,22,12,79,112,82,307
Pennsylvania,Bonneauville borough,1881,74,36,118,81,113,422
Pennsylvania,Boiling Springs,2929,50,15,56,123,326,570
Pennsylvania,Birchwood Lakes,1570,9,14,27,112,232,394
Pennsylvania,Big Run borough,605,22,3,39,30,27,121
Pennsylvania,Biglerville borough,1195,7,12,72,61,43,195
Pennsylvania,Bigler,464,14,16,17,27,15,89
Pennsylvania,Big Beaver borough,1918,19,0,39,104,71,233
Pennsylvania,Big Bass Lake,1453,30,6,48,91,77,252
Pennsylvania,Beurys Lake,122,2,0,0,0,2,4
Pennsylvania,Bird-in-Hand,616,0,2,57,47,91,197
Pennsylvania,Bethlehem,75004,769,860,2506,3486,3364,10985
Pennsylvania,Bethel,736,0,0,33,0,0,33
Pennsylvania,Bethany borough,227,0,2,3,9,12,26
Pennsylvania,Bessemer borough,1186,14,14,29,88,50,195
Pennsylvania,Berwyn,3113,51,54,297,209,146,757
Pennsylvania,Berwick borough,10328,101,60,440,605,571,1777
Pennsylvania,Berrysburg borough,377,0,0,20,15,37,72
Pennsylvania,Bernville borough,814,5,16,29,24,44,118
Pennsylvania,Bethel Park municipal,32322,425,375,1463,1660,1510,5433
Pennsylvania,Bolivar borough,440,8,7,27,19,24,85
Pennsylvania,Birdsboro borough,5155,87,38,237,324,293,979
Pennsylvania,Black Lick,1523,76,55,48,74,6,259
Pennsylvania,Bobtown,778,12,11,10,18,36,87
Pennsylvania,Boalsburg,4017,84,7,163,344,254,852
Pennsylvania,Blue Ridge Summit,994,10,0,15,33,96,154
Pennsylvania,Blue Bell,5985,60,44,225,297,326,952
Pennsylvania,Blue Ball,1056,0,0,0,121,48,169
Pennsylvania,Blossburg borough,1568,17,8,81,77,111,294
Pennsylvania,Bloomsburg,14631,103,69,365,258,271,1066
Pennsylvania,Birmingham borough,109,5,2,0,6,6,19
Pennsylvania,Blooming Valley borough,331,1,3,11,6,15,36
Pennsylvania,Blawnox borough,1570,32,37,63,77,21,230
Pennsylvania,Blandon,7231,63,132,404,616,397,1612
Pennsylvania,Blandburg,369,4,3,25,29,42,103
Pennsylvania,Blanchard,693,4,15,28,30,23,100
Pennsylvania,Blakely borough,6496,159,27,148,44,309,687
Pennsylvania,Blairsville borough,3356,13,63,215,113,158,562
Pennsylvania,Blain borough,276,2,3,26,21,18,70
Pennsylvania,Bloomfield borough,1347,17,35,89,47,38,226
Pennsylvania,Upland borough,3234,43,123,186,246,180,778
Pennsylvania,Pomeroy,245,0,0,0,0,0,0
Pennsylvania,Unionville borough,221,11,0,11,9,11,42
Pennsylvania,Friendsville borough,147,0,1,9,7,13,30
Pennsylvania,Friedensburg,833,16,21,36,0,37,110
Pennsylvania,Friedens,1758,29,25,85,109,95,343
Pennsylvania,Freeport borough,1790,9,13,89,146,109,366
Pennsylvania,Freemansburg borough,2618,39,25,94,161,167,486
Pennsylvania,Freeland borough,3498,55,93,197,205,118,668
Pennsylvania,Freedom borough,1621,52,51,113,72,71,359
Pennsylvania,Frizzleburg,613,0,0,0,26,0,26
Pennsylvania,Freeburg borough,639,10,4,38,25,35,112
Pennsylvania,Fredericktown,504,0,0,0,36,49,85
Pennsylvania,Fredericksburg CDP (Lebanon County),1374,16,63,87,44,18,228
Pennsylvania,Port Carbon borough,1779,15,10,105,82,52,264
Pennsylvania,Port Clinton borough,210,0,3,11,9,9,32
Pennsylvania,Portersville borough,267,14,0,10,18,2,44
Pennsylvania,Portland borough,431,4,0,10,23,12,49
Pennsylvania,Port Matilda borough,698,14,0,30,44,35,123
Pennsylvania,Fredonia borough,526,0,14,20,30,27,91
Pennsylvania,Port Royal borough,861,18,2,49,73,21,163
Pennsylvania,Frystown,258,0,0,0,37,0,37
Pennsylvania,Galeton borough,1241,21,23,52,56,52,204
Pennsylvania,Girard borough,3054,31,46,140,158,43,418
Pennsylvania,Gilberton borough,799,8,0,56,50,27,141
Pennsylvania,Gibsonia,2801,63,0,264,210,78,615
Pennsylvania,Gibraltar,682,15,0,0,0,10,25
Pennsylvania,Gettysburg borough,7615,115,37,267,277,180,876
Pennsylvania,Georgetown CDP (Luzerne County),1782,30,65,70,19,98,282
Pennsylvania,Georgetown CDP (Lancaster County),986,4,22,68,32,37,163
Pennsylvania,Fullerton,15662,128,232,1030,916,753,3059
Pennsylvania,Georgetown borough,164,2,4,11,11,10,38
Pennsylvania,Geistown borough,2368,45,10,136,100,105,396
Pennsylvania,University of Pittsburgh Johnstown,1523,0,0,0,0,0,0
Pennsylvania,Garrett borough,414,5,11,16,33,17,82
Pennsylvania,Gardners,214,0,0,8,0,10,18
Pennsylvania,Garden View,2504,22,0,111,113,116,362
Pennsylvania,Gap,1865,46,8,160,50,104,368
Pennsylvania,Gallitzin borough,1495,21,9,88,75,39,232
Pennsylvania,Geneva,154,0,2,2,6,14,24
Pennsylvania,Girardville borough,1298,16,8,82,48,72,226
Pennsylvania,Port Trevorton,725,11,22,43,53,55,184
Pennsylvania,Potlicker Flats,152,0,0,6,10,0,16
Pennsylvania,Ramey borough,434,2,3,31,24,24,84
Pennsylvania,Rankin borough,2190,25,78,64,160,116,443
Pennsylvania,Ranshaw,401,7,0,5,0,13,25
Pennsylvania,Raubsville,935,14,0,17,30,105,166
Pennsylvania,Rauchtown,649,7,5,24,25,38,99
Pennsylvania,Ravine,598,0,9,9,9,48,75
Pennsylvania,Reading,88057,1199,1161,6313,5948,5795,20416
Pennsylvania,Ramblewood,1110,64,23,0,10,39,136
Pennsylvania,Reamstown,3666,35,53,218,127,95,528
Pennsylvania,Red Hill borough,2508,21,24,120,65,117,347
Pennsylvania,Red Lion borough,6332,35,172,360,214,395,1176
Pennsylvania,Reedsville,499,0,7,7,18,65,97
Pennsylvania,Refton,153,0,0,7,0,30,37
Pennsylvania,Rehrersburg,381,0,19,26,38,32,115
Pennsylvania,Reiffton,5028,48,132,168,325,369,1042
Pennsylvania,Reinerton,370,5,6,9,9,18,47
Pennsylvania,Rebersburg,500,0,10,13,29,31,83
Pennsylvania,Port Vue borough,3785,105,54,118,168,130,575
Pennsylvania,Rainsburg borough,138,2,7,15,2,7,33
Pennsylvania,Quentin,459,8,0,34,22,19,83
Pennsylvania,Pottsgrove,3344,34,41,109,133,148,465
Pennsylvania,Pottstown borough,22586,553,269,1184,1025,1068,4099
Pennsylvania,Pottsville,14025,83,133,762,674,859,2511
Pennsylvania,Pringle borough,956,6,19,12,40,40,117
Pennsylvania,Progress,9294,233,61,201,534,554,1583
Pennsylvania,Prompton borough,272,7,9,3,12,21,52
Pennsylvania,Prospect borough,1258,14,31,69,57,44,215
Pennsylvania,Railroad borough,222,1,2,9,12,12,36
Pennsylvania,Prospect Park,277,0,0,4,0,28,32
Pennsylvania,Punxsutawney borough,5899,57,76,125,229,276,763
Pennsylvania,Pymatuning Central,2223,38,14,65,78,93,288
Pennsylvania,Pymatuning North,276,0,0,8,0,24,32
Pennsylvania,Pymatuning South,450,18,6,16,11,20,71
Pennsylvania,Quakertown borough,8917,118,107,418,382,445,1470
Pennsylvania,Quarryville borough,2687,64,39,181,189,103,576
Pennsylvania,Queens Gate,1328,0,0,44,0,44,88
Pennsylvania,Prospect Park borough,6468,86,41,315,279,488,1209
Pennsylvania,Glasgow borough,76,1,0,5,1,4,11
Pennsylvania,Gastonville,2740,28,10,86,108,136,368
Pennsylvania,Glenburn,905,19,11,35,68,64,197
Pennsylvania,Troutville borough,186,3,0,3,3,7,16
Pennsylvania,Trooper,5959,123,98,273,305,434,1233
Pennsylvania,Trexlertown,2251,96,15,225,18,37,391
Pennsylvania,Trevose,3516,102,88,161,122,278,751
Pennsylvania,Trevorton,1494,0,4,86,82,62,234
Pennsylvania,Glassport borough,4454,70,13,160,122,244,609
Pennsylvania,Tremont borough,1807,34,45,78,69,58,284
Pennsylvania,Troxelville,254,0,2,18,14,43,77
Pennsylvania,Treasure Lake,3621,15,115,115,288,252,785
Pennsylvania,Trainer borough,1805,22,56,149,169,116,512
Pennsylvania,Trafford borough,3335,47,31,142,171,100,491
Pennsylvania,Townville borough,379,0,4,24,22,21,71
Pennsylvania,Tower City borough,1283,11,26,57,44,69,207
Pennsylvania,Towanda borough,2878,32,71,137,127,171,538
Pennsylvania,Towamensing Trails,1889,48,0,105,50,200,403
Pennsylvania,Toughkenamon,1797,45,8,26,169,109,357
Pennsylvania,Trappe borough,3550,78,26,247,216,216,783
Pennsylvania,Topton borough,2119,37,10,89,105,108,349
Pennsylvania,Troy borough,1505,11,11,79,67,85,253
Pennsylvania,Trumbauersville borough,1016,7,16,51,46,37,157
Pennsylvania,Unionville,1108,68,12,22,46,3,151
Pennsylvania,Uniontown,10150,108,84,303,436,439,1370
Pennsylvania,Union Deposit,604,16,12,45,26,26,125
Pennsylvania,Union Dale borough,267,0,0,9,9,16,34
Pennsylvania,Union City borough,3252,63,85,114,184,127,573
Pennsylvania,Ulysses borough,635,5,5,23,30,46,109
Pennsylvania,Tyrone borough,5415,90,91,242,226,168,817
Pennsylvania,Trucksville,2108,12,9,91,104,105,321
Pennsylvania,Tylersburg,82,0,0,0,0,5,5
Pennsylvania,Twilight borough,201,5,2,14,10,5,36
Pennsylvania,Tuscarora,1022,25,16,62,37,9,149
Pennsylvania,Turtle Creek borough,5324,107,92,227,338,301,1065
Pennsylvania,Turbotville borough,654,14,13,50,25,28,130
Pennsylvania,Tunnelhill borough,368,8,4,15,5,18,50
Pennsylvania,Tunkhannock borough,1906,30,5,60,103,140,338
Pennsylvania,Tullytown borough,1857,28,16,78,60,114,296
Pennsylvania,Tyler Run,1521,0,0,73,90,40,203
Pennsylvania,Toftrees,2875,0,0,0,0,0,0
Pennsylvania,Tresckow,890,29,0,11,35,21,96
Pennsylvania,Tipton,908,0,0,26,62,49,137
Pennsylvania,Gouglersville,534,6,0,16,12,27,61
Pennsylvania,Gordonville,428,0,0,0,6,0,6
Pennsylvania,Gordon borough,865,36,12,68,26,28,170
Pennsylvania,Goodville,835,16,0,86,140,54,296
Pennsylvania,Goldsboro borough,1003,27,20,73,57,58,235
Pennsylvania,Gold Key Lake,1794,0,34,67,129,111,341
Pennsylvania,Glenside,7667,196,31,300,504,422,1453
Pennsylvania,Gouldsboro,641,5,0,3,28,61,97
Pennsylvania,Glenshaw,8773,108,73,279,288,345,1093
Pennsylvania,Glen Osborne borough,582,24,5,38,22,40,129
Pennsylvania,Titusville,5438,54,124,192,272,171,813
Pennsylvania,Glen Lyon,1732,57,39,104,168,18,386
Pennsylvania,Glen Hope borough,149,0,0,7,5,0,12
Pennsylvania,Glenfield borough,197,9,5,15,7,7,43
Pennsylvania,Glendon borough,424,0,1,31,18,14,64
Pennsylvania,Glen Campbell borough,227,11,2,22,4,9,48
Pennsylvania,Glen Rock borough,1863,41,11,113,93,105,363
Pennsylvania,Graceton,161,6,0,6,0,0,12
Pennsylvania,Glenolden borough,7159,50,27,233,372,402,1084
Pennsylvania,Grantley,3895,31,32,108,82,257,510
Pennsylvania,Grampian borough,410,9,9,37,17,35,107
Pennsylvania,Tionesta borough,405,8,2,0,7,18,35
Pennsylvania,Tioga borough,664,19,10,40,32,33,134
Pennsylvania,Timblin borough,207,0,5,20,9,5,39
Pennsylvania,Timber Hills,265,0,0,0,0,0,0
Pennsylvania,Tidioute borough,770,3,17,26,33,31,110
Pennsylvania,Throop borough,4052,65,125,117,198,132,637
Pennsylvania,Three Springs borough,455,0,10,22,33,13,78
Pennsylvania,Thorndale,3765,90,0,53,101,72,316
Pennsylvania,Dickson City borough,6005,43,94,196,349,175,857
Pennsylvania,Thompsonville,3748,86,48,145,199,268,746
Pennsylvania,Greencastle borough,4031,37,14,303,198,160,712
Pennsylvania,Great Bend borough,787,7,5,47,17,29,105
Pennsylvania,Grazierville,615,0,31,32,56,22,141
Pennsylvania,Gratz borough,827,22,13,44,61,41,181
Pennsylvania,Grassflat,647,4,0,32,29,42,107
Pennsylvania,Grapeville,550,0,0,58,21,20,99
Pennsylvania,Thornburg borough,507,10,8,25,16,22,81
Pennsylvania,Granville,493,0,12,30,50,11,103
Puerto Rico,G. L. García comunidad,1303,0,0,0,24,113,137
Puerto Rico,Rafael González comunidad,2102,21,0,81,191,93,386
Puerto Rico,Antón Ruíz comunidad,2636,64,89,53,131,120,457
Puerto Rico,San Germán zona urbana,12202,167,56,505,721,647,2096
Puerto Rico,María Antonia comunidad,1059,30,13,42,67,57,209
Puerto Rico,Corazón comunidad,2192,0,0,88,186,169,443
Puerto Rico,Rafael Capó comunidad,1666,0,0,38,64,79,181
Puerto Rico,Bayamón zona urbana,177709,2690,1961,8118,8211,8974,29954
Puerto Rico,Loíza zona urbana,3465,93,85,223,206,128,735
Puerto Rico,Manatí zona urbana,13606,203,142,570,635,637,2187
Puerto Rico,Palomas comunidad (Comerío Municipio),1636,17,17,47,68,53,202
Puerto Rico,Suárez comunidad,2108,32,44,80,164,119,439
Puerto Rico,Rafael Hernández comunidad,1459,14,0,58,63,138,273
Puerto Rico,San José comunidad,2664,0,51,185,166,209,611
Puerto Rico,Luis M. Cintrón comunidad,2130,50,16,80,95,93,334
Puerto Rico,El Mangó comunidad,1693,24,0,48,124,0,196
Puerto Rico,Mayagüez zona urbana,67110,1252,627,2760,3545,3221,11405
Puerto Rico,Río Cañas Abajo comunidad,926,0,41,20,38,31,130
Puerto Rico,Añasco zona urbana,5025,85,39,135,309,277,845
Puerto Rico,Santa Bárbara comunidad,5691,47,0,190,421,256,914
Puerto Rico,Imbéry comunidad,4103,75,22,229,307,352,985
Puerto Rico,H. Rivera Colón comunidad,2156,0,0,53,70,108,231
Puerto Rico,Guánica zona urbana,7404,79,90,390,337,310,1206
Puerto Rico,Río Grande zona urbana,13013,249,173,627,899,568,2516
Puerto Rico,Coquí comunidad,2562,31,0,178,63,105,377
Puerto Rico,Búfalo comunidad,953,61,0,55,89,28,233
Puerto Rico,Las Marías zona urbana,677,21,0,57,30,34,142
Puerto Rico,Breñas comunidad,2741,35,36,186,261,120,638
Puerto Rico,Vega Alta zona urbana,10033,209,110,396,482,566,1763
Puerto Rico,Vega Baja zona urbana,25251,249,160,1447,1460,1312,4628
Puerto Rico,Vieques comunidad,2949,85,12,121,136,88,442
Puerto Rico,Vieques zona urbana,2365,132,58,125,116,98,529
Puerto Rico,Villalba zona urbana,3513,15,36,205,232,70,558
Puerto Rico,Yabucoa zona urbana,6604,100,94,664,362,328,1548
Puerto Rico,Yauco zona urbana,17815,178,260,1256,1233,1309,4236
Puerto Rico,Yaurel comunidad,1063,0,7,42,112,40,201
Puerto Rico,Comerío zona urbana,4031,48,69,279,297,363,1056
Puerto Rico,Aceitunas comunidad,2103,39,0,114,43,121,317
Puerto Rico,Adjuntas zona urbana,4129,82,47,236,272,200,837
Puerto Rico,Vayas comunidad,562,0,0,0,0,62,62
Puerto Rico,Aguada zona urbana,2707,0,0,0,185,225,410
Puerto Rico,Aguas Buenas zona urbana,3483,36,110,81,138,225,590
Puerto Rico,Aguas Claras comunidad,2573,0,49,152,106,176,483
Puerto Rico,Aguilita comunidad,4530,100,71,327,283,330,1111
Puerto Rico,Aibonito zona urbana,8541,27,66,402,626,463,1584
Puerto Rico,Alianza comunidad,2581,14,15,97,115,157,398
Puerto Rico,Animas comunidad,1389,15,19,49,51,42,176
Puerto Rico,Anon Raices comunidad,216,0,0,0,18,17,35
Puerto Rico,Arecibo zona urbana,43152,750,342,1926,2034,2631,7683
Puerto Rico,Arroyo zona urbana,6540,190,42,296,268,363,1159
Puerto Rico,Bairoa La Veinticinco comunidad,202,0,26,0,0,2,28
Puerto Rico,Bajadero comunidad,3414,39,0,161,131,169,500
Puerto Rico,Aguadilla zona urbana,11690,261,72,657,546,496,2032
Puerto Rico,Utuado zona urbana,8075,122,73,360,532,446,1533
Puerto Rico,Trujillo Alto zona urbana,47679,952,606,2514,2701,2628,9401
Puerto Rico,Toa Baja zona urbana,1582,35,34,105,68,46,288
Puerto Rico,Quebradillas zona urbana,4834,99,130,208,273,304,1014
Puerto Rico,Ramos comunidad,1866,10,10,33,119,114,286
Puerto Rico,Rodriguez Hevia comunidad,141,0,0,0,0,18,18
Puerto Rico,Sabana comunidad,860,0,24,23,71,39,157
Puerto Rico,Sabana Eneas comunidad,1260,0,27,13,78,65,183
Puerto Rico,Sabana Grande zona urbana,10043,141,175,690,643,559,2208
Puerto Rico,Sabana Hoyos comunidad,2036,0,21,81,120,135,357
Puerto Rico,Sabana Seca comunidad,8867,152,63,373,484,528,1600
Puerto Rico,Salinas zona urbana,4791,73,68,276,361,339,1117
Puerto Rico,San Antonio comunidad (Aguadilla Municipio),1533,28,0,0,51,55,134
Puerto Rico,San Antonio comunidad (Dorado Municipio),7945,217,169,484,422,551,1843
Puerto Rico,San Antonio comunidad (Quebradillas Municipio),1856,0,12,41,100,103,256
Puerto Rico,San Isidro comunidad,6743,123,41,385,565,552,1666
Puerto Rico,San Juan zona urbana,357627,6099,4165,17098,16142,16329,59833
Puerto Rico,San Lorenzo zona urbana,8255,199,128,520,424,664,1935
Puerto Rico,Santa Clara comunidad,1103,31,0,159,90,110,390
Puerto Rico,Santa Isabel zona urbana,6223,111,32,265,284,458,1150
Puerto Rico,Santo Domingo comunidad,3630,105,31,242,102,249,729
Puerto Rico,Stella comunidad,1146,0,11,13,0,12,36
Puerto Rico,Tallaboa comunidad,873,18,0,41,10,14,83
Puerto Rico,Tallaboa Alta comunidad,1826,66,48,71,103,110,398
Puerto Rico,Tibes comunidad,574,15,15,61,41,14,146
Puerto Rico,Tiburones comunidad,1860,53,44,57,169,152,475
Puerto Rico,Tierras Nuevas Poniente comunidad,3513,16,40,194,244,215,709
Puerto Rico,Toa Alta zona urbana,3387,55,10,130,80,251,526
Puerto Rico,Bajandas comunidad,730,0,0,11,0,47,58
Puerto Rico,Quebrada del Agua comunidad,1221,0,41,99,35,14,189
Puerto Rico,Barahona comunidad,1918,32,0,0,130,151,313
Puerto Rico,Barranquitas zona urbana,2095,45,81,111,110,192,539
Puerto Rico,Comunas comunidad,1392,0,0,22,0,35,57
Puerto Rico,Corcovado comunidad,1622,60,0,37,42,107,246
Puerto Rico,Corozal zona urbana,9550,49,80,577,339,419,1464
Puerto Rico,Corral Viejo comunidad,422,0,15,0,23,24,62
Puerto Rico,Coto Laurel comunidad,2209,0,32,0,135,68,235
Puerto Rico,Coto Norte comunidad,1296,12,25,39,77,84,237
Puerto Rico,Culebra zona urbana,1401,30,39,55,58,72,254
Puerto Rico,Daguao comunidad,1396,0,0,24,136,145,305
Puerto Rico,Dorado zona urbana,12773,270,149,731,780,623,2553
Puerto Rico,Duque comunidad,1429,32,0,90,28,53,203
Puerto Rico,El Combate comunidad,264,0,0,0,0,0,0
Puerto Rico,Coco comunidad,6151,86,55,211,536,554,1442
Puerto Rico,El Negro comunidad,1226,0,0,75,13,61,149
Puerto Rico,El Paraiso comunidad,1775,19,0,104,55,81,259
Puerto Rico,El Tumbao comunidad,2115,11,56,191,21,101,380
Puerto Rico,Emajagua comunidad,2940,0,45,184,247,230,706
Puerto Rico,Esperanza comunidad,1153,0,0,0,0,0,0
Puerto Rico,Espino comunidad,1357,33,35,51,19,44,182
Puerto Rico,Fajardo zona urbana,26777,450,334,1265,1411,1502,4962
Puerto Rico,Florida zona urbana,4585,84,235,166,252,248,985
Puerto Rico,Fuig comunidad,1024,28,5,98,54,46,231
Puerto Rico,Galateo comunidad,2361,52,0,78,124,139,393
Puerto Rico,Garrochales comunidad,1131,0,0,99,28,26,153
Puerto Rico,Río Blanco comunidad,1525,0,41,95,29,55,220
Puerto Rico,El Ojo comunidad,1190,0,0,19,113,100,232
Puerto Rico,Coamo zona urbana,11604,160,93,695,765,810,2523
Puerto Rico,Cidra zona urbana,5519,84,51,330,332,392,1189
Puerto Rico,Ciales zona urbana,2154,115,44,95,82,135,471
Puerto Rico,Bartolo comunidad,1289,0,0,51,0,24,75
Puerto Rico,Betances comunidad,974,21,0,0,11,46,78
Puerto Rico,Boqueron comunidad (Cabo Rojo Municipio),2677,38,69,134,114,68,423
Puerto Rico,Buena Vista comunidad (Arroyo Municipio),990,0,41,40,52,40,173
Puerto Rico,Buena Vista comunidad (Humacao Municipio),989,0,0,0,90,67,157
Puerto Rico,Cabo Rojo zona urbana,10132,253,49,560,260,484,1606
Puerto Rico,Cacao comunidad,1102,50,14,62,23,40,189
Puerto Rico,Caguas zona urbana,80556,1312,849,4133,4195,4389,14878
Puerto Rico,Calzada comunidad,241,0,9,9,8,8,34
Puerto Rico,Campanilla comunidad,5781,45,47,338,489,483,1402
Puerto Rico,Campo Rico comunidad,2619,18,0,57,85,80,240
Puerto Rico,Camuy zona urbana,3108,0,8,86,294,252,640
Puerto Rico,Candelaria comunidad,15586,267,185,863,783,825,2923
Puerto Rico,Candelaria Arenas comunidad,5021,153,24,386,59,200,822
Puerto Rico,Candelero Abajo comunidad,671,21,0,43,41,13,118
Puerto Rico,Candelero Arriba comunidad,1634,0,0,127,98,30,255
Puerto Rico,Capitanejo comunidad,3901,95,0,337,253,159,844
Puerto Rico,Carolina zona urbana,150712,2256,1348,6847,8085,7936,26472
Puerto Rico,Carrizales comunidad,2539,0,34,61,137,37,269
Puerto Rico,Cayey zona urbana,16727,117,316,724,914,734,2805
Puerto Rico,Cayuco comunidad,1224,42,0,126,112,70,350
Puerto Rico,Ceiba zona urbana,5704,42,90,353,305,372,1162
Puerto Rico,Ceiba comunidad,3135,31,24,186,119,186,546
Puerto Rico,Celada comunidad,4612,75,38,183,283,370,949
Puerto Rico,Central Aguirre comunidad,1222,17,0,76,67,60,220
Puerto Rico,Barceloneta zona urbana,3841,32,25,151,289,286,783
Puerto Rico,Quebrada comunidad,1012,38,0,17,0,71,126
Puerto Rico,Cerrillos Hoyos comunidad,952,0,23,80,0,69,172
Puerto Rico,Puerto Real comunidad,6408,151,0,217,620,424,1412
Puerto Rico,Jobos comunidad,2286,21,26,155,117,60,379
Puerto Rico,Jayuya zona urbana,2950,84,9,203,203,214,713
Puerto Rico,Jauca comunidad,1676,59,0,0,110,125,294
Puerto Rico,Jagual comunidad,1096,0,0,14,22,32,68
Puerto Rico,Isabela zona urbana,11201,162,111,294,530,740,1837
Puerto Rico,Ingenio comunidad,4485,25,0,334,368,275,1002
Puerto Rico,Indios comunidad,1568,0,37,131,80,88,336
Puerto Rico,Humacao zona urbana,18061,253,225,896,1183,1138,3695
Puerto Rico,Hormigueros zona urbana,11825,118,220,448,632,482,1900
Puerto Rico,Hato Candal comunidad,1520,0,36,28,87,30,181
Puerto Rico,Hato Arriba comunidad,704,34,0,0,29,28,91
Puerto Rico,Juncal comunidad,850,0,0,13,34,54,101
Puerto Rico,Hatillo zona urbana,4139,0,73,156,240,233,702
Puerto Rico,Gurabo zona urbana,7943,74,123,239,148,381,965
Puerto Rico,Guaynabo zona urbana,72972,1154,889,3387,3217,3444,12091
Puerto Rico,Guayanilla zona urbana,4160,83,13,148,187,287,718
Puerto Rico,Levittown comunidad,26786,310,275,1258,1133,1262,4238
Puerto Rico,Guayama zona urbana,23379,425,391,1617,1476,1702,5611
Puerto Rico,Guayabal comunidad,2141,70,27,125,122,165,509
Puerto Rico,Pueblito del Río comunidad,1672,10,15,84,45,139,293
Puerto Rico,Pájaros comunidad,10711,47,88,625,812,912,2484
Puerto Rico,Palomas comunidad (Yauco Municipio),2067,0,44,21,105,47,217
Puerto Rico,Palmer comunidad,1058,27,0,0,39,164,230
Puerto Rico,Palmas del Mar comunidad,1653,57,0,107,169,114,447
Puerto Rico,Hacienda San Jose comunidad,3152,72,70,246,309,138,835
Puerto Rico,Juncos zona urbana,8463,85,35,366,446,628,1560
Puerto Rico,La Alianza comunidad,2071,21,55,46,104,99,325
Puerto Rico,La Dolores comunidad,3516,67,101,154,60,95,477
Puerto Rico,Lluveras comunidad,1639,0,0,0,50,263,313
Puerto Rico,Lomas comunidad,1068,20,63,30,49,66,228
Puerto Rico,Los Llanos comunidad,2252,94,12,18,0,65,189
Puerto Rico,Los Panes comunidad,384,0,0,0,9,14,23
Puerto Rico,Los Prados comunidad,2296,44,68,140,97,111,460
Puerto Rico,Luquillo zona urbana,8352,220,79,558,594,464,1915
Puerto Rico,Luyando comunidad,3223,22,102,191,289,140,744
Puerto Rico,Magas Arriba comunidad,1269,0,0,28,92,101,221
Puerto Rico,Maguayo comunidad,1205,56,0,53,146,0,255
Puerto Rico,Maricao zona urbana,747,0,25,13,53,54,145
Puerto Rico,Martorell comunidad,2434,24,23,108,160,106,421
Puerto Rico,Las Piedras zona urbana,6099,165,73,249,298,247,1032
Puerto Rico,Las Ollas comunidad,1936,18,0,213,185,66,482
Puerto Rico,Las Ochenta comunidad,654,15,0,23,0,38,76
Puerto Rico,Las Croabas comunidad,866,0,35,70,47,12,164
Puerto Rico,Las Carolinas comunidad,2453,72,32,55,109,368,636
Puerto Rico,Lares zona urbana,5059,76,78,293,258,259,964
Puerto Rico,La Plena comunidad,603,0,0,14,0,54,68
Puerto Rico,La Playa comunidad,2428,46,11,94,144,92,387
Puerto Rico,La Parguera comunidad,855,25,0,49,0,0,74
Puerto Rico,Lamboglia comunidad,1387,42,14,106,41,16,219
Puerto Rico,La Luisa comunidad,1847,17,47,0,90,42,196
Puerto Rico,La Liga comunidad,246,0,0,0,0,0,0
Puerto Rico,Lajas zona urbana,4306,53,60,220,301,356,990
Puerto Rico,La Fermina comunidad,2899,46,56,113,127,113,455
Puerto Rico,Palmas comunidad,1713,60,0,47,54,105,266
Puerto Rico,Palmarejo comunidad (Lajas Municipio),1390,0,0,27,69,79,175
Puerto Rico,La Yuca comunidad,581,22,0,15,50,45,132
Puerto Rico,Pajonal comunidad,581,0,0,39,66,47,152
Puerto Rico,Liborio Negrón Torres comunidad,1534,23,24,116,127,81,371
Puerto Rico,Cabán comunidad,3419,88,106,264,186,166,810
Puerto Rico,Juana Díaz zona urbana,7396,205,95,342,301,370,1313
Puerto Rico,Las Marías comunidad,1902,0,0,190,97,37,324
Puerto Rico,San Sebastián zona urbana,9843,236,211,568,574,569,2158
Puerto Rico,Vázquez comunidad,1841,19,0,113,106,155,393
Puerto Rico,Rosa Sánchez comunidad,849,14,15,14,10,35,88
Puerto Rico,Benítez comunidad,1379,29,38,85,85,107,344
Puerto Rico,Parcelas Peñuelas comunidad,808,19,0,23,14,85,141
Puerto Rico,Peñuelas zona urbana,5453,92,13,320,260,309,994
Puerto Rico,Fránquez comunidad,2837,78,32,229,220,328,887
Puerto Rico,Río Lajas comunidad,2788,75,67,193,190,105,630
Puerto Rico,Boquerón comunidad,1431,0,0,58,116,0,174
Puerto Rico,Bayamón comunidad,1893,93,0,141,91,44,369
Puerto Rico,Canóvanas zona urbana,7762,71,131,370,408,469,1449
Puerto Rico,Mariano Colón comunidad,2476,0,60,17,152,136,365
Puerto Rico,Marueño comunidad,906,0,0,55,18,70,143
Puerto Rico,Luis Lloréns Torres comunidad,3193,31,106,122,144,192,595
Puerto Rico,Maunabo zona urbana,1520,36,29,81,67,46,259
Puerto Rico,Miranda comunidad,1603,0,19,0,96,59,174
Puerto Rico,Moca zona urbana,3772,114,26,177,224,265,806
Puerto Rico,Monte Verde comunidad,108,0,0,0,15,14,29
Puerto Rico,Monserrate comunidad,2261,26,37,93,107,88,351
Puerto Rico,Monte Grande comunidad,3003,0,70,283,182,140,675
Puerto Rico,Cataño zona urbana,26680,458,430,1319,1474,1316,4997
Puerto Rico,Peña Pobre comunidad,966,0,0,0,0,62,62
Puerto Rico,Rincón zona urbana,1355,15,19,134,100,21,289
Puerto Rico,Palo Seco comunidad,850,29,0,58,0,25,112
Puerto Rico,Punta Santiago comunidad,5514,76,34,254,219,207,790
Puerto Rico,Olimpo comunidad,1547,17,18,58,72,80,245
Puerto Rico,Naranjito zona urbana,1805,10,41,50,185,129,415
Puerto Rico,Naguabo zona urbana,4790,68,79,343,377,162,1029
Puerto Rico,Mucarabones comunidad,972,0,0,26,19,102,147
Puerto Rico,Morovis zona urbana,2406,28,13,83,157,125,406
Puerto Rico,Mora comunidad,2245,0,21,175,150,120,466
Puerto Rico,Pueblito del Carmen comunidad,439,16,0,11,38,63,128
Puerto Rico,Potala Pastillo comunidad,2891,20,27,103,142,180,472
Puerto Rico,Ponce zona urbana,126302,2217,1416,6388,7335,6638,23994
Puerto Rico,Pole Ojea comunidad,2021,23,0,79,133,174,409
Puerto Rico,Playita Cortada comunidad,1339,0,18,51,163,149,381
Puerto Rico,Orocovis zona urbana,991,22,0,91,21,127,261
Puerto Rico,Playita comunidad (Salinas Municipio),450,0,25,7,20,32,84
Puerto Rico,Playita comunidad (Yabucoa Municipio),1750,0,47,150,55,170,422
Puerto Rico,Parcelas de Navarro comunidad,1551,0,0,0,0,49,49
Puerto Rico,Parcelas La Milagrosa comunidad,1075,0,21,50,75,47,193
Puerto Rico,Parcelas Mandry comunidad,654,32,19,0,16,50,117
Puerto Rico,Parcelas Nuevas comunidad,1406,0,20,49,155,90,314
Puerto Rico,Parcelas Viejas Borinquen comunidad,658,0,0,20,0,28,48
Puerto Rico,Palmarejo comunidad (Coamo Municipio),1131,30,43,0,0,24,97
Puerto Rico,Patillas zona urbana,4380,72,114,244,289,333,1052
Puerto Rico,Piedra Aguza comunidad,2537,0,37,70,67,131,305
Puerto Rico,Piedra Gorda comunidad,2082,0,29,160,114,149,452
Puerto Rico,Playa Fortuna comunidad,1190,15,25,20,99,36,195
Puerto Rico,Pastos comunidad,1336,23,84,57,43,38,245
Rhode Island,Newport East,11091,202,84,536,583,444,1849
Rhode Island,Newport,24459,225,264,883,636,800,2808
Rhode Island,Narragansett Pier,3957,40,10,105,77,115,347
Rhode Island,Misquamicut,349,6,0,12,0,20,38
Rhode Island,Melville,1327,21,30,193,69,38,351
Rhode Island,Kingston,6969,13,35,126,60,74,308
Rhode Island,Hopkinton,396,0,0,12,0,0,12
Rhode Island,Hope Valley,1733,28,1,112,161,243,545
Rhode Island,Harrisville,1833,9,11,72,166,94,352
Rhode Island,Harmony,876,0,0,0,10,73,83
Rhode Island,Greenville,8419,89,91,299,330,585,1394
Rhode Island,Foster Center,325,25,0,7,0,7,39
Rhode Island,East Providence,47266,819,586,1827,2179,1915,7326
Rhode Island,Cumberland Hill,8439,341,155,424,407,498,1825
Rhode Island,Cranston,80761,1276,627,3458,3632,4217,13210
Rhode Island,Pascoag,4583,53,38,169,179,247,686
Rhode Island,Chepachet,1656,14,0,23,77,94,208
Rhode Island,Charlestown,1207,9,0,23,17,19,68
Rhode Island,Central Falls,19378,379,396,959,1262,1075,4071
Rhode Island,Carolina,787,3,7,21,37,0,68
Rhode Island,Bradford,1158,0,38,49,38,64,189
Rhode Island,Ashaway,1108,0,0,41,42,51,134
Rhode Island,Greene,863,4,48,18,19,49,138
Rhode Island,Clayville,159,0,0,14,13,0,27
Rhode Island,Pawtucket,71395,1055,656,3493,3806,3359,12369
Rhode Island,Quonochontaug,558,0,0,18,26,30,74
Rhode Island,Providence,178680,2214,1935,8918,8373,9453,30893
Rhode Island,Woonsocket,41213,579,492,1836,2038,1945,6890
Rhode Island,Westerly,17957,232,173,670,715,997,2787
Rhode Island,Weekapaug,430,0,0,16,14,27,57
Rhode Island,Watch Hill,184,0,0,0,0,7,7
Rhode Island,Wyoming,96,0,0,0,0,0,0
Rhode Island,Wakefield-Peacedale,8862,222,19,353,442,595,1631
Rhode Island,Valley Falls,12088,113,155,495,577,753,2093
Rhode Island,Tiverton,7407,149,38,215,243,281,926
Rhode Island,Warwick,81855,1228,976,2807,3295,3741,12047
South Carolina,Clemson,14664,238,222,609,337,334,1740
South Carolina,Modoc,241,0,0,0,0,0,0
South Carolina,Monarch Mill,1941,25,38,95,62,71,291
South Carolina,Moncks Corner,9108,135,217,577,463,373,1765
South Carolina,Monetta,171,0,0,16,9,3,28
South Carolina,Mount Carmel,204,0,6,0,12,8,26
South Carolina,Mount Croghan,122,0,0,10,12,3,25
South Carolina,Mount Pleasant,74952,1678,1363,4464,3662,3942,15109
South Carolina,Mountville,115,0,0,0,8,0,8
South Carolina,Mulberry,424,4,24,55,30,16,129
South Carolina,Mullins,4560,61,94,171,288,228,842
South Carolina,Myrtle Beach,29198,301,289,1050,643,1392,3675
South Carolina,Murrells Inlet,8823,48,88,248,332,232,948
South Carolina,Oak Grove,10183,110,183,654,582,638,2167
South Carolina,Norway,300,0,0,0,9,24,33
South Carolina,North Myrtle Beach,14824,29,61,387,327,282,1086
South Carolina,Northlake,4168,30,87,265,72,211,665
South Carolina,North Hartsville,3282,41,77,40,123,358,639
South Carolina,North Charleston,104146,1513,2175,5183,5423,4944,19238
South Carolina,North Augusta,22037,226,357,1241,901,1268,3993
South Carolina,Murphys Estates,1496,12,19,116,191,87,425
South Carolina,North,800,0,24,41,30,65,160
South Carolina,Ninety Six,2011,53,49,103,82,106,393
South Carolina,Nichols,355,0,0,18,21,13,52
South Carolina,Newry,113,0,0,0,0,9,9
South Carolina,Newport,3795,80,22,163,132,80,477
South Carolina,New Ellenton,2431,4,73,87,161,86,411
South Carolina,Newberry,10279,259,162,644,355,481,1901
South Carolina,Neeses,278,3,5,5,11,18,42
South Carolina,Norris,818,2,17,68,29,29,145
South Carolina,Clearwater,4497,52,63,243,104,200,662
South Carolina,Chesterfield,1410,26,7,51,47,67,198
South Carolina,City View,1672,0,38,151,144,62,395
South Carolina,Lowndesville,126,0,12,4,7,5,28
South Carolina,Loris,2500,27,40,122,138,132,459
South Carolina,Lodge,96,0,0,0,4,2,6
South Carolina,Lockhart,544,0,8,41,60,0,109
South Carolina,Livingston,152,8,5,14,7,0,34
South Carolina,Little River,9617,69,55,131,227,208,690
South Carolina,Little Mountain,259,16,5,10,9,6,46
South Carolina,Lincolnville,1299,17,15,87,65,82,266
South Carolina,Liberty,3254,0,0,171,302,355,828
South Carolina,Lexington,19447,499,305,1032,1112,1040,3988
South Carolina,Lesslie,2218,13,0,101,103,157,374
South Carolina,Laurens,9122,122,213,296,484,572,1687
South Carolina,Laurel Bay,6318,162,167,476,331,429,1565
South Carolina,Latta,1242,5,41,78,127,59,310
South Carolina,Langley,1116,0,0,21,0,110,131
South Carolina,Lowrys,202,0,12,4,13,20,49
South Carolina,Lugoff,8248,97,124,562,686,471,1940
South Carolina,Luray,176,0,0,16,10,8,34
South Carolina,Lydia,404,0,34,10,15,16,75
South Carolina,Chester,5527,137,97,300,332,341,1207
South Carolina,Meggett,1432,14,15,40,64,55,188
South Carolina,Mayo,1119,13,11,55,93,72,244
South Carolina,Mayesville,544,12,0,18,21,50,101
South Carolina,Mauldin,24396,228,350,882,1132,2042,4634
South Carolina,Marion,6793,130,170,542,541,419,1802
South Carolina,Manning,4056,111,126,346,175,118,876
South Carolina,Clarks Hill,330,28,0,13,12,19,72
South Carolina,McCormick,2707,10,45,76,87,80,298
South Carolina,McClellanville,517,7,4,28,15,24,78
South Carolina,McBee,775,36,2,25,54,39,156
South Carolina,Lancaster,8853,88,125,454,437,540,1644
South Carolina,Landrum,2642,21,23,149,166,193,552
South Carolina,Lane,472,10,9,22,27,14,82
South Carolina,Lynchburg,297,1,2,8,8,2,21
South Carolina,Lyman,3350,53,0,133,147,111,444
South Carolina,McConnells,264,2,2,12,15,18,49
South Carolina,McColl,2399,20,28,149,61,157,415
South Carolina,Wellford,2472,24,41,120,134,116,435
South Carolina,West Columbia,15757,129,172,530,434,429,1694
South Carolina,Gaffney,12562,180,272,523,658,650,2283
South Carolina,Gantt,14693,155,329,980,783,631,2878
South Carolina,Garden City,9246,115,44,248,345,213,965
South Carolina,Gaston,1466,2,13,79,47,49,190
South Carolina,Gayle Mill,893,0,57,91,47,39,234
South Carolina,Georgetown,9079,55,130,529,554,468,1736
South Carolina,Gifford,363,8,4,16,20,28,76
South Carolina,Gilbert,715,1,20,54,43,83,201
South Carolina,Glendale,175,0,0,0,0,0,0
South Carolina,Gloverville,2925,106,69,70,155,144,544
South Carolina,Golden Grove,2404,18,23,66,15,162,284
South Carolina,Goose Creek,39408,576,686,2282,2131,1717,7392
South Carolina,Govan,59,0,0,0,0,0,0
South Carolina,Gramling,0,0,0,0,0,0,0
South Carolina,Graniteville,2516,180,39,101,162,144,626
South Carolina,Gray Court,711,11,4,41,14,33,103
South Carolina,Great Falls,1944,26,29,134,61,139,389
South Carolina,Greeleyville,485,18,7,26,50,15,116
South Carolina,Greenville,61734,655,837,2779,2574,2110,8955
South Carolina,Gadsden,2143,21,0,12,231,76,340
South Carolina,Greenwood,23254,366,375,1300,1234,1269,4544
South Carolina,Furman,264,0,5,16,19,15,55
South Carolina,Fort Mill,12525,212,283,806,844,872,3017
South Carolina,Ehrhardt,636,0,1,43,5,62,111
South Carolina,Elgin,1542,21,19,55,139,68,302
South Carolina,Elgin,2781,21,88,54,167,173,503
South Carolina,Elko,168,5,3,9,9,6,32
South Carolina,Elloree,712,8,22,15,24,43,112
South Carolina,Enoree,652,10,0,22,37,15,84
South Carolina,Estill,2244,37,44,41,126,222,470
South Carolina,Eureka Mill,1451,20,20,56,111,144,351
South Carolina,Eutawville,332,4,11,13,13,25,66
South Carolina,Fairfax,1908,22,39,68,58,156,343
South Carolina,Fairforest,2090,0,132,218,242,23,615
South Carolina,Fair Play,645,0,0,0,13,66,79
South Carolina,Fingerville,24,0,0,0,0,0,0
South Carolina,Five Forks,16398,319,394,1140,1329,1438,4620
South Carolina,Florence,38000,419,1124,2106,1955,2019,7623
South Carolina,Folly Beach,2715,21,0,34,30,172,257
South Carolina,Forest Acres,10545,218,74,722,506,340,1860
South Carolina,Forestbrook,5111,0,80,119,213,374,786
South Carolina,Fort Lawn,940,10,12,45,47,67,181
South Carolina,Fountain Inn,8399,45,227,644,542,594,2052
South Carolina,Greer,27186,488,391,1564,1513,1307,5263
South Carolina,Hampton,2726,18,47,197,202,172,636
South Carolina,Hanahan,19707,177,218,828,1080,1092,3395
South Carolina,Jenkinsville,71,0,0,1,0,11,12
South Carolina,Jefferson,757,24,5,22,30,15,96
South Carolina,Jamestown,123,0,2,3,8,2,15
South Carolina,James Island,11544,148,110,540,710,419,1927
South Carolina,Jacksonboro,558,17,0,12,27,103,159
South Carolina,Jackson,1661,7,29,127,94,75,332
South Carolina,Iva,1085,10,12,62,60,62,206
South Carolina,Isle of Palms,4274,62,7,126,137,293,625
South Carolina,Islandton,42,0,0,0,0,20,20
South Carolina,Irwin,1518,41,40,39,48,82,250
South Carolina,Irmo,11704,207,181,687,582,835,2492
South Carolina,Inman Mills,1793,18,32,265,85,59,459
South Carolina,Inman,2182,46,39,100,119,157,461
South Carolina,India Hook,4118,26,136,198,342,170,872
South Carolina,Hopkins,2985,0,20,66,121,206,413
South Carolina,Honea Path,3649,38,135,155,185,278,791
South Carolina,Homeland Park,6419,54,121,256,265,375,1071
South Carolina,Hollywood,4872,47,95,287,99,167,695
South Carolina,Holly Hill,1407,64,15,130,98,45,352
South Carolina,Joanna,1307,27,47,87,61,66,288
South Carolina,Johnsonville,2011,5,60,40,143,198,446
South Carolina,Johnston,2284,17,40,147,176,93,473
South Carolina,Jonesville,833,20,13,53,20,45,151
South Carolina,Hardeeville,4353,28,63,210,256,148,705
South Carolina,Harleyville,657,10,1,41,31,30,113
South Carolina,Hartsville,7851,98,224,430,350,378,1480
South Carolina,Heath Springs,713,5,2,45,23,32,107
South Carolina,Hemingway,460,19,2,26,16,17,80
South Carolina,Hickory Grove,443,6,2,14,27,22,71
South Carolina,Hilda,439,6,0,8,15,17,46
South Carolina,Lamar,913,0,8,56,41,29,134
South Carolina,Lake Wylie,10738,410,151,728,726,780,2795
South Carolina,Edisto Beach,600,0,0,0,7,0,7
South Carolina,Lakewood,2670,97,28,117,193,114,549
South Carolina,Lake Secession,1310,0,13,26,80,5,124
South Carolina,Lake Murray of Richland,5915,191,79,358,370,237,1235
South Carolina,Lake City,6728,25,175,587,524,394,1705
South Carolina,Ladson,14770,145,105,864,1114,959,3187
South Carolina,Kline,189,16,6,8,13,1,44
South Carolina,Kingstree,3233,93,58,328,120,223,822
South Carolina,Kiawah Island,1432,0,0,0,10,4,14
South Carolina,Kershaw,2303,12,100,118,141,108,479
South Carolina,Judson,1916,0,14,93,85,90,282
South Carolina,Lake View,818,14,0,12,50,56,132
South Carolina,Edisto,2321,52,29,159,141,113,494
South Carolina,Edgefield,4723,82,31,155,67,196,531
South Carolina,East Sumter,1315,29,0,61,20,28,138
South Carolina,Timmonsville,2283,10,70,84,81,171,416
South Carolina,Tigerville,2060,0,0,9,9,9,27
South Carolina,Tega Cay,8609,140,208,556,824,618,2346
South Carolina,Taylors,22475,257,243,1059,1239,1149,3947
South Carolina,Tatum,129,3,0,2,3,4,12
South Carolina,Sycamore,217,1,0,6,11,22,40
South Carolina,Swansea,746,14,17,27,21,40,119
South Carolina,Surfside Beach,4090,0,26,92,185,142,445
South Carolina,Sumter,40851,670,707,2404,2299,2188,8268
South Carolina,Summit,564,6,15,33,40,30,124
South Carolina,Summerville,46200,778,611,2711,2880,3046,10026
South Carolina,Summerton,1093,15,39,31,14,22,121
South Carolina,Sullivan's Island,2067,29,19,63,113,135,359
South Carolina,Stuckey,262,0,0,25,11,11,47
South Carolina,Stateburg,1714,18,60,142,46,87,353
South Carolina,Startex,1137,0,90,84,172,43,389
South Carolina,Starr,150,0,4,6,11,17,38
South Carolina,Springfield,588,5,19,4,45,29,102
South Carolina,Springdale,2727,7,57,140,100,75,379
South Carolina,Travelers Rest,4834,209,50,224,203,262,948
South Carolina,Trenton,286,5,0,11,2,15,33
South Carolina,Troy,92,0,0,3,2,6,11
South Carolina,Turbeville,1052,28,47,93,77,41,286
South Carolina,Hodges,132,2,0,2,9,12,25
South Carolina,Welcome,6390,47,132,279,289,282,1029
South Carolina,Wedgefield,1553,0,8,44,133,143,328
South Carolina,Watts Mills,1822,0,31,165,75,167,438
South Carolina,Waterloo,160,1,0,2,0,5,8
South Carolina,Warrenville,1008,10,24,80,11,36,161
South Carolina,Ware Shoals,2459,40,34,124,85,126,409
South Carolina,Ware Place,143,0,0,0,0,11,11
South Carolina,Ward,90,0,0,2,0,9,11
South Carolina,Springdale,2151,0,0,172,141,104,417
South Carolina,Walterboro,5312,125,117,300,221,176,939
South Carolina,Walhalla,4234,117,114,288,328,232,1079
South Carolina,Wagener,774,6,7,59,13,60,145
South Carolina,Wade Hampton,20205,186,272,942,855,986,3241
South Carolina,Varnville,2277,36,57,82,131,134,440
South Carolina,Vance,82,0,0,3,6,8,17
South Carolina,Valley Falls,5885,86,18,141,48,313,606
South Carolina,Utica,1388,0,9,96,90,69,264
South Carolina,Union,8144,131,209,530,338,490,1698
South Carolina,Ulmer,45,0,0,0,0,6,6
South Carolina,Wallace,860,16,0,0,32,34,82
South Carolina,Westminster,2435,32,10,115,155,76,388
South Carolina,Spartanburg,37465,545,629,1752,1504,1928,6358
South Carolina,Southern Shops,4533,130,99,345,282,201,1057
South Carolina,Cordova,231,6,12,23,9,13,63
South Carolina,Coronaca,165,0,16,52,0,0,68
South Carolina,Cottageville,853,15,10,87,15,26,153
South Carolina,Coward,708,0,25,33,38,29,125
South Carolina,Cowpens,1702,17,12,39,95,107,270
South Carolina,Cross Anchor,180,0,0,0,0,0,0
South Carolina,Cross Hill,523,2,0,33,32,41,108
South Carolina,Dalzell,4462,53,118,180,277,374,1002
South Carolina,Darlington,6212,52,178,347,323,249,1149
South Carolina,Denmark,3425,13,32,126,183,120,474
South Carolina,Dentsville,14151,181,166,766,470,669,2252
South Carolina,Dillon,6705,122,152,466,502,432,1674
South Carolina,Donalds,335,8,2,24,22,10,66
South Carolina,Due West,1214,11,14,51,39,53,168
South Carolina,Duncan,3231,16,30,196,205,191,638
South Carolina,Dunean,4048,12,123,173,172,342,822
South Carolina,Easley,20374,110,291,1082,1083,1053,3619
South Carolina,East Gaffney,3274,0,47,98,115,118,378
South Carolina,Eastover,765,19,3,85,54,33,194
South Carolina,Cope,56,0,0,0,0,8,8
South Carolina,Conway,19356,251,274,1056,686,783,3050
South Carolina,Converse,607,11,57,66,4,11,149
South Carolina,Columbia,131958,1298,1385,4262,4397,7145,18487
South Carolina,South Congaree,2246,11,64,117,122,91,405
South Carolina,Society Hill,560,6,2,23,39,38,108
South Carolina,Socastee,21641,297,279,1100,1178,1181,4035
South Carolina,Snelling,281,0,0,3,41,15,59
South Carolina,Smyrna,49,0,0,1,1,0,2
South Carolina,Smoaks,143,0,0,0,5,9,14
South Carolina,Slater-Marietta,2386,0,53,233,291,105,682
South Carolina,Six Mile,918,15,12,51,62,46,186
South Carolina,Simpsonville,19706,315,355,1044,786,678,3178
South Carolina,South Sumter,2255,11,57,228,41,137,474
South Carolina,Silverstreet,158,2,7,1,3,3,16
South Carolina,Shell Point,2331,7,77,188,170,52,494
South Carolina,Sharon,486,3,23,37,23,19,105
South Carolina,Seven Oaks,16185,322,248,1000,731,923,3224
South Carolina,Seneca,8184,197,119,360,289,342,1307
South Carolina,Clifton,433,0,0,8,16,31,55
South Carolina,Clinton,8561,149,110,423,448,283,1413
South Carolina,Clio,665,3,0,22,27,49,101
South Carolina,Clover,5442,151,102,329,351,306,1239
South Carolina,Cokesbury,142,0,0,9,0,15,24
South Carolina,Shiloh,104,0,0,7,0,0,7
South Carolina,Chesnee,717,0,19,18,40,39,116
South Carolina,Hilton Head Island,39071,400,470,1420,1445,1523,5258
South Carolina,Cheraw,5800,19,101,204,487,316,1127
South Carolina,Santee,1009,59,3,37,63,41,203
South Carolina,Sans Souci,8288,140,137,455,418,395,1545
South Carolina,Sangaree,8157,157,150,377,527,388,1599
South Carolina,Saluda,3585,51,95,218,132,130,626
South Carolina,Salley,329,6,15,11,14,7,53
South Carolina,Salem,137,5,0,3,7,9,24
South Carolina,St. Stephen,1640,6,22,116,120,87,351
South Carolina,St. Matthews,1947,21,13,85,109,57,285
South Carolina,St. George,2192,25,43,60,117,87,332
South Carolina,St. Andrews,21779,415,258,1365,787,1123,3948
South Carolina,Russellville,437,0,18,0,0,35,53
South Carolina,Ruby,379,7,2,18,28,26,81
South Carolina,Rowesville,321,6,9,22,27,10,74
South Carolina,Cherryvale,2051,18,33,171,205,81,508
South Carolina,York,7945,56,76,277,452,407,1268
South Carolina,Yemassee,893,13,5,49,56,55,178
South Carolina,Roebuck,2670,19,61,40,225,238,583
South Carolina,Rockville,156,0,2,5,2,0,9
South Carolina,Rock Hill,69196,1120,1139,3704,3547,3512,13022
South Carolina,Riverview,404,0,0,9,0,16,25
South Carolina,Ridgeway,456,5,5,38,28,38,114
South Carolina,Saxon,3623,57,117,320,97,90,681
South Carolina,Scotia,163,0,0,1,3,6,10
South Carolina,Scranton,839,7,20,44,19,37,127
South Carolina,Seabrook Island,1688,0,0,11,12,24,47
South Carolina,Beaufort,12839,535,155,737,614,436,2477
South Carolina,Batesburg-Leesville,5251,23,120,380,308,238,1069
South Carolina,Barnwell,4664,267,171,272,347,266,1323
South Carolina,Bamberg,3501,14,61,132,193,185,585
South Carolina,Aynor,713,3,14,74,37,39,167
South Carolina,Awendaw,1415,19,34,37,129,98,317
South Carolina,Atlantic Beach,285,0,0,20,19,21,60
South Carolina,Arial,2155,0,50,53,167,63,333
South Carolina,Arcadia Lakes,956,13,10,21,41,32,117
South Carolina,Arcadia,3159,25,108,324,210,116,783
South Carolina,Ridgeville,1929,4,0,39,12,56,111
South Carolina,Antreville,120,0,0,0,0,0,0
South Carolina,Anderson,26978,421,510,1429,1208,1429,4997
South Carolina,Allendale,3261,34,55,221,168,146,624
South Carolina,Alcolu,470,7,22,6,5,21,61
South Carolina,Aiken,30183,339,338,1033,1352,1583,4645
South Carolina,Abbeville,5197,68,120,132,245,397,962
South Carolina,Woodford,160,0,0,6,0,4,10
South Carolina,West Pelzer,921,12,22,47,31,37,149
South Carolina,West Union,316,5,14,10,22,24,75
South Carolina,Whitmire,1357,8,17,64,95,102,286
South Carolina,Sellers,191,0,0,2,2,15,19
South Carolina,Andrews,2842,29,46,178,117,153,523
South Carolina,Belton,4247,58,117,77,307,254,813
South Carolina,Ridge Spring,921,6,18,40,61,34,159
South Carolina,Richburg,445,0,12,40,26,14,92
South Carolina,Pawleys Island,97,0,0,0,0,0,0
South Carolina,Patrick,439,2,11,13,29,16,71
South Carolina,Parksville,128,4,4,5,5,9,27
South Carolina,Parker,12571,79,356,1079,635,591,2740
South Carolina,Pamplico,1181,4,22,93,72,94,285
South Carolina,Pageland,2745,9,42,114,103,197,465
South Carolina,Pacolet,2453,10,73,141,109,87,420
South Carolina,Oswego,11,0,0,0,0,0,0
South Carolina,Orangeburg,13685,185,165,490,568,522,1930
South Carolina,Olar,213,0,0,4,12,14,30
South Carolina,Olanta,544,13,13,37,34,35,132
South Carolina,Oakland,1081,25,89,67,18,42,241
South Carolina,Wilkinson Heights,2723,8,0,106,85,146,345
South Carolina,Williams,131,3,2,3,3,3,14
South Carolina,Williamston,4029,98,110,165,137,198,708
South Carolina,Willington,126,0,0,0,0,23,23
South Carolina,Williston,3069,135,26,57,377,157,752
South Carolina,Windsor,71,0,0,7,3,0,10
South Carolina,Winnsboro,3419,60,78,181,61,187,567
South Carolina,Winnsboro Mills,2111,0,63,138,92,157,450
South Carolina,Woodfield,9776,234,109,443,622,480,1888
South Carolina,Paxville,215,2,14,16,11,18,61
South Carolina,Peak,51,1,0,2,2,2,7
South Carolina,Pelion,705,3,21,34,29,54,141
South Carolina,Pelzer,82,0,0,1,9,2,12
South Carolina,Rembert,220,0,0,0,0,0,0
South Carolina,Reidville,764,9,14,53,73,37,186
South Carolina,Reevesville,261,4,3,14,13,25,59
South Carolina,Red Hill,14357,168,106,600,448,389,1711
South Carolina,Red Bank,8920,172,175,337,366,545,1595
South Carolina,Ravenel,2544,79,67,166,123,157,592
South Carolina,Quinby,1253,23,12,39,92,87,253
South Carolina,Prosperity,1112,13,24,72,31,63,203
South Carolina,Promised Land,496,0,0,0,0,44,44
South Carolina,Privateer,2805,30,76,374,84,107,671
South Carolina,Ridgeland,4030,61,153,217,121,86,638
South Carolina,Princeton,57,0,0,0,0,0,0
South Carolina,Port Royal,11513,134,143,511,323,441,1552
South Carolina,Pomaria,102,3,1,3,0,7,14
South Carolina,Plum Branch,106,0,0,17,0,1,18
South Carolina,Pinopolis,1098,0,0,19,67,47,133
South Carolina,Pinewood,686,60,16,51,43,42,212
South Carolina,Pine Ridge,1990,12,48,109,95,102,366
South Carolina,Piedmont,5648,64,17,234,405,479,1199
South Carolina,Pickens,3148,49,54,255,154,146,658
South Carolina,Perry,303,0,7,20,12,31,70
South Carolina,Pendleton,3089,20,101,112,10,105,348
South Carolina,Powdersville,8230,115,30,601,476,329,1551
South Carolina,Belvedere,5706,177,85,451,318,195,1226
South Carolina,Woodruff,4104,19,112,105,123,250,609
South Carolina,Berea,14091,212,298,905,898,938,3251
South Carolina,Burnettown,2753,9,56,194,102,151,512
South Carolina,Burton,6266,19,50,406,417,366,1258
South Carolina,Calhoun Falls,1733,8,38,74,111,94,325
South Carolina,Camden,6982,46,165,217,329,292,1049
South Carolina,Cameron,472,9,6,31,15,22,83
South Carolina,Campobello,525,4,4,21,42,25,96
South Carolina,Cane Savannah,805,10,0,29,8,41,88
South Carolina,Carlisle,360,4,0,22,18,8,52
South Carolina,Catawba,1044,26,31,30,73,34,194
South Carolina,Cayce,13554,257,130,370,418,375,1550
South Carolina,Centerville,6806,84,104,306,327,340,1161
South Carolina,Bennettsville,8834,42,215,416,585,582,1840
South Carolina,Central Pacolet,155,1,7,7,21,11,47
South Carolina,Chapin,1605,19,42,113,108,77,359
South Carolina,Charleston,127694,2124,1582,5398,3567,4332,17003
South Carolina,Buffalo,1544,21,12,0,45,92,170
South Carolina,Bucksport,839,24,0,32,14,19,89
South Carolina,Central,5160,114,80,84,17,86,381
South Carolina,Boykin,103,0,0,4,0,0,4
South Carolina,Bethune,290,0,7,10,18,8,43
South Carolina,Brunson,547,25,3,30,19,30,107
South Carolina,Briarcliffe Acres,493,0,6,22,11,37,76
South Carolina,Branchville,1255,12,25,51,90,71,249
South Carolina,Bradley,149,0,0,15,11,0,26
South Carolina,Bowman,816,3,18,31,46,41,139
South Carolina,Bonneau Beach,2170,0,0,222,142,0,364
South Carolina,Bonneau,487,2,22,18,42,25,109
South Carolina,Boiling Springs,8743,216,288,569,438,726,2237
South Carolina,Blythewood,2479,30,64,114,163,162,533
South Carolina,Bluffton,14607,420,374,732,1262,843,3631
South Carolina,Blenheim,137,0,6,1,8,3,18
South Carolina,Brookdale,4289,84,128,381,268,160,1021
South Carolina,Blackville,2203,18,42,90,133,87,370
South Carolina,Bishopville,3342,104,163,250,91,115,723
South Carolina,Blacksburg,1975,8,3,164,181,156,512
South Dakota,Agency Village,170,34,6,19,11,4,74
South Dakota,Agar,71,0,0,4,5,0,9
South Dakota,Aberdeen,27418,438,283,1414,1377,1253,4765
South Dakota,Davis,49,0,0,5,9,0,14
South Dakota,Dante,101,8,5,9,5,10,37
South Dakota,Dallas,98,1,0,0,6,6,13
South Dakota,Dakota Dunes,2970,122,111,171,123,215,742
South Dakota,Akaska,31,0,0,0,0,0,0
South Dakota,Custer,1899,47,52,92,35,38,264
South Dakota,Crooks,1329,27,27,94,119,77,344
South Dakota,Crocker,0,0,0,0,0,0,0
South Dakota,Cresbard,148,0,0,2,2,2,6
South Dakota,Cow Creek,20,0,0,0,0,0,0
South Dakota,Albee,10,0,0,0,0,0,0
South Dakota,Java,137,0,3,10,8,6,27
South Dakota,Cottonwood,6,0,0,0,0,0,0
South Dakota,Alexandria,671,44,4,36,50,57,191
South Dakota,Deadwood,1211,14,5,42,26,33,120
South Dakota,Allen,658,29,16,67,82,116,310
South Dakota,Alpena,261,2,5,10,14,3,34
South Dakota,Altamont,28,0,1,2,2,2,7
South Dakota,Anderson,325,3,4,8,26,44,85
South Dakota,Andover,94,0,0,5,3,0,8
South Dakota,Antelope,1126,39,45,188,73,59,404
South Dakota,Arlington,1013,6,17,72,41,25,161
South Dakota,Armour,870,4,19,54,54,25,156
South Dakota,Artas,5,0,0,0,0,0,0
South Dakota,Artesian,168,3,1,9,4,5,22
South Dakota,Ashland Heights,891,13,0,29,15,46,103
South Dakota,Alcester,847,29,3,46,62,11,151
South Dakota,Corsica,610,17,0,36,23,22,98
South Dakota,Corn Creek,72,8,0,3,0,9,20
South Dakota,Ashton,142,0,5,5,15,15,40
South Dakota,Butler,14,0,0,0,0,0,0
South Dakota,Bushnell,100,1,0,0,0,8,9
South Dakota,Burke,635,17,3,16,34,31,101
South Dakota,Bullhead,298,12,7,40,22,20,101
South Dakota,Buffalo Gap,103,0,2,1,3,1,7
South Dakota,Buffalo,359,4,0,12,24,49,89
South Dakota,Bryant,372,4,7,17,22,11,61
South Dakota,Bruce,168,2,2,0,8,13,25
South Dakota,Brookings,22974,277,314,812,866,751,3020
South Dakota,Broadland,37,1,1,2,0,9,13
South Dakota,Winfred,52,0,0,0,2,0,2
South Dakota,Winner,2855,64,69,93,98,127,451
South Dakota,Wolsey,462,6,11,17,31,18,83
South Dakota,Wood,23,0,0,0,0,0,0
South Dakota,Woonsocket,597,15,11,20,19,28,93
South Dakota,Worthing,930,41,12,62,48,41,204
South Dakota,Wounded Knee,590,21,31,70,0,50,172
South Dakota,Yale,110,0,5,0,6,4,15
South Dakota,Yankton,14531,184,169,696,544,925,2518
South Dakota,Camp Crook,85,0,0,0,2,19,21
South Dakota,Canistota,592,21,3,26,39,20,109
South Dakota,Canova,88,0,0,6,4,6,16
South Dakota,Canton,3258,76,13,201,112,264,666
South Dakota,Conde,134,0,0,2,6,2,10
South Dakota,Columbia,136,2,0,7,1,1,11
South Dakota,Colton,705,5,16,26,38,28,113
South Dakota,Colonial Pine Hills,1906,0,55,98,120,174,447
South Dakota,Colome,320,0,6,23,54,17,100
South Dakota,Colman,665,12,10,47,47,50,166
South Dakota,Clear Lake,1284,9,9,66,81,60,225
South Dakota,Clark,1141,18,18,24,40,30,130
South Dakota,Claremont,139,2,4,9,3,13,31
South Dakota,Corona,113,0,6,2,0,11,19
South Dakota,Claire City,80,0,1,6,4,2,13
South Dakota,Chelsea,34,0,4,0,1,1,6
South Dakota,Chancellor,315,6,2,19,24,11,62
South Dakota,Chamberlain,2582,26,43,161,129,153,512
South Dakota,Central City,170,3,0,6,3,0,12
South Dakota,Centerville,804,21,4,45,47,28,145
South Dakota,Cavour,118,5,0,9,6,3,23
South Dakota,Castlewood,668,5,14,55,39,40,153
South Dakota,Carthage,173,0,1,6,1,6,14
South Dakota,Caputa,0,0,0,0,0,0,0
South Dakota,Chester,334,19,8,13,16,34,90
South Dakota,Astoria,141,1,0,11,1,5,18
South Dakota,Bath,251,0,0,42,44,0,86
South Dakota,Aurora Center,62,4,6,12,0,0,22
South Dakota,Henry,355,0,8,22,34,13,77
South Dakota,Hecla,176,0,0,0,6,5,11
South Dakota,Hazel,81,4,6,7,1,7,25
South Dakota,Hayti,371,5,2,32,24,23,86
South Dakota,Hartford,2887,102,47,219,194,176,738
South Dakota,Harrison,113,0,0,9,16,14,39
South Dakota,Harrisburg,4942,75,94,340,540,231,1280
South Dakota,Hermosa,412,2,9,22,11,15,59
South Dakota,Hamill,0,0,0,0,0,0,0
South Dakota,Dolton,29,0,0,0,4,6,10
South Dakota,Draper,71,0,0,3,0,7,10
South Dakota,Dupree,586,13,17,67,57,50,204
South Dakota,Eagle Butte,1271,40,35,103,106,87,371
South Dakota,Eden,93,0,1,0,0,0,1
South Dakota,Edgemont,827,0,9,32,20,64,125
South Dakota,Egan,310,3,10,11,24,16,64
South Dakota,Groton,1873,65,26,105,129,170,495
South Dakota,Herreid,534,7,15,18,44,56,140
South Dakota,Herrick,119,4,4,3,0,2,13
South Dakota,Hetland,35,0,0,0,16,4,20
South Dakota,Isabel,132,6,0,20,3,4,33
South Dakota,Iroquois,270,11,8,10,19,8,56
South Dakota,Irene,543,8,5,26,12,41,92
South Dakota,Ipswich,1002,14,0,99,48,54,215
South Dakota,Interior,70,0,0,4,6,5,15
South Dakota,Huron,13159,170,344,652,625,668,2459
South Dakota,Hurley,374,1,11,10,26,22,70
South Dakota,Humboldt,653,11,7,25,16,14,73
South Dakota,Hudson,318,5,3,4,9,17,38
South Dakota,Howard,1094,24,2,55,113,62,256
South Dakota,Hoven,400,0,0,33,30,27,90
South Dakota,Hot Springs,3542,30,39,197,113,201,580
South Dakota,Hosmer,227,0,0,6,6,6,18
South Dakota,Hitchcock,107,0,0,9,2,5,16
South Dakota,Hillsview,0,0,0,0,0,0,0
South Dakota,Hill City,1422,19,27,129,137,123,435
South Dakota,Highmore,898,4,9,28,50,42,133
South Dakota,Elk Point,2080,37,32,141,79,187,476
South Dakota,Aurora,705,25,25,31,22,17,120
South Dakota,Elkton,728,17,9,46,55,45,172
South Dakota,Erwin,67,0,0,13,0,2,15
South Dakota,Belvidere,68,0,2,3,3,6,14
South Dakota,Belle Fourche,5702,25,66,283,296,365,1035
South Dakota,Johnson Siding,736,0,0,19,0,17,36
South Dakota,Kadoka,777,7,25,45,44,25,146
South Dakota,Doland,194,0,0,14,11,9,34
South Dakota,Dimock,155,2,10,10,14,2,38
South Dakota,De Smet,1171,18,20,38,23,19,118
South Dakota,Beresford,2211,30,56,177,166,189,618
South Dakota,Delmont,255,3,2,27,5,7,44
South Dakota,Bath Corner,129,0,0,0,0,24,24
South Dakota,Jefferson,577,13,13,13,40,50,129
South Dakota,Batesland,136,4,0,26,15,7,52
South Dakota,Bancroft,20,0,0,0,0,0,0
South Dakota,Baltic,1070,10,13,64,89,65,241
South Dakota,Badger,68,0,2,0,1,3,6
South Dakota,Avon,690,15,32,52,29,46,174
South Dakota,Dell Rapids,3693,151,19,181,132,308,791
South Dakota,Big Stone City,566,7,6,13,26,28,80
South Dakota,Bijou Hills,0,0,0,0,0,0,0
South Dakota,Bison,317,2,3,9,19,18,51
South Dakota,Estelline,901,6,7,67,30,70,180
South Dakota,Ethan,352,8,5,19,35,18,85
South Dakota,Eureka,771,3,4,26,45,12,90
South Dakota,Britton,1522,0,34,80,40,90,244
South Dakota,Bristol,325,2,2,14,9,10,37
South Dakota,Bridgewater,540,7,12,36,14,12,81
South Dakota,Brentford,78,3,0,4,3,0,10
South Dakota,Brant Lake,192,0,0,0,13,3,16
South Dakota,Brandt,85,8,2,1,1,0,12
South Dakota,Brandon,9497,198,233,741,779,664,2615
South Dakota,Bradley,78,0,0,5,1,3,9
South Dakota,Box Elder,8959,91,192,572,436,491,1782
South Dakota,Bowdle,561,11,0,38,76,41,166
South Dakota,Bonesteel,299,6,0,14,20,10,50
South Dakota,Blunt,324,1,0,23,18,13,55
South Dakota,Blucksberg Mountain,541,0,0,0,0,0,0
South Dakota,Blackhawk,2893,88,46,143,116,172,565
South Dakota,Emery,491,6,20,59,29,21,135
South Dakota,Harrold,98,0,0,2,5,10,17
South Dakota,Gayville,392,8,3,10,10,17,48
South Dakota,Gregory,1479,49,22,82,50,59,262
South Dakota,Oglala,1404,18,8,115,91,187,419
South Dakota,Okaton,6,0,0,0,0,0,0
South Dakota,Okreek,373,0,8,31,46,19,104
South Dakota,Ola,0,0,0,0,0,0,0
South Dakota,Oldham,160,1,0,10,16,6,33
South Dakota,Olivet,53,0,0,0,6,6,12
South Dakota,Onaka,12,0,0,0,0,0,0
South Dakota,Oelrichs,137,0,0,8,8,0,16
South Dakota,Onida,750,27,6,46,37,27,143
South Dakota,Ortley,36,0,0,2,0,0,2
South Dakota,Parker,1142,21,22,51,76,64,234
South Dakota,Parkston,1691,61,33,118,88,94,394
South Dakota,Parmelee,729,51,15,97,91,112,366
South Dakota,Peever,208,5,3,8,7,4,27
South Dakota,Philip,718,7,4,25,38,31,105
South Dakota,Pickstown,192,5,3,1,10,13,32
South Dakota,Orient,63,0,0,2,3,5,10
South Dakota,Oacoma,556,15,16,8,9,33,81
South Dakota,Nunda,64,0,0,2,0,0,2
South Dakota,Northville,181,2,4,16,18,31,71
South Dakota,Sturgis,6657,162,74,319,368,318,1241
South Dakota,Stratford,72,1,1,16,1,1,20
South Dakota,Strandburg,79,0,0,10,5,2,17
South Dakota,Storla,11,0,0,0,0,0,0
South Dakota,Stockholm,112,2,1,2,0,6,11
South Dakota,Stickney,257,1,10,6,17,4,38
South Dakota,Springfield,1942,5,7,44,28,77,161
South Dakota,Spring Creek,211,0,0,8,16,18,42
South Dakota,Spencer,113,0,0,16,8,6,30
South Dakota,Spearfish,10980,243,92,408,498,396,1637
South Dakota,South Shore,179,7,6,1,8,3,25
South Dakota,Soldier Creek,115,0,0,0,18,0,18
South Dakota,Sisseton,2668,35,27,185,232,178,657
South Dakota,Sioux Falls,164341,3046,2148,8971,7986,7568,29719
South Dakota,North Eagle Butte,2091,90,66,134,142,159,591
South Dakota,North Sioux City,2597,37,5,59,93,111,305
South Dakota,North Spearfish,2054,37,14,45,73,76,245
South Dakota,Piedmont,930,3,45,182,108,14,352
South Dakota,Summerset,2221,46,23,147,181,74,471
South Dakota,Pierpont,125,2,6,4,7,2,21
South Dakota,Pine Lakes Addition,291,9,0,24,10,48,91
South Dakota,Rosebud,1665,81,35,191,145,130,582
South Dakota,Rosholt,495,4,10,25,33,35,107
South Dakota,Roslyn,195,4,0,10,11,4,29
South Dakota,Roswell,7,0,0,0,0,0,0
South Dakota,Running Water,63,0,0,0,0,11,11
South Dakota,St. Charles,20,0,0,0,0,0,0
South Dakota,St. Francis,610,18,13,57,46,27,161
South Dakota,Roscoe,330,10,5,6,21,17,59
South Dakota,St. Lawrence,169,4,3,17,7,11,42
South Dakota,Salem,1476,25,18,98,73,87,301
South Dakota,Scotland,859,5,3,52,50,55,165
South Dakota,Selby,857,9,20,52,35,50,166
South Dakota,Seneca,13,0,0,0,3,0,3
South Dakota,Sherman,76,0,0,6,9,2,17
South Dakota,Shindler,601,7,9,32,54,33,135
South Dakota,Sinai,130,12,0,7,12,18,49
South Dakota,St. Onge,31,0,0,0,0,0,0
South Dakota,Rockham,94,0,6,24,12,0,42
South Dakota,Richland,66,0,0,0,0,0,0
South Dakota,Revillo,100,0,0,4,2,10,16
South Dakota,Pine Ridge,3562,126,33,236,313,366,1074
South Dakota,Plankinton,654,26,7,32,40,20,125
South Dakota,Pollock,155,0,0,2,5,5,12
South Dakota,Porcupine,1369,28,50,86,130,72,366
South Dakota,Prairie City,4,0,0,0,0,0,0
South Dakota,Presho,522,7,15,44,28,2,96
South Dakota,Pringle,165,5,7,0,5,1,18
South Dakota,Pukwana,235,4,1,11,11,11,38
South Dakota,Quinn,92,3,0,2,4,13,22
South Dakota,Ramona,144,1,3,7,4,7,22
South Dakota,Rapid City,71692,933,1041,4079,3069,3249,12371
South Dakota,Ravinia,114,3,9,20,16,4,52
South Dakota,Raymond,55,0,0,2,0,1,3
South Dakota,Redfield,2581,60,31,113,95,82,381
South Dakota,Ree Heights,64,0,0,1,2,2,5
South Dakota,Reliance,223,7,0,17,17,16,57
South Dakota,Renner Corner,270,0,0,0,9,18,27
South Dakota,Pierre,13938,236,134,681,516,797,2364
South Dakota,Grenville,90,0,2,1,0,5,8
South Dakota,Summit,338,4,3,13,34,14,68
South Dakota,Tea,4427,123,141,331,359,288,1242
South Dakota,Ferney,30,0,0,0,0,0,0
South Dakota,Fedora,23,0,0,0,0,0,0
South Dakota,Faulkton,782,5,11,40,56,17,129
South Dakota,Farmer,2,0,0,0,0,0,0
South Dakota,Faith,387,5,6,13,35,18,77
South Dakota,Fairview,52,1,0,0,1,5,7
South Dakota,Fairfax,138,0,0,1,0,25,26
South Dakota,Flandreau,2082,46,29,85,129,104,393
South Dakota,Fairburn,60,0,0,2,3,4,9
South Dakota,Willow Lake,334,1,3,12,21,15,52
South Dakota,Whitewood,925,17,15,78,58,41,209
South Dakota,White Rock,2,0,0,0,0,0,0
South Dakota,White River,572,13,27,54,16,14,124
South Dakota,White Lake,421,5,5,11,26,21,68
South Dakota,White Horse,202,0,0,33,19,35,87
South Dakota,Whitehorse,162,4,6,17,15,6,48
South Dakota,Wilmot,433,5,5,14,24,5,53
South Dakota,Florence,377,8,9,30,34,14,95
South Dakota,Forestburg,128,0,0,0,2,1,3
South Dakota,Fort Pierre,2244,56,53,159,98,98,464
South Dakota,Green Valley,599,0,13,12,0,44,69
South Dakota,Green Grass,14,0,0,0,4,0,4
South Dakota,Goodwin,176,1,2,4,2,9,18
South Dakota,Goodwill,623,38,0,55,29,29,151
South Dakota,Glenham,91,0,0,0,0,0,0
South Dakota,Gettysburg,1260,19,6,61,55,68,209
South Dakota,Geddes,204,11,6,8,2,1,28
South Dakota,Gary,260,4,6,6,5,17,38
South Dakota,Garretson,1210,22,0,90,107,98,317
South Dakota,Garden City,45,2,0,2,0,1,5
South Dakota,Gann Valley,18,0,0,0,0,0,0
South Dakota,Fulton,78,3,0,8,5,1,17
South Dakota,Fruitdale,42,2,2,2,0,0,6
South Dakota,Freeman,1298,17,18,66,56,74,231
South Dakota,Frederick,284,1,7,6,19,31,64
South Dakota,Frankfort,92,3,0,5,3,10,21
South Dakota,Fort Thompson,1286,41,38,101,126,50,356
South Dakota,White,490,9,4,7,21,16,57
South Dakota,Tabor,405,2,5,21,27,22,77
South Dakota,Wetonka,3,0,0,0,0,1,1
South Dakota,Wessington Springs,842,21,13,49,11,35,129
South Dakota,Vermillion,10746,90,88,283,327,353,1141
South Dakota,Verdon,4,0,0,0,0,0,0
South Dakota,Veblen,508,8,15,20,18,6,67
South Dakota,Valley Springs,778,2,8,42,49,46,147
South Dakota,Vale,128,0,0,0,0,0,0
South Dakota,Utica,86,0,0,6,8,0,14
South Dakota,Tyndall,1043,13,5,48,41,89,196
South Dakota,Viborg,840,7,10,22,38,36,113
South Dakota,Two Strike,298,7,0,17,16,38,78
South Dakota,Turton,43,4,0,4,0,0,8
South Dakota,Tulare,239,3,3,14,14,12,46
South Dakota,Tripp,646,13,5,29,18,78,143
South Dakota,Trent,278,0,0,17,9,9,35
South Dakota,Toronto,205,0,6,13,16,14,49
South Dakota,Tolstoy,24,0,0,0,0,0,0
South Dakota,Timber Lake,476,12,8,18,25,34,97
South Dakota,Twin Brooks,54,4,0,6,4,0,14
South Dakota,Vienna,48,0,2,6,3,6,17
South Dakota,Vilas,12,0,0,0,0,0,0
South Dakota,Virgil,14,0,0,0,0,0,0
South Dakota,Wessington,293,9,3,33,21,0,66
South Dakota,Wentworth village,164,2,1,6,6,3,18
South Dakota,Webster,1798,37,43,94,98,91,363
South Dakota,Waverly,9,0,0,0,0,0,0
South Dakota,Waubay,645,4,40,41,61,32,178
South Dakota,Watertown,21919,367,234,1248,1073,986,3908
South Dakota,Wasta,104,0,0,2,9,6,17
South Dakota,Warner,441,0,9,34,17,26,86
South Dakota,Ward,50,0,0,1,3,1,5
South Dakota,Wanblee,801,5,15,42,70,73,205
South Dakota,Wallace,104,9,2,5,10,5,31
South Dakota,Wall,724,13,5,21,70,31,140
South Dakota,Wakonda,329,4,2,5,9,12,32
South Dakota,Wagner,1572,32,21,59,97,79,288
South Dakota,Volin,220,9,0,6,14,14,43
South Dakota,Volga,2401,97,22,158,145,162,584
South Dakota,Vivian,52,0,0,0,0,0,0
South Dakota,Westport,118,1,0,5,0,11,17
South Dakota,Rapid Valley,8516,131,153,644,464,425,1817
South Dakota,Platte,1543,46,48,37,72,61,264
South Dakota,Mansfield,111,0,0,2,0,28,30
South Dakota,Marty,479,38,13,31,45,37,164
South Dakota,Martin,954,21,20,62,30,40,173
South Dakota,Marion,784,4,4,40,33,31,112
South Dakota,Manderson-White Horse Creek,681,0,24,77,80,16,197
South Dakota,Madison,6972,183,52,263,390,319,1207
South Dakota,McLaughlin,551,2,8,18,45,37,110
South Dakota,McIntosh,230,3,1,28,13,11,56
South Dakota,Lowry,7,0,0,0,0,0,0
South Dakota,Lower Brule,587,28,23,56,34,34,175
South Dakota,Loomis,7,0,0,0,0,0,0
South Dakota,Marvin,23,0,0,0,0,0,0
South Dakota,Long Lake,26,0,0,0,0,2,2
South Dakota,Little Eagle,332,28,9,27,22,26,112
South Dakota,Lily,2,0,0,0,0,0,0
South Dakota,Letcher,205,4,7,18,10,27,66
South Dakota,Lesterville,122,0,0,1,1,1,3
South Dakota,Leola,505,2,14,30,19,15,80
South Dakota,Lennox,2371,47,43,179,162,130,561
South Dakota,Lemmon,1309,27,11,54,27,46,165
South Dakota,Lebanon,34,6,0,6,1,0,13
South Dakota,Lead,3082,33,59,91,210,221,614
South Dakota,La Plant,193,0,0,52,3,0,55
South Dakota,Long Hollow,298,17,37,0,23,15,92
South Dakota,Meadow View Addition,382,0,0,9,0,0,9
South Dakota,Mellette,192,3,6,7,15,14,45
South Dakota,Menno,601,2,0,11,12,12,37
South Dakota,Norris,165,2,11,31,10,18,72
South Dakota,Nisland,328,0,4,24,13,42,83
South Dakota,New Witten,57,0,0,5,0,0,5
South Dakota,New Underwood,543,0,3,22,28,38,91
South Dakota,New Holland,38,0,0,0,0,0,0
South Dakota,Newell,721,0,9,29,28,65,131
South Dakota,New Effington,197,4,2,23,5,4,38
South Dakota,Naples,28,1,0,0,0,0,1
South Dakota,Murdo,393,0,0,16,24,13,53
South Dakota,Mount Vernon,541,12,11,57,36,32,148
South Dakota,Mound City,71,0,0,0,0,0,0
South Dakota,Morristown,45,0,0,0,1,0,1
South Dakota,Morningside,72,0,0,0,0,7,7
South Dakota,Montrose,469,15,7,25,28,34,109
South Dakota,Monroe,162,1,9,1,5,7,23
South Dakota,Mobridge,3302,79,55,131,82,171,518
South Dakota,Mitchell,15543,292,204,922,679,617,2714
South Dakota,Mission Hill,245,11,13,13,12,13,62
South Dakota,Mission,1211,34,42,93,72,68,309
South Dakota,Milltown,11,0,0,0,0,0,0
South Dakota,Miller,1537,13,13,54,73,88,241
South Dakota,Milbank,3269,50,69,107,134,128,488
South Dakota,Midland,152,0,5,6,5,11,27
South Dakota,Langford,395,8,10,25,38,23,104
South Dakota,Lane,90,4,0,4,10,5,23
South Dakota,Lake Preston,581,7,3,8,32,52,102
South Dakota,Keystone,318,3,5,5,11,8,32
South Dakota,Lake Norden,586,10,20,16,9,9,64
South Dakota,Lake Madison,859,0,0,9,16,16,41
South Dakota,Lake City,32,0,0,4,0,0,4
South Dakota,Lake Andes,874,25,31,87,43,75,261
South Dakota,La Bolt,101,10,5,6,5,10,36
South Dakota,Kyle,983,11,20,99,91,70,291
South Dakota,Kranzburg,157,0,0,13,11,20,44
South Dakota,Kimball,549,4,2,36,35,14,91
South Dakota,Kidder,0,0,0,0,0,0,0
South Dakota,Kennebec,326,10,8,18,14,21,71
South Dakota,Kaylor,77,0,0,0,0,0,0
South Dakota,Lake Poinsett,441,2,4,5,7,23,41
Tennessee,Grand Junction,446,7,5,14,27,18,71
Tennessee,Graball,196,0,0,0,17,4,21
Tennessee,Gordonsville,1444,17,18,82,83,83,283
Tennessee,Fairfield Glade,8216,0,16,125,59,81,281
Tennessee,Gleason,1428,0,26,43,77,92,238
Tennessee,Gilt Edge,535,2,7,34,30,27,100
Tennessee,Gray,1811,72,0,53,139,59,323
Tennessee,Goodlettsville,16672,109,183,662,702,870,2526
Tennessee,Graysville,1934,16,65,130,94,106,411
Tennessee,Grimsley,1373,0,6,70,103,98,277
Tennessee,Greenbrier,6611,40,127,511,339,572,1589
Tennessee,Greeneville,15031,306,190,789,1014,628,2927
Tennessee,Greenfield,2262,38,44,116,92,136,426
Tennessee,Green Hill,6741,0,0,348,356,418,1122
Tennessee,Gibson,356,6,0,15,28,19,68
Tennessee,Gruetli-Laager,1966,16,54,88,95,107,360
Tennessee,Guys,504,8,0,43,24,27,102
Tennessee,Halls,2547,53,23,269,173,139,657
Tennessee,Greenback,1021,8,18,39,112,42,219
Tennessee,Germantown,39262,763,424,2268,2367,2630,8452
Tennessee,Gadsden,458,14,1,13,21,24,73
Tennessee,Gates,792,11,27,73,73,64,248
Tennessee,Fairmount,2984,101,56,272,260,289,978
Tennessee,Fairview,8121,201,110,491,467,447,1716
Tennessee,Fall Branch,1557,0,14,62,93,76,245
Tennessee,Falling Water,1277,4,0,57,38,68,167
Tennessee,Farragut,21374,463,390,1359,1475,1532,5219
Tennessee,Fayetteville,7060,53,81,468,244,451,1297
Tennessee,Fincastle,1315,7,19,17,44,139,226
Tennessee,Finger,376,6,7,34,24,5,76
Tennessee,Gatlinburg,4099,0,23,106,86,220,435
Tennessee,Flat Top Mountain,331,0,0,6,6,9,21
Tennessee,Forest Hills,4969,64,87,220,357,264,992
Tennessee,Franklin,68549,1857,1015,4480,4274,3976,15602
Tennessee,Friendship,775,26,20,71,35,53,205
Tennessee,Friendsville,912,15,10,28,49,35,137
Tennessee,Gainesboro,962,22,6,85,20,40,173
Tennessee,Gallatin,32518,679,337,2098,1768,1516,6398
Tennessee,Gallaway,828,8,22,28,9,39,106
Tennessee,Garland,310,3,2,14,20,18,57
Tennessee,Fairgarden,347,0,0,0,45,0,45
Tennessee,Fairfield,271,14,8,15,8,0,45
Tennessee,Trenton,4188,23,17,166,145,311,662
Tennessee,Etowah,3493,57,21,285,243,206,812
Tennessee,Dover,1894,16,21,106,65,138,346
Tennessee,Dodson Branch,1342,45,14,31,80,30,200
Tennessee,Dickson,14951,128,313,742,891,973,3047
Tennessee,Decherd,2703,60,20,173,154,145,552
Tennessee,Decaturville,983,6,24,63,59,36,188
Tennessee,Decatur,1523,31,17,68,88,51,255
Tennessee,Dayton,7355,23,92,357,347,357,1176
Tennessee,Darden,364,9,13,44,9,19,94
Tennessee,Dowelltown,355,3,2,26,24,18,73
Tennessee,Dandridge,2860,19,37,122,91,221,490
Tennessee,Cumberland City,353,9,7,12,3,22,53
Tennessee,Crump,1166,7,6,52,24,38,127
Tennessee,Crossville,11245,291,190,493,638,478,2090
Tennessee,Cross Plains,1928,13,25,117,149,149,453
Tennessee,Crab Orchard,786,18,11,40,42,39,150
Tennessee,Cowan,1436,9,15,68,35,71,198
Tennessee,Covington,9036,343,41,458,360,513,1715
Tennessee,Cottontown,439,8,0,21,9,6,44
Tennessee,Cumberland Gap,427,0,0,5,2,3,10
Tennessee,Eva,191,0,0,0,15,12,27
Tennessee,Doyle,474,3,2,17,20,6,48
Tennessee,Ducktown,411,0,0,0,18,11,29
Tennessee,Harriman,6267,128,32,203,309,409,1081
Tennessee,Ethridge,613,11,18,48,11,28,116
Tennessee,Estill Springs,2142,8,38,177,55,159,437
Tennessee,Erwin,6028,33,76,445,377,227,1158
Tennessee,Erin,1346,17,27,54,81,116,295
Tennessee,Enville,203,1,0,12,6,8,27
Tennessee,Englewood,1869,16,19,77,161,124,397
Tennessee,Elkton,633,18,4,18,27,12,79
Tennessee,Dresden,2924,71,11,109,163,117,471
Tennessee,Elizabethton,14058,123,200,667,530,441,1961
Tennessee,Eastview,885,6,17,69,51,36,179
Tennessee,East Ridge,21275,244,262,1106,1391,784,3787
Tennessee,East Cleveland,1612,5,49,40,36,85,215
Tennessee,Eagleville,714,19,2,24,44,40,129
Tennessee,Eagleton Village,4360,26,34,188,151,269,668
Tennessee,Dyersburg,16932,207,241,684,903,1434,3469
Tennessee,Dyer,2330,16,21,104,133,165,439
Tennessee,Dunlap,5022,11,25,197,318,330,881
Tennessee,Elgin,261,0,0,0,8,44,52
Tennessee,Cottage Grove,89,0,0,1,8,2,11
Tennessee,Harrison,7601,94,58,238,154,326,870
Tennessee,Hartsville/Trousdale,7884,67,70,445,420,555,1557
Tennessee,Medina,3944,116,38,378,337,238,1107
Tennessee,Maynardville,2425,21,37,101,122,148,429
Tennessee,Maury City,665,0,9,23,26,41,99
Tennessee,Mason,1384,16,20,55,80,85,256
Tennessee,Mascot,2666,0,46,198,213,90,547
Tennessee,Maryville,27993,492,256,1653,1710,1802,5913
Tennessee,Martin,11199,184,28,546,242,237,1237
Tennessee,Manchester,10298,169,142,623,552,514,2000
Tennessee,Madisonville,4743,16,59,213,290,177,755
Tennessee,McMinnville,13651,110,235,833,526,822,2526
Tennessee,McLemoresville,325,3,5,11,12,21,52
Tennessee,McKenzie,5551,50,37,344,402,132,965
Tennessee,McEwen,1812,6,38,60,121,74,299
Tennessee,Lynnville,334,4,2,13,12,15,46
Tennessee,Lyles,593,0,0,0,0,20,20
Tennessee,Medon,238,0,7,8,22,9,46
Tennessee,Luttrell,880,4,13,62,25,75,179
Tennessee,Memphis,657167,10398,9810,34412,34637,36213,125470
Tennessee,Middleton,647,43,4,44,23,38,152
Tennessee,Moscow,626,18,2,17,24,36,97
Tennessee,Morristown,29247,310,499,1765,1696,1351,5621
Tennessee,Morrison,613,0,20,15,43,33,111
Tennessee,Mooresburg,966,0,10,65,60,73,208
Tennessee,Monterey,2863,70,81,143,162,116,572
Tennessee,Monteagle,1436,14,28,93,33,46,214
Tennessee,Tracy City,1440,10,45,91,56,42,244
Tennessee,Mitchellville,153,4,1,3,0,4,12
Tennessee,Minor Hill,615,20,14,56,22,19,131
Tennessee,Millington,11113,229,186,586,340,424,1765
Tennessee,Millersville,6579,202,147,193,320,447,1309
Tennessee,Milledgeville,204,1,0,9,10,0,20
Tennessee,Milan,7817,79,56,340,641,499,1615
Tennessee,Midtown,1669,14,11,56,46,79,206
Tennessee,Middle Valley,12235,132,53,647,568,496,1896
Tennessee,Michie,622,0,2,24,18,25,69
Tennessee,Mosheim,2632,13,72,98,143,108,434
Tennessee,Louisville,4092,99,37,212,154,200,702
Tennessee,Loretto,2092,29,22,89,49,94,283
Tennessee,Lafayette,4819,33,47,159,242,194,675
Tennessee,Knoxville,183066,2071,1565,7173,6699,6597,24105
Tennessee,Kingston Springs,2767,31,0,184,183,127,525
Tennessee,Kingston,5865,30,22,402,210,294,958
Tennessee,Kingsport,52898,511,392,2500,2758,2255,8416
Tennessee,Kimball,1392,6,4,103,96,33,242
Tennessee,Kenton,1100,20,4,19,43,65,151
Tennessee,Jonesborough,5189,11,91,181,147,355,785
Tennessee,Johnson City,64978,987,581,2833,2822,2601,9824
Tennessee,Jellico,2391,19,32,75,101,54,281
Tennessee,Jefferson City,8396,55,89,244,161,284,833
Tennessee,Jasper,3278,42,38,260,118,127,585
Tennessee,Jamestown,1816,29,35,41,94,134,333
Tennessee,Jackson,67161,943,786,3653,3344,3355,12081
Tennessee,Jacksboro,1981,32,15,56,62,37,202
Tennessee,La Follette,7218,87,132,292,339,245,1095
Tennessee,Loudon,5653,172,146,405,189,343,1255
Tennessee,La Grange,99,0,0,0,1,0,1
Tennessee,Lakeland,12556,221,235,868,1047,935,3306
Tennessee,Lookout Mountain,1871,40,34,159,100,121,454
Tennessee,Lone Oak,971,0,10,23,38,51,122
Tennessee,Lobelville,957,9,4,93,55,28,189
Tennessee,Livingston,4067,22,33,189,314,191,749
Tennessee,Linden,948,3,7,66,68,40,184
Tennessee,Liberty,267,2,0,10,13,10,35
Tennessee,Lexington,7802,177,127,337,474,413,1528
Tennessee,Lewisburg,11321,138,94,593,584,656,2065
Tennessee,Lenoir City,8943,148,144,360,604,441,1697
Tennessee,Lebanon,28638,278,381,1566,1591,1433,5249
Tennessee,Lawrenceburg,10487,191,114,426,696,283,1710
Tennessee,La Vergne,34081,497,701,2585,2865,2044,8692
Tennessee,Lakewood Park,783,27,0,116,37,0,180
Tennessee,Lake Tansi,3972,76,57,182,120,143,578
Tennessee,Lakesite,1912,13,34,89,86,105,327
Tennessee,Lake City,1812,38,21,155,82,74,370
Tennessee,Mountain City,2543,36,4,56,133,128,357
Tennessee,Mount Carmel,5441,72,53,113,230,361,829
Tennessee,Mount Juliet,28395,584,653,1840,1979,2010,7066
Tennessee,Ramer,317,0,4,9,22,14,49
Tennessee,Puryear,677,8,0,27,26,24,85
Tennessee,Pulaski,7648,166,93,333,354,358,1304
Tennessee,Powells Crossroads,1359,9,4,64,123,62,262
Tennessee,Portland,11963,142,169,819,585,713,2428
Tennessee,Pleasant View,4215,113,40,274,282,168,877
Tennessee,Pleasant Hill,492,0,0,4,16,8,28
Tennessee,Plainview,1851,8,6,88,108,128,338
Tennessee,Pittman Center,423,0,0,1,21,20,42
Tennessee,Piperton,1709,34,32,62,62,76,266
Tennessee,Pine Crest,2330,5,19,48,67,73,212
Tennessee,Pikeville,2018,47,20,90,104,65,326
Tennessee,Pigeon Forge,6039,109,106,252,232,238,937
Tennessee,Philadelphia,1020,11,0,104,75,46,236
Tennessee,Petros,473,0,0,0,7,44,51
Tennessee,Red Bank,11793,191,181,387,476,232,1467
Tennessee,Petersburg,698,2,3,42,44,34,125
Tennessee,Iron City,208,5,0,21,9,19,54
Tennessee,Huntland,723,5,3,25,34,30,97
Tennessee,Helenwood,686,0,0,22,22,0,44
Tennessee,Henderson,6474,118,74,297,340,284,1113
Tennessee,Hendersonville,54168,869,660,3175,3113,3312,11129
Tennessee,Henning,879,0,11,28,49,46,134
Tennessee,Henry,545,5,30,25,32,59,151
Tennessee,Hickory Valley,211,0,0,1,0,19,20
Tennessee,Hillsboro,305,0,16,20,19,18,73
Tennessee,Hohenwald,3699,28,0,173,139,162,502
Tennessee,Hollow Rock,633,10,4,36,33,49,132
Tennessee,Hopewell,1922,0,31,42,59,158,290
Tennessee,Hornbeak,392,0,2,19,19,14,54
Tennessee,Hornsby,309,2,3,22,35,25,87
Tennessee,Humboldt,8325,134,45,601,353,260,1393
Tennessee,Hunter,1684,0,0,98,86,40,224
Tennessee,Huntingdon,3962,20,0,206,305,286,817
Tennessee,Huntsville,1401,31,15,69,27,71,213
Tennessee,Pelham,428,0,0,17,30,17,64
Tennessee,Pegram,2166,28,4,59,153,219,463
Tennessee,Parsons,2542,51,26,118,182,182,559
Tennessee,Nolensville,6361,187,84,639,583,440,1933
Tennessee,Niota,875,24,5,39,59,48,175
Tennessee,New Union,1801,0,39,117,56,104,316
Tennessee,New Tazewell,2984,17,10,142,106,134,409
Tennessee,Newport,6874,59,139,313,299,235,1045
Tennessee,New Market,1418,0,19,106,77,94,296
Tennessee,New Johnsonville,1960,35,29,116,98,141,419
Tennessee,New Hope,961,5,9,81,70,47,212
Tennessee,New Deal,352,3,0,32,18,11,64
Tennessee,Newbern,3314,26,64,315,129,138,672
Tennessee,Nashville-Davidson metropolitan government (balance),634512,9207,7489,31148,26526,26534,100904
Tennessee,Murfreesboro,117983,1815,1414,5737,5764,5671,20401
Tennessee,Munford,6044,92,52,465,408,382,1399
Tennessee,Mowbray Mountain,1537,7,0,64,82,85,238
Tennessee,Mount Pleasant,4657,0,18,254,172,328,772
Tennessee,Normandy,79,0,0,6,5,5,16
Tennessee,Norris,2036,18,3,99,95,116,331
Tennessee,Oakdale,198,0,8,11,24,9,52
Tennessee,Oak Grove CDP (Sumner County),245,0,0,9,39,23,71
Tennessee,Parrottsville,274,1,1,34,10,22,68
Tennessee,Parker's Crossroads,310,3,11,7,2,11,34
Tennessee,Park City,2734,7,48,336,226,45,662
Tennessee,Paris,10166,85,124,824,507,733,2273
Tennessee,Palmer,695,3,20,48,24,41,136
Tennessee,Orme,125,2,0,2,0,3,7
Tennessee,Orlinda,1016,20,9,54,66,57,206
Tennessee,Harrogate,4355,15,52,128,219,157,571
Tennessee,Ooltewah,323,0,0,0,14,16,30
Tennessee,Olivet,1413,0,19,65,35,92,211
Tennessee,Oliver Springs,3767,80,40,338,46,241,745
Tennessee,Obion,1071,9,3,22,45,96,175
Tennessee,Oak Ridge,29310,326,336,1491,1459,1293,4905
Tennessee,Oakland,7106,85,43,471,427,190,1216
Tennessee,Oak Hill,4658,67,56,258,315,189,885
Tennessee,Oak Grove CDP (Washington County),5099,135,89,315,346,209,1094
Tennessee,Oneida,3730,78,93,412,193,250,1026
Tennessee,Cornersville,1315,4,35,83,62,109,293
Tennessee,Flintville,614,0,0,62,39,0,101
Tennessee,Coopertown,4343,60,34,253,276,345,968
Tennessee,Bruceton,1641,16,7,63,76,84,246
Tennessee,Clarksburg,395,7,11,19,11,23,71
Tennessee,Clarkrange,701,35,22,97,0,21,175
Tennessee,Church Hill,6725,96,112,272,295,391,1166
Tennessee,Christiana,2781,28,30,229,155,146,588
Tennessee,Chesterfield,366,0,11,13,27,28,79
Tennessee,Chattanooga,174483,2718,1848,7824,7997,7984,28371
Tennessee,Charlotte,1577,29,24,137,55,24,269
Tennessee,Charleston,834,3,22,46,38,64,173
Tennessee,Chapel Hill,1573,31,19,79,79,71,279
Tennessee,Central,2258,0,21,133,101,46,301
Tennessee,Centerville,3572,16,0,105,284,125,530
Tennessee,Centertown,249,0,5,17,16,5,43
Tennessee,Adams,840,11,0,22,37,102,172
Tennessee,Adamsville,2306,14,39,102,74,86,315
Tennessee,Alamo,2281,58,86,108,130,144,526
Tennessee,Alcoa,8737,101,187,528,407,376,1599
Tennessee,Alexandria,988,25,8,44,65,58,200
Tennessee,Algood,3581,152,42,170,191,104,659
Tennessee,Allardt,610,0,0,20,35,27,82
Tennessee,Altamont,1174,6,28,53,48,46,181
Tennessee,Andersonville,347,0,0,0,24,20,44
Tennessee,Apison,2505,5,29,34,15,187,270
Tennessee,Ardmore,1182,9,21,39,34,53,156
Tennessee,Arlington,11635,174,246,1108,1023,830,3381
Tennessee,Townsend,426,0,4,14,16,3,37
Tennessee,Ashland City,4650,46,86,345,172,199,848
Tennessee,Toone,443,0,8,21,17,10,56
Tennessee,Three Way,1641,6,8,54,70,86,224
Tennessee,Sneedville,1309,20,14,90,67,35,226
Tennessee,Soddy-Daisy,13158,200,89,718,685,465,2157
Tennessee,Somerville,3115,87,89,290,142,61,669
Tennessee,South Carthage,1487,41,4,71,107,87,310
Tennessee,South Cleveland,6458,66,142,370,356,311,1245
Tennessee,South Fulton,2448,18,45,102,77,137,379
Tennessee,South Pittsburg,3107,74,44,108,168,261,655
Tennessee,Sparta,5074,24,8,208,366,215,821
Tennessee,Spencer,1726,19,18,90,73,91,291
Tennessee,Spring City,2248,40,24,256,86,121,527
Tennessee,Springfield,16639,316,208,1224,809,627,3184
Tennessee,Spring Hill,32831,902,734,2853,2870,1840,9199
Tennessee,Spurgeon,3961,46,89,174,188,200,697
Tennessee,Stanton,396,5,0,43,14,44,106
Tennessee,Stantonville,291,0,2,8,8,28,46
Tennessee,Summertown,721,8,8,58,48,47,169
Tennessee,Sunbright,454,7,3,35,27,27,99
Tennessee,Surgoinsville,1986,17,43,96,86,78,320
Tennessee,Sweetwater,5872,19,48,250,201,396,914
Tennessee,Tazewell,2293,65,5,107,123,115,415
Tennessee,Telford,810,9,23,27,40,25,124
Tennessee,Tellico Plains,820,10,14,41,36,33,134
Tennessee,Tellico Village,6136,0,0,51,21,51,123
Tennessee,Tennessee Ridge,1459,34,19,62,80,93,288
Tennessee,Thompson's Station,2862,23,25,183,172,248,651
Tennessee,Tiptonville,4396,43,51,74,138,399,705
Tennessee,Athens,13634,322,117,478,791,655,2363
Tennessee,Atoka,8845,221,112,442,609,662,2046
Tennessee,Atwood,905,5,0,16,45,27,93
Tennessee,Wildwood,1314,0,0,70,133,117,320
Tennessee,Whitwell,1978,6,58,103,53,71,291
Tennessee,Whiteville,4568,5,18,47,38,228,336
Tennessee,White Pine,2274,37,47,137,173,115,509
Tennessee,White House,10810,179,135,681,611,961,2567
Tennessee,White Bluff,3299,26,28,135,140,163,492
Tennessee,Benton,1897,18,48,125,108,78,377
Tennessee,Berry Hill,668,0,0,2,5,2,9
Tennessee,Bethel Springs,772,19,4,56,26,42,147
Tennessee,Bethpage,309,0,0,0,0,13,13
Tennessee,Big Sandy,533,0,6,16,15,8,45
Tennessee,Blaine,1943,10,22,56,121,127,336
Tennessee,Bloomingdale,9730,134,82,436,476,336,1464
Tennessee,Blountville,2364,12,12,32,10,32,98
Tennessee,Bluff City,1863,55,44,71,107,97,374
Tennessee,Bolivar,5219,25,97,444,345,317,1228
Tennessee,Bon Aqua Junction,994,18,0,0,0,43,61
Tennessee,Bowman,301,0,0,10,21,0,31
Tennessee,Braden,259,2,0,11,5,17,35
Tennessee,Bradford,1295,25,28,77,62,72,264
Tennessee,Bransford,217,0,0,0,46,10,56
Tennessee,Brentwood,39974,974,599,2863,3036,3707,11179
Tennessee,Brighton,2954,66,28,255,322,195,866
Tennessee,Bristol,26674,312,344,1068,1522,1169,4415
Tennessee,Brownsville,10016,78,156,634,631,643,2142
Tennessee,Wildwood Lake,3475,15,28,127,218,193,581
Tennessee,Williston,413,9,3,18,18,21,69
Tennessee,Winchester,8502,78,42,492,452,442,1506
Tennessee,Winfield,799,12,15,48,28,34,137
Tennessee,Auburntown,311,2,10,18,18,12,60
Tennessee,Baileyton,531,3,4,11,30,14,62
Tennessee,Baneberry,534,3,3,11,20,20,57
Tennessee,Banner Hill,1529,35,0,33,28,85,181
Tennessee,Bartlett,58107,1124,459,3110,3971,3911,12575
Tennessee,Baxter,1517,37,30,74,98,131,370
Tennessee,Bean Station,3089,44,4,117,166,182,513
Tennessee,Beersheba Springs,573,8,0,23,17,50,98
Tennessee,Bell Buckle,400,6,6,9,27,20,68
Tennessee,Belle Meade,2857,69,65,226,250,150,760
Tennessee,Bells,2552,42,49,184,125,112,512
Tennessee,Yorkville,448,3,0,28,51,46,128
Tennessee,Smyrna,43580,667,704,2752,2729,2440,9292
Tennessee,Wrigley,174,0,0,24,0,24,48
Tennessee,Woodbury,2720,32,7,208,152,139,538
Tennessee,Copperhill,428,5,11,24,32,12,84
Tennessee,Celina,1674,32,28,98,130,62,350
Tennessee,Cedar Hill,394,11,4,29,40,18,102
Tennessee,Castalian Springs,923,6,7,20,56,114,203
Tennessee,Caryville,2418,24,60,141,123,77,425
Tennessee,Carthage,2025,16,7,71,127,114,335
Tennessee,Camden,3578,35,68,99,175,205,582
Tennessee,Calhoun,503,1,8,27,28,30,94
Tennessee,Byrdstown,996,20,6,45,50,45,166
Tennessee,Burns,1536,7,38,85,86,72,288
Tennessee,Burlison,409,0,3,14,11,23,51
Tennessee,Woodland Mills,443,12,7,11,31,26,87
Tennessee,Smithville,4611,6,135,194,188,363,886
Tennessee,Clarksville,143618,2237,2496,8655,7822,6974,28184
Tennessee,Bulls Gap,593,11,4,26,10,26,77
Tennessee,Viola,56,0,0,0,2,2,4
Tennessee,Vanleer,338,11,8,19,13,12,63
Tennessee,Unionville,1396,12,0,92,109,53,266
Tennessee,Union City,10722,166,157,773,516,540,2152
Tennessee,Unicoi,3598,0,34,151,216,193,594
Tennessee,Tusculum,2677,16,39,75,128,112,370
Tennessee,Vonore,1775,5,22,54,125,146,352
Tennessee,Tullahoma,19022,217,228,934,1093,873,3345
Tennessee,Trimble,502,8,10,24,34,16,92
Tennessee,Trezevant,923,16,0,63,39,31,149
Tennessee,Seymour,11059,48,161,273,887,669,2038
Tennessee,Slayden,174,1,1,7,8,15,32
Tennessee,Sewanee,2642,12,16,31,29,77,165
Tennessee,Sevierville,15903,113,235,587,731,874,2540
Tennessee,Troy,1450,5,11,54,58,99,227
Tennessee,Selmer,4491,13,85,219,258,264,839
Tennessee,Walden,2052,43,22,134,129,163,491
Tennessee,Walnut Grove CDP (Hardin County),259,0,0,0,10,0,10
Tennessee,Signal Mountain,8456,396,114,461,425,482,1878
Tennessee,Shelbyville,20779,345,257,1198,1337,1357,4494
Tennessee,Sharon,989,6,22,55,17,35,135
Tennessee,Shackle Island,3029,17,9,165,305,228,724
Tennessee,Westmoreland,2003,18,14,231,131,97,491
Tennessee,Waynesboro,2425,6,33,132,94,140,405
Tennessee,Walland,240,0,5,0,6,0,11
Tennessee,Waverly,4111,80,51,155,288,259,833
Tennessee,Watauga,376,5,2,10,13,21,51
Tennessee,Wartrace,653,19,5,16,27,25,92
Tennessee,Wartburg,804,4,2,51,25,30,112
Tennessee,Walterhill,326,0,0,0,21,65,86
Tennessee,Walnut Hill,2301,21,7,39,95,68,230
Tennessee,Walnut Grove CDP (Sumner County),987,10,9,67,44,24,154
Tennessee,Watertown,1462,8,6,42,83,102,241
Tennessee,Scotts Hill,825,14,19,26,53,48,160
Tennessee,Silerton,84,0,3,1,3,9,16
Tennessee,Saulsbury,191,0,0,0,35,7,42
Tennessee,Ridgeside,563,8,5,30,42,48,133
Tennessee,Ridgetop,2338,59,43,115,144,90,451
Tennessee,Ripley,8291,109,95,613,492,652,1961
Tennessee,Rives,232,2,4,6,10,6,28
Tennessee,Robbins,180,0,0,0,7,17,24
Tennessee,Rockford,789,4,3,21,40,40,108
Tennessee,Rockvale,753,23,27,37,74,74,235
Tennessee,Ridgely,1902,46,6,121,131,80,384
Tennessee,Rockwood,5466,44,56,272,187,130,689
Tennessee,Sale Creek,2657,23,0,29,113,226,391
Tennessee,Rossville,662,3,2,10,16,58,89
Tennessee,Rural Hill,1716,0,12,31,63,73,179
Tennessee,Rutherford,1199,2,4,24,28,63,121
Tennessee,Rutledge,1286,19,0,67,58,38,182
Tennessee,St. Joseph,986,17,3,45,34,35,134
Tennessee,Savannah,7032,120,36,342,266,380,1144
Tennessee,Rogersville,4400,78,0,224,180,136,618
Tennessee,Riceville,671,0,0,0,90,31,121
Tennessee,Roan Mountain,1591,0,55,121,68,87,331
Tennessee,Cleveland,42895,612,722,2042,2255,2186,7817
Tennessee,Sardis,460,2,7,9,23,23,64
Tennessee,Samburg,180,0,0,5,1,2,8
Tennessee,Red Boiling Springs,1314,41,27,112,76,47,303
Tennessee,Cookeville,31831,312,418,1204,1061,1343,4338
Tennessee,Columbia,35627,432,563,2199,1910,1563,6667
Tennessee,Colonial Heights,3512,25,33,142,108,190,498
Tennessee,Collinwood,1029,5,26,44,49,56,180
Tennessee,Saltillo,557,3,0,9,25,36,73
Tennessee,Clifton,2666,7,3,74,33,74,191
Tennessee,Collierville,47434,1144,434,2848,3437,3844,11707
Tennessee,Collegedale,9918,60,162,361,456,369,1408
Tennessee,Coalmont,668,3,0,29,23,41,96
Tennessee,Coalfield,2690,0,51,240,116,153,560
Tennessee,Clinton,9918,93,161,335,605,379,1573
Texas,Runge,1128,15,5,33,37,39,129
Texas,Rosharon,2120,0,0,132,139,133,404
Texas,Rosita,2824,59,8,339,303,183,892
Texas,Ross,249,0,0,22,19,21,62
Texas,Rosser village,312,0,0,11,23,33,67
Texas,Rotan,1459,0,6,61,63,66,196
Texas,Round Mountain,166,7,2,11,5,5,30
Texas,Round Rock,109690,2339,1831,7696,6655,7109,25630
Texas,Roxton,518,0,0,26,15,27,68
Texas,Rowlett,58296,789,789,3278,3550,4295,12701
Texas,Runaway Bay,1598,55,23,80,64,43,265
Texas,Royse City,10128,194,82,638,666,932,2512
Texas,Rule,608,7,2,23,41,14,87
Texas,Rosenberg,33600,380,630,2556,2275,1771,7612
Texas,Sabinal,1981,64,19,193,119,150,545
Texas,Rusk,5594,173,58,180,258,288,957
Texas,Round Top,73,0,0,0,0,3,3
Texas,Rose Hill Acres,448,6,6,11,31,18,72
Texas,Ropesville,358,9,5,15,14,8,51
Texas,Rosebud,1401,11,19,72,67,75,244
Texas,Berryville,1123,3,3,90,47,101,244
Texas,Benjamin Perez,0,0,0,0,0,0,0
Texas,Benjamin,258,2,8,9,16,0,35
Texas,Benbrook,22144,261,346,977,984,763,3331
Texas,Benavides,1705,37,42,94,89,126,388
Texas,Belton,19766,167,398,1045,874,922,3406
Texas,Bellville,4171,74,36,150,172,247,679
Texas,Bells,1538,33,28,105,93,76,335
Texas,Bellmead,10022,269,342,960,801,651,3023
Texas,Bertram,1461,20,16,85,68,82,271
Texas,Bellevue,307,1,8,10,13,18,50
Texas,Beeville,13192,214,192,895,912,780,2993
Texas,Bee Cave,5362,115,64,572,486,282,1519
Texas,Bedias,310,3,0,8,3,23,37
Texas,Bedford,48559,589,517,1770,2094,2396,7366
Texas,Beckville,966,4,15,86,61,52,218
Texas,Beaumont,117676,2196,1685,6825,6281,5871,22858
Texas,Beasley,572,20,9,46,33,6,114
Texas,Granite Shoals,4988,153,110,582,217,194,1256
Texas,Granjeno,288,0,1,4,0,24,29
Texas,Bellaire,17869,620,373,1169,1049,1154,4365
Texas,Beverly Hills,1827,52,36,135,115,64,402
Texas,Bevil Oaks,1308,26,14,40,25,71,176
Texas,Bigfoot,234,0,0,0,0,0,0
Texas,Roscoe,1394,25,31,87,84,136,363
Texas,Roman Forest,2068,14,28,79,179,171,471
Texas,Roma Creek,425,0,6,24,38,27,95
Texas,Roma,10041,124,190,685,693,814,2506
Texas,Rollingwood,1603,58,24,134,95,99,410
Texas,Rogers,957,0,18,52,57,75,202
Texas,Rocky Mound,68,2,2,17,2,2,25
Texas,Rockwall,40830,869,790,3044,2661,2323,9687
Texas,Rocksprings,1285,29,22,54,51,80,236
Texas,Rockport,9992,75,207,461,667,256,1666
Texas,Rockdale,5507,81,199,368,178,111,937
Texas,Rochester,322,8,3,24,25,5,65
Texas,Roby,772,18,9,80,43,49,199
Texas,Combes,3019,47,25,229,206,127,634
Texas,Comanche,4224,67,69,239,196,357,928
Texas,Columbus,3631,14,13,256,158,247,688
Texas,Colorado City,4122,75,29,315,232,177,828
Texas,Colmesneil,643,0,7,39,42,60,148
Texas,Big Spring,28054,420,251,1601,1671,1280,5223
Texas,Big Sandy,1843,13,32,180,131,121,477
Texas,Big Lake,3146,13,49,310,161,238,771
Texas,Rose City,386,4,3,8,11,16,42
Texas,Colorado Acres,98,8,0,9,17,0,34
Texas,San Carlos I,180,0,10,20,22,29,81
Texas,Sadler,403,5,2,27,38,13,85
Texas,Westworth Village,2584,78,50,117,124,92,461
Texas,Westwood Shores,1391,41,21,41,33,117,253
Texas,Westway,3868,105,1,284,218,338,946
Texas,West University Place,15412,479,455,1071,905,872,3782
Texas,West Tawakoni,1707,22,26,73,107,89,317
Texas,West Sharyland,1986,0,52,101,274,132,559
Texas,Highlands,7515,171,94,693,353,396,1707
Texas,Highland Park,8916,298,180,615,625,406,2124
Texas,Highland Haven,451,0,12,14,7,6,39
Texas,Horseshoe Bay,3557,37,18,26,150,45,276
Texas,Higgins,466,6,9,35,35,38,123
Texas,Hidalgo,13287,204,463,1163,1227,1058,4115
Texas,Hico,1408,6,37,69,65,67,244
Texas,Hickory Creek,3774,56,31,246,156,172,661
Texas,Hewitt,14022,134,94,826,595,703,2352
Texas,Hermleigh,384,5,0,38,31,14,88
Texas,Hereford,15257,289,365,1031,1136,1197,4018
Texas,Henrietta,3047,8,0,163,248,223,642
Texas,Henderson,13695,212,165,759,415,666,2217
Texas,Hempstead,6432,133,184,283,541,403,1544
Texas,Hideaway,3026,0,0,65,50,74,189
Texas,Hemphill,1441,25,53,88,106,103,375
Texas,Hornsby Bend,7441,140,101,492,626,600,1959
Texas,Hooks,2757,19,58,178,194,215,664
Texas,Highland Village,15793,215,258,901,1100,1100,3574
Texas,Hill Country Village,793,2,4,36,35,69,146
Texas,Hillcrest village,762,6,6,19,29,33,93
Texas,Hillsboro,8360,188,177,496,554,424,1839
Texas,Hillside Acres,0,0,0,0,0,0,0
Texas,Hilltop CDP (Frio County),226,0,0,0,0,0,0
Texas,Hilltop CDP (Starr County),29,0,0,0,0,0,0
Texas,Hilltop Lakes,985,0,0,0,85,0,85
Texas,Hilshire Village,727,23,12,48,37,58,178
Texas,Horizon City,18981,458,530,1933,1596,1237,5754
Texas,Hitchcock,7325,206,187,434,544,460,1831
Texas,Holiday Lakes,948,31,21,63,97,73,285
Texas,Holland,1038,5,0,101,65,100,271
Texas,Holliday,1614,0,17,55,82,149,303
Texas,Holly Lake Ranch,2926,0,35,91,44,99,269
Texas,Hollywood Park,3218,15,0,58,122,108,303
Texas,Homestead Meadows North,4564,93,160,380,409,244,1286
Texas,Homestead Meadows South,5811,125,48,193,294,759,1419
Texas,Hondo,8987,100,131,413,416,898,1958
Texas,Honey Grove,1975,28,15,84,123,204,454
Texas,Holiday Beach,453,0,0,0,0,0,0
Texas,Helotes,8125,151,87,628,503,621,1990
Texas,Heidelberg,1806,58,71,206,135,163,633
Texas,Hedwig Village,2653,36,42,237,200,205,720
Texas,Sanderson,828,0,0,55,41,27,123
Texas,Sanctuary,380,0,12,11,32,12,67
Texas,San Carlos II,225,10,0,21,10,30,71
Texas,Grape Creek,2935,50,26,149,255,212,692
Texas,San Carlos,3731,15,71,412,282,333,1113
Texas,San Benito,24486,582,579,1909,1391,1628,6089
Texas,San Augustine,2481,62,24,136,174,141,537
Texas,San Antonio,1413881,22691,21601,82517,80281,80123,287213
Texas,San Angelo,97595,1469,1556,5232,4486,4473,17216
Texas,Sandia,648,68,42,72,110,0,292
Texas,Sam Rayburn,1060,43,0,16,45,8,112
Texas,Sammy Martinez,96,0,10,5,10,21,46
Texas,Saline?o North,26,0,0,0,0,0,0
Texas,Saline?o,117,0,0,0,0,10,10
Texas,Salado village,1642,46,0,25,48,112,231
Texas,St. Paul,670,40,28,34,40,36,178
Texas,St. Paul,1183,10,18,84,107,82,301
Texas,St. Jo,1113,7,10,60,56,94,227
Texas,St. Hedwig,2149,25,21,62,94,134,336
Texas,Saginaw,21270,260,524,1258,1551,1556,5149
Texas,Samnorwood,13,2,0,0,4,0,6
Texas,San Diego,4528,44,50,266,187,251,798
Texas,Sandoval,9,0,3,0,0,0,3
Texas,Sand Springs,920,22,18,20,34,78,172
Texas,Hedley,392,3,8,11,39,8,69
Texas,Hebron,475,10,7,37,34,28,116
Texas,Hebbronville,4583,56,121,287,357,278,1099
Texas,Heath,7793,133,149,397,530,520,1729
Texas,Hearne,4439,172,78,216,192,286,944
Texas,H. Cuellar Estates,27,0,0,0,0,6,6
Texas,Hays,333,2,9,14,8,35,68
Texas,Hawley,612,13,12,34,79,30,168
Texas,Hawkins,1441,20,10,64,80,100,274
Texas,Hawk Cove,396,6,1,23,5,10,45
Texas,Havana,516,19,0,0,21,21,61
Texas,San Juan,182,0,10,11,10,5,36
Texas,San Juan,35692,580,957,2678,3382,2233,9830
Texas,San Isidro,351,0,0,10,14,21,45
Texas,Sanger,7410,135,248,583,550,426,1942
Texas,Sanford,157,0,0,16,12,6,34
Texas,San Fernando,39,0,0,0,0,0,0
Texas,San Felipe,709,12,6,13,28,39,98
Texas,San Elizario,9158,180,265,883,785,725,2838
Texas,Sandy Point,138,0,0,0,3,2,5
Texas,Sandy Hollow-Escondidas,582,0,0,65,11,78,154
Texas,Sachse,22585,553,442,1274,1362,1352,4983
Texas,Grapeland,1784,12,0,115,125,87,339
Texas,Hutchins,5669,79,73,254,325,395,1126
Texas,Grays Prairie village,349,0,3,20,15,42,80
Texas,Anacua,14,0,0,0,0,0,0
Texas,Amistad,10,0,0,0,0,0,0
Texas,Horseshoe Bend,662,0,71,0,0,43,114
Texas,Amherst,957,14,19,73,52,59,217
Texas,Ames,1216,7,53,51,131,67,309
Texas,Amaya,25,0,0,0,0,4,4
Texas,Amarillo,196571,4103,3156,12410,10986,10821,41476
Texas,Amargosa,15,0,0,0,0,0,0
Texas,Amada Acres,0,0,0,0,0,0,0
Texas,Alvord,1554,17,31,107,162,88,405
Texas,Bayview,424,2,2,22,11,33,70
Texas,Beach City,2447,10,24,47,251,149,481
Texas,Bear Creek village,407,1,1,26,20,33,81
Texas,Haslet,1565,10,33,111,108,154,416
Texas,Haskell,3284,61,24,207,92,76,460
Texas,Hartley,637,11,9,70,46,33,169
Texas,Hart,1216,25,6,32,101,108,272
Texas,Harper,1035,8,31,80,109,30,258
Texas,Harlingen,65801,1083,1188,4607,4476,4090,15444
Texas,Harker Heights,28199,452,624,2325,2018,1880,7299
Texas,Hargill,380,0,0,9,35,18,62
Texas,Anahuac,2056,42,41,99,132,84,398
Texas,Anderson,248,6,3,16,17,3,45
Texas,Andrews,12696,104,209,1082,748,882,3025
Texas,Angleton,19153,143,371,1187,1402,1265,4368
Texas,Atascocita,70773,1375,1724,4448,5360,4796,17703
Texas,Aspermont,996,72,19,50,85,53,279
Texas,Asherton,967,38,0,59,33,94,224
Texas,Arroyo Gardens,403,0,10,20,0,12,42
Texas,Arroyo Colorado Estates,575,0,0,0,46,66,112
Texas,Arp,961,3,19,46,68,117,253
Texas,Arlington,379716,6688,6106,22110,21829,22896,79629
Texas,Argyle,3612,33,22,245,266,249,815
Texas,Arcola,2638,39,62,191,189,178,659
Texas,Archer City,1662,13,25,114,129,168,449
Texas,Hardin,854,40,18,37,22,51,168
Texas,Aransas Pass,8067,46,69,490,450,256,1311
Texas,Appleby,565,6,7,34,17,47,111
Texas,Anton,1236,21,9,83,102,91,306
Texas,Anthony,5305,62,94,331,226,265,978
Texas,Anson,2148,56,69,178,169,108,580
Texas,Annona,375,0,3,7,12,38,60
Texas,Annetta South,620,31,2,62,24,27,146
Texas,Annetta North,469,4,0,18,17,30,69
Texas,Annetta,1394,25,40,117,84,108,374
Texas,Anna,9733,258,323,732,483,315,2111
Texas,Angus,502,1,7,21,47,59,135
Texas,Aquilla,166,0,0,0,6,0,6
Texas,Happy,754,22,26,55,29,31,163
Texas,Hamlin,1627,4,21,72,133,97,327
Texas,Hamilton,2985,47,30,138,117,128,460
Texas,Irving,228776,3632,3496,14764,12246,10610,44748
Texas,Iredell,377,4,1,11,25,38,79
Texas,Iraan,1208,24,23,47,62,130,286
Texas,Iowa Park,6386,62,91,322,442,309,1226
Texas,Iowa Colony village,1232,7,19,61,42,61,190
Texas,Iola,486,0,6,36,37,38,117
Texas,Ingram,2044,7,39,97,203,124,470
Texas,Ingleside on the Bay,565,3,8,15,31,27,84
Texas,Ingleside,9554,84,111,692,654,786,2327
Texas,Inez,2148,39,40,48,178,193,498
Texas,Italy,1864,23,22,101,148,154,448
Texas,Industry,231,2,5,9,3,10,29
Texas,Indian Springs,807,0,0,0,97,46,143
Texas,Indian Lake,913,6,13,107,56,58,240
Texas,Indian Hills,2876,91,10,329,180,293,903
Texas,Imperial,345,4,0,20,12,17,53
Texas,Impact,11,0,0,0,0,0,0
Texas,Iglesia Antigua,421,12,0,20,31,22,85
Texas,Idalou,2373,77,50,166,138,120,551
Texas,Iago,76,0,0,0,0,0,0
Texas,Huxley,377,1,4,29,26,12,72
Texas,Hutto,20052,453,644,1539,1377,1062,5075
Texas,Indio,0,0,0,0,0,0,0
Texas,Athens,12777,109,216,774,977,476,2552
Texas,Itasca,1660,21,32,115,70,103,341
Texas,Jacinto City,10751,108,158,873,681,588,2408
Texas,Haltom City,43625,530,800,2835,2765,1761,8691
Texas,Hallsville,3888,9,211,411,114,86,831
Texas,Hallsburg,548,8,6,26,34,17,91
Texas,Hallettsville,2582,57,44,181,93,102,477
Texas,Hale Center,2486,36,36,130,222,172,596
Texas,Hackberry,1530,36,13,99,98,98,344
Texas,Gutierrez,21,0,0,0,8,7,15
Texas,Guthrie,147,2,0,4,4,6,16
Texas,Gustine,574,13,12,20,25,25,95
Texas,Gunter,1441,35,22,91,79,118,345
Texas,Ivanhoe,1184,19,8,48,67,61,203
Texas,Gun Barrel City,5856,58,89,255,316,290,1008
Texas,Guadalupe Guerra,13,0,0,0,3,2,5
Texas,Gruver,1112,29,13,104,75,39,260
Texas,Groveton,1365,18,11,74,156,120,379
Texas,Groves,15845,186,158,871,972,614,2801
Texas,Groom,561,3,7,23,61,25,119
Texas,Groesbeck,4326,76,87,272,293,172,900
Texas,Grey Forest,540,9,16,12,47,34,118
Texas,Houston,2217706,39298,34917,127482,118639,112833,433169
Texas,Howardwick,440,3,8,30,14,12,67
Texas,Jacksboro,4461,6,92,104,229,289,720
Texas,Guerra,0,0,0,0,0,0,0
Texas,Grapevine,49609,708,529,3407,2941,2232,9817
Texas,Atlanta,5635,260,155,282,219,223,1139
Texas,Aurora,1561,64,22,124,172,137,519
Texas,Chula Vista CDP (Zavala County),363,0,0,86,60,55,201
Texas,Chula Vista CDP (Maverick County),3438,139,69,380,216,173,977
Texas,Chula Vista CDP (Cameron County),491,14,0,98,0,0,112
Texas,Christoval,309,0,0,13,15,27,55
Texas,Christine,392,14,4,35,21,18,92
Texas,Chireno,408,0,0,22,36,37,95
Texas,China Spring,1345,39,36,91,36,71,273
Texas,China Grove,1299,4,14,16,30,36,100
Texas,China,891,0,7,32,41,46,126
Texas,Chilton,640,9,20,92,56,10,187
Texas,Chillicothe,796,6,0,23,28,69,126
Texas,Childress,6085,51,97,308,400,163,1019
Texas,Chico,1217,19,31,52,53,73,228
Texas,Chester,329,2,12,21,18,12,65
Texas,Charlotte,2031,32,25,144,161,100,462
Texas,Chapeno,60,0,0,0,0,0,0
Texas,Chaparrito,31,0,0,0,0,0,0
Texas,Channing,207,3,2,18,2,14,39
Texas,Channelview,39379,760,673,3156,2706,3061,10356
Texas,Chandler,2820,18,52,158,133,186,547
Texas,Cesar Chavez,1700,33,31,224,175,117,580
Texas,Cibolo,23977,549,311,1397,1721,2434,6412
Texas,Cienegas Terrace,2888,0,65,187,180,203,635
Texas,Cinco Ranch,17015,310,221,877,1380,1378,4166
Texas,Circle D-KC Estates,1962,0,0,165,159,75,399
Texas,Collinsville,1744,14,38,162,62,152,428
Texas,Colleyville,24453,422,331,1405,1682,1830,5670
Texas,College Station,101141,1338,807,3346,3497,3644,12632
Texas,Coleman,4508,72,126,184,148,117,647
Texas,Coldspring,911,29,23,36,32,43,163
Texas,Coffee City,281,6,2,8,8,3,27
Texas,Cockrell Hill,4284,127,41,284,323,341,1116
Texas,Coahoma,749,6,0,58,33,43,140
Texas,Clyde,3733,72,74,256,313,259,974
Texas,Clute,11324,143,175,724,636,741,2419
Texas,Central Gardens,4317,45,0,108,114,189,456
Texas,Cloverleaf,23285,316,542,1897,1718,1569,6042
Texas,Hurst,38458,567,579,2306,1876,1729,7057
Texas,Cleveland,7728,214,155,505,413,476,1763
Texas,Cleburne,29780,390,477,1768,1750,1613,5998
Texas,Clear Lake Shores,1235,12,3,42,38,30,125
Texas,Claude,1214,22,13,50,65,74,224
Texas,Clarksville City,768,3,0,40,25,46,114
Texas,Clarksville,3204,175,52,160,234,132,753
Texas,Clarendon,1993,18,40,70,93,92,313
Texas,Citrus City,4141,70,103,704,293,299,1469
Texas,Cisco,3833,0,51,66,72,213,402
Texas,Clint,820,5,15,27,19,41,107
Texas,Centerville,958,17,4,22,82,47,172
Texas,Center,5262,109,43,398,310,342,1202
Texas,Celina,6894,230,249,678,448,272,1877
Texas,Barstow,462,2,0,43,35,27,107
Texas,Barry,360,2,11,27,59,18,117
Texas,Barrett,4720,155,121,235,245,441,1197
Texas,Barrera,0,0,0,0,0,0,0
Texas,Bardwell,626,3,24,55,54,66,202
Texas,Banquete,684,9,25,18,8,24,84
Texas,Bangs,1674,37,0,95,74,105,311
Texas,Bandera,1207,37,21,120,50,42,270
Texas,B and E,698,0,0,46,31,82,159
Texas,Balmorhea,584,11,13,36,45,50,155
Texas,Bartlett,2226,0,20,54,106,107,287
Texas,Ballinger,3732,14,24,218,292,356,904
Texas,Balch Springs,24948,373,434,2241,2298,1848,7194
Texas,Baird,1841,24,23,111,42,106,306
Texas,Bailey's Prairie village,780,17,0,51,69,65,202
Texas,Bailey,214,0,6,6,13,11,36
Texas,Bacliff,8753,153,122,477,741,514,2007
Texas,Azle,10860,203,130,457,327,495,1612
Texas,Avinger,393,4,10,19,2,19,54
Texas,Avery,434,5,3,16,38,32,94
Texas,Austwell,124,0,0,1,0,5,6
Texas,Austin,887061,15020,11584,43665,38087,35474,143830
Texas,Balcones Heights,2930,33,87,118,208,49,495
Texas,Aubrey,2852,49,85,108,227,221,690
Texas,Carthage,6856,18,52,552,312,314,1248
Texas,Casas,42,0,0,0,0,0,0
Texas,Celeste,779,14,7,32,53,64,170
Texas,Cedar Point,762,0,12,27,12,0,51
Texas,Cedar Park,60841,1295,1295,4691,4343,3415,15039
Texas,Cedar Hill,47089,937,836,2918,3595,3467,11753
Texas,Catarina,139,0,0,0,0,0,0
Texas,Castroville,2860,28,24,136,184,162,534
Texas,Castle Hills,4311,76,43,229,217,170,735
Texas,Cashion Community,275,5,2,10,11,11,39
Texas,Greatwood,12198,425,96,876,1094,814,3305
Texas,Green Valley Farms,451,0,0,42,12,0,54
Texas,Casa Blanca,31,0,0,0,0,0,0
Texas,Greenville,26058,368,563,1382,1596,1024,4933
Texas,Hudson,4775,54,184,426,327,297,1288
Texas,Hudson Bend,2823,26,49,194,111,169,549
Texas,Hudson Oaks,2123,24,6,56,94,178,358
Texas,Hughes Springs,1902,91,24,119,146,55,435
Texas,Hull,529,0,0,7,27,47,81
Texas,Humble,15516,330,352,622,1117,743,3164
Texas,Hungerford,64,0,0,0,0,0,0
Texas,Hunters Creek Village,4620,52,117,289,330,445,1233
Texas,Huntington,2268,92,17,197,161,76,543
Texas,Huntsville,40129,469,505,1113,1187,1250,4524
Texas,Gregory,2137,12,41,109,161,138,461
Texas,Clifton,3385,55,0,227,210,168,660
Texas,Yznaga,23,0,0,0,0,0,0
Texas,Wheeler,1593,43,11,144,108,76,382
Texas,Cranfills Gap,265,0,8,12,14,12,46
Texas,Crawford,671,0,0,43,32,67,142
Texas,Creedmoor,177,3,0,0,9,7,19
Texas,Cresson,785,4,28,18,78,2,130
Texas,Crockett,6616,47,62,283,359,449,1200
Texas,Crosby,2600,103,46,178,112,61,500
Texas,Crosbyton,1770,40,33,94,91,60,318
Texas,Cross Mountain,2725,7,105,143,135,194,584
Texas,Cross Plains,1187,23,11,125,58,84,301
Texas,Cross Roads,1016,12,12,60,49,46,179
Texas,Cross Timber,295,1,1,20,4,11,37
Texas,Crowell,773,0,0,35,25,69,129
Texas,Crowley,14174,214,326,1151,1131,742,3564
Texas,Crystal City,7381,84,118,526,610,423,1761
Texas,Cuero,7024,304,17,461,353,432,1567
Texas,Cuevitas,0,0,0,0,0,0,0
Texas,Cumby,811,0,15,41,37,76,169
Texas,Cumings,1408,0,0,136,53,157,346
Texas,Cuney,88,0,0,8,7,0,15
Texas,Cushing,589,7,7,9,33,43,99
Texas,Cut and Shoot,1327,20,7,32,85,109,253
Texas,Crane,3756,44,48,343,190,223,848
Texas,Daingerfield,2815,80,11,159,147,149,546
Texas,Crandall,3059,80,71,185,231,212,779
Texas,Coyote Acres,447,0,0,0,74,98,172
Texas,Conroe,63521,984,1160,3596,3021,3133,11894
Texas,Converse,20450,431,297,1584,1222,1225,4759
Texas,Cool,241,5,1,9,17,9,41
Texas,Coolidge,727,5,6,58,26,46,141
Texas,Cooper,2096,22,26,100,62,99,309
Texas,Coppell,40602,794,565,2615,2533,3390,9897
Texas,Copperas Cove,33005,619,490,2180,2140,2044,7473
Texas,Copper Canyon,1128,20,3,33,53,48,157
Texas,Corinth,20614,672,235,1390,1469,1162,4928
Texas,Corpus Christi,316513,4772,4404,18485,17979,17189,62829
Texas,Corral City,16,1,1,0,0,0,2
Texas,Corrigan,1742,50,18,98,143,110,419
Texas,Corsicana,23945,164,425,1339,1654,1165,4747
Texas,Cottonwood,140,3,0,5,10,10,28
Texas,Cottonwood Shores,1414,28,23,73,99,113,336
Texas,Cotulla,3963,116,112,234,198,331,991
Texas,Country Acres,133,0,0,0,14,15,29
Texas,Coupland,207,2,4,23,2,7,38
Texas,Cove,451,11,10,23,27,21,92
Texas,Covington,267,5,9,6,21,2,43
Texas,Coyanosa,211,0,19,0,19,0,38
Texas,Coyote Flats,404,0,1,28,11,13,53
Texas,Daisetta,738,13,9,52,32,32,138
Texas,Dalhart,8254,171,97,538,675,612,2093
Texas,Dallas,1260688,20796,21137,75650,65861,61982,245426
Texas,Santa Cruz,136,0,0,0,0,0,0
Texas,Santa Fe,12700,133,223,706,1041,743,2846
Texas,Santa Maria,822,44,0,55,75,65,239
Texas,Santa Monica,90,0,0,0,0,16,16
Texas,Santa Rosa,2893,72,24,181,244,320,841
Texas,Santa Rosa,237,0,0,5,11,25,41
Texas,Santel,0,0,0,0,0,0,0
Texas,San Ygnacio,461,0,0,25,50,25,100
Texas,Sarita,425,0,0,43,71,26,140
Texas,Savannah,4557,48,110,376,356,299,1189
Texas,Savoy,642,0,2,15,17,23,57
Texas,Scenic Oaks,5468,51,45,445,325,296,1162
Texas,Schertz,36535,494,403,2466,2364,2269,7996
Texas,Schulenburg,2892,61,102,127,98,64,452
Texas,Scissors,3234,37,114,285,332,301,1069
Texas,Scotland,555,0,5,30,36,52,123
Texas,Scottsville,341,8,3,9,24,25,69
Texas,Scurry,654,10,0,44,34,41,129
Texas,Seabrook,12774,238,213,714,708,1051,2924
Texas,Seadrift,1534,22,18,91,78,73,282
Texas,Seagoville,15558,144,324,1249,1035,613,3365
Texas,Santa Clara,723,9,11,17,38,67,142
Texas,Santa Anna,47,0,0,0,13,0,13
Texas,Santa Anna,1357,16,12,97,74,128,327
Texas,Sansom Park,4796,100,73,345,405,123,1046
Texas,Dalworthington Gardens,2119,9,13,80,70,191,363
Texas,Damon,549,6,6,60,8,35,115
Texas,Danbury,1463,9,27,82,83,94,295
Texas,Darrouzett,389,11,5,31,19,22,88
Texas,Dawson,801,24,31,27,38,34,154
Texas,Dayton,7413,136,109,394,475,311,1425
Texas,Dayton Lakes,182,0,3,0,20,9,32
Texas,Dean,543,9,7,34,28,29,107
Texas,Decatur,6301,156,133,314,410,254,1267
Texas,DeCordova,2763,0,51,97,184,116,448
Texas,Concepcion,39,0,0,0,0,0,0
Texas,Deer Park,33313,544,391,2017,1830,2047,6829
Texas,De Leon,2221,60,7,142,109,97,415
Texas,Dell City,321,0,11,7,2,30,50
Texas,Del Mar Heights,230,17,0,35,35,17,104
Texas,San Leanna village,599,0,2,15,9,45,71
Texas,San Leon,5299,85,46,222,264,211,828
Texas,San Marcos,54712,503,541,1667,1696,2090,6497
Texas,San Patricio,448,0,4,11,12,16,43
Texas,San Pedro,473,18,0,32,33,10,93
Texas,San Perlita,664,8,26,59,50,26,169
Texas,San Saba,3020,65,27,242,107,254,695
Texas,De Kalb,1665,31,35,82,63,66,277
Texas,Como,770,4,21,113,65,51,254
Texas,Commerce,8558,131,29,401,301,205,1067
Texas,Comfort,3091,0,46,101,149,468,764
Texas,Keller,43107,717,695,2944,3324,3271,10951
Texas,Kemah,2125,19,15,49,197,145,425
Texas,Kemp,1522,32,36,79,118,68,333
Texas,Kempner,1326,12,12,39,50,75,188
Texas,Kendleton,296,0,9,15,5,9,38
Texas,Kenedy,3410,93,88,182,251,167,781
Texas,Kenefick,485,3,0,21,55,20,99
Texas,Kennard,348,5,2,11,20,37,75
Texas,Kennedale,7273,59,149,240,321,529,1298
Texas,Kerens,1651,42,39,77,134,103,395
Texas,Kermit,6057,73,195,465,335,389,1457
Texas,Kerrville,22687,349,210,1053,1001,927,3540
Texas,Kilgore,14442,236,191,830,638,732,2627
Texas,Killeen,136378,3119,2903,8756,7371,7392,29541
Texas,Kingsbury,799,36,7,55,24,27,149
Texas,Kingsland,6756,222,136,243,345,411,1357
Texas,Kingsville,26285,739,395,1343,1669,1394,5540
Texas,Kirby,8332,33,108,436,558,317,1452
Texas,Kirbyville,2409,4,70,220,134,189,617
Texas,Kirvin,117,0,5,2,0,12,19
Texas,Knippa,788,23,10,77,51,40,201
Texas,Keene,6091,109,85,457,347,378,1376
Texas,K-Bar Ranch,701,0,0,0,0,206,206
Texas,Kaufman,6947,122,84,464,454,316,1440
Texas,Katy,15796,341,99,826,828,1099,3193
Texas,Jacksonville,14743,178,281,1065,1057,947,3528
Texas,Jamaica Beach,1008,0,0,49,29,48,126
Texas,Jardin de San Julian,27,0,0,6,0,0,6
Texas,Jarrell,927,11,0,33,48,61,153
Texas,Jasper,7684,193,301,660,465,552,2171
Texas,Jayton,614,10,0,16,37,14,77
Texas,Jefferson,2305,21,4,125,89,98,337
Texas,Jersey Village,7849,104,108,264,180,366,1022
Texas,Jewett,1318,28,35,87,58,47,255
Texas,J.F. Villareal,37,0,0,0,0,0,0
Texas,Knollwood,394,2,0,13,17,8,40
Texas,Joaquin,913,11,10,96,71,51,239
Texas,Jolly,162,0,3,8,11,6,28
Texas,Jones Creek village,2506,41,56,151,154,164,566
Texas,Jonestown,1945,24,55,60,102,65,306
Texas,Josephine,809,7,13,61,35,46,162
Texas,Joshua,5966,53,124,437,311,339,1264
Texas,Jourdanton,4120,91,30,267,326,284,998
Texas,Juarez,294,0,0,0,0,32,32
Texas,Junction,2643,35,41,86,111,158,431
Texas,Justin,3351,69,68,205,178,178,698
Texas,Karnes City,3216,42,57,217,134,245,695
Texas,Johnson City,1738,78,4,152,77,72,383
Texas,Seagraves,2606,57,17,229,192,128,623
Texas,Knox City,1179,9,19,88,148,79,343
Texas,Kountze,2037,19,75,75,96,147,412
Texas,Olton,1852,21,19,88,61,106,295
Texas,Olney,3215,105,56,124,138,191,614
Texas,Olmos Park,1990,52,9,142,135,106,444
Texas,Olmito and Olmito,275,0,26,24,38,51,139
Texas,Olmito,948,0,18,10,82,136,246
Texas,Olivia Lopez de Gutierrez,0,0,0,0,0,0,0
Texas,Olivarez,3800,39,123,294,410,453,1319
Texas,Old River-Winfree,1894,7,40,113,96,162,418
Texas,Oilton,362,13,0,17,20,4,54
Texas,Oglesby,590,4,25,25,60,21,135
Texas,O'Donnell,982,11,13,89,79,74,266
Texas,Odessa,111330,1463,2342,6924,7180,6153,24062
Texas,Baytown,74897,1322,1322,4996,5199,4487,17326
Texas,Bayside,417,1,6,17,13,32,69
Texas,Bayou Vista,1861,11,2,36,47,37,133
Texas,Bay City,17499,456,328,1141,976,1017,3918
Texas,Batesville,1122,16,20,0,95,55,186
Texas,Bastrop,7669,131,159,272,364,324,1250
Texas,Bartonville,2101,38,25,168,172,187,590
Texas,Barton Creek,3373,18,80,116,132,194,540
Texas,Combine,2091,34,38,111,80,100,363
Texas,Omaha,931,11,1,23,102,15,152
Texas,Onalaska,1719,16,22,120,92,77,327
Texas,Opdyke West,112,4,1,8,8,1,22
Texas,Orange,18945,391,270,808,761,1227,3457
Texas,Kress,623,13,14,38,15,48,128
Texas,Krugerville,1555,41,20,111,82,82,336
Texas,Krum,4625,59,50,217,519,369,1214
Texas,Kurten,341,6,9,19,18,18,70
Texas,Kyle,32078,888,623,2542,2496,1917,8466
Texas,La Blanca,2421,15,4,192,170,201,582
Texas,La Carla,179,31,0,21,4,3,59
Texas,La Casita,0,0,0,0,0,0,0
Texas,La Chuparosa,0,0,0,0,0,0,0
Texas,Lackland AFB,7714,68,73,201,182,418,942
Texas,Kosse,378,5,6,16,7,10,44
Texas,La Coma,25,0,0,0,0,0,0
Texas,Lacy-Lakeview,6561,91,122,333,460,332,1338
Texas,Ladonia,537,17,2,61,15,29,124
Texas,La Escondida,23,0,0,4,0,4,8
Texas,La Esperanza,30,0,0,0,0,0,0
Texas,La Feria,7325,160,111,637,535,342,1785
Texas,La Feria North,86,0,0,0,0,0,0
Texas,Lago,126,0,0,0,0,0,0
Texas,Lago Vista,134,0,0,34,0,0,34
Texas,Orason,106,0,0,0,0,0,0
Texas,Orange Grove,1422,2,11,62,47,85,207
Texas,LaCoste,1299,15,47,76,65,24,227
Texas,Wharton,8733,79,105,535,522,316,1557
Texas,Orchard,322,2,7,24,22,17,72
Texas,Overton,2426,14,50,137,91,137,429
Texas,Shady Hollow,5187,37,15,296,157,380,885
Texas,Shady Shores,2776,35,56,205,153,74,523
Texas,Shallowater,2529,37,29,160,182,211,619
Texas,Shamrock,1861,5,10,101,79,74,269
Texas,Shavano Park,3326,72,48,150,132,222,624
Texas,Sheldon,1615,0,0,90,77,118,285
Texas,Shenandoah,2523,15,2,85,76,52,230
Texas,Shepherd,2887,37,117,222,210,51,637
Texas,Sherman,39569,644,414,2546,2052,2250,7906
Texas,Sherwood Shores,1087,0,0,13,27,6,46
Texas,Shiner,2088,48,26,82,135,127,418
Texas,Shoreacres,1767,27,7,122,144,161,461
Texas,Sienna Plantation,15720,337,385,1082,1454,1454,4712
Texas,Sierra Blanca,453,2,15,31,17,20,85
Texas,Siesta Acres,2260,13,23,202,70,70,378
Texas,Siesta Shores,1457,52,41,172,62,28,355
Texas,Silsbee,6687,44,80,526,381,336,1367
Texas,Silverton,722,9,21,51,71,51,203
Texas,Simonton,786,33,21,48,56,22,180
Texas,Sinton,5701,0,34,354,256,331,975
Texas,Skellytown,475,0,12,38,48,17,115
Texas,Shadybrook,1585,0,17,0,198,49,264
Texas,Skidmore,934,15,0,8,0,33,56
Texas,Seymour,2484,28,28,118,190,187,551
Texas,Seven Oaks,175,0,2,12,10,18,42
Texas,La Presa,330,0,0,30,25,14,69
Texas,La Pryor,1568,72,29,107,129,90,427
Texas,La Puerta,391,6,21,4,20,35,86
Texas,Laredo,248855,5652,4788,19731,18471,17882,66524
Texas,Laredo Ranchettes,58,0,0,0,11,19,30
Texas,Laredo Ranchettes West,0,0,0,0,0,0,0
Texas,La Rosita,106,0,0,0,0,18,18
Texas,Lasana,67,0,0,6,0,4,10
Texas,Lasara,994,21,9,61,69,105,265
Texas,Las Haciendas,0,0,0,0,0,0,0
Texas,Las Lomas,3743,105,125,206,342,339,1117
Texas,Las Lomitas,312,0,0,31,29,34,94
Texas,Las Palmas,17,0,0,0,0,0,0
Texas,Las Palmas II,1765,153,64,168,61,82,528
Texas,Las Pilas,0,0,0,0,0,0,0
Texas,Las Quintas Fronterizas,2251,63,0,159,82,218,522
Texas,Latexo,337,2,7,26,36,20,91
Texas,La Tina Ranch,730,0,57,0,12,59,128
Texas,Laughlin AFB,2163,35,13,122,77,24,271
Texas,Laureles,5087,19,143,463,363,458,1446
Texas,Seth Ward,1838,46,8,146,169,143,512
Texas,Seven Points,1360,22,10,64,54,82,232
Texas,Slaton,6097,22,170,266,471,283,1212
Texas,Smiley,578,7,18,32,43,50,150
Texas,Zuehl,468,0,0,0,0,16,16
Texas,Windthorst,318,1,0,21,11,18,51
Texas,Windom,177,6,2,3,7,9,27
Texas,Windcrest,5648,11,70,118,80,197,476
Texas,Wimberley,2625,10,6,97,194,144,451
Texas,Wilson,518,16,11,27,23,25,102
Texas,Wilmer,3826,57,21,374,218,202,872
Texas,Wills Point,3518,41,92,244,123,341,841
Texas,Willow Park,4478,18,98,215,321,188,840
Texas,Willis,6127,35,0,782,693,232,1742
Texas,Wildwood,711,0,0,0,25,52,77
Texas,Wild Peach Village,2367,56,61,169,171,134,591
Texas,Wickett,452,9,8,24,6,12,59
Texas,Wichita Falls,104926,1831,1649,5492,4870,4888,18730
Texas,Whitney,2349,24,67,231,147,113,582
Texas,Whitewright,1868,17,30,176,87,88,398
Texas,White Settlement,16733,150,256,1118,813,687,3024
Texas,Whitesboro,3842,32,86,167,318,244,847
Texas,White Oak,6409,16,42,539,625,366,1588
Texas,Whitehouse,7994,284,128,724,464,317,1917
Texas,Whiteface,404,23,2,38,22,29,114
Texas,White Deer,930,25,0,89,41,42,197
Texas,Winfield,487,12,2,51,36,50,151
Texas,Wink,1001,24,28,57,33,56,198
Texas,Winnie,3238,0,67,193,174,174,608
Texas,Winnsboro,3273,11,52,222,220,180,685
Texas,Zavalla,771,7,9,16,41,54,127
Texas,Zarate,26,0,0,0,0,0,0
Texas,Zapata Ranch,200,0,0,73,0,24,97
Texas,Zapata,4222,90,76,303,216,71,756
Texas,Yorktown,2053,25,0,129,70,35,259
Texas,Yoakum,5483,171,51,293,274,335,1124
Texas,Yantis,571,0,4,29,33,27,93
Texas,Wylie,44461,808,1041,3103,3193,2843,10988
Texas,Wyldwood,3912,0,0,182,377,367,926
Texas,Wortham,1044,0,20,76,80,54,230
Texas,La Porte,34746,663,391,2053,2100,2131,7338
Texas,Woodway,8667,69,100,323,284,522,1298
Texas,Woodson,272,3,0,9,21,30,63
Texas,Woodsboro,1500,46,10,53,124,108,341
Texas,Woodloch,213,2,0,10,15,13,40
Texas,Woodcreek,1288,3,8,33,27,44,115
Texas,Woodbranch,1431,22,21,59,69,64,235
Texas,Wolfforth,3996,132,119,308,319,277,1155
Texas,Wolfe City,1636,47,18,113,109,82,369
Texas,Wixon Valley,257,6,2,7,12,17,44
Texas,Winters,2551,102,24,225,118,177,646
Texas,Winona,893,7,9,50,58,28,152
Texas,Woodville,2738,35,20,193,166,130,544
Texas,La Paloma Ranchettes,497,0,27,52,85,50,214
Texas,La Paloma-Lost Creek,637,4,19,58,27,58,166
Texas,La Paloma Addition,101,0,0,0,0,15,15
Texas,Palo Pinto,216,0,0,0,13,8,21
Texas,Pampa,18216,273,295,1082,1186,889,3725
Texas,Panhandle,2549,24,25,245,126,225,645
Texas,Panorama Village,2013,12,0,15,49,56,132
Texas,Pantego,2475,55,15,59,163,197,489
Texas,Paradise,415,3,1,16,18,31,69
Texas,Paris,24903,537,302,1183,1380,1344,4746
Texas,Parker,4118,167,40,267,317,321,1112
Texas,Big Thicket Lake Estates,659,0,28,40,41,33,142
Texas,Pasadena,153036,2671,2339,10796,9841,9923,35570
Texas,Pattison,586,3,28,29,20,18,98
Texas,Patton Village,1925,0,58,136,161,182,537
Texas,Pawnee,168,0,11,6,9,0,26
Texas,Payne Springs,626,7,6,16,14,29,72
Texas,Pearland,101725,2435,2637,6425,6546,5040,23083
Texas,Pearsall,9651,202,167,558,459,554,1940
Texas,Pecan Acres,5437,78,61,447,546,474,1606
Texas,Pecan Gap,231,0,4,6,5,1,16
Texas,Pecan Grove,16399,234,197,872,968,895,3166
Texas,Pecan Hill,763,2,13,32,64,41,152
Texas,Pecan Plantation,5755,49,62,137,148,236,632
Texas,Paloma Creek South,5141,180,86,397,158,207,1028
Texas,Paloma Creek,3780,177,36,578,565,69,1425
Texas,Palo Blanco,170,0,8,8,8,6,30
Texas,Palmview South,5476,86,82,288,558,473,1487
Texas,Ovilla,3616,132,85,243,329,192,981
Texas,Owl Ranch,126,0,0,0,39,0,39
Texas,Oyster Creek,1088,9,7,104,63,108,291
Texas,Ozona,3101,52,48,128,114,139,481
Texas,Pablo Pena,0,0,0,0,0,0,0
Texas,Paducah,1219,86,0,62,55,41,244
Texas,Paint Rock,357,10,7,16,31,23,87
Texas,Paisano Park,81,0,0,0,0,0,0
Texas,Palacios,4659,78,83,482,172,199,1014
Texas,Palestine,18488,419,210,1264,1076,967,3936
Texas,Pecos,9074,114,81,555,618,645,2013
Texas,Palisades village,286,1,0,29,9,5,44
Texas,Palmhurst,2642,56,10,184,159,199,608
Texas,Sealy,6222,40,108,479,393,494,1514
Texas,Sebastian,1676,23,27,75,103,126,354
Texas,Seco Mines,477,20,0,32,6,6,64
Texas,Seguin,27095,424,423,1538,1512,1733,5630
Texas,Selma,7743,82,93,540,650,487,1852
Texas,Seminole,7018,59,106,403,404,288,1260
Texas,Serenada,1399,0,0,28,101,103,232
Texas,Palm Valley,1720,55,10,95,91,39,290
Texas,Palmview,5626,134,99,359,513,573,1678
Texas,Palmer,2302,43,69,192,159,152,615
Texas,Ore City,981,19,16,60,35,48,178
Texas,Pelican Bay,1867,21,52,115,123,110,421
Texas,Penelope,204,2,3,19,16,9,49
Texas,Lake Meredith Estates,146,0,0,0,0,0,0
Texas,Lakeport,1097,13,11,37,60,107,228
Texas,Lakeshore Gardens-Hidden Acres,845,18,28,75,69,7,197
Texas,Lakeside town (San Patricio County),294,2,7,15,10,1,35
Texas,Lakeside town (Tarrant County),1592,10,18,10,52,122,212
Texas,Lakeside City,1036,18,4,72,50,46,190
Texas,Lake Tanglewood village,694,0,10,14,21,26,71
Texas,Lakeview,89,0,0,0,0,1,1
Texas,Lake View,127,0,0,0,0,0,0
Texas,Lakeway,13212,182,102,788,794,954,2820
Texas,Lakewood Village,584,2,15,22,39,55,133
Texas,Lake Worth,4718,41,16,360,160,184,761
Texas,La Loma de Falcon,115,0,0,0,21,19,40
Texas,Lamar,1040,0,19,0,0,0,19
Texas,La Marque,15230,295,169,775,902,901,3042
Texas,Lamesa,9343,127,210,549,641,602,2129
Texas,La Minita,127,0,0,0,16,6,22
Texas,Lampasas,7096,150,57,554,297,371,1429
Texas,Lancaster,38152,793,813,2105,2551,2778,9040
Texas,Lantana,8585,212,255,562,984,659,2672
Texas,La Paloma,2704,75,21,346,215,336,993
Texas,Lake Medina Shores,896,0,0,29,45,88,162
Texas,Lake Kiowa,2522,0,35,17,76,47,175
Texas,Lake Jackson,27352,482,315,1840,1721,1287,5645
Texas,Lakehills,4900,55,125,253,234,248,915
Texas,Penitas,4551,50,66,282,432,366,1196
Texas,Perezville,4680,135,0,304,429,386,1254
Texas,Perrin,415,0,0,16,0,0,16
Texas,Perryton,9358,180,232,665,584,760,2421
Texas,Petersburg,1137,33,26,47,70,89,265
Texas,Lago Vista,6443,34,88,193,282,476,1073
Texas,La Grange,4666,56,248,398,280,214,1196
Texas,La Grulla,1319,6,41,88,28,74,237
Texas,Laguna Heights,3240,100,82,232,244,189,847
Texas,Laguna Park,1446,15,14,32,35,30,126
Texas,Pena,185,0,0,0,51,59,110
Texas,Laguna Seca,383,0,18,20,12,14,64
Texas,La Homa,13406,234,191,1302,1032,1312,4071
Texas,La Joya,4183,221,63,270,360,209,1123
Texas,Lake Bridgeport,422,0,3,13,17,19,52
Texas,Lake Brownwood,1264,0,7,139,73,13,232
Texas,Lake Bryan,2262,96,43,192,204,145,680
Texas,Lake Cherokee,2665,17,45,108,89,35,294
Texas,Lake City,442,0,6,25,8,23,62
Texas,Lake Colorado City,518,8,12,10,26,20,76
Texas,Lake Dallas,7465,132,91,370,294,357,1244
Texas,Lake Dunlap,2688,39,99,298,111,122,669
Texas,Laguna Vista,3211,42,48,106,198,129,523
Texas,Big Wells,737,23,29,50,32,1,135
Texas,Lolita,589,0,0,87,73,29,189
Texas,Bishop Hills,285,0,7,4,27,39,77
Texas,Bullard,2677,71,30,302,173,236,812
Texas,Buffalo Springs village,375,11,0,3,0,6,20
Texas,Buffalo Gap,408,0,2,23,19,7,51
Texas,Buffalo,2129,11,23,219,100,182,535
Texas,Buena Vista,144,0,0,25,28,3,56
Texas,Buda,10655,272,145,767,672,539,2395
Texas,Buckholts,471,2,11,26,31,75,145
Texas,Buchanan Lake Village,722,0,14,24,41,0,79
Texas,Buchanan Dam,1145,0,0,2,6,41,49
Texas,Bryson,536,17,3,29,32,83,164
Texas,Bryan,79411,1279,1181,4491,4379,3194,14524
Texas,Brushy Creek,21254,540,331,1204,1909,1847,5831
Texas,Bulverde,4761,70,126,95,291,196,778
Texas,Bruni,261,0,0,4,10,10,24
Texas,Bruceville-Eddy,1616,7,45,180,118,101,451
Texas,Brownwood,19021,331,324,1070,1075,980,3780
Texas,Brownsville,181487,3870,2994,13524,13004,13810,47202
Texas,Brownsboro,1039,34,22,59,60,104,279
Texas,Brownfield,9688,170,168,621,515,696,2170
Texas,Browndell,189,2,0,8,16,3,29
Texas,Brookside Village,1532,12,29,77,89,82,289
Texas,Brookshire,4879,58,116,417,190,579,1360
Texas,Bronte,860,3,10,20,46,33,112
Texas,Broaddus,194,0,5,3,5,20,33
Texas,Bristol,275,0,0,0,0,0,0
Texas,Bridgeport,6192,81,103,286,546,375,1391
Texas,Brundage,0,0,0,0,0,0,0
Texas,Buna,2600,0,111,287,126,54,578
Texas,Bunker Hill Village,3842,103,91,336,267,344,1141
Texas,Burkburnett,10960,270,85,475,612,497,1939
Texas,Canyon Creek,1438,0,0,23,115,53,191
Texas,Canyon,14248,286,219,667,416,691,2279
Texas,Canutillo,6110,116,50,267,427,409,1269
Texas,Cantu Addition,428,0,0,12,56,26,94
Texas,Canton,3578,28,18,159,108,143,456
Texas,Caney City,212,0,0,0,2,6,8
Texas,Canadian,2999,4,90,246,211,236,787
Texas,Camp Wood,910,29,9,15,20,33,106
Texas,Camp Swift,6461,67,152,492,380,321,1412
Texas,Campo Verde,183,0,0,0,0,7,7
Texas,Campbell,515,10,7,41,46,42,146
Texas,Cameron Park,6972,164,89,533,717,487,1990
Texas,Cameron,5448,160,149,258,414,411,1392
Texas,Camargito,433,22,0,16,40,27,105
Texas,Calvert,1327,7,22,133,115,117,394
Texas,Callisburg,345,10,7,15,44,9,85
Texas,Callender Lake,1201,0,0,4,4,21,29
Texas,Caldwell,4214,104,31,368,204,213,920
Texas,Caddo Mills,1772,46,25,173,138,109,491
Texas,Cactus,3210,18,3,186,218,279,704
Texas,Bynum,191,4,1,4,12,13,34
Texas,Byers,506,9,17,29,35,29,119
Texas,Butterfield,83,0,0,4,3,3,10
Texas,Burton,393,1,0,43,12,5,61
Texas,Burnet,6104,70,48,360,516,202,1196
Texas,Burleson,40652,439,705,2956,3133,2587,9820
Texas,Burke,703,4,7,23,75,28,137
Texas,Bridge City,7907,166,223,401,665,585,2040
Texas,Briaroaks,548,0,2,24,32,54,112
Texas,Briarcliff village,1565,16,5,94,74,68,257
Texas,Talco,558,8,17,34,17,41,117
Texas,Stanton,2738,36,99,283,132,150,700
Texas,Stamford,3004,8,42,197,270,162,679
Texas,Stagecoach,596,11,5,21,35,55,127
Texas,Stafford,18097,129,414,705,816,881,2945
Texas,Spur,1157,0,12,77,63,42,194
Texas,Spring Valley Village,4031,93,47,244,235,271,890
Texas,Springtown,2741,54,24,110,166,167,521
Texas,Springlake,111,4,0,5,9,10,28
Texas,Spring Gardens,627,0,0,61,62,68,191
Texas,Spring,56369,982,1105,3451,3837,3870,13245
Texas,Odem,2671,89,54,226,199,138,706
Texas,O'Brien,116,0,0,7,8,15,30
Texas,Oakwood,515,3,1,16,17,26,63
Texas,Oak Valley,444,16,7,25,10,14,72
Texas,Oak Trail Shores,2880,75,17,306,135,101,634
Texas,Oak Ridge North,3127,13,50,168,186,199,616
Texas,Oak Ridge town (Kaufman County),454,5,12,27,6,33,83
Texas,Oak Ridge town (Cooke County),126,3,5,3,7,7,25
Texas,Oak Point,3107,47,17,150,189,129,532
Texas,Oak Leaf,1467,37,7,65,45,117,271
Texas,Oak Island,282,0,0,21,31,18,70
Texas,Oakhurst,481,0,60,108,0,0,168
Texas,Oak Grove,862,16,0,68,36,124,244
Texas,Novice,80,0,0,9,12,8,29
Texas,North San Pedro,589,19,0,21,46,18,104
Texas,Northridge,0,0,0,0,0,0,0
Texas,North Richland Hills,66950,1370,976,3684,3248,3978,13256
Texas,Staples,289,0,2,9,7,3,21
Texas,Canyon Lake,22759,99,253,863,1040,1001,3256
Texas,Star Harbor,436,0,7,8,9,3,27
Texas,Sterling City,1026,0,9,82,53,60,204
Texas,Tahoka,2605,53,21,254,122,103,553
Texas,Taft Southwest,1301,32,24,92,56,91,295
Texas,Taft,3063,32,12,123,217,359,743
Texas,Sweetwater,10794,277,170,758,618,450,2273
Texas,Sweeny,3738,95,131,198,217,323,964
Texas,Surfside Beach,588,8,6,10,16,32,72
Texas,Sun Valley,153,0,0,13,0,0,13
Texas,Sunset Valley,821,12,14,44,64,55,189
Texas,Sunset Acres,0,0,0,0,0,0,0
Texas,Sunset CDP (Starr County),30,0,0,0,3,3,6
Texas,Sunset CDP (Montague County),255,0,10,11,0,11,32
Texas,Sunrise Beach Village,747,6,3,10,21,28,68
Texas,Sunray,2071,31,19,133,168,92,443
Texas,Sunnyvale,5677,89,55,323,329,691,1487
Texas,Sundown,1312,40,36,102,109,81,368
Texas,Sulphur Springs,15780,239,197,643,992,835,2906
Texas,Sullivan City,4125,127,65,251,307,194,944
Texas,Sugar Land,84268,1609,1265,4241,4422,5508,17045
Texas,Sudan,978,24,18,48,68,58,216
Texas,Study Butte,252,6,3,24,24,10,67
Texas,Streetman,255,10,5,17,18,10,60
Texas,Strawn,533,2,14,16,37,5,74
Texas,Stratford,2145,46,55,199,123,133,556
Texas,Stowell,1504,60,0,69,250,49,428
Texas,Stonewall,445,0,0,24,19,26,69
Texas,Stockdale,1530,37,32,96,132,65,362
Texas,Stinnett,1498,26,9,105,93,66,299
Texas,Stephenville,19074,165,151,997,576,849,2738
Texas,North Pearsall,963,75,55,0,68,56,254
Texas,Cape Royale,575,0,0,0,0,0,0
Texas,Carlsbad,655,17,15,35,50,42,159
Texas,Emory,1017,8,20,25,61,61,175
Texas,Emhouse,108,2,0,4,2,2,10
Texas,Emerald Bay,1006,0,0,0,0,74,74
Texas,El Socio,137,0,0,19,0,0,19
Texas,Elsa,6444,115,227,579,590,463,1974
Texas,El Refugio,377,0,37,10,0,24,71
Texas,El Rancho Vela,224,24,0,19,25,9,77
Texas,El Quiote,208,0,0,0,0,0,0
Texas,El Paso,676325,12030,9695,41796,42498,43021,149040
Texas,E. Lopez,75,0,0,0,8,11,19
Texas,Elmo,792,0,0,188,31,29,248
Texas,El Mesquite,0,0,0,0,0,0,0
Texas,Encantada-Ranchito-El Calaboz,1756,62,69,63,128,202,524
Texas,Elmendorf,1234,8,17,25,58,79,187
Texas,El Lago,2754,48,25,129,200,89,491
Texas,Robstown,11616,337,221,891,643,599,2691
Texas,Robinson,11214,83,198,729,677,738,2425
Texas,Robert Lee,1071,11,24,104,59,13,211
Texas,Roaring Springs,311,9,0,13,17,25,64
Texas,Roanoke,6770,116,127,290,438,309,1280
Texas,Riviera,760,9,28,28,51,42,158
Texas,Riverside,600,3,7,19,29,35,93
Texas,River Oaks,7641,142,152,511,434,496,1735
Texas,Rivereno,0,0,0,0,0,0,0
Texas,Rising Star,1047,19,10,63,86,112,290
Texas,Rio Vista,1174,21,45,95,96,60,317
Texas,Elm Creek,2840,47,12,162,183,332,736
Texas,Enchanted Oaks,370,0,2,3,6,25,36
Texas,Encinal,904,6,14,82,51,73,226
Texas,Encino,53,6,0,0,0,0,6
Texas,Falman,125,0,0,0,14,24,38
Texas,Falls City,581,13,0,34,19,0,66
Texas,Falfurrias,4512,101,39,191,211,98,640
Texas,Falcon Village,45,0,0,0,0,0,0
Texas,Falcon Mesa,663,0,0,42,23,38,103
Texas,Falcon Lake Estates,1620,103,109,90,135,240,677
Texas,Falcon Heights,30,0,0,0,0,0,0
Texas,Falconaire,115,0,13,0,7,20,40
Texas,Fairview,8109,135,58,338,425,306,1262
Texas,Fair Oaks Ranch,7315,151,55,539,490,469,1704
Texas,Fairfield,2897,97,45,164,145,159,610
Texas,Fairchilds village,817,17,6,104,42,42,211
Texas,Fabrica,851,0,9,99,148,120,376
Texas,Fabens,7846,176,203,731,594,718,2422
Texas,Everman,6279,39,109,351,581,585,1665
Texas,Evergreen,10,0,0,0,0,0,0
Texas,Evant,423,5,0,8,43,39,95
Texas,Evadale,1553,22,57,82,67,112,340
Texas,Eustace,1089,17,17,50,59,102,245
Texas,Alvin,25224,275,504,1366,1339,1372,4856
Texas,Eureka,359,4,2,18,41,24,89
Texas,Euless,53220,749,704,3210,2886,2369,9918
Texas,Eugenio Saenz,39,0,0,0,8,6,14
Texas,Hubbard,1640,28,26,96,111,107,368
Texas,Estelline,76,2,0,0,0,8,10
Texas,Escobares,1690,21,59,71,94,108,353
Texas,Ennis,18758,423,149,1371,1440,1170,4553
Texas,Rio Hondo,2005,25,29,67,133,141,395
Texas,Rio Grande City,14154,500,182,1064,934,1137,3817
Texas,Rio Bravo,4860,173,61,465,365,357,1421
Texas,Riesel,1028,13,22,46,69,72,222
Texas,Rangerville village,52,0,0,0,0,0,0
Texas,Ranger,3238,12,156,341,65,159,733
Texas,Randolph AFB,1120,39,30,106,143,71,389
Texas,Rancho Viejo,231,31,0,7,7,31,76
Texas,Rancho Viejo,2277,57,25,111,182,169,544
Texas,Ranchos Penitas West,819,0,18,114,30,126,288
Texas,Rancho Chico,572,0,0,0,0,44,44
Texas,Rancho Banquete,602,0,86,0,48,0,134
Texas,Rancho Alegre,1612,56,0,60,112,78,306
Texas,Ranchitos Las Lomas,127,0,0,20,7,0,27
Texas,Ranchitos East,353,13,0,31,33,16,93
Texas,Ranchitos del Norte,0,0,0,0,0,0,0
Texas,Ranchette Estates,80,0,0,0,18,0,18
Texas,Ramos,235,0,24,23,13,46,106
Texas,Ramirez-Perez,41,0,0,0,0,0,0
Texas,Ramireno,76,0,0,0,0,46,46
Texas,Ralls,1946,40,31,135,145,132,483
Texas,Rafael Pena,0,0,0,0,0,0,0
Texas,Radar Base,610,0,0,4,0,0,4
Texas,Quitman,2019,14,14,103,97,129,357
Texas,Quitaque,478,2,5,23,23,26,79
Texas,Quintana,44,0,0,1,5,0,6
Texas,Carrollton,127279,2002,1870,6603,7212,7441,25128
Texas,Carrizo Springs,5740,167,12,273,505,355,1312
Texas,Carrizo Hill,1046,0,0,99,88,92,279
Texas,Carmine,211,4,2,5,0,16,27
Texas,Carl's Corner,155,2,0,5,10,10,27
Texas,Rankin,811,20,0,31,33,63,147
Texas,Carbon,396,30,0,40,23,55,148
Texas,Ransom Canyon,1319,17,28,83,119,57,304
Texas,Ravenna,184,3,0,0,0,13,16
Texas,Richwood,3686,88,75,264,165,111,703
Texas,Richmond,11895,211,229,691,635,607,2373
Texas,Richland Springs,295,0,6,24,35,21,86
Texas,Richland Hills,7992,79,96,245,366,406,1192
Texas,Richland,222,2,0,3,6,4,15
Texas,Richardson,106123,1794,1430,4553,5514,5485,18776
Texas,Rice,989,7,21,92,99,112,331
Texas,Ricardo,693,0,0,14,15,0,29
Texas,Rhome,1572,19,17,75,138,101,350
Texas,Retreat,389,3,5,32,18,15,73
Texas,Reno city (Parker and Tarrant Counties),2597,15,58,206,135,99,513
Texas,Reno city (Lamar County),3245,83,26,214,209,213,745
Texas,Rendon,14114,181,177,909,753,910,2930
Texas,Relampago,44,0,0,0,0,0,0
Texas,Reklaw,397,4,6,33,17,22,82
Texas,Reid Hope King,889,34,16,168,164,0,382
Texas,Regino Ramirez,102,0,22,6,30,0,58
Texas,Refugio,2846,21,2,180,85,160,448
Texas,Redwood,4044,87,49,133,230,273,772
Texas,Redwater,1124,29,15,57,71,84,256
Texas,Red Oak,11360,124,255,864,839,693,2775
Texas,Red Lick,1044,3,18,60,61,75,217
Texas,Redland,1594,98,101,147,104,41,491
Texas,Redford,89,0,0,6,7,8,21
Texas,Redfield,516,35,26,58,52,47,218
Texas,Realitos,413,0,0,41,0,19,60
Texas,Raymondville,11191,37,99,587,618,800,2141
Texas,Ratamosa,257,0,0,62,62,0,124
Texas,Fannett,1742,21,17,98,81,104,321
Texas,Northlake,2655,71,48,178,113,152,562
Texas,North Cleveland,168,0,0,10,5,5,20
Texas,Devers,416,14,4,18,11,28,75
Texas,Devine,4529,18,26,257,364,620,1285
Texas,Deweyville,1075,0,0,49,26,33,108
Texas,D'Hanis,899,0,19,32,52,105,208
Texas,Diboll,5370,97,164,399,307,366,1333
Texas,Dickens,192,0,1,1,0,4,6
Texas,Dickinson,19355,258,439,1117,977,1018,3809
Texas,Dilley,4090,50,56,273,240,299,918
Texas,Dimmitt,4354,32,151,392,188,199,962
Texas,DISH,259,1,9,9,11,10,40
Texas,Dodd City,375,9,8,30,48,13,108
Texas,Dodson,94,0,0,6,2,11,19
Texas,Detroit,767,5,4,44,45,52,150
Texas,Doffing,5629,167,60,555,537,748,2067
Texas,Donna,16292,347,521,1498,995,837,4198
Texas,Doolittle,3746,95,86,398,384,265,1228
Texas,Dorchester,101,0,0,9,16,0,25
Texas,Double Oak,3013,57,36,200,181,228,702
Texas,Douglassville,150,0,0,2,15,5,22
Texas,Doyle,507,0,0,0,0,12,12
Texas,Driftwood,107,0,0,0,0,0,0
Texas,Dripping Springs,2415,65,45,218,104,149,581
Texas,Driscoll,697,6,3,63,41,56,169
Texas,Dublin,3671,95,47,208,310,166,826
Texas,Dumas,14997,217,238,1354,1094,861,3764
Texas,Duncanville,39567,649,855,2781,1981,2100,8366
Texas,Domino,102,0,0,3,4,3,10
Texas,DeSoto,51478,697,677,3168,3626,3341,11509
Texas,Deport,495,4,8,22,22,28,84
Texas,Denver City,4673,124,113,275,516,172,1200
Texas,Murillo,7374,64,74,505,716,750,2109
Texas,Alice Acres,340,0,0,12,54,0,66
Texas,Alice,19425,520,316,1210,1053,1192,4291
Texas,Alfred,108,0,0,0,0,0,0
Texas,Aledo,2999,60,33,246,280,273,892
Texas,Aldine,15310,240,484,1191,890,1339,4144
Texas,Albany,2203,62,36,102,119,144,463
Texas,Alba,861,10,5,138,47,33,233
Texas,Alamo Heights,7593,107,144,548,501,220,1520
Texas,Alamo,18943,388,469,1365,1178,1066,4466
Texas,Airport Road Addition,111,7,0,10,10,14,41
Texas,Airport Heights,102,7,0,5,0,0,12
Texas,Aguilares,44,0,0,0,6,11,17
Texas,Agua Dulce,832,21,6,31,85,60,203
Texas,Agua Dulce,2926,35,132,193,275,308,943
Texas,Adrian,183,0,4,17,9,12,42
Texas,Addison,15087,114,239,344,445,381,1523
Texas,Ackerly,183,12,4,25,21,11,73
Texas,Abram,1910,27,37,112,199,228,603
Texas,Abilene,122226,1965,1803,6311,5361,6007,21447
Texas,Abernathy,3290,0,20,152,226,166,564
Texas,Abbott,390,8,5,26,27,30,96
Texas,Delmita,108,6,5,6,3,3,23
Texas,Del Rio,36119,523,714,2379,2391,2140,8147
Texas,Del Sol,309,18,0,0,54,40,112
Texas,Denison,22846,496,279,1100,1329,1071,4275
Texas,Denton,125734,1755,1691,5571,5147,6020,20184
Texas,Eagle Lake,3612,33,65,189,248,240,775
Texas,Eagle Pass,27956,521,595,2087,1568,2161,6932
Texas,Early,2804,28,49,190,153,146,566
Texas,Earth,832,7,9,45,20,71,152
Texas,Elkhart,1386,9,36,62,93,99,299
Texas,Smithville,3967,37,42,302,282,255,918
Texas,Smyer,634,7,0,54,54,53,168
Texas,Snook,482,17,15,38,9,29,108
Texas,Snyder,11484,309,183,709,808,705,2714
Texas,Socorro,32877,501,563,2201,2360,2375,8000
Texas,Solis,396,12,0,25,55,28,120
Texas,Somerset,1474,6,14,110,76,108,314
Texas,Somerville,1629,20,8,119,90,46,283
Texas,Sonora,3024,75,60,160,188,229,712
Texas,Sour Lake,1751,16,40,97,102,58,313
Texas,South Alamo,3868,182,63,312,420,369,1346
Texas,South Fork Estates,136,14,0,4,0,0,18
Texas,South Houston,17430,267,298,1425,1257,1040,4287
Texas,Southlake,28361,698,427,2106,2610,2681,8522
Texas,South La Paloma,326,15,0,30,73,0,118
Texas,Southmayd,1019,28,13,48,94,53,236
Texas,South Mountain,403,1,4,13,17,20,55
Texas,South Padre Island,2888,0,0,61,85,105,251
Texas,South Point,1363,17,0,75,69,56,217
Texas,Southside Place,1762,69,35,124,95,137,460
Texas,South Toledo Bend,388,0,0,0,0,0,0
Texas,Spade,101,0,0,17,0,23,40
Texas,Sparks,3980,118,48,225,420,298,1109
Texas,Spearman,3387,29,41,233,260,229,792
Texas,Splendora,1635,64,2,170,106,45,387
Texas,Spofford,95,0,0,5,21,7,33
Texas,El Indio,209,0,0,0,0,0,0
Texas,Murchison,518,7,7,32,18,29,93
Texas,Elias-Fela Solis,29,0,0,0,0,0,0
Texas,Electra,2737,16,32,48,103,97,296
Texas,East Alto Bonito,978,25,56,43,122,46,292
Texas,East Bernard,2779,52,42,142,255,243,734
Texas,Eastland,3881,39,40,165,110,163,517
Texas,East Mountain,985,9,10,35,75,59,188
Texas,Easton,501,4,0,22,44,48,118
Texas,East Tawakoni,868,8,3,52,46,53,162
Texas,Ector,778,2,20,35,47,48,152
Texas,Edcouch,3244,101,60,215,157,203,736
Texas,Eden,2485,59,11,23,46,203,342
Texas,Edgecliff Village,2934,27,30,132,164,164,517
Texas,Edgewater Estates,85,0,0,16,0,18,34
Texas,Edgewood,1392,16,12,81,81,39,229
Texas,Edinburg,80924,1488,1614,5766,5194,5931,19993
Texas,Edmonson,109,0,5,0,3,6,14
Texas,Edna,5661,76,6,342,466,353,1243
Texas,Edom,347,0,5,9,20,42,76
Texas,Edroy,307,0,0,13,26,48,87
Texas,Eidson Road,9983,160,127,826,810,1057,2980
Texas,Elbert,52,0,0,6,0,0,6
Texas,El Brazil,36,0,0,0,0,0,0
Texas,El Camino Angosto,272,28,0,0,0,0,28
Texas,El Campo,11545,297,244,994,671,763,2969
Texas,El Castillo,368,18,0,13,36,52,119
Texas,El Cenizo,567,0,56,60,17,17,150
Texas,El Cenizo,3307,116,84,272,317,340,1129
Texas,El Chaparral,212,22,0,0,28,40,90
Texas,Eldorado,1897,47,50,142,148,101,488
Texas,Elgin,8249,85,167,500,444,575,1771
Texas,North Escobares,245,0,0,24,20,43,87
Texas,Muniz,1645,44,0,129,0,110,283
Texas,Mullin,136,0,0,5,13,23,41
Texas,Nesbitt,174,0,0,0,0,1,1
Texas,Needville,3025,35,54,168,264,213,734
Texas,Nederland,17063,222,383,801,655,1162,3223
Texas,Nazareth,281,0,9,10,20,13,52
Texas,Navasota,7281,86,58,377,606,622,1749
Texas,Navarro,267,2,1,16,22,21,62
Texas,Natalia,1398,9,0,83,133,114,339
Texas,Nassau Bay,4085,25,74,179,250,257,785
Texas,Nash,3083,88,97,196,207,127,715
Texas,Narciso Pena,0,0,0,0,0,0,0
Texas,Naples,1443,20,7,100,69,61,257
Texas,Nacogdoches,33774,559,433,1445,1452,1265,5154
Texas,Netos,17,0,0,0,0,0,0
Texas,Myrtle Springs,473,0,0,32,12,12,56
Texas,Mustang,15,3,0,3,0,0,6
Texas,Murphy,19691,599,400,1448,1560,1376,5383
Texas,Alvarado,3868,61,30,257,135,370,853
Texas,Alton,15092,203,444,1041,1290,1117,4095
Texas,Alto Bonito Heights,116,0,12,0,0,0,12
Texas,Alto,1279,0,21,34,143,78,276
Texas,Alpine,6000,142,67,212,350,168,939
Texas,Alma,448,12,2,1,11,62,88
Texas,Allen,92502,2587,1724,6380,7013,6369,24073
Texas,Melvin,181,0,0,8,14,12,34
Texas,Memphis,2217,0,5,175,209,160,549
Texas,Menard,1628,61,13,118,159,82,433
Texas,Mustang Ridge,1232,6,30,98,51,82,267
Texas,Nevada,1043,22,28,48,48,74,220
Texas,Newark,1108,19,16,71,36,76,218
Texas,New Berlin,538,5,7,23,26,35,96
Texas,North Alamo,4095,67,167,404,450,120,1208
Texas,Normanna,101,0,0,5,0,10,15
Texas,Normangee,576,8,7,23,30,51,119
Texas,Nordheim,250,8,1,9,13,12,43
Texas,Noonday,719,2,16,36,46,8,108
Texas,Nome,448,0,10,24,25,8,67
Texas,Nolanville,4533,248,211,347,116,240,1162
Texas,Nocona Hills,738,0,0,14,36,5,55
Texas,Nocona,2984,55,32,94,173,189,543
Texas,Nixon,2529,54,67,285,208,301,915
Texas,Nina,274,0,0,0,10,0,10
Texas,Niederwald,607,8,7,38,49,46,148
Texas,Neylandville,111,0,0,3,21,3,27
Texas,New Waverly,1335,2,23,71,126,141,363
Texas,Newton,2227,50,68,114,87,103,422
Texas,New Territory,15494,119,108,893,1218,1829,4167
Texas,New Summerfield,1351,31,41,65,52,119,308
Texas,New London,1182,19,20,93,82,35,249
Texas,New Hope,775,6,7,17,34,25,89
Texas,New Home,386,2,8,25,19,53,107
Texas,New Falcon,223,0,31,31,0,0,62
Texas,New Fairview,1010,22,7,61,39,68,197
Texas,New Deal,875,27,8,42,92,75,244
Texas,New Chapel Hill,657,5,1,48,28,40,122
Texas,Newcastle,485,12,0,21,37,39,109
Texas,New Braunfels,64076,989,999,3834,4154,3601,13577
Texas,New Boston,4730,47,33,107,285,240,712
Texas,Mentone,37,0,0,0,0,0,0
Texas,Mercedes,16425,353,337,1720,1300,1302,5012
Texas,Meridian,1714,56,10,125,134,45,370
Texas,Merkel,2617,24,57,125,166,134,506
Texas,Mobile City,291,0,7,18,0,35,60
Texas,Monahans,7349,32,98,495,550,457,1632
Texas,Montague,308,1,5,10,16,15,47
Texas,Mont Belvieu,4585,66,52,412,312,270,1112
Texas,Monte Alto,1836,20,0,104,116,191,431
Texas,Montgomery,750,40,15,48,69,52,224
Texas,Moody,1628,26,49,85,69,101,330
Texas,Moore,404,0,0,18,18,10,46
Texas,Moore Station,251,5,2,23,5,17,52
Texas,Moraida,194,48,0,11,0,12,71
Texas,Morales-Sanchez,46,0,0,0,0,0,0
Texas,Moran,347,4,4,11,20,13,52
Texas,Morgan,615,10,13,24,28,47,122
Texas,Morgan Farm,348,14,6,14,7,0,41
Texas,Morgan's Point,322,9,2,9,44,30,94
Texas,Morgan's Point Resort,4223,95,25,283,265,289,957
Texas,Morning Glory,423,20,0,62,17,0,99
Texas,Morse,206,5,6,17,3,10,41
Texas,Morton,1841,48,30,142,104,108,432
Texas,Moulton,930,25,15,76,49,42,207
Texas,Mountain City,771,14,5,49,61,50,179
Texas,Mount Calm,265,8,0,9,14,9,40
Texas,Mount Enterprise,436,6,1,5,31,16,59
Texas,Mount Pleasant,16007,356,475,1064,1164,1018,4077
Texas,Mount Vernon,2752,57,37,229,255,113,691
Texas,Muenster,1584,22,6,112,59,121,320
Texas,Muleshoe,5300,38,155,572,341,411,1517
Texas,Mobeetie,156,3,0,6,12,12,33
Texas,Munday,1388,38,24,49,80,77,268
Texas,Missouri City,70538,979,1015,4031,4425,4877,15327
Texas,Mission,81573,1539,1264,6580,6438,5876,21697
Texas,Mertens,140,9,1,10,9,10,39
Texas,Mertzon,811,10,8,42,61,45,166
Texas,Mesquite,143584,1729,2625,9673,10040,9913,33980
Texas,Mesquite,650,29,0,76,0,93,198
Texas,Mexia,7453,133,158,459,407,603,1760
Texas,Miami,613,6,1,51,67,46,171
Texas,Midland,123820,2293,1870,7428,7299,6950,25840
Texas,Midlothian,20679,243,421,1418,1338,1269,4689
Texas,Midway,343,0,0,44,35,11,90
Texas,Midway North,5050,81,67,491,267,307,1213
Texas,Midway South,2732,62,46,212,293,194,807
Texas,Miguel Barrera,260,5,0,68,28,25,126
Texas,Mikes,879,67,39,167,75,64,412
Texas,Mila Doce,6225,245,139,648,490,622,2144
Texas,Milam,1374,0,0,133,24,47,204
Texas,Milano,447,10,3,48,18,37,116
Texas,Mildred,511,4,4,21,20,47,96
Texas,Miles,1086,10,5,42,56,105,218
Texas,Milford,673,7,0,44,17,68,136
Texas,Miller's Cove,190,6,12,25,13,5,61
Texas,Millican,265,1,4,10,11,7,33
Texas,Millsap,454,6,6,18,42,17,89
Texas,Mineola,4540,52,59,203,487,140,941
Texas,Mineral Wells,16159,262,271,802,906,889,3130
Texas,Mingus,304,2,0,4,9,13,28
Texas,Mi Ranchito Estate,106,0,0,0,0,0,0
Texas,Mirando City,382,6,12,47,64,48,177
Texas,Mission Bend,36723,449,695,2529,1915,2532,8120
Texas,Bishop,3169,48,24,135,135,241,583
Texas,Farmers Branch,31052,610,506,1702,1564,1768,6150
Texas,Farwell,1748,33,34,79,109,113,368
Texas,Wellman,301,3,0,12,9,44,68
Texas,Wellington,2306,64,46,128,170,79,487
Texas,Welch,214,7,0,10,16,21,54
Texas,Weir,472,25,1,36,35,28,125
Texas,Weinert,216,0,0,1,10,8,19
Texas,Weimar,2282,18,47,150,135,161,511
Texas,Webster,10993,200,187,555,290,358,1590
Texas,Webberville village,661,33,0,33,41,29,136
Texas,Weatherford,27234,438,348,1425,1903,1217,5331
Texas,Waxahachie,31756,377,510,2455,2016,1600,6958
Texas,Watauga,24179,337,334,1438,1652,1819,5580
Texas,Waskom,1992,15,19,57,72,91,254
Texas,Wells,881,34,0,88,22,45,189
Texas,Warren City,356,1,7,22,26,15,71
Texas,Walnut Springs,823,19,45,43,74,47,228
Texas,Wallis,1173,25,28,21,55,38,167
Texas,Waller,2237,65,16,124,110,58,373
Texas,Wake Village,5479,127,133,394,343,439,1436
Texas,Waelder,1175,25,19,38,82,58,222
Texas,Waco,129193,2426,2267,6489,6655,5954,23791
Texas,Von Ormy,1169,0,23,105,73,114,315
Texas,Volente village,677,19,11,45,46,27,148
Texas,Vinton village,1460,23,16,145,138,109,431
Texas,Villa Verde,561,0,18,30,30,45,123
Texas,Villarreal,440,0,0,90,39,13,142
Texas,Villa Pancho,698,0,0,14,71,33,118
Texas,Warren,640,0,6,5,93,38,142
Texas,Wells Branch,12014,155,182,419,353,453,1562
Texas,Weslaco,38666,596,833,2826,2828,2071,9154
Texas,West,2802,17,16,207,110,219,569
Texas,Plainview,21666,268,432,1363,1578,1395,5036
Texas,Plano,275645,5005,3939,15196,16208,16471,56819
Texas,Pleak village,1498,23,18,72,90,53,256
Texas,Pleasant Hill,528,0,0,28,19,59,106
Texas,Pleasanton,9473,293,98,769,559,529,2248
Texas,Pleasant Valley,369,5,4,20,6,23,58
Texas,Plum Grove,471,9,0,52,15,31,107
Texas,Point,769,2,22,68,40,32,164
Texas,Point Blank,869,9,6,25,15,27,82
Texas,Point Comfort,689,7,6,34,60,38,145
Texas,Point Venture village,809,5,11,24,35,28,103
Texas,Ponder,1534,11,7,125,144,134,421
Texas,Port Aransas,3772,20,32,133,206,234,625
Texas,Westover Hills,636,10,12,36,43,64,165
Texas,West Orange,3452,20,28,222,211,105,586
Texas,Weston Lakes,2548,56,34,87,101,143,421
Texas,Weston,321,0,20,20,15,20,75
Texas,West Odessa,23742,426,526,1691,1726,1368,5737
Texas,Westminster,719,0,52,42,33,23,150
Texas,West Livingston,8168,16,108,139,216,397,876
Texas,West Lake Hills,3262,71,38,248,207,171,735
Texas,Westlake,1091,20,17,68,111,83,299
Texas,Western Lake,1230,0,55,83,17,78,233
Texas,Westdale,409,0,0,18,23,13,54
Texas,West Columbia,3919,54,87,259,152,308,860
Texas,Westbrook,212,0,9,9,13,20,51
Texas,West Alto Bonito,1108,24,22,34,68,89,237
Texas,Villa del Sol,106,6,5,6,0,0,17
Texas,Vidor,10887,244,161,735,426,392,1958
Texas,Victoria Vera,108,0,0,23,0,0,23
Texas,Victoria,65303,1515,1317,3709,3871,3737,14149
Texas,Gordon,450,7,0,24,28,34,93
Texas,Goodrich,260,0,12,11,13,41,77
Texas,Goodlow,209,3,3,1,3,16,26
Texas,Gonzales,7370,168,71,558,440,525,1762
Texas,Golinda,500,5,3,39,43,10,100
Texas,Goliad,2111,21,20,104,199,115,459
Texas,Goldthwaite,2142,23,70,194,141,112,540
Texas,Goldsmith,208,3,5,10,4,1,23
Texas,Godley,1237,35,10,93,133,74,345
Texas,Glidden,443,19,0,51,67,0,137
Texas,Glen Rose,2523,49,22,122,197,135,525
Texas,Glenn Heights,11795,158,261,799,835,788,2841
Texas,Gladewater,6451,27,0,243,270,193,733
Texas,Girard,31,0,0,6,0,0,6
Texas,Gilmer,5088,119,83,457,161,399,1219
Texas,Giddings,4957,43,43,444,287,429,1246
Texas,Gholson,851,0,13,32,36,31,112
Texas,Geronimo,1432,0,3,101,130,62,296
Texas,George West,2538,47,43,210,171,193,664
Texas,Georgetown,56102,855,960,2506,2856,2472,9649
Texas,Gatesville,15826,153,49,385,751,1488,2826
Texas,Garza-Salinas II,753,25,7,79,57,62,230
Texas,Gary City,305,3,3,25,22,27,80
Texas,Garrison,897,18,18,47,77,32,192
Texas,Garrett,845,44,19,55,82,23,223
Texas,Garland,234213,3827,4075,16286,14488,15107,53783
Texas,Port Arthur,54864,764,964,3299,3048,3070,11145
Texas,Goree,258,5,2,10,24,6,47
Texas,Plains,1629,22,7,108,117,159,413
Texas,Gorman,901,0,22,35,29,61,147
Texas,Graham,8837,87,186,448,573,630,1924
Texas,Vernon,10887,238,65,656,686,478,2123
Texas,Venus,3126,42,36,123,103,190,494
Texas,Vega,797,7,10,56,46,56,175
Texas,Van Vleck,2039,0,22,132,63,92,309
Texas,Van Horn,2175,33,30,77,96,169,405
Texas,Vanderbilt,480,20,15,32,16,42,125
Texas,Van Alstyne,3165,32,39,207,146,137,561
Texas,Van,2654,44,35,141,156,138,514
Texas,Val Verde Park,2736,0,19,150,214,220,603
Texas,Valley View,978,28,9,52,71,78,238
Texas,Valley Mills,1466,12,13,95,103,140,363
Texas,Valle Vista,354,0,0,47,27,23,97
Texas,Valle Verde,0,0,0,0,0,0,0
Texas,Valle Hermoso,0,0,0,0,0,0,0
Texas,Valentine,100,0,2,12,3,0,17
Texas,Uvalde Estates,2150,29,0,133,130,69,361
Texas,Uvalde,16220,488,361,1366,856,834,3905
Texas,Utopia,227,11,6,31,7,29,84
Texas,University Park,24101,586,386,1800,2021,1843,6636
Texas,Universal City,19466,249,211,1072,863,1102,3497
Texas,Union Valley,343,7,0,12,18,8,45
Texas,Granger,1583,30,19,69,87,75,280
Texas,Grandview,1444,18,24,101,102,61,306
Texas,Grand Saline,3108,70,53,212,150,163,648
Texas,Grand Prairie,183500,2869,2966,11939,12319,11917,42010
Texas,Grandfalls,331,12,5,37,25,25,104
Texas,Granbury,8750,119,9,233,463,341,1165
Texas,Graford,711,8,1,45,79,66,199
Texas,Porter Heights,1619,50,47,84,71,86,338
Texas,Placedo,851,4,41,87,83,87,302
Texas,Piney Point Village,3270,38,31,91,217,309,686
Texas,Brazoria,3049,80,35,150,218,179,662
Texas,Brazos Bend,335,3,0,23,11,5,42
Texas,Brazos Country,771,2,0,26,72,64,164
Texas,Breckenridge,5596,147,117,450,287,311,1312
Texas,Bremond,956,10,13,27,21,54,125
Texas,La Vernia,1387,11,15,114,96,89,325
Texas,La Victoria,91,0,0,0,0,0,0
Texas,La Villa,2509,45,58,237,234,170,744
Texas,Lavon,2507,83,43,195,147,228,696
Texas,La Ward,190,4,0,8,13,19,44
Texas,Lawn,326,4,5,27,15,30,81
Texas,League City,91665,2231,1410,5633,5646,5174,20094
Texas,Brady,5509,23,216,303,206,314,1062
Texas,Leakey,637,10,5,23,31,53,122
Texas,Leary,690,6,6,39,49,66,166
Texas,Lefors,374,7,15,14,16,5,57
Texas,Leming,680,17,11,42,67,52,189
Texas,Leona,167,0,0,0,15,22,37
Texas,Leonard,2171,30,9,127,256,123,545
Texas,Leon Valley,10846,114,91,744,484,465,1898
Texas,Leroy,381,4,4,18,36,16,78
Texas,Levelland,13823,380,241,937,647,870,3075
Texas,Lewisville,101151,1951,2030,6054,5186,5293,20514
Texas,Lexington,1301,25,31,58,84,50,248
Texas,Liberty,8817,106,190,727,312,272,1607
Texas,Liberty City,2177,15,15,80,164,175,449
Texas,Leander,32051,942,387,2539,2451,2010,8329
Texas,Brackettville,2060,37,31,133,111,114,426
Texas,Boys Ranch,374,5,4,0,32,123,164
Texas,Boyd,1295,14,11,35,100,86,246
Texas,Bixby,624,0,11,12,0,37,60
Texas,Blackwell,383,4,4,20,31,21,80
Texas,Blanco,2309,74,52,143,114,135,518
Texas,Blanket,384,8,5,17,41,30,101
Texas,Blessing,994,0,34,65,96,119,314
Texas,Bloomburg,390,3,15,19,24,27,88
Texas,Blooming Grove,963,12,8,45,74,70,209
Texas,Bloomington,1984,46,48,159,108,0,361
Texas,Blossom,1253,9,2,29,67,107,214
Texas,Blue Berry Hill,581,23,0,0,6,17,46
Texas,Blue Mound,3348,35,63,289,168,226,781
Texas,Blue Ridge,1138,14,7,123,87,76,307
Texas,Bluetown,287,0,0,28,69,37,134
Texas,Blum,462,4,18,42,24,4,92
Texas,Boerne,12272,296,108,773,869,900,2946
Texas,Bogata,1191,11,26,51,56,64,208
Texas,Boling,959,48,11,25,19,0,103
Texas,Bolivar Peninsula,2196,3,28,95,112,49,287
Texas,Bonanza Hills,121,0,0,25,0,17,42
Texas,Bonham,10044,173,96,371,357,664,1661
Texas,Bonney village,303,10,5,28,33,31,107
Texas,Booker,1483,20,33,51,45,97,246
Texas,Borger,13041,271,180,754,729,839,2773
Texas,Botines,15,0,0,0,0,0,0
Texas,Bovina,1825,43,30,176,54,92,395
Texas,Bowie,5172,90,164,283,264,248,1049
Texas,Box Canyon,25,0,0,0,0,0,0
Texas,Liberty Hill,1242,8,30,99,134,75,346
Texas,Lincoln Park,278,14,0,6,3,7,30
Texas,Lindale,5332,128,39,434,203,273,1077
Texas,Linden,2256,19,34,132,142,114,441
Texas,Lorena,1896,56,39,101,145,152,493
Texas,Lorenzo,1160,28,24,100,86,74,312
Texas,Los Altos,109,12,10,21,10,0,53
Texas,Los Alvarez,374,11,0,0,12,52,75
Texas,Los Angeles,157,0,0,28,34,0,62
Texas,Los Arcos,60,0,0,8,8,0,16
Texas,Los Arrieros,40,0,0,2,0,0,2
Texas,Los Barreras,184,0,7,0,23,37,67
Texas,Los Centenarios,0,0,0,0,0,0,0
Texas,Los Corralitos,64,0,0,0,0,0,0
Texas,Los Ebanos CDP (Hidalgo County),197,0,0,15,0,0,15
Texas,Los Ebanos CDP (Starr County),356,0,0,31,6,27,64
Texas,Brenham,16257,304,182,537,787,721,2531
Texas,Briar,4221,29,51,34,25,172,311
Texas,Petrolia,686,16,10,31,15,44,116
Texas,Petronila,172,4,0,12,32,2,50
Texas,Pettus,557,6,0,40,39,13,98
Texas,Pflugerville,53847,798,982,3550,3001,3623,11954
Texas,Pharr,74273,1482,1715,6109,5905,5262,20473
Texas,Pilot Point,4011,84,75,113,168,258,698
Texas,Pine Forest,605,17,14,41,34,18,124
Texas,Pine Harbor,690,0,0,20,13,9,42
Texas,Pinehurst,5011,57,122,370,374,421,1344
Texas,Pinehurst,1933,36,40,27,53,76,232
Texas,Pine Island,1416,57,23,114,57,73,324
Texas,Pineland,942,36,8,116,133,56,349
Texas,Pinewood Estates,1787,72,12,165,91,189,529
Texas,Loraine,561,8,3,46,42,36,135
Texas,Pittsburg,4545,110,27,286,337,337,1097
Texas,Lopezville,4217,222,37,242,97,132,730
Texas,Loop,332,3,0,39,43,24,109
Texas,Lindsay,1103,33,3,108,77,79,300
Texas,Lindsay,351,15,20,8,41,20,104
Texas,Linn,562,5,0,62,42,18,127
Texas,Lipan,509,23,8,25,39,24,119
Texas,Lipscomb,29,0,0,0,0,0,0
Texas,Little Elm,32581,892,657,2654,2858,1627,8688
Texas,Littlefield,6263,33,122,474,489,434,1552
Texas,Little River-Academy,1919,48,37,111,123,154,473
Texas,Live Oak,14649,119,284,524,652,702,2281
Texas,Liverpool,375,2,8,22,16,29,77
Texas,Livingston,5219,46,90,243,281,335,995
Texas,Llano,3313,58,35,175,163,114,545
Texas,Llano Grande,3019,13,54,288,110,298,763
Texas,Lockhart,13091,161,252,856,590,913,2772
Texas,Lockney,1835,9,13,183,118,139,462
Texas,Log Cabin,572,4,3,21,8,19,55
Texas,Loma Grande,20,0,0,0,0,0,0
Texas,Loma Linda,60,0,0,0,0,0,0
Texas,Loma Linda East CDP (Jim Wells County),302,0,18,24,0,0,42
Texas,Loma Linda East CDP (Starr County),0,0,0,0,0,0,0
Texas,Loma Linda West,163,9,0,55,0,27,91
Texas,Loma Vista,252,0,0,0,12,10,22
Texas,Lometa,1010,33,13,79,103,66,294
Texas,Lone Oak,579,2,10,44,32,42,130
Texas,Lone Star,1557,25,19,85,66,59,254
Texas,Longoria,0,0,0,0,0,0,0
Texas,Longview,82112,1388,1401,4674,4269,4286,16018
Texas,Lope?o,0,0,0,0,0,0,0
Texas,Farmersville,3424,38,17,68,212,168,503
Texas,Port Isabel,5033,53,37,271,221,263,845
Texas,Port Lavaca,12315,167,198,748,699,710,2522
Texas,Fulshear,3228,101,122,304,239,198,964
Texas,Fruitvale,582,5,6,46,66,57,180
Texas,Frost,639,12,16,8,36,45,117
Texas,Fronton Ranchettes,155,0,0,36,13,22,71
Texas,Fronton,154,0,4,8,0,16,28
Texas,Fritch,2982,50,67,130,142,232,621
Texas,Frisco,137797,4313,2741,12045,10340,8363,37802
Texas,Friona,4018,85,62,338,301,263,1049
Texas,Friendswood,37602,553,500,1990,2886,2695,8624
Texas,Fresno,21877,502,446,2024,2300,1542,6814
Texas,Freer,2775,43,18,134,266,191,652
Texas,Freeport,12118,272,283,779,794,847,2975
Texas,Fulton,1319,0,0,37,29,60,126
Texas,Fredericksburg,10826,119,100,489,604,339,1651
Texas,Franklin,1882,51,19,118,143,52,383
Texas,Fowlerton,165,0,0,56,0,56,112
Texas,Four Points,0,0,0,0,0,0,0
Texas,Four Corners,13626,224,396,780,1010,870,3280
Texas,Fort Worth,796614,14441,12859,53468,50874,44081,175723
Texas,Fort Stockton,8441,79,126,540,390,486,1621
Texas,Fort Hood,30739,1094,707,1934,1369,1017,6121
Texas,Tolar,996,21,7,78,84,73,263
Texas,Todd Mission,49,0,0,0,1,6,7
Texas,Toco,94,0,1,1,3,13,18
Texas,Tivoli,603,4,24,58,46,31,163
Texas,Tira,263,3,0,14,10,12,39
Texas,Frankston,1017,23,10,53,54,63,203
Texas,Gail,326,3,0,19,45,27,94
Texas,Gainesville,16119,338,467,1090,493,713,3101
Texas,Galena Park,11126,172,267,786,1096,733,3054
Texas,Marquez,278,0,2,7,11,49,69
Texas,Marshall,23743,363,309,1586,1070,1267,4595
Texas,Mart,2050,38,36,170,137,62,443
Texas,Martindale,1341,14,17,89,83,82,285
Texas,Martinez,0,0,0,0,0,0,0
Texas,Mason,1873,0,53,10,124,62,249
Texas,Matador,541,0,10,27,25,41,103
Texas,Matagorda,335,0,0,0,0,16,16
Texas,Mathis,4989,87,24,289,280,400,1080
Texas,Maud,1027,23,13,63,99,87,285
Texas,Mauriceville,3132,0,59,348,234,188,829
Texas,Maypearl,703,10,0,58,37,90,195
Texas,Meadow,801,26,19,70,56,33,204
Texas,Meadowlakes,2051,67,23,169,76,109,444
Texas,Meadows Place,4730,90,102,180,344,234,950
Texas,Medina,4921,70,142,575,254,436,1477
Texas,Megargel,224,0,0,0,4,15,19
Texas,Melissa,6214,0,85,434,543,377,1439
Texas,Garfield,1535,0,20,139,102,122,383
Texas,Garden Ridge,3637,63,84,285,244,212,888
Texas,Gardendale,1399,84,0,115,127,0,326
Texas,Garden City,292,0,8,42,12,16,78
Texas,Garciasville,55,0,11,11,11,0,33
Texas,Garceno,592,34,0,10,66,12,122
Texas,Ganado,1796,59,22,77,93,108,359
Texas,Galveston,48971,930,524,1571,2114,2181,7320
Texas,Gallatin,349,5,2,9,24,10,50
Texas,Tioga,1035,14,20,63,69,70,236
Texas,Marlin,5804,168,61,267,258,492,1246
Texas,Timpson,1385,5,31,90,50,77,253
Texas,Timbercreek Canyon village,408,5,5,14,25,24,73
Texas,Taylor,16276,176,220,1259,938,743,3336
Texas,Tatum,960,16,21,73,63,95,268
Texas,Tanquecitos South Acres II,0,0,0,0,0,0,0
Texas,Tanquecitos South Acres,471,40,0,99,19,21,179
Texas,Talty,1652,23,23,143,131,87,407
Texas,Fort Hancock,1623,30,42,157,95,128,452
Texas,Fort Davis,1112,27,8,35,80,66,216
Texas,Fort Clark Springs,1012,0,0,45,61,31,137
Texas,Fort Bliss,9321,240,156,615,453,307,1771
Texas,Forsan,216,8,6,18,19,17,68
Texas,Forney,16793,214,234,1426,1165,1228,4267
Texas,Forest Hill,12709,220,208,1048,803,1094,3373
Texas,Taylor Lake Village,3638,67,102,159,149,341,818
Texas,Follett,577,4,20,49,38,34,145
Texas,Flower Mound,68654,1702,903,4514,5324,5443,17886
Texas,Flowella,69,0,0,0,9,0,9
Texas,Floresville,6985,103,129,292,403,482,1409
Texas,Florence,870,3,3,29,26,39,100
Texas,Flor del Rio,139,0,0,0,0,0,0
Texas,Flatonia,1565,42,12,82,108,75,319
Texas,Fifth Street,1943,37,57,340,107,113,654
Texas,Ferris,2489,93,43,193,157,123,609
Texas,Fernando Salinas,11,0,0,0,0,0,0
Texas,Faysville,608,26,0,86,0,70,182
Texas,Fayetteville,251,0,0,0,17,12,29
Texas,Fate,8414,194,117,524,569,682,2086
Texas,Floydada,2916,49,28,222,193,181,673
Texas,Taylor Landing,227,0,3,3,4,7,17
Texas,Teague,3546,44,64,161,270,189,728
Texas,Tehuacana,256,0,9,19,0,16,44
Texas,Tilden,365,0,0,16,25,29,70
Texas,Tiki Island village,873,8,9,7,2,22,48
Texas,Tierra Verde,296,0,0,27,0,32,59
Texas,Tierra Grande,165,0,0,7,25,0,32
Texas,Tierra Dorada,8,0,0,0,0,0,0
Texas,Tierra Bonita,112,0,16,24,12,0,52
Texas,Thunderbird Bay,634,4,0,15,23,35,77
Texas,Throckmorton,738,6,13,19,33,24,95
Texas,Three Rivers,1596,0,20,50,129,77,276
Texas,Thrall,656,10,6,36,19,39,110
Texas,Thorntonville,495,6,14,41,22,21,104
Texas,Thornton,404,5,10,5,17,14,51
Texas,Thorndale,1414,27,29,91,70,119,336
Texas,Thompsonville,0,0,0,0,0,0,0
Texas,Thompsons,163,14,4,10,3,10,41
Texas,The Woodlands,105713,3331,1686,6744,7258,7700,26719
Texas,The Hills village,2550,65,28,172,154,230,649
Texas,The Colony,39736,613,430,2056,2274,2210,7583
Texas,Texline,490,11,5,15,35,23,89
Texas,Texhoma,275,5,0,5,2,0,12
Texas,Texas City,46266,1205,666,2491,2764,2646,9772
Texas,Texarkana,37088,563,470,2314,1961,2006,7314
Texas,Terrell Hills,5123,123,38,327,392,420,1300
Texas,Terrell,16355,158,287,900,872,665,2882
Texas,Terlingua,145,0,0,0,0,0,0
Texas,Tenaha,1454,51,26,29,71,114,291
Texas,Temple,69938,1203,779,4137,3878,3502,13499
Texas,Timberwood Park,26219,371,357,1809,1887,1882,6306
Texas,Portland,15638,118,354,1268,984,1132,3856
Texas,Howe,2635,55,75,128,117,75,450
Texas,Los Fresnos,6280,23,80,435,538,517,1593
Texas,Turkey,367,5,8,33,20,28,94
Texas,Tulsita,45,0,0,0,0,0,0
Texas,Tulia,4872,73,80,380,219,270,1022
Texas,Tuleta,274,0,21,7,8,0,36
Texas,Troy,1755,31,12,152,84,104,383
Texas,Troup,1661,19,9,105,114,69,316
Texas,Trophy Club,10187,271,241,622,598,671,2403
Texas,Trinity,2748,33,14,145,159,104,455
Texas,Trinidad,838,8,6,33,50,55,152
Texas,Trenton,775,7,12,44,40,43,146
Texas,Trent,291,0,2,8,12,19,41
Texas,Travis Ranch,3021,151,92,274,250,140,907
Texas,Tradewinds,131,0,0,0,0,0,0
Texas,Toyah,164,0,0,6,10,1,17
Texas,Tornillo,1367,0,48,130,122,115,415
Texas,Tool,2438,18,6,31,64,80,199
Texas,Tom Bean,1004,6,0,46,82,95,229
Texas,Tomball,11186,97,220,578,647,648,2190
Texas,Powell,79,7,3,2,0,5,17
Texas,Los Fresnos,61,0,0,0,8,7,15
Texas,Los Huisaches,27,0,0,0,0,9,9
Texas,Los Indios,1222,13,35,83,63,58,252
Texas,Los Lobos,0,0,0,0,0,0,0
Texas,Tuscola,769,1,2,48,47,34,132
Texas,Tye,1153,19,8,98,70,75,270
Texas,Tyler,100806,1363,1185,5124,5627,5210,18509
Texas,Tynan,269,0,0,18,9,0,27
Texas,Prairie View,6064,22,23,9,55,93,202
Texas,Premont,2686,56,53,143,80,196,528
Texas,Presidio,4139,27,50,210,407,382,1076
Texas,Preston,1713,0,41,51,28,29,149
Texas,Primera,4247,87,36,332,178,233,866
Texas,Princeton,7942,105,25,497,683,686,1996
Texas,Progreso,5789,95,232,444,198,374,1343
Texas,Progreso Lakes,352,0,3,12,25,23,63
Texas,Prosper,13939,430,199,1184,1194,1159,4166
Texas,Providence Village,5160,111,110,454,363,454,1492
Texas,Pueblo East,0,0,0,0,0,0,0
Texas,Los Minerales,33,0,0,0,0,4,4
Texas,Pueblo Nuevo,795,0,53,137,52,65,307
Texas,Pyote,130,6,0,8,3,6,23
Texas,Quail,18,0,0,0,0,0,0
Texas,Quail Creek,1653,35,7,98,128,26,294
Texas,Quanah,2568,37,15,203,249,147,651
Texas,Queen City,1863,33,32,114,76,177,432
Texas,Quemado,169,0,0,0,27,0,27
Texas,Quesada,0,0,0,0,0,0,0
Texas,Quinlan,1631,20,32,74,91,124,341
Texas,Union Grove,348,0,0,15,23,25,63
Texas,Uncertain,94,0,0,0,0,0,0
Texas,Uhland,1214,28,13,139,94,125,399
Texas,Putnam,65,0,0,0,0,13,13
Texas,Los Nopalitos,94,10,0,9,0,0,19
Texas,Lost Creek,4570,125,49,340,370,401,1285
Texas,Los Veteranos I,0,0,0,0,0,0,0
Texas,Malakoff,2982,36,69,268,359,128,860
Texas,Malone,290,7,2,32,27,7,75
Texas,Manchaca,1427,9,0,70,124,16,219
Texas,Manor,6435,178,180,705,465,445,1973
Texas,Mansfield,61559,1385,740,3695,4609,4622,15051
Texas,Manuel Garcia,310,34,0,22,7,8,71
Texas,Manuel Garcia II,232,34,0,35,0,0,69
Texas,Manvel,6690,81,24,452,359,474,1390
Texas,Marathon,546,0,5,29,13,28,75
Texas,Marble Falls,6170,54,0,98,302,523,977
Texas,Marfa,1921,7,59,124,93,124,407
Texas,Magnolia,1566,23,13,65,102,72,275
Texas,Marietta,109,0,0,1,2,2,5
Texas,Markham,1280,23,30,129,70,63,315
Texas,Powderly,835,13,9,38,51,42,153
Texas,Pottsboro,2411,49,38,146,309,99,641
Texas,Potosi,3113,182,0,235,162,366,945
Texas,Poth,2114,25,29,146,145,81,426
Texas,Poteet,3359,108,68,192,67,116,551
Texas,Post Oak Bend City,992,5,2,61,107,61,236
Texas,Post,5218,84,38,223,192,262,799
Texas,Port O'Connor,923,25,44,64,61,0,194
Texas,Port Neches,12826,192,155,579,729,661,2316
Texas,Port Mansfield,70,0,0,0,0,0,0
Texas,Marion,1051,0,0,45,68,60,173
Texas,Prado Verde,262,0,0,0,0,42,42
Texas,Madisonville,4518,43,22,191,138,324,718
Texas,McLendon-Chisholm,1655,33,23,97,101,102,356
Texas,Los Veteranos II,65,0,0,0,0,0,0
Texas,Los Ybanez,11,0,0,0,0,0,0
Texas,Lott,851,13,0,58,32,52,155
Texas,Louise,599,7,6,26,5,30,74
Texas,Lovelady,579,15,0,82,31,29,157
Texas,Lowry Crossing,1747,13,27,53,116,103,312
Texas,Lozano,593,21,0,89,66,23,199
Texas,Lubbock,240719,4464,3539,12919,11855,11196,43973
Texas,Lucas,6241,219,90,701,549,334,1893
Texas,Lueders,141,5,0,7,4,5,21
Texas,Lufkin,36015,731,697,2116,1918,1994,7456
Texas,McQueeney,2480,34,49,94,82,151,410
Texas,Luling,5624,51,75,246,235,284,891
Texas,Lyford,2601,19,75,137,216,202,649
Texas,Lytle,2934,37,22,165,249,180,653
Texas,Mabank,3327,124,29,279,250,246,928
Texas,McAllen,136993,2823,2396,8982,9029,8733,31963
Texas,McCamey,1870,32,36,159,143,107,477
Texas,McDade,913,0,15,84,27,11,137
Texas,Macdona,285,0,0,14,0,0,14
Texas,McGregor,5042,30,181,265,318,329,1123
Texas,McKinney,150064,3072,2465,10885,10349,9901,36672
Texas,McKinney Acres,1086,26,22,91,88,73,300
Texas,McLean,942,24,17,56,66,29,192
Texas,Lumberton,12216,147,170,832,729,531,2409
Texas,Poynor,208,2,2,4,4,13,25
Utah,Apple Valley,996,24,18,63,44,52,201
Utah,Alpine,9986,146,230,730,1051,1187,3344
Utah,Alta,391,0,0,13,0,14,27
Utah,Altamont,211,2,1,9,9,27,48
Utah,Alton,128,0,6,16,6,16,44
Utah,Amalga,568,5,22,40,38,74,179
Utah,American Fork,27799,492,568,2162,2453,2138,7813
Utah,Aneth,446,8,6,43,27,58,142
Utah,Annabella,862,46,6,105,107,44,308
Utah,Antimony,118,0,0,4,0,0,4
Utah,Ballard,812,21,9,67,53,42,192
Utah,Aurora,938,19,28,47,107,63,264
Utah,Avon,293,0,5,20,24,13,62
Utah,Elk Ridge,2856,64,56,260,258,296,934
Utah,Beaver,3051,43,87,279,222,247,878
Utah,Tremonton,7999,208,237,763,525,553,2286
Utah,Trenton,473,6,2,41,49,50,148
Utah,Tropic,655,27,16,41,45,70,199
Utah,Tselakai Dezza,155,0,0,4,12,11,27
Utah,Uintah,1427,27,10,144,100,97,378
Utah,Vernal,10321,400,190,624,504,539,2257
Utah,Vernon,266,5,0,20,23,20,68
Utah,Veyo,492,0,0,43,30,0,73
Utah,Vineyard,901,13,8,26,16,26,89
Utah,Virgin,503,7,2,15,43,68,135
Utah,Torrey,222,0,7,9,5,10,31
Utah,Wales,273,1,12,16,26,38,93
Utah,Wanship,497,9,17,29,4,18,77
Utah,Washington,22080,448,585,1596,1354,827,4810
Utah,Washington Terrace,9119,242,87,251,580,618,1778
Utah,Wellington,1694,25,45,125,67,56,318
Utah,Wellsville,3593,75,99,229,258,283,944
Utah,Wendover,1273,31,15,86,72,113,317
Utah,West Bountiful,5394,112,87,328,399,413,1339
Utah,West Haven,11323,210,291,699,808,822,2830
Utah,West Jordan,109549,2249,1755,7749,8835,7831,28419
Utah,West Mountain,950,0,20,59,80,120,279
Utah,Wallsburg,368,23,1,8,14,6,52
Utah,Toquerville,1838,57,27,105,141,106,436
Utah,Tooele,32454,559,455,2552,2297,2452,8315
Utah,Timber Lakes,410,0,0,24,0,0,24
Utah,South Salt Lake,24501,226,377,1327,1061,1477,4468
Utah,South Weber,6568,109,77,517,597,619,1919
Utah,South Willard,1992,114,40,174,112,182,622
Utah,Spanish Fork,36916,1213,976,3727,3150,2405,11471
Utah,Spanish Valley,276,0,0,24,4,44,72
Utah,Spring City,916,24,24,49,33,32,162
Utah,Springdale,444,0,2,0,4,10,16
Utah,Spring Glen,1217,0,0,97,72,28,197
Utah,Spring Lake,383,25,9,25,15,40,114
Utah,Springville,31178,725,672,2478,2350,2189,8414
Utah,Stansbury Park,8752,282,154,959,872,680,2947
Utah,Sterling,226,6,0,18,12,19,55
Utah,Stockton,721,17,7,41,37,50,152
Utah,Summit,142,0,0,9,0,7,16
Utah,Summit Park,8025,87,60,548,631,675,2001
Utah,Sunset,5163,102,175,291,309,376,1253
Utah,Sutherland,296,0,0,13,19,51,83
Utah,Syracuse,25977,704,541,2681,2697,2253,8876
Utah,Tabiona,128,0,4,8,3,7,22
Utah,Taylorsville,60383,1088,889,3703,3507,3125,12312
Utah,Teasdale,132,0,0,13,14,14,41
Utah,Thatcher,665,17,37,56,48,46,204
Utah,Thompson Springs,85,0,0,0,0,9,9
Utah,West Point,9932,133,267,890,810,1007,3107
Utah,West Valley City,133660,2390,2668,9814,8897,9364,33133
Utah,West Wood,738,0,15,68,60,38,181
Utah,White City,5497,97,95,365,187,380,1124
Utah,Independence,185,10,1,19,16,3,49
Utah,Hyrum,7820,185,144,726,790,710,2555
Utah,Hyde Park,4170,116,42,323,339,322,1142
Utah,Hurricane,14694,251,240,1090,829,984,3394
Utah,Huntsville,804,29,7,35,39,51,161
Utah,Huntington,2044,36,25,101,106,122,390
Utah,Hoytsville,761,14,11,102,56,49,232
Utah,Howell,237,3,3,9,15,23,53
Utah,Hooper,7873,159,165,534,732,512,2102
Utah,Honeyville,1350,28,23,110,91,100,352
Utah,Holladay,30748,797,344,1811,1815,1710,6477
Utah,Holden,375,21,10,24,20,24,99
Utah,Hinckley,638,4,9,14,38,94,159
Utah,Hildale,2926,136,76,445,415,164,1236
Utah,Highland,17030,465,314,1550,1776,2143,6248
Utah,Hideout,691,3,7,41,46,15,112
Utah,Herriman,26721,1019,696,2719,2759,2680,9873
Utah,Henrieville,244,8,1,15,18,12,54
Utah,Henefer,667,11,12,51,58,40,172
Utah,Helper,2169,48,31,144,190,58,471
Utah,Heber,13001,341,163,1101,1190,1068,3863
Utah,Hatch,175,2,0,7,14,13,36
Utah,Harrisville,5942,147,109,506,365,285,1412
Utah,Ivins,7406,108,88,401,384,396,1377
Utah,South Ogden,16805,284,134,951,962,1055,3386
Utah,Jensen,197,0,0,0,18,0,18
Utah,Junction,262,7,1,29,14,17,68
Utah,White Mesa,276,0,4,37,63,33,137
Utah,Whiterocks,108,0,0,10,0,0,10
Utah,Willard,1737,26,11,119,114,109,379
Utah,Wolf Creek,800,0,0,15,65,14,94
Utah,Woodland,163,0,0,0,0,0,0
Utah,Woodland Hills,1389,23,24,88,122,117,374
Utah,Woodruff,294,5,4,25,31,15,80
Utah,Leeds,890,15,9,55,50,55,184
Utah,Leamington,254,4,8,15,10,20,57
Utah,Layton,71007,2034,1458,5389,4552,4454,17887
Utah,La Verkin,4156,102,84,222,310,383,1101
Utah,La Sal,267,0,0,0,0,0,0
Utah,Laketown,242,1,2,25,31,11,70
Utah,Lake Shore,723,12,0,7,56,60,135
Utah,Koosharem,284,5,2,0,30,69,106
Utah,Kingston,270,12,5,5,21,26,69
Utah,Kenilworth,123,0,0,0,0,0,0
Utah,Kearns,36530,638,869,2690,2646,2524,9367
Utah,Kaysville,29213,743,524,2728,2373,2301,8669
Utah,Kanosh,410,2,7,24,29,19,81
Utah,Kanarraville,290,1,4,15,8,22,50
Utah,Kanab,4410,34,57,283,290,313,977
Utah,Kamas,2148,16,42,176,138,162,534
Utah,Joseph,350,6,1,21,23,12,63
Utah,South Jordan,59662,1679,928,4628,4748,4045,16028
Utah,Snyderville,6252,107,88,453,501,353,1502
Utah,Snowville,117,0,0,7,5,20,32
Utah,Orem,91697,2064,1614,5495,5649,5830,20652
Utah,Palmyra,387,0,10,34,0,6,50
Utah,Panguitch,1789,54,35,94,127,76,386
Utah,Paradise,1134,22,18,125,98,67,330
Utah,Paragonah,543,7,15,24,24,20,90
Utah,Park City,7963,189,132,327,257,433,1338
Utah,Parowan,2858,33,17,181,142,257,630
Utah,Payson,19313,406,271,1708,1552,1492,5429
Utah,Peoa,130,0,0,0,0,0,0
Utah,Perry,4566,93,110,442,408,361,1414
Utah,Peter,431,0,20,35,22,13,90
Utah,Pine Valley,150,0,0,0,0,17,17
Utah,Plain City,6028,209,97,531,479,491,1807
Utah,Pleasant Grove,35771,736,839,2800,2993,2674,10042
Utah,Pleasant View,8647,211,87,680,633,791,2402
Utah,Plymouth,362,2,4,37,30,21,94
Utah,Portage,287,2,2,14,12,15,45
Utah,Price,8505,224,76,482,470,547,1799
Utah,Providence,7043,179,162,668,532,409,1950
Utah,Provo,115345,1542,1351,5318,4622,5163,17996
Utah,Randlett,184,0,0,11,10,16,37
Utah,Randolph,535,12,10,38,50,24,134
Utah,Redmond,710,12,5,41,33,49,140
Utah,Orderville,782,32,9,27,36,59,163
Utah,Richfield,7570,140,139,672,565,469,1985
Utah,Orangeville,1597,36,49,103,142,169,499
Utah,Oljato-Monument Valley,1151,30,16,80,55,103,284
Utah,Montezuma Creek,350,0,0,37,26,0,63
Utah,Monticello,2517,61,42,176,215,157,651
Utah,Morgan,3855,160,88,258,232,273,1011
Utah,Moroni,1543,32,46,127,129,106,440
Utah,Mountain Green,2981,72,79,194,441,224,1010
Utah,Mount Pleasant,3251,88,64,200,197,234,783
Utah,Murray,48460,653,605,2265,2204,2237,7964
Utah,Myton,512,6,2,17,23,40,88
Utah,Naples,2352,30,59,191,190,95,565
Utah,Navajo Mountain,521,13,19,54,60,34,180
Utah,Neola,419,4,0,36,56,16,112
Utah,Nephi,5463,81,177,307,392,455,1412
Utah,Newcastle,299,20,0,20,20,52,112
Utah,New Harmony,192,0,0,14,17,1,32
Utah,Newton,831,37,16,60,74,61,248
Utah,Nibley,6060,180,99,621,628,383,1911
Utah,North Logan,9380,268,199,659,694,549,2369
Utah,North Ogden,18006,417,387,1354,1281,1232,4671
Utah,North Salt Lake,18046,397,364,1313,1044,941,4059
Utah,Oak City,662,10,9,54,49,47,169
Utah,Oakley,1412,19,53,87,73,147,379
Utah,Oasis,0,0,0,0,0,0,0
Utah,Ogden,84273,1294,1275,4756,4837,3951,16113
Utah,Ophir,18,0,0,0,0,0,0
Utah,Hanksville,118,3,3,0,8,21,35
Utah,Richmond,2526,67,34,209,201,152,663
Utah,River Heights,1973,22,37,101,133,177,470
Utah,Mexican Hat,0,0,0,0,0,0,0
Utah,Mendon,1121,13,18,100,116,137,384
Utah,Meadow,298,0,2,24,15,30,71
Utah,Mayfield,416,12,6,14,10,9,51
Utah,Marysvale,468,4,6,8,14,20,52
Utah,Marriott-Slaterville,1819,25,41,124,134,143,467
Utah,Marion,711,5,8,95,65,22,195
Utah,Mapleton,8788,175,233,778,815,750,2751
Utah,Mantua,674,8,2,29,46,39,124
Utah,Manti,3301,85,48,153,253,330,869
Utah,Manila,128,5,0,11,15,0,31
Utah,Magna,27451,405,477,2075,1802,2195,6954
Utah,Maeser,4260,96,122,328,443,269,1258
Utah,Lynndyl,104,0,0,4,3,13,20
Utah,Lyman,358,13,6,43,22,21,105
Utah,Logan,49400,661,1149,2104,2200,1999,8113
Utah,Loa,472,20,17,43,24,20,124
Utah,Lindon,10552,176,184,841,1017,1058,3276
Utah,Liberty,1881,44,0,91,211,222,568
Utah,Lewiston,2048,47,24,146,167,154,538
Utah,Levan,738,4,0,48,53,65,170
Utah,Lehi,54079,1977,1802,5602,4729,3741,17851
Utah,Smithfield,10413,160,199,942,821,915,3037
Utah,Midvale,30844,354,508,2003,1560,1160,5585
Utah,Riverdale,8610,72,137,523,557,423,1712
Utah,Midway,4261,26,106,278,366,355,1131
Utah,Millcreek,60119,980,822,2875,2729,2950,10356
Utah,Riverside,829,0,44,72,0,42,158
Utah,Riverton,40912,1353,873,3288,3328,2573,11415
Utah,Rockville,395,8,2,1,13,45,69
Utah,Rocky Ridge,1168,18,38,168,143,105,472
Utah,Roosevelt,6555,207,156,612,498,391,1864
Utah,Roy,37670,714,892,2451,2895,2617,9569
Utah,Rush Valley,564,5,2,11,21,42,81
Utah,St. George,76915,1625,1191,4806,4411,4756,16789
Utah,Salem,7015,164,127,571,577,711,2150
Utah,Salina,2503,29,41,181,132,169,552
Utah,Salt Lake City,190679,2993,2177,9101,7822,8047,30140
Utah,Samak,146,0,0,0,0,27,27
Utah,Sandy,91533,1797,1365,6272,5779,5641,20854
Utah,Santa Clara,6550,143,182,423,563,543,1854
Utah,Santaquin,10054,214,192,1206,1144,750,3506
Utah,Saratoga Springs,22532,694,518,2528,2642,1691,8073
Utah,Scipio,408,3,14,31,10,15,73
Utah,Scofield,34,0,0,0,0,0,0
Utah,Sigurd,561,10,8,52,51,11,132
Utah,Silver Summit,3768,109,66,232,236,287,930
Utah,Moab,5175,73,52,351,368,128,972
Utah,Minersville,863,5,9,47,22,64,147
Utah,Millville,2080,46,36,123,186,223,614
Utah,Milford,1516,46,23,91,164,62,386
Utah,Monroe,2603,116,55,197,165,158,691
Utah,Halls Crossing,0,0,0,0,0,0,0
Utah,Gunnison,3256,17,8,77,89,305,496
Utah,Coalville,1502,20,8,124,130,124,406
Utah,Copperton,648,15,0,111,9,21,156
Utah,Corinne,865,17,20,49,43,59,188
Utah,Cornish,359,11,12,22,12,24,81
Utah,Cottonwood Heights,34234,644,438,1861,1423,1740,6106
Utah,Cove,406,26,9,21,9,29,94
Utah,Dammeron Valley,484,0,0,0,0,0,0
Utah,Daniel,1072,5,17,45,54,75,196
Utah,Delta,3466,51,25,292,182,283,833
Utah,Deseret,309,7,0,19,26,33,85
Utah,Deweyville,353,8,5,22,18,20,73
Utah,Draper,45469,1160,869,3416,3458,3654,12557
Utah,Duchesne,2051,34,13,154,153,190,544
Utah,Dugway,597,8,10,22,31,29,100
Utah,Dutch John,143,3,0,9,12,16,40
Utah,Eagle Mountain,25037,882,957,2664,2470,1573,8546
Utah,East Carbon-Sunnyside,1480,30,22,60,83,37,232
Utah,Escalante,797,6,11,20,52,39,128
Utah,Erda,2181,8,17,132,162,207,526
Utah,Ephraim,6598,119,182,380,464,336,1481
Utah,Enterprise,1691,81,36,159,169,155,600
Utah,Enterprise,683,66,0,37,83,78,264
Utah,Enoch,6075,42,114,625,628,589,1998
Utah,Clinton,21036,496,360,1862,1547,1516,5781
Utah,Emigration Canyon,1838,18,7,56,190,152,423
Utah,Elwood,1209,11,36,114,106,76,343
Utah,Elsinore,799,21,12,46,25,56,160
Utah,Elmo,368,11,15,30,3,9,68
Utah,Elberta,223,5,0,10,29,34,78
Utah,Eden,627,15,15,60,23,43,156
Utah,Echo,99,0,0,0,0,23,23
Utah,Emery,335,5,5,14,14,4,42
Utah,Eureka,658,15,0,23,32,53,123
Utah,Cleveland,557,15,11,45,38,41,150
Utah,Clear Creek,0,0,0,0,0,0,0
Utah,Benjamin,1545,36,19,170,93,109,427
Utah,Benson,1190,0,0,76,37,62,175
Utah,Beryl Junction,0,0,0,0,0,0,0
Utah,Bicknell,352,0,5,23,7,57,92
Utah,Big Water,555,0,7,21,6,20,54
Utah,Blanding,3564,61,94,370,395,336,1256
Utah,Bluebell,149,0,0,0,13,0,13
Utah,Bluff,358,0,0,0,0,0,0
Utah,Bluffdale,9008,212,76,734,831,827,2680
Utah,Bonanza,0,0,0,0,0,0,0
Utah,Boulder,130,0,0,0,2,4,6
Utah,Bountiful,43221,634,657,2598,2970,2770,9629
Utah,Brian Head,60,0,0,0,5,11,16
Utah,Brigham City,18397,396,323,1184,1094,1231,4228
Utah,Bryce Canyon City,158,3,3,12,5,22,45
Utah,Cache,0,0,0,0,0,0,0
Utah,Cannonville,231,1,16,8,10,31,66
Utah,Clawson,171,9,0,15,12,9,45
Utah,Clarkston,633,11,5,49,65,64,194
Utah,Circleville,635,21,1,21,37,30,110
Utah,Charleston,614,1,9,34,32,64,140
Utah,Central Valley,627,8,5,43,45,48,149
Utah,Central,742,0,18,9,8,66,101
Utah,Clearfield,30299,626,673,2304,2305,2011,7919
Utah,Centerville,16387,368,268,959,1131,1126,3852
Utah,Cedar Hills,10165,217,322,1117,1129,1154,3939
Utah,Cedar Fort,423,6,5,12,33,37,93
Utah,Cedar City,29429,693,518,1881,1260,1602,5954
Utah,Castle Valley,310,0,0,4,0,1,5
Utah,Castle Dale,1758,55,22,106,144,96,423
Utah,Carbonville,1558,11,0,23,144,72,250
Utah,Centerfield,1134,25,19,91,75,88,298
Utah,Halchita,521,18,17,46,44,39,164
Utah,Mona,1464,52,37,120,142,107,458
Utah,Fairview,1819,38,20,136,193,190,577
Utah,Bear River City,843,16,21,49,47,43,176
Utah,Woods Cross,10686,338,276,951,601,531,2697
Utah,Fairfield,135,0,0,6,9,17,32
Utah,Farmington,21223,538,433,1462,1763,1633,5829
Utah,Farr West,6270,57,162,451,479,409,1558
Utah,Fayette,328,12,13,39,34,33,131
Utah,Ferron,1634,39,12,106,123,107,387
Utah,Fielding,417,10,9,35,22,30,106
Utah,Flaming Gorge,90,7,0,8,5,7,27
Utah,Fort Duchesne,784,49,11,106,12,61,239
Utah,Fountain Green,989,2,18,63,83,56,222
Utah,Francis,1217,16,18,82,84,82,282
Utah,Fillmore,2849,40,78,285,230,176,809
Utah,Fruit Heights,5625,111,62,345,383,380,1281
Utah,Green River,1106,22,14,131,58,47,272
Utah,Grantsville,9609,226,202,788,887,787,2890
Utah,Fremont,127,0,0,0,28,18,46
Utah,Goshen,916,9,12,73,107,63,264
Utah,Glenwood,555,17,2,58,27,35,139
Utah,Granite,1414,0,49,4,46,95,194
Utah,Genola,1467,39,24,82,110,149,404
Utah,Garland,2491,29,63,257,216,204,769
Utah,Garden City,683,18,24,77,67,33,219
Utah,Garden,161,0,0,15,0,0,15
Utah,Glendale,284,3,7,21,8,4,43
Vermont,Concord,277,0,0,11,20,11,42
Vermont,East Burke,111,0,0,13,16,3,32
Vermont,Coventry,98,0,0,10,0,10,20
Vermont,Danville,326,10,0,0,0,0,10
Vermont,Derby Center village,555,8,2,37,20,23,90
Vermont,Derby Line village,814,11,3,27,41,49,131
Vermont,Dorset,311,0,0,0,0,5,5
Vermont,Perkinsville village,191,8,0,16,19,13,56
Vermont,East Barre,996,0,0,53,29,123,205
Vermont,East Middlebury,279,0,9,0,16,17,42
Vermont,Windsor,2194,30,27,159,54,119,389
Vermont,Enosburg Falls village,1341,7,14,43,56,84,204
Vermont,Essex Junction village,9709,149,83,518,444,684,1878
Vermont,Fairfax,703,0,12,0,0,29,41
Vermont,Fair Haven,2238,27,7,78,91,220,423
Vermont,Fairlee,294,11,5,42,7,17,82
Vermont,Glover,292,5,0,7,8,9,29
Vermont,Worcester,94,6,0,3,20,2,31
Vermont,Orleans village,835,17,8,47,37,51,160
Vermont,Chester,775,12,9,44,35,10,110
Vermont,East Montpelier,63,0,0,0,0,0,0
Vermont,Chelsea,319,0,7,0,14,24,45
Vermont,Bennington,8865,122,87,380,413,503,1505
Vermont,Castleton,1203,9,0,10,0,0,19
Vermont,Albany village,195,5,6,23,13,8,55
Vermont,Alburgh village,489,6,6,40,31,37,120
Vermont,Arlington,1287,32,24,44,40,62,202
Vermont,Ascutney,393,0,0,0,0,1,1
Vermont,Barnet,187,0,0,12,2,3,17
Vermont,Barre,8885,29,127,307,478,557,1498
Vermont,Barton village,567,17,14,5,28,13,77
Vermont,Beecher Falls,160,0,0,10,5,17,32
Vermont,Bellows Falls village,2985,41,72,137,233,194,677
Vermont,Cavendish,240,0,0,0,8,4,12
Vermont,Old Bennington village,155,3,2,9,9,4,27
Vermont,Bethel,649,15,19,38,51,21,144
Vermont,Bradford,895,26,7,33,33,34,133
Vermont,Brandon,1617,29,15,135,99,84,362
Vermont,Brattleboro,7259,87,61,257,256,440,1101
Vermont,Bristol,1831,61,52,84,50,106,353
Vermont,Burlington,42570,363,385,1223,1114,1428,4513
Vermont,Cabot,202,0,6,19,15,8,48
Vermont,Cambridge village,188,2,0,0,2,4,8
Vermont,Canaan,322,3,2,9,10,15,39
Vermont,Benson,309,0,3,6,13,26,48
Vermont,Norwich,1058,9,16,25,99,106,255
Vermont,North Westminster,243,9,0,1,5,7,22
Vermont,North Troy village,635,15,5,31,46,17,114
Vermont,South Shaftsbury,540,0,29,38,39,27,133
Vermont,South Royalton,727,0,0,19,11,0,30
Vermont,South Burlington,18536,296,185,698,681,697,2557
Vermont,South Barre,1457,24,8,82,69,119,302
Vermont,Shelburne,690,0,0,45,35,65,145
Vermont,Saxtons River village,562,21,14,18,8,18,79
Vermont,Springfield,3700,106,57,350,265,53,831
Vermont,St. Johnsbury,6122,95,58,216,330,327,1026
Vermont,Rutland,16091,214,85,770,694,754,2517
Vermont,Rochester,304,12,13,7,12,20,64
Vermont,Richmond,630,0,0,26,80,43,149
Vermont,Richford,1338,14,11,37,64,65,191
Vermont,Readsboro,272,2,2,6,11,11,32
Vermont,Randolph,2214,32,9,87,75,148,351
Vermont,St. Albans,6864,141,51,353,340,287,1172
Vermont,Stowe,434,0,0,0,0,0,0
Vermont,Swanton village,2558,36,5,130,76,90,337
Vermont,Troy,134,0,0,2,0,0,2
Vermont,Wilmington,442,16,0,7,40,9,72
Vermont,Williamstown,1161,0,9,42,48,67,166
Vermont,Wilder,1562,0,0,98,207,133,438
Vermont,White River Junction,2267,38,35,80,67,104,324
Vermont,West Rutland,2075,52,52,97,70,135,406
Vermont,Westminster village,279,11,0,15,5,10,41
Vermont,West Burke village,332,4,10,21,27,22,84
Vermont,West Brattleboro,2559,49,9,195,95,72,420
Vermont,Wells River village,386,15,0,16,17,4,52
Vermont,Wells,354,11,0,20,11,4,46
Vermont,Websterville,432,0,12,0,17,25,54
Vermont,Waterbury village,1815,45,5,51,120,83,304
Vermont,Wallingford,717,5,5,39,16,1,66
Vermont,Waitsfield,192,6,0,10,4,0,20
Vermont,Vergennes,2629,36,20,90,85,127,358
Vermont,Quechee,645,24,0,38,8,18,88
Vermont,Winooski,7223,210,77,164,206,349,1006
Vermont,Putney,395,0,0,7,12,17,36
Vermont,Woodstock village,1064,14,2,36,101,60,213
Vermont,Marshfield village,293,2,7,18,29,12,68
Vermont,Middlebury,6885,61,29,171,215,141,617
Vermont,Milton,1926,16,54,94,98,73,335
Vermont,Montpelier,7712,122,135,332,323,292,1204
Vermont,Morrisville village,2401,38,25,54,36,102,255
Vermont,Newbury village,313,3,9,18,4,7,41
Vermont,Manchester Center,2238,131,58,159,78,50,476
Vermont,Newfane village,65,0,0,6,1,0,7
Vermont,Newport Center,288,0,0,0,25,14,39
Vermont,North Bennington village,1795,17,0,58,59,45,179
Vermont,Northfield,2181,16,41,76,105,88,326
Vermont,North Hartland,172,0,0,0,0,0,0
Vermont,North Springfield,549,0,0,0,0,45,45
Vermont,Pittsford,539,17,0,6,14,40,77
Vermont,Newport,4493,64,24,333,233,183,837
Vermont,Manchester village,777,0,7,16,24,83,130
Vermont,Lyndonville village,1178,19,0,21,17,39,96
Vermont,Ludlow village,944,8,4,36,25,60,133
Vermont,Graniteville,595,12,0,0,29,33,74
Vermont,Greensboro,103,0,0,0,0,2,2
Vermont,Greensboro Bend,232,0,2,27,4,19,52
Vermont,Groton,432,0,11,44,23,9,87
Vermont,Hardwick,1478,22,25,112,73,127,359
Vermont,Hartland,395,0,0,7,32,13,52
Vermont,Hinesburg,963,0,63,29,12,30,134
Vermont,Hyde Park village,506,3,0,27,34,36,100
Vermont,Irasburg,171,0,0,15,0,4,19
Vermont,Island Pond,701,17,10,46,38,20,131
Vermont,Jacksonville village,238,0,2,20,4,15,41
Vermont,Jeffersonville village,936,10,4,75,48,74,211
Vermont,Jericho village,1352,24,0,70,66,55,215
Vermont,Johnson village,1418,31,28,41,30,36,166
Vermont,Lowell,116,0,2,14,2,6,24
Vermont,Proctorsville,510,0,0,11,26,13,50
Vermont,Poultney village,1518,13,11,43,36,70,173
Vermont,Plainfield,278,0,0,13,26,0,39
Village of Islands village; Florida,Islamorada,6386,50,37,176,202,328,793
Virginia,Yogaville,179,0,0,0,0,0,0
Virginia,Heathsville,53,0,0,0,0,0,0
Virginia,Haysi,452,0,1,15,16,39,71
Virginia,Haymarket,1915,68,35,89,125,162,479
Virginia,Hayfield,4610,80,71,241,266,341,999
Virginia,Harriston,1050,0,26,99,36,48,209
Virginia,Harrisonburg,51388,581,456,1883,1748,1360,6028
Virginia,Harborton,131,0,0,0,0,0,0
Virginia,Hanover,237,0,0,0,0,5,5
Virginia,Hampton,137081,2426,1666,6344,6624,6657,23717
Virginia,Hampden-Sydney,1704,0,0,0,0,0,0
Virginia,Hamilton,463,6,0,18,18,17,59
Virginia,Bon Air,17128,345,276,700,762,1290,3373
Virginia,Bobtown,444,0,0,56,0,46,102
Virginia,Blue Ridge Shores,791,0,28,26,69,75,198
Virginia,Henry Fork,1374,45,0,91,109,47,292
Virginia,Herndon,24384,320,373,1547,1181,1292,4713
Virginia,Highland Springs,16955,68,242,960,930,1182,3382
Virginia,Chatmoss,1475,0,52,0,55,111,218
Virginia,Castlewood,1875,28,84,56,116,70,354
Virginia,Catlett,297,0,0,0,12,0,12
Virginia,Cats Bridge,262,0,0,0,67,0,67
Virginia,Cave Spring,25554,418,251,1052,1052,1128,3901
Virginia,Cedar Bluff,1148,26,26,36,44,56,188
Virginia,Central Garage,1156,30,17,58,46,13,164
Virginia,Centreville,73660,1429,984,3834,4259,4465,14971
Virginia,Chamberlayne,6190,27,114,170,520,297,1128
Virginia,Chantilly,23864,547,320,1420,1430,1661,5378
Virginia,Charles City,213,8,0,13,12,12,45
Virginia,Charlotte Court House,736,13,2,31,67,45,158
Virginia,Charlottesville,45084,763,463,1437,1090,1403,5156
Virginia,Chase City,2312,53,27,94,147,140,461
Virginia,Chase Crossing,539,0,0,56,96,25,177
Virginia,Chatham,1059,6,0,40,52,42,140
Virginia,Blue Ridge,2640,34,0,86,89,154,363
Virginia,Bluefield,5350,74,160,201,142,161,738
Virginia,Bloxom,414,5,4,30,22,37,98
Virginia,Bland,588,27,27,0,0,13,67
Virginia,Riverview,504,9,0,9,21,28,67
Virginia,Riverdale,1483,17,21,91,72,71,272
Virginia,Rivanna,1795,0,27,57,109,105,298
Virginia,Riner,713,17,28,39,27,0,111
Virginia,Ridgeway,850,6,6,69,29,39,149
Virginia,Richmond,213735,3188,2791,8114,7158,7188,28439
Virginia,Cheriton,462,0,0,0,22,19,41
Virginia,Richlands,5630,51,47,391,257,272,1018
Virginia,Reston,60112,1171,528,2716,2490,2365,9270
Virginia,Remington,619,8,12,23,26,30,99
Virginia,Ravensworth,2563,54,0,140,105,108,407
Virginia,Raven,2018,24,5,23,98,119,269
Virginia,Radford,17057,83,105,515,551,620,1874
Virginia,Quinby,206,10,6,0,0,8,24
Virginia,Rich Creek,797,0,6,25,37,34,102
Virginia,Bealeton,4666,103,96,220,252,393,1064
Virginia,Bedford,6522,43,101,248,241,476,1109
Virginia,Belle Haven,441,1,5,22,45,28,101
Virginia,Blairs,834,11,6,53,22,65,157
Virginia,Blackstone,3553,0,47,147,185,303,682
Virginia,Blacksburg,43530,196,273,859,906,981,3215
Virginia,Big Stone Gap,5508,40,25,194,140,310,709
Virginia,Big Island,261,0,0,5,7,7,19
Virginia,Bethel Manor,3996,140,190,417,291,193,1231
Virginia,Berryville,4267,68,17,204,193,361,843
Virginia,Bensley,6228,77,74,363,301,231,1046
Virginia,Benns Church,585,0,0,2,39,25,66
Virginia,Belview,1236,0,0,0,65,143,208
Virginia,Belspring,201,0,0,0,24,0,24
Virginia,Belmont Estates,1388,0,0,84,144,59,287
Virginia,Belmont,6360,162,136,530,583,407,1818
Virginia,Bellwood,5772,115,96,251,334,389,1185
Virginia,Belle Haven,6721,111,52,483,353,327,1326
Virginia,Cascades,12194,304,271,668,709,734,2686
Virginia,Carrsville,269,0,0,0,0,14,14
Virginia,Carrollton,5383,50,13,247,262,359,931
Virginia,Captains Cove,1082,0,43,34,53,19,149
Virginia,Fairlawn,2402,59,32,63,125,77,356
Virginia,Fair Oaks,33268,726,434,1599,894,1452,5105
Virginia,Courtland,2065,50,39,139,85,49,362
Virginia,County Center,2513,32,43,231,105,118,529
Virginia,Countryside,10301,189,137,637,687,481,2131
Virginia,Concord,1543,0,7,58,115,64,244
Virginia,Fair Lakes,7721,136,39,347,257,335,1114
Virginia,Columbia,62,0,0,5,3,0,8
Virginia,Colonial Beach,3556,0,41,121,138,83,383
Virginia,Collinsville,7507,61,43,290,312,439,1145
Virginia,Coeburn,2377,5,39,178,171,138,531
Virginia,Cluster Springs,903,0,0,40,85,138,263
Virginia,Cloverdale,3415,34,61,159,237,156,647
Virginia,Clover,450,6,0,0,31,8,45
Virginia,Colonial Heights,17515,103,238,900,899,966,3106
Virginia,Fairfax Station,11290,147,132,408,571,849,2107
Virginia,Fairfax,23402,309,208,1058,949,1128,3652
Virginia,Exmore,1510,19,0,62,124,41,246
Virginia,Staunton,24193,337,192,1150,840,972,3491
Virginia,Stephens City,1905,12,27,68,67,130,304
Virginia,Sterling,28883,608,549,1456,1406,1907,5926
Virginia,Stone Ridge,9578,473,114,1002,560,408,2557
Virginia,Stony Creek,160,2,4,13,2,3,24
Virginia,Strasburg,6506,56,40,251,448,328,1123
Virginia,Stuart,1613,17,0,59,76,51,203
Virginia,Stuarts Draft,9005,85,108,549,429,385,1556
Virginia,Sudley,17009,348,327,922,1430,892,3919
Virginia,Suffolk,86184,1676,1238,5594,4585,4647,17740
Virginia,Crimora,1913,4,0,97,17,104,222
Virginia,Crewe,2746,99,17,272,131,179,698
Virginia,Craigsville,1164,0,11,55,70,81,217
Virginia,Covington,5736,23,41,240,387,248,939
Virginia,Ewing,280,15,0,18,0,10,43
Virginia,Clintwood,1423,0,16,34,36,47,133
Virginia,Quantico Base,6560,101,182,252,207,96,838
Virginia,Clinchport,74,0,7,1,3,1,12
Virginia,Clifton Forge,3839,23,86,219,236,155,719
Virginia,Buckhall,17066,264,367,1184,1181,1061,4057
Virginia,Buckingham Courthouse,209,0,0,0,15,0,15
Virginia,Buena Vista,6666,131,95,248,316,291,1081
Virginia,Bull Run,14781,122,150,606,778,477,2133
Virginia,Bull Run Mountain Estates,1380,19,0,94,105,121,339
Virginia,Burke,42205,731,554,2256,2584,2595,8720
Virginia,Buchanan,1098,16,24,51,55,53,199
Virginia,Burke Centre,17982,616,211,962,803,1183,3775
Virginia,Callaghan,183,0,0,0,0,0,0
Virginia,Calverton,196,0,0,0,0,0,0
Virginia,Camptown,609,8,8,36,25,32,109
Virginia,Cana,1310,13,28,72,62,56,231
Virginia,Cape Charles,912,8,10,6,23,18,65
Virginia,Yorkshire,9244,101,131,683,632,503,2050
Virginia,Burkeville,400,7,0,33,13,12,65
Virginia,Brookneal,1184,18,6,34,28,43,129
Virginia,Brodnax,278,5,0,12,32,12,61
Virginia,Broadway,3765,66,49,166,262,215,758
Virginia,Boones Mill,158,0,0,8,5,8,21
Virginia,Boston,336,0,0,13,0,0,13
Virginia,Boswell's Corner,1399,0,38,178,80,39,335
Virginia,Bowling Green,1266,19,11,41,54,53,178
Virginia,Boyce,775,28,5,48,39,14,134
Virginia,Boydton,350,2,0,8,22,27,59
Virginia,Boykins,762,2,31,19,46,34,132
Virginia,Bracey,1357,0,10,51,118,4,183
Virginia,Brambleton,15537,729,445,1308,1115,752,4349
Virginia,Branchville,145,2,4,10,5,12,33
Virginia,Brandermill,13721,170,225,474,768,698,2335
Virginia,Bridgewater,5844,47,54,103,232,303,739
Virginia,Brightwood,1703,0,0,77,73,166,316
Virginia,Bristol,17524,397,298,833,731,789,3048
Virginia,Broadlands,13436,526,240,1379,1452,961,4558
Virginia,Clinchco,336,5,7,19,12,14,57
Virginia,Quantico,469,3,7,12,17,13,52
Virginia,Purcellville,8658,300,129,663,795,730,2617
Virginia,Pungoteague,251,0,0,23,23,6,52
Virginia,Allisonia,140,11,0,10,0,28,49
Virginia,Alexandria,149315,2526,1426,5627,3987,4403,17969
Virginia,Alberta,296,8,0,3,16,16,43
Virginia,Adwolf,1418,15,0,52,57,38,162
Virginia,Accomac,468,2,0,26,22,44,94
Virginia,Abingdon,8143,36,42,232,391,395,1096
Virginia,Altavista,3464,90,60,95,114,137,496
Virginia,Cherry Hill,18089,278,274,1472,1001,1058,4083
Virginia,Chester,21927,116,280,1005,1516,1346,4263
Virginia,Chester Gap,800,0,0,24,49,50,123
Virginia,Chilhowie,1839,40,15,61,83,124,323
Virginia,Chincoteague,2930,0,16,79,146,49,290
Virginia,Christiansburg,21623,166,344,1193,1048,691,3442
Virginia,Churchville,68,0,0,0,0,0,0
Virginia,Chesapeake,230601,3301,3351,12993,13020,13586,46251
Virginia,Amelia Court House,483,0,0,16,0,0,16
Virginia,Amherst,2323,39,50,115,35,150,389
Virginia,Annandale,42893,727,676,1989,1776,2092,7260
Virginia,Bassett,1113,7,10,26,50,84,177
Virginia,Baskerville,47,0,0,0,0,0,0
Virginia,Bailey's Crossroads,26075,223,588,1520,1001,976,4308
Virginia,Augusta Springs,339,0,0,30,0,0,30
Virginia,Atlantic,1111,9,0,0,44,0,53
Virginia,Atkins,1009,0,0,24,49,39,112
Virginia,Ashland,7298,80,67,325,220,335,1027
Virginia,Ashburn,48954,955,703,3110,3338,3288,11394
Virginia,Arrington,767,0,0,96,83,71,250
Virginia,Arlington,223945,3966,2381,7939,6228,6322,26836
Virginia,Arcola,229,6,0,0,0,0,6
Virginia,Aquia Harbour,6975,107,70,266,360,582,1385
Virginia,Appomattox,2124,41,14,104,61,113,333
Virginia,Apple Mountain Lake,1459,80,20,154,63,45,362
Virginia,Appalachia,1871,32,45,11,86,83,257
Virginia,Claremont,281,0,3,4,5,23,35
Virginia,Basye,685,0,0,25,0,0,25
Virginia,Clarksville,1213,8,3,31,58,52,152
Virginia,Cleveland,198,0,3,16,14,8,41
Virginia,Forest,10292,167,198,367,534,910,2176
Virginia,Floyd,558,7,0,12,11,35,65
Virginia,Floris,8357,131,134,613,559,752,2189
Virginia,Flint Hill,171,0,0,0,0,0,0
Virginia,Fishersville,7911,135,114,329,396,535,1509
Virginia,Fincastle,374,4,0,16,14,20,54
Virginia,Fort Belvoir,8209,297,233,726,638,515,2409
Virginia,Fieldale,770,0,32,32,0,0,64
Virginia,Farmville,8355,94,62,308,269,239,972
Virginia,Fancy Gap,190,0,20,14,0,0,34
Virginia,Falmouth,4630,28,60,428,316,352,1184
Virginia,Falls Church,13308,403,200,692,828,736,2859
Virginia,Fairview Beach,413,0,0,27,0,0,27
Virginia,Fairview,141,0,0,0,0,0,0
Virginia,Ferrum,1996,0,0,51,91,142,284
Virginia,Fort Chiswell,1024,0,0,64,10,32,106
Virginia,Fort Hunt,17273,714,241,1194,950,947,4046
Virginia,Fort Lee,4747,134,58,387,522,318,1419
Virginia,Clifton,257,4,4,23,13,18,62
Virginia,Glade Spring,1575,20,20,51,64,108,263
Virginia,George Mason,10065,158,58,269,429,459,1373
Virginia,Gate City,2370,73,69,67,69,105,383
Virginia,Gasburg,504,0,0,22,17,25,64
Virginia,Gargatha,519,0,27,27,33,13,100
Virginia,Galax,6876,54,20,421,338,370,1203
Virginia,Gainesville,12950,324,249,961,720,845,3099
Virginia,Front Royal,14846,164,280,825,728,680,2677
Virginia,Fries,513,2,6,16,11,33,68
Virginia,Free Union,358,0,0,18,0,15,33
Virginia,Fredericksburg,27395,302,295,1081,1362,956,3996
Virginia,Franklin Farm,19776,503,225,1298,1785,1538,5349
Virginia,Franklin,8457,186,55,539,525,416,1721
Virginia,Franconia,19698,424,200,981,791,907,3303
Virginia,Claypool Hill,1625,0,0,113,107,38,258
Virginia,Stanleytown,1280,10,9,24,45,79,167
Virginia,Bayside,85,0,0,0,0,0,0
Virginia,New Kent,283,0,0,0,0,10,10
Virginia,Grundy,891,0,12,31,70,87,200
Virginia,Groveton,16373,334,276,1003,633,682,2928
Virginia,Grottoes,2714,42,58,120,186,148,554
Virginia,Gretna,1283,22,11,89,22,37,181
Virginia,Greenville,1287,0,0,103,184,60,347
Virginia,Greenbush,151,0,7,0,13,8,28
Virginia,Gwynn,695,0,0,73,23,20,116
Virginia,Greenbriar,8060,109,135,713,402,321,1680
Virginia,Great Falls,15764,234,282,861,1064,1481,3922
Virginia,Gratton,920,0,44,41,46,96,227
Virginia,Goshen,381,8,0,15,4,3,30
Virginia,Gordonsville,1564,19,15,63,64,58,219
Virginia,Goochland,777,0,0,16,38,42,96
Virginia,Gloucester Point,9199,114,62,384,515,542,1617
Virginia,Greenbackville,139,0,0,0,0,0,0
Virginia,Halifax,1335,22,3,33,39,76,173
Virginia,Hallwood,320,0,10,22,13,14,59
Virginia,Pennington Gap,1804,7,8,139,67,37,258
Virginia,Pulaski,8958,63,25,394,347,399,1228
Virginia,Prince George,1944,29,63,62,121,129,404
Virginia,Prices Fork,1407,92,22,108,20,19,261
Virginia,Powhatan,185,0,0,0,0,0,0
Virginia,Pound,948,4,3,80,58,47,192
Virginia,Potomac Mills,5768,57,41,469,247,283,1097
Virginia,Portsmouth,96135,1700,1192,5065,4593,4666,17216
Virginia,Port Royal,99,2,0,4,1,0,7
Virginia,Poquoson,12077,136,107,608,867,870,2588
Virginia,Pocahontas,365,0,2,33,11,16,62
Virginia,Plum Creek,1646,0,0,69,151,156,376
Virginia,Piney Mountain,1564,26,53,160,125,142,506
Virginia,Pimmit Hills,6646,99,26,273,233,410,1041
Virginia,Phenix,285,2,1,47,12,12,74
Virginia,Petersburg,32123,282,400,1464,983,1475,4604
Virginia,Gloucester Courthouse,2732,31,21,131,127,220,530
Virginia,Newington Forest,12280,159,169,852,744,642,2566
Virginia,Glenvar,978,52,0,36,13,0,101
Virginia,Glen Allen,15007,168,242,827,759,584,2580
Virginia,Oak Level,745,0,29,0,49,29,107
Virginia,Oak Hall,370,0,0,95,0,63,158
Virginia,Oak Grove,1727,16,23,206,113,80,438
Virginia,Nottoway Court House,97,0,0,9,8,9,26
Virginia,Norton,4007,77,17,122,150,250,616
Virginia,North Springfield,6825,103,74,310,370,290,1147
Virginia,Oakton,36739,699,689,2020,2083,1495,6986
Virginia,North Shore,2951,15,17,51,61,39,183
Virginia,Nokesville,1901,42,10,114,79,151,396
Virginia,Nickelsville,430,11,6,35,25,17,94
Virginia,Newsoms,350,2,0,11,5,22,40
Virginia,New River,497,0,0,18,17,0,35
Virginia,Newport News,181323,3407,2805,9773,8505,8650,33140
Virginia,New Market,2336,15,20,90,76,71,272
Virginia,Norfolk,245452,4084,3351,10635,10149,9228,37447
Virginia,Occoquan,932,16,7,27,39,23,112
Virginia,Onancock,1214,36,10,31,16,53,146
Virginia,Onley,501,10,6,17,14,39,86
Virginia,Glasgow,1362,19,4,65,43,26,157
Virginia,Penhook,784,21,11,0,0,24,56
Virginia,Pembroke,1328,7,29,47,69,60,212
Virginia,Pearisburg,2727,66,67,157,206,157,653
Virginia,Patrick Springs,1695,11,10,12,50,69,152
Virginia,Pastoria,1028,19,0,85,13,6,123
Virginia,Passapatanzy,1204,0,0,73,180,103,356
Virginia,Parrott,528,0,17,34,51,0,102
Virginia,Parksley,756,2,10,37,61,14,124
Virginia,Pantops,3647,37,121,69,110,162,499
Virginia,Pamplin City,175,0,7,22,12,12,53
Virginia,Palmyra,143,0,0,0,16,35,51
Virginia,Painter,251,10,0,28,15,19,72
Virginia,Orange,4854,72,93,264,208,160,797
Virginia,Opal,649,11,3,50,31,75,170
Virginia,Glen Lyn,152,0,0,11,31,18,60
Virginia,Stanley,1697,9,13,91,70,66,249
Virginia,Capron,89,4,0,1,1,2,8
Virginia,Stafford Courthouse,4295,21,73,147,332,247,820
Virginia,Round Hill,541,11,7,36,29,37,120
Virginia,Rose Hill CDP (Lee County),878,0,21,76,26,78,201
Virginia,Rose Hill CDP (Fairfax County),20142,267,229,1154,895,1277,3822
Virginia,Rocky Mount,4794,119,51,150,178,83,581
Virginia,Rockwood,8634,277,200,445,390,353,1665
Virginia,Roanoke,98736,1661,1305,4704,4356,4347,16373
Virginia,Crosspointe,6197,93,87,405,375,582,1542
Virginia,Crozet,6601,330,223,478,420,299,1750
Virginia,Culpeper,17167,230,326,1086,1237,1190,4069
Virginia,Cumberland,216,6,0,0,6,0,12
Virginia,Dahlgren,3049,32,4,97,109,206,448
Virginia,Dahlgren Center,573,20,17,58,40,19,154
Virginia,Dale City,72130,869,1259,4748,4439,4926,16241
Virginia,Daleville,2872,20,14,144,280,257,715
Virginia,Damascus,759,15,15,56,52,27,165
Virginia,Dante,632,0,23,33,131,42,229
Virginia,Danville,42450,714,599,1996,2073,1812,7194
Virginia,Dayton,1654,23,11,120,62,76,292
Virginia,Stanardsville,363,14,5,21,38,3,81
Virginia,Deerfield,101,0,0,0,0,0,0
Virginia,Deltaville,1032,0,8,34,49,21,112
Virginia,Ruckersville,984,10,12,43,35,72,172
Virginia,Rural Retreat,1559,24,24,78,72,81,279
Virginia,Rushmere,786,9,13,33,20,35,110
Virginia,Rustburg,1039,0,0,27,37,65,129
Virginia,Mineral,636,9,3,28,60,34,134
Virginia,Midland,210,16,18,10,0,0,44
Virginia,Middletown,1537,2,10,143,64,112,331
Virginia,Middleburg,689,6,7,38,35,38,124
Virginia,Middlebrook,256,0,0,30,32,13,75
Virginia,Metompkin,498,0,20,0,24,20,64
Virginia,Merrimac,1890,16,34,10,66,28,154
Virginia,Merrifield,16412,386,224,779,597,496,2482
Virginia,Scottsburg,120,3,0,2,8,4,17
Virginia,Scotland,135,0,0,0,0,0,0
Virginia,Dendron,328,5,0,5,7,29,46
Virginia,Schuyler,101,0,0,0,0,0,0
Virginia,Savageville,63,0,0,0,0,0,0
Virginia,Savage Town,90,0,0,0,36,22,58
Virginia,Sanford,169,0,0,0,17,12,29
Virginia,Sandy Level,406,3,0,12,10,9,34
Virginia,Sandston,7317,147,159,411,559,276,1552
Virginia,Saluda,629,0,0,19,0,20,39
Virginia,Saltville,2343,26,13,157,162,118,476
Virginia,Salem,25165,378,307,1082,917,1311,3995
Virginia,St. Paul,1080,0,0,29,57,56,142
Virginia,St. Charles,113,5,3,6,9,6,29
Virginia,Saxis,198,0,0,1,3,7,11
Virginia,Modest Town,118,0,0,0,0,0,0
Virginia,Dillwyn,486,13,27,21,40,16,117
Virginia,Drakes Branch,698,24,25,30,43,33,155
Virginia,Max Meadows,221,0,0,0,0,0,0
Virginia,Maurertown,881,0,40,61,9,111,221
Virginia,Matoaca,2132,22,20,42,114,196,394
Virginia,Mathews,589,0,0,92,0,0,92
Virginia,Massanutten,2213,42,30,82,167,97,418
Virginia,Massanetta Springs,5015,193,47,377,303,184,1104
Virginia,Mason Neck,1983,48,14,98,140,90,390
Virginia,Marumsco,38847,296,701,2340,2361,2211,7909
Virginia,Martinsville,13624,150,361,664,512,670,2357
Virginia,Marshall,1864,95,17,114,116,140,482
Virginia,Marion,5919,90,55,226,178,252,801
Virginia,Mappsville,501,83,0,0,0,30,113
Virginia,Mappsburg,46,0,0,0,0,0,0
Virginia,Mantua,7531,75,153,403,625,459,1715
Virginia,Manchester,10378,108,162,439,568,433,1710
Virginia,Manassas Park,15625,223,332,943,903,860,3261
Virginia,Manassas,40743,521,430,2764,2417,2444,8576
Virginia,Makemie Park,264,0,0,0,0,0,0
Virginia,Madison Heights,10355,148,156,418,509,402,1633
Virginia,Madison,182,0,1,4,16,12,33
Virginia,McNair,20022,791,339,989,821,554,3494
Virginia,Meadowbrook,19027,140,390,980,1031,1223,3764
Virginia,Meadow View,1090,35,5,116,37,13,206
Virginia,Mechanicsville,37210,707,381,1763,2462,2163,7476
Virginia,Melfa,439,7,2,15,18,18,60
Virginia,Dranesville,11895,253,144,524,768,788,2477
Virginia,Draper,291,0,0,0,0,48,48
Virginia,Dryden,1268,42,12,46,49,102,251
Virginia,Dublin,2665,17,55,167,55,61,355
Virginia,Duffield,115,0,0,2,7,3,12
Virginia,Dulles Town Center,4971,62,62,275,189,448,1036
Virginia,Dumbarton,8701,41,181,443,185,226,1076
Virginia,Dumfries,5158,66,102,349,245,293,1055
Virginia,Dungannon,443,5,11,18,34,30,98
Virginia,Dunn Loring,9393,188,122,409,595,562,1876
Virginia,Dooms,1247,18,38,56,68,34,214
Virginia,East Highland Park,14733,230,81,603,780,770,2464
Virginia,Eastville,175,5,2,12,10,0,29
Virginia,Ebony,109,0,0,0,0,12,12
Virginia,Edinburg,1279,22,20,59,92,72,265
Virginia,Elkton,2779,59,10,86,122,107,384
Virginia,Elliston,1210,13,0,94,93,65,265
Virginia,Emory,1189,0,12,48,10,7,77
Virginia,Emporia,5672,76,140,231,406,267,1120
Virginia,Enon,3973,54,18,197,253,246,768
Virginia,Esmont,521,8,0,29,35,30,102
Virginia,Ettrick,5696,26,13,167,250,288,744
Virginia,East Lexington,1171,23,0,0,86,51,160
Virginia,Montclair,19896,247,349,1294,1085,1209,4184
Virginia,Monterey,156,7,0,11,8,1,27
Virginia,Hillsboro,84,0,0,2,4,15,21
Virginia,Mount Crawford,431,11,0,2,20,14,47
Virginia,Mountain Road,1430,0,0,89,184,118,391
Virginia,Motley,992,0,7,77,13,33,130
Virginia,Moorefield Station,1096,42,0,29,60,50,181
Virginia,Montvale,556,0,0,0,19,0,19
Virginia,Montross,440,0,11,0,46,23,80
Virginia,Montrose,7880,111,175,344,561,308,1499
Virginia,Lovingston,380,0,0,13,0,0,13
Virginia,Lovettsville,2022,65,30,147,137,106,485
Virginia,Louisa,2204,28,30,187,109,88,442
Virginia,Loudoun Valley Estates,5659,212,147,579,432,130,1500
Virginia,Lorton,19722,255,302,1150,1020,1147,3874
Virginia,Long Branch,7560,99,88,330,404,609,1530
Virginia,Loch Lomond,4149,11,60,230,136,262,699
Virginia,Linton Hall,40567,1215,968,3528,3008,2750,11469
Virginia,Lincolnia,23802,281,406,1267,1073,1212,4239
Virginia,Lexington,7071,98,45,247,84,171,645
Virginia,Leesburg,47872,972,663,3637,2934,3189,11395
Virginia,Lee Mont,265,0,0,23,0,24,47
Virginia,Lebanon,3388,32,16,103,134,131,416
Virginia,Laymantown,2510,77,0,226,106,149,558
Virginia,Mount Hermon,3981,68,66,278,178,133,723
Virginia,Mount Jackson,2253,33,40,144,84,244,545
Virginia,Mount Sidney,412,0,0,35,34,0,69
Virginia,Mount Vernon,12639,302,198,679,706,723,2608
Virginia,Wytheville,8154,62,84,381,275,342,1144
Virginia,Yorktown,130,0,0,0,0,0,0
Virginia,Scottsville,546,5,0,33,27,33,98
Virginia,Sedley,537,0,27,0,47,33,107
Virginia,Selma,339,0,0,0,0,0,0
Virginia,Seven Corners,8801,124,149,348,258,250,1129
Virginia,Seven Mile Ford,696,0,7,16,23,42,88
Virginia,Shawneeland,1345,0,14,73,8,41,136
Virginia,Shawsville,1274,21,74,181,0,0,276
Virginia,Shenandoah,2412,13,48,84,96,81,322
Virginia,Lawrenceville,1419,12,25,82,72,39,230
Virginia,Shenandoah Farms,3930,91,35,164,254,120,664
Virginia,New Hope,972,0,33,65,119,48,265
Virginia,New Church,211,0,0,21,0,0,21
Virginia,New Castle,166,7,0,26,8,9,50
Virginia,New Baltimore,9192,144,165,587,744,554,2194
Virginia,Nelsonia,367,0,0,0,0,27,27
Virginia,Nellysford,1139,0,0,20,23,47,90
Virginia,Neabsco,16073,165,393,827,833,1034,3252
Virginia,Nathalie,146,0,27,27,0,0,54
Virginia,Nassawadox,631,0,0,9,23,32,64
Virginia,Narrows,2166,23,44,75,127,56,325
Virginia,Newington,13470,410,113,766,714,651,2654
Virginia,Laurel Park,883,0,0,93,0,0,93
Virginia,Laurel Hill,7569,201,102,454,511,503,1771
Virginia,Laurel,16618,147,214,660,577,857,2455
Virginia,Jarratt,628,10,8,57,51,24,150
Virginia,Ivy,927,64,5,50,115,34,268
Virginia,Ivor,407,2,11,21,18,23,75
Virginia,Ivanhoe,379,0,0,0,0,72,72
Virginia,Irvington,490,8,6,10,0,0,24
Virginia,Iron Gate,354,0,6,19,9,19,53
Virginia,Innsbrook,7699,146,99,491,518,434,1688
Virginia,Independent Hill,8583,173,110,583,698,774,2338
Virginia,Independence,1211,5,24,76,50,44,199
Virginia,Idylwood,18514,375,316,1054,690,716,3151
Virginia,Jolivue,1255,53,0,72,0,44,169
Virginia,Hybla Valley,16106,305,337,1028,963,1203,3836
Virginia,Huntington,12718,125,84,292,191,312,1004
Virginia,Hot Springs,526,0,23,0,97,35,155
Virginia,Horse Pasture,1857,7,18,99,53,84,261
Virginia,Horntown,431,0,0,0,0,0,0
Virginia,Hopewell,22279,405,314,986,1421,1152,4278
Virginia,Honaker,1576,12,24,67,78,53,234
Virginia,Hollymead,8352,215,250,537,355,468,1825
Virginia,Hollins,14654,144,169,635,835,1000,2783
Virginia,Hiwassee,188,0,0,0,8,0,8
Virginia,Hillsville,2701,0,20,56,56,58,190
Virginia,Hurt,1412,7,20,73,68,84,252
Virginia,McMullin,329,0,0,0,0,28,28
Virginia,Jonesville,1263,11,29,54,79,17,190
Virginia,Kenbridge,1233,8,18,72,124,49,271
Virginia,Lansdowne,11707,208,215,953,872,457,2705
Virginia,Lancaster,167,0,0,0,0,0,0
Virginia,Lake Wilderness,2570,72,81,73,143,198,567
Virginia,Lakeside,13039,153,141,621,790,544,2249
Virginia,Lake Ridge,43963,717,991,2676,2620,2099,9103
Virginia,Lake of the Woods,7926,95,73,591,158,304,1221
Virginia,Lake Monticello,9629,254,118,564,385,505,1826
Virginia,Lake Land'Or,3865,50,27,282,300,138,797
Virginia,Lake Holiday,2302,66,18,201,165,99,549
Virginia,Lake Caroline,2154,37,22,76,122,0,257
Virginia,Keller,170,6,10,7,6,13,42
Virginia,Lake Barcroft,9833,125,67,465,571,571,1799
Virginia,La Crosse,741,12,17,30,29,47,135
Virginia,King William,119,0,0,0,0,4,4
Virginia,Kingstowne,15935,320,238,730,846,581,2715
Virginia,Kings Park West,13702,307,219,596,923,1006,3051
Virginia,Kings Park,4564,96,128,253,251,305,1033
Virginia,King George,5299,86,69,383,324,289,1151
Virginia,King and Queen Court House,132,0,0,0,42,0,42
Virginia,Kilmarnock,1443,25,21,20,29,28,123
Virginia,Keysville,1067,39,15,46,59,125,284
Virginia,Keokee,286,0,0,0,0,0,0
Virginia,Lafayette,450,0,10,50,13,0,73
Virginia,McLean,47784,1156,501,3020,3017,3434,11128
Virginia,Deep Creek,55,0,0,7,8,0,15
Virginia,Woodlawn CDP (Carroll County),2266,27,12,31,114,61,245
Virginia,Warm Springs,58,0,0,8,8,0,16
Virginia,Warrenton,9843,156,143,598,585,649,2131
Virginia,Warsaw,1287,82,5,57,57,55,256
Virginia,Washington,136,0,0,5,0,0,5
Virginia,Wattsville,1195,0,37,69,36,37,179
Virginia,Waverly,1570,35,54,106,100,28,323
Virginia,Waynesboro,21150,275,363,1100,918,1004,3660
Virginia,Weber City,1389,12,21,48,49,27,157
Virginia,West Falls Church,29489,505,377,1444,1514,1437,5277
Virginia,Westlake Corner,1058,46,0,46,27,11,130
Virginia,West Point,3336,56,44,204,250,60,614
Virginia,West Springfield,22897,413,320,1171,1172,1412,4488
Virginia,Weyers Cave,2754,119,64,267,98,101,649
Virginia,White Stone,479,14,1,15,17,28,75
Virginia,Whitesville,346,0,0,35,6,60,101
Virginia,Williamsburg,14754,186,78,297,288,281,1130
Virginia,Winchester,27168,205,198,1555,1380,1344,4682
Virginia,Lynchburg,78158,1162,660,3193,3423,3523,11961
Virginia,Luray,4843,42,18,159,171,320,710
Virginia,Lunenburg,180,11,0,12,13,11,47
Virginia,Wyndham,10040,235,199,951,944,799,3128
Virginia,Woodstock,5181,82,119,450,179,120,950
Virginia,Woodlawn CDP (Fairfax County),22466,212,460,1140,1067,1231,4110
Virginia,Warfield,87,5,0,0,0,0,5
Virginia,Low Moor,122,0,0,0,0,0,0
Virginia,Woodburn,8883,186,93,298,320,366,1263
Virginia,Woodbridge,4448,52,60,331,84,219,746
Virginia,Wolf Trap,16631,375,210,890,1317,1320,4112
Virginia,Wise,3185,94,34,153,72,174,527
Virginia,Wintergreen,377,0,0,0,0,0,0
Virginia,Windsor,2642,4,75,132,85,213,509
Virginia,Woodlake,6945,93,105,505,388,639,1730
Virginia,Lyndhurst,1681,11,16,94,167,168,456
Virginia,Wakefield,13082,331,97,658,783,1016,2885
Virginia,Virginia Beach,448290,7278,5289,22771,23133,22573,81044
Virginia,Surry,235,0,4,2,16,14,36
Virginia,Sussex,145,0,0,0,11,4,15
Virginia,Tangier,491,0,2,1,16,40,59
Virginia,Tappahannock,2223,12,19,113,99,103,346
Virginia,Tasley,237,28,9,0,13,0,50
Virginia,Tazewell,4522,80,102,237,219,273,911
Virginia,Temperanceville,449,0,0,0,0,25,25
Virginia,Templeton,488,0,15,14,13,45,87
Virginia,The Plains,187,4,4,4,8,20,40
Virginia,Thynedale,72,0,0,0,0,0,0
Virginia,Timberlake,12440,165,105,735,599,631,2235
Virginia,Timberville,2576,46,45,136,181,69,477
Virginia,Toms Brook,337,0,12,21,40,15,88
Virginia,Triangle,8901,189,57,558,314,593,1711
Virginia,Troutdale,149,1,2,6,4,7,20
Virginia,Troutville,551,5,2,6,10,8,31
Virginia,Tuckahoe,47316,1018,485,2244,2474,2761,8982
Virginia,Virgilina,135,0,5,5,0,8,18
Virginia,Vinton,8162,63,119,341,525,575,1623
Virginia,Villa Heights,458,12,0,0,0,0,12
Virginia,Vienna,16341,384,202,1137,902,1174,3799
Virginia,Victoria,1809,10,23,86,76,80,275
Virginia,Verona,3434,17,58,141,173,135,524
Virginia,Wachapreague,201,0,0,11,8,2,21
Virginia,Vansant,389,0,0,6,37,5,48
Virginia,University of Virginia,8902,27,28,49,60,15,179
Virginia,University Center,4341,29,57,163,75,216,540
Virginia,Union Level,101,0,0,0,0,0,0
Virginia,Union Hall,1365,7,24,82,52,34,199
Virginia,Tysons Corner,22437,426,224,841,1049,900,3440
Virginia,Twin Lakes,1744,0,64,138,105,61,368
Virginia,Urbanna,556,0,0,12,31,7,50
Virginia,McKenney,401,5,1,15,21,20,62
Virginia,Wakefield,850,8,17,16,76,48,165
Virginia,South Riding,27441,918,673,2422,2284,1705,8002
Virginia,Springfield,30444,285,339,1440,1427,2079,5570
Virginia,Spotsylvania Courthouse,4382,31,116,331,263,260,1001
Virginia,Sperryville,259,8,0,5,18,7,38
Virginia,Southside Chesconessex,159,0,26,53,0,0,79
Virginia,South Run,6500,102,84,279,458,636,1559
Virginia,South Hill,4566,18,79,300,189,346,932
Virginia,Southern Gateway,2900,0,83,240,165,182,670
Virginia,South Boston,8037,68,87,279,559,435,1428
Virginia,Southampton Meadows,398,0,0,0,0,108,108
Virginia,Snowville,185,0,0,8,22,22,52
Virginia,Smithfield,8233,190,198,474,471,389,1722
Virginia,Skyland Estates,713,23,0,16,22,37,98
Virginia,Shipman,412,0,0,26,8,7,41
Virginia,Sherando,746,0,0,22,34,34,90
Virginia,Short Pump,26902,796,386,1718,2171,1740,6811
Virginia,Shenandoah Retreat,578,0,0,53,0,31,84
Virginia,Lowes Island,11396,376,181,611,786,795,2749
Virginia,Sugar Grove,549,9,0,9,0,22,40
Virginia,Sugarland Run,12527,194,202,724,688,769,2577
Virginia,Springville,1647,33,6,37,55,34,165
Virginia,Shenandoah Shores,906,0,20,99,27,78,224
Washington,Bryant,1815,0,15,99,76,137,327
Washington,Bryn Mawr-Skyway,16473,125,150,748,1109,913,3045
Washington,Camano,15500,179,123,564,627,732,2225
Washington,Burlington,8509,230,179,386,392,433,1620
Washington,Burley,1735,0,27,105,115,77,324
Washington,Buckley,4475,137,33,155,344,264,933
Washington,Burbank,3114,75,23,173,154,316,741
Washington,Bunk Foss,3522,59,97,125,326,322,929
Washington,Buena,1691,0,92,227,213,77,609
Washington,Bucoda,622,0,8,25,15,40,88
Washington,Brush Prairie,2708,0,61,132,188,136,517
Washington,Burien,49785,622,651,2469,2606,2647,8995
Washington,Browns Point,1260,13,20,66,42,43,184
Washington,Krupp,45,0,0,2,0,2,4
Washington,Forks,3693,49,56,302,99,175,681
Washington,Fort Lewis,13163,121,281,1301,653,358,2714
Washington,Four Lakes,221,0,0,0,0,0,0
Washington,Camas,20890,410,233,1296,1664,1753,5356
Washington,Fox Island,3731,59,72,144,151,293,719
Washington,Frederickson,19949,287,402,1167,1139,992,3987
Washington,Freeland,1803,26,0,77,66,81,250
Washington,Friday Harbor,2162,35,13,103,110,113,374
Washington,Garfield,496,6,0,13,20,6,45
Washington,Garrett,1508,0,8,111,55,78,252
Washington,Geneva,2544,44,76,111,120,138,489
Washington,George,648,7,9,39,29,61,145
Washington,Gig Harbor,7918,132,126,281,347,382,1268
Washington,Fords Prairie,1815,0,40,153,110,91,394
Washington,Canterwood,3408,10,65,80,145,245,545
Washington,Cathlamet,612,11,1,38,24,59,133
Washington,Carbonado,547,9,11,37,35,23,115
Washington,Clear Lake CDP (Pierce County),1114,0,0,40,28,89,157
Washington,Clayton,346,0,0,47,31,17,95
Washington,Clarkston Heights-Vineland,6590,123,101,340,303,424,1291
Washington,Clarkston,7330,63,144,399,283,395,1284
Washington,Clallam Bay,378,16,0,17,15,0,48
Washington,Chinook,341,0,17,31,0,14,62
Washington,Chico,2157,8,10,96,58,155,327
Washington,Chewelah,2592,14,57,115,162,130,478
Washington,Cherry Grove,647,0,0,84,96,0,180
Washington,Cheney,11171,45,20,351,397,437,1250
Washington,Chelan Falls,186,0,0,0,0,0,0
Washington,Chelan,3974,117,68,195,139,97,616
Washington,Canyon Creek,3045,78,30,254,161,232,755
Washington,Chehalis,7314,210,143,327,266,498,1444
Washington,Central Park,2652,21,37,160,88,63,369
Washington,Centralia,16683,237,275,833,754,826,2925
Washington,Centerville,167,0,0,0,13,11,24
Washington,Cavalero,4950,119,62,297,229,401,1108
Washington,Glacier,73,0,0,0,0,0,0
Washington,Cathcart,2553,0,43,148,127,226,544
Washington,Castle Rock,2334,0,58,96,130,170,454
Washington,Cashmere,3146,66,48,102,163,187,566
Washington,Cascade Valley,2280,15,22,139,35,132,343
Washington,Carson,2361,25,25,126,129,148,453
Washington,Carnation,1733,28,33,79,113,139,392
Washington,Carlsborg,675,0,0,0,0,0,0
Washington,Chain Lake,4660,36,92,285,297,256,966
Washington,Gleed,2948,38,34,144,163,219,598
Washington,Grapeview,1156,0,0,63,0,24,87
Washington,Gold Bar,2193,46,17,113,138,113,427
Washington,Hockinson,4985,128,47,296,505,338,1314
Washington,Hobart,6362,76,28,332,363,354,1153
Washington,High Bridge,3152,78,17,148,136,232,611
Washington,Herron Island,81,0,0,0,0,0,0
Washington,Hazel Dell,20155,192,210,1282,823,1124,3631
Washington,Hatton,74,0,1,7,3,8,19
Washington,Hat Island,0,0,0,0,0,0,0
Washington,Hartline,119,0,0,2,2,9,13
Washington,Harrington,327,3,0,14,13,21,51
Washington,Harrah,680,15,16,48,46,47,172
Washington,Hansville,3617,28,31,168,150,190,567
Washington,Hamilton,230,4,1,11,6,8,30
Washington,Hogans Corner,161,0,0,0,0,38,38
Washington,Clear Lake CDP (Skagit County),1061,21,0,24,45,68,158
Washington,Green Bluff,992,27,0,0,85,208,320
Washington,Grays River,474,0,0,9,67,69,145
Washington,Grayland,489,0,0,0,0,0,0
Washington,Kent,124292,1351,1918,7095,6152,7835,24351
Washington,Ketron Island,0,0,0,0,0,0,0
Washington,Kettle Falls,1437,11,10,67,93,40,221
Washington,Key Center,3811,17,73,210,239,353,892
Washington,Keyport,488,0,0,35,17,0,52
Washington,Kingston,1963,42,64,131,82,79,398
Washington,Kirkland,84721,1520,1060,3487,3771,3360,13198
Washington,Kittitas,1387,18,8,78,69,46,219
Washington,Klahanie,11586,298,246,854,653,576,2627
Washington,Greenwater,109,0,0,0,0,0,0
Washington,Glenwood,186,5,7,17,4,4,37
Washington,Home,1702,39,29,130,127,84,409
Washington,Hoquiam,8479,216,96,419,405,424,1560
Washington,Goldendale,3437,97,107,99,88,219,610
Washington,Gorst,484,0,0,0,0,25,25
Washington,Graham,24976,327,450,1371,1852,1642,5642
Washington,Grand Coulee,897,9,3,26,20,48,106
Washington,Grand Mound,3329,247,15,355,70,181,868
Washington,Grandview,11083,92,242,1026,947,666,2973
Washington,Granger,3404,43,63,281,311,342,1040
Washington,Granite Falls,3451,16,68,152,254,285,775
Washington,Klickitat,448,0,0,1,39,12,52
Washington,Kendall,126,0,0,26,0,0,26
Washington,Kelso,11837,217,105,650,507,573,2052
Washington,Keller,228,10,8,9,18,16,61
Washington,Hoodsport,880,0,0,64,0,0,64
Washington,Kayak Point,2068,0,0,142,135,209,486
Washington,Kalama,2498,23,68,190,81,88,450
Washington,Kahlotus,224,18,4,13,5,5,45
Washington,Junction City,9,0,0,0,0,0,0
Washington,Jamestown,427,0,0,15,14,36,65
Washington,Issaquah,33682,450,532,1938,1800,1620,6340
Washington,Ione,342,13,4,7,5,20,49
Washington,Indianola,3486,48,46,177,173,153,597
Washington,Index,178,0,2,2,11,18,33
Washington,Inchelium,494,18,5,48,18,48,137
Washington,Ilwaco,1021,5,0,35,87,61,188
Washington,Hunts Point,508,2,9,34,36,38,119
Washington,Humptulips,251,0,0,0,0,74,74
Washington,Kapowsin,285,0,14,14,8,14,50
Washington,Clearview,3682,38,45,157,235,220,695
Washington,Des Moines,30715,396,436,1483,1345,1597,5257
Washington,Cliffdell,138,0,0,0,13,0,13
Washington,Everson,2553,65,9,121,197,196,588
Washington,Everett,105685,1382,1191,5142,4639,5028,17382
Washington,Esperance,3811,135,58,194,120,135,642
Washington,Eschbach,260,0,0,21,30,35,86
Washington,Erlands Point-Kitsap Lake,3065,54,47,173,234,154,662
Washington,Ephrata,7948,132,258,534,461,478,1863
Washington,Fairchild AFB,2947,99,62,199,142,73,575
Washington,Enumclaw,11494,103,162,782,734,626,2407
Washington,Enetai,1919,21,51,90,52,43,257
Washington,Endicott,239,13,2,4,9,7,35
Washington,Elmer City,307,7,5,30,5,20,67
Washington,Elma,3035,54,105,143,79,206,587
Washington,Ellensburg,18637,177,200,688,470,305,1840
Washington,Elk Plain,14252,99,211,873,830,794,2807
Washington,Entiat,1190,8,23,54,47,86,218
Washington,Electric City,1094,30,8,84,36,45,203
Washington,Fairfield,464,7,6,28,18,7,66
Washington,Fairwood CDP (Spokane County),8262,91,108,574,717,560,2050
Washington,McKenna,970,0,0,210,46,45,301
Washington,McMillin,1399,21,0,59,47,44,171
Washington,Malden,168,0,0,4,10,2,16
Washington,Malo,0,0,0,0,0,0,0
Washington,Fircrest,6612,68,66,328,423,227,1112
Washington,Finley,5958,64,70,300,441,372,1247
Washington,Fairwood CDP (King County),20032,414,247,1113,873,1111,3758
Washington,Fife Heights,2009,38,10,116,116,119,399
Washington,Fern Prairie,2108,8,28,160,46,131,373
Washington,Ferndale,12355,206,245,686,565,654,2356
Washington,Felida,7744,137,158,400,515,530,1740
Washington,Federal Way,92859,607,953,4722,5172,5344,16798
Washington,Farmington,104,5,2,4,7,9,27
Washington,Fall City,1729,44,0,40,63,100,247
Washington,Fife,9477,90,146,509,444,556,1745
Washington,Machias,1168,0,0,102,75,102,279
Washington,Elbe,0,0,0,0,0,0,0
Washington,Edison,162,42,18,0,0,0,60
Washington,Dixie,268,2,11,17,11,4,45
Washington,Curlew Lake,560,18,10,45,0,11,84
Washington,Cusick,106,0,0,0,1,6,7
Washington,Custer,423,0,9,0,0,0,9
Washington,Dallesport,1365,0,20,67,57,15,159
Washington,Danville,32,0,0,0,0,2,2
Washington,Dollars Corner,1101,10,0,13,20,92,135
Washington,Darrington,1497,36,9,123,78,94,340
Washington,Davenport,1610,39,24,53,69,135,320
Washington,Dayton,2852,13,7,139,140,174,473
Washington,Deep River,182,0,0,0,0,6,6
Washington,Deer Park,3784,39,32,277,282,125,755
Washington,Deming,420,0,0,22,52,19,93
Washington,Desert Aire,2131,0,41,385,150,113,689
Washington,Dash Point,830,10,5,26,28,15,84
Washington,Edmonds,40689,386,328,1514,1399,1839,5466
Washington,Donald,0,0,0,0,0,0,0
Washington,DuPont,9054,119,173,667,678,545,2182
Washington,Covington,18689,371,411,973,1381,1126,4262
Washington,Cowiche,1007,20,0,82,89,46,237
Washington,Creston,273,2,6,10,6,0,24
Washington,Crocker,1385,12,27,49,44,174,306
Washington,Curlew,117,0,4,2,13,3,22
Washington,Edgewood,9600,83,65,422,447,571,1588
Washington,Duluth,1550,10,6,30,70,52,168
Washington,Eatonville,2830,25,5,221,194,154,599
Washington,East Renton Highlands,11092,228,220,689,363,568,2068
Washington,East Port Orchard,5109,79,51,237,383,290,1040
Washington,Easton,374,0,0,24,15,42,81
Washington,Eastmont,21274,287,217,1099,1122,1394,4119
Washington,East Cathlamet,490,0,0,0,0,48,48
Washington,Duvall,7373,162,109,698,842,562,2373
Washington,East Wenatchee,13473,182,145,806,706,732,2571
Washington,Cle Elum,2544,55,58,118,96,158,485
Washington,McCleary,1965,60,74,150,106,79,469
Washington,Mabton,2329,54,50,159,223,142,628
Washington,Coupeville,2141,13,5,43,103,94,258
Washington,Fobes Hill,2824,41,65,138,96,114,454
Washington,Five Corners,19662,303,401,1070,1470,1294,4538
Washington,La Center,3066,52,52,167,246,219,736
Washington,Lacey,44825,796,532,1918,2288,2426,7960
Washington,La Conner,748,0,3,43,45,9,100
Washington,Country Homes,5573,55,32,141,168,255,651
Washington,LaCrosse,265,0,2,4,2,9,17
Washington,Lake Bosworth,554,0,8,36,29,44,117
Washington,Lake Cassidy,3666,28,17,400,137,322,904
Washington,Lake Cavanaugh,125,0,0,8,0,0,8
Washington,Lake Forest Park,13059,224,193,519,445,463,1844
Washington,Lake Goodwin,3577,65,51,65,82,306,569
Washington,Lake Holm,3416,0,58,180,153,239,630
Washington,La Grande,102,0,0,0,0,0,0
Washington,Disautel,27,0,0,0,0,0,0
Washington,Coulee Dam,1290,19,18,78,51,77,243
Washington,Cottage Lake,23703,421,223,1211,1658,1973,5486
Washington,Clinton,766,7,6,2,44,1,60
Washington,Clover Creek,6792,19,35,370,207,362,993
Washington,Clyde Hill,3150,105,55,155,200,315,830
Washington,Cohassett Beach,641,16,0,32,44,29,121
Washington,Colfax,2842,37,50,124,149,143,503
Washington,College Place,8957,127,25,303,236,210,901
Washington,Coulee City,634,0,8,22,58,11,99
Washington,Colton,435,7,4,8,25,32,76
Washington,Conconully,172,0,3,3,0,5,11
Washington,Concrete,739,15,22,40,28,48,153
Washington,Connell,5359,108,52,395,235,360,1150
Washington,Conway,10,0,0,0,0,0,0
Washington,Copalis Beach,370,0,0,0,0,0,0
Washington,Cosmopolis,1547,0,7,67,113,88,275
Washington,Colville,4692,38,54,195,301,335,923
Washington,McChord AFB,3288,66,118,280,164,103,731
Washington,Lakeland North,12380,198,105,714,632,676,2325
Washington,Lake McMurray,132,0,0,9,0,0,9
Washington,Lind,488,26,3,25,34,35,123
Washington,Lochsloy,2593,0,37,192,167,88,484
Washington,Lofall,2081,16,25,52,75,152,320
Washington,Long Beach,1434,36,15,41,43,31,166
Washington,Longbranch,3023,31,88,154,85,154,512
Washington,Longview,36619,451,580,1527,2024,1579,6161
Washington,Liberty Lake,8269,376,155,543,618,177,1869
Washington,Longview Heights,3403,40,51,135,115,277,618
Washington,Loon Lake,766,6,10,43,46,28,133
Washington,Lower Elochoman,130,0,0,0,0,0,0
Washington,Lyle,578,0,0,59,0,59,118
Washington,Lyman,591,12,4,29,47,19,111
Washington,Lynden,12886,168,169,672,864,612,2485
Washington,Lynnwood,36491,472,434,1672,1874,1558,6010
Washington,Loomis,85,0,0,0,0,0,0
Washington,Lakeland South,13460,132,365,855,576,743,2671
Washington,Lewisville,1732,43,30,127,112,90,402
Washington,Leavenworth,2227,45,4,55,66,136,306
Washington,Lake Marcel-Stillwater,1269,36,17,48,64,132,297
Washington,Lake Morton-Berrydale,9921,100,67,364,436,477,1444
Washington,Lake Roesiger,772,15,14,85,28,46,188
Washington,Lake Shore,6957,47,142,310,436,343,1278
Washington,Lake Stevens,29774,546,439,1806,1607,2019,6417
Washington,Lake Stickney,8930,164,106,318,421,407,1416
Washington,Lebam,133,0,0,5,0,8,13
Washington,Lake Tapps,12710,155,184,823,671,961,2794
Washington,Lakewood,59122,754,868,2895,2409,2649,9575
Washington,Lamont,84,0,0,4,2,7,13
Washington,Langley,1287,6,0,72,82,64,224
Washington,Larch Way,3834,55,101,331,306,307,1100
Washington,Latah,160,1,2,13,18,14,48
Washington,Laurier,0,0,0,0,0,0,0
Washington,Lakeview,892,8,26,15,24,68,141
Washington,Lake Ketchum,948,0,0,36,33,33,102
Washington,Kenmore,21575,478,216,1163,1309,973,4139
Washington,Tukwila,19757,121,320,1096,958,1137,3632
Washington,Winlock,1513,49,54,54,119,60,336
Washington,Winthrop,364,8,3,19,16,15,61
Washington,Wishram,364,11,3,9,18,14,55
Washington,Wollochet,5930,95,51,324,313,182,965
Washington,Woodinville,11373,144,206,598,652,528,2128
Washington,Woodland,5589,131,49,437,375,569,1561
Washington,Woods Creek,5652,90,56,362,314,402,1224
Washington,Woodway,1337,26,27,66,120,106,345
Washington,Yacolt,1819,56,9,89,105,101,360
Washington,Yakima,93261,1018,1502,5564,5440,5269,18793
Washington,Yarrow Point,1172,44,18,56,74,110,302
Washington,Yelm,7701,34,142,518,870,734,2298
Washington,Zillah,3100,93,68,273,106,202,742
Washington,Alderton,3314,32,28,207,274,172,713
Washington,Alder,64,0,5,15,0,0,20
Washington,Albion,585,13,8,5,16,26,68
Washington,Airway Heights,6449,68,37,314,229,236,884
Washington,Ahtanum,3359,109,0,210,304,220,843
Washington,Addy,139,0,0,0,0,44,44
Washington,Wilson Creek,185,0,0,12,18,15,45
Washington,Willapa,233,5,0,4,12,13,34
Washington,Wilkeson,406,4,9,15,17,20,65
Washington,Wilderness Rim,1476,17,0,69,18,0,104
Washington,Nooksack,1807,74,40,141,151,102,508
Washington,Normandy Park,6568,199,21,325,176,252,973
Washington,North Bend,6305,70,215,268,484,338,1375
Washington,Warm Beach,2397,49,64,21,116,131,381
Washington,Washougal,14777,398,202,911,779,783,3073
Washington,Washtucna,279,0,3,43,4,10,60
Washington,Waterville,1869,25,50,116,164,130,485
Washington,Wauna,4451,110,22,147,220,216,715
Washington,Waverly,80,0,0,5,5,6,16
Washington,Acme,156,0,0,0,0,44,44
Washington,Wenatchee,32950,381,353,1779,2425,1988,6926
Washington,West Pasco,2223,13,22,200,106,71,412
Washington,Westport,1965,71,49,75,44,81,320
Washington,West Richland,13048,174,159,965,843,1028,3169
Washington,West Side Highway,5812,128,39,498,482,313,1460
Washington,Whidbey Island Station,1938,0,18,20,0,7,45
Washington,White Center,14728,59,188,773,810,957,2787
Washington,White Salmon,2212,37,9,167,117,79,409
Washington,White Swan,652,32,5,53,34,85,209
Washington,Wilbur,682,18,26,23,35,30,132
Washington,West Clarkston-Highland,5470,90,42,194,232,219,777
Washington,Nisqually Indian Community,644,28,8,46,44,27,153
Washington,Aberdeen Gardens,261,6,0,12,6,15,39
Washington,North Fort Lewis,3682,79,37,285,88,47,536
Washington,Othello,7624,62,275,737,422,468,1964
Washington,Otis Orchards-East Farms,6792,45,84,453,388,439,1409
Washington,Outlook,305,0,0,0,35,0,35
Washington,Oyehut,13,0,0,0,0,0,0
Washington,Pacific,6954,109,64,373,336,510,1392
Washington,Pacific Beach,216,0,0,0,0,0,0
Washington,Packwood,212,0,0,0,0,0,0
Washington,Palouse,1071,11,3,56,83,70,223
Washington,Parker,125,0,0,17,8,10,35
Washington,Parkland,36318,286,343,2005,2171,1833,6638
Washington,Parkwood,7294,93,77,349,305,422,1246
Washington,Pasco,67391,1008,1378,5114,4514,4858,16872
Washington,Pateros,678,7,0,49,54,107,217
Washington,Peaceful Valley,3654,15,33,173,279,308,808
Washington,Pe Ell,553,17,1,25,16,33,92
Washington,Picnic Point,9094,133,103,309,545,621,1711
Washington,Pine Grove,136,0,0,0,11,13,24
Washington,Point Roberts,1270,8,7,5,56,118,194
Washington,Pomeroy,1279,11,9,93,38,46,197
Washington,Oso,231,0,0,0,0,58,58
Washington,Orting,7078,84,216,623,514,272,1709
Washington,Oroville,1863,15,19,93,39,133,299
Washington,Orient,73,2,0,1,0,0,3
Washington,North Lynnwood,18829,186,256,760,927,698,2827
Washington,North Marysville,137,0,0,0,0,12,12
Washington,North Omak,773,15,0,48,82,80,225
Washington,Northport,334,3,0,7,26,25,61
Washington,North Puyallup,1758,0,18,45,57,92,212
Washington,North Sultan,201,12,0,0,12,10,34
Washington,Northwest Stanwood,82,0,0,10,10,0,20
Washington,North Yelm,2700,13,10,194,267,121,605
Washington,Oakesdale,543,7,5,19,21,31,83
Washington,Aberdeen,16429,278,135,860,1018,903,3194
Washington,Oak Harbor,22331,341,457,1204,1067,1064,4133
Washington,Ocean City,156,0,0,0,0,0,0
Washington,Ocean Park,1315,30,0,36,23,10,99
Washington,Ocean Shores,5637,43,48,15,148,201,455
Washington,Odessa,744,8,0,22,38,30,98
Washington,Okanogan,2594,23,42,117,148,135,465
Washington,Olympia,48941,732,532,2045,2092,2437,7838
Washington,Omak,4812,174,71,125,332,289,991
Washington,Onalaska,977,10,79,127,0,0,216
Washington,Orchards,21299,257,571,1491,1323,1449,5091
Washington,Oakville,725,7,3,23,57,17,107
Washington,Nile,89,0,0,0,0,0,0
Washington,Newport,2263,28,34,115,149,180,506
Washington,Newcastle,10994,298,230,563,502,469,2062
Washington,Benton City,3156,42,72,106,302,274,796
Washington,Bethel,3906,24,23,244,224,299,814
Washington,Bickleton,61,0,0,4,6,0,10
Washington,Big Lake,1934,0,21,83,56,122,282
Washington,Bingen,914,26,8,62,50,18,164
Washington,Birch Bay,8404,95,133,351,456,277,1312
Washington,Tumwater,18478,205,303,955,778,857,3098
Washington,Ames Lake,1358,13,22,99,34,122,290
Washington,Amboy,1878,59,35,186,228,27,535
Washington,Amanda Park,154,0,5,4,7,7,23
Washington,Altoona,66,0,0,0,0,0,0
Washington,Almira,263,5,2,18,9,8,42
Washington,Allyn,2144,0,0,21,112,142,275
Washington,Algona,3107,41,51,225,259,223,799
Washington,Alger,141,0,0,15,0,10,25
Washington,Alderwood Manor,9337,157,237,341,579,419,1733
Washington,Mercer Island,24120,519,216,1691,1704,1194,5324
Washington,Mesa,352,8,7,11,27,22,75
Washington,Metaline,206,0,7,10,4,0,21
Washington,Bellingham,82944,1083,839,2687,2824,3148,10581
Washington,Bell Hill,954,0,0,0,22,19,41
Washington,Bellevue,134630,2573,1436,5389,6124,6083,21605
Washington,Belfair,3298,62,42,218,173,166,661
Washington,Anacortes,16048,198,154,597,636,659,2244
Washington,Anderson Island,1053,0,0,0,0,10,10
Washington,Arlington,18578,282,312,1113,1524,813,4044
Washington,Arlington Heights,2725,54,46,133,96,179,508
Washington,Artondale,13376,216,158,560,1044,845,2823
Washington,Ashford,296,0,0,0,19,0,19
Washington,Asotin,1360,15,12,74,101,112,314
Washington,Auburn,74527,886,1261,4279,3733,4160,14319
Washington,Bainbridge Island,23343,458,270,1473,1374,1315,4890
Washington,Metaline Falls,136,1,0,0,0,2,3
Washington,Bangor Base,6392,164,168,261,286,165,1044
Washington,Barberton,6201,300,151,391,301,349,1492
Washington,Baring,164,0,0,16,0,0,16
Washington,Barney's Junction,179,0,0,0,0,0,0
Washington,Barstow,69,0,1,3,0,0,4
Washington,Basin City,1373,0,20,135,99,108,362
Washington,Battle Ground,18576,242,289,1348,1451,1461,4791
Washington,Bay Center,202,0,0,0,0,0,0
Washington,Bay View,826,11,12,33,74,24,154
Washington,Beaux Arts Village,333,15,0,36,29,30,110
Washington,Banks Lake South,200,15,10,11,9,22,67
Washington,Methow,49,0,0,0,0,0,0
Washington,Midland,8349,40,67,325,756,566,1754
Washington,Mill Creek,19028,268,251,1145,919,816,3399
Washington,Blaine,4905,39,78,237,420,176,950
Washington,Blyn,30,0,0,0,1,0,1
Washington,Bonney Lake,18516,332,386,899,1376,1086,4079
Washington,Bothell,41207,677,539,2158,1955,2076,7405
Washington,Bothell East,9307,207,171,661,576,412,2027
Washington,Bothell West,19088,417,277,1321,1025,816,3856
Washington,Boulevard Park,3815,56,0,152,128,176,512
Washington,Boyds,91,0,0,12,0,0,12
Washington,Brady,604,0,23,52,29,0,104
Washington,Black Diamond,4291,103,46,296,130,206,781
Washington,Bremerton,39017,705,438,1407,1062,1320,4932
Washington,Bridgeport,2285,16,66,229,174,145,630
Washington,Brier,6443,17,58,263,326,270,934
Washington,Brinnon,705,7,4,6,21,13,51
Washington,Medina,3120,89,60,175,314,293,931
Washington,Medical Lake,4924,59,107,132,408,323,1029
Washington,Neah Bay,945,38,9,64,66,55,232
Washington,Neilton,361,3,0,16,37,33,89
Washington,Nespelem,173,2,4,10,8,16,40
Washington,Nespelem Community,230,0,4,13,10,10,37
Washington,Brewster,2624,38,85,172,173,186,654
Washington,Port Angeles,19200,251,214,722,853,1033,3073
Washington,Navy Yard City,2622,10,11,70,91,195,377
Washington,Napavine,1748,19,24,75,84,100,302
Washington,Mill Creek East,17967,456,441,1265,757,968,3887
Washington,Millwood,1686,14,28,51,64,106,263
Washington,Milton,7219,65,59,417,178,412,1131
Washington,Mineral,188,0,0,0,0,0,0
Washington,Minnehaha,9548,71,216,616,417,310,1630
Washington,Mirrormont,3763,28,60,282,137,252,759
Washington,Moclips,0,0,0,0,0,0,0
Washington,Monroe,17734,311,274,944,931,1520,3980
Washington,Monroe North,1584,45,44,135,105,38,367
Washington,Naselle,342,0,4,5,15,25,49
Washington,Montesano,3894,98,37,218,194,232,779
Washington,Moses Lake,21579,427,503,1327,1614,1455,5326
Washington,Moses Lake North,4057,94,86,260,238,329,1007
Washington,Mossyrock,789,9,4,45,51,30,139
Washington,Mountlake Terrace,20521,206,309,787,1058,736,3096
Washington,Mount Vernon,32957,482,461,1985,1789,2157,6874
Washington,Mount Vista,7995,100,94,357,388,455,1394
Washington,Moxee,3702,105,72,322,300,265,1064
Washington,Mukilteo,20818,206,282,1032,1348,1346,4214
Washington,Naches,881,8,7,46,37,66,164
Washington,Morton,1296,4,9,70,119,68,270
Washington,Port Angeles East,3406,44,63,178,122,171,578
Washington,North Bonneville,1317,6,77,58,17,50,208
Washington,Port Gamble Tribal Community,898,24,11,51,69,53,208
Washington,Sumas,1563,17,28,71,133,80,329
Washington,Summit,7467,57,22,207,443,398,1127
Washington,Summit View,7014,44,74,439,289,354,1200
Washington,Summitview,1501,0,0,47,269,186,502
Washington,Sumner,9584,76,199,510,501,548,1834
Washington,Sunday Lake,838,0,0,57,100,0,157
Washington,Sunnyside,16204,286,273,1443,992,1110,4104
Washington,Sunnyslope,3452,50,34,139,245,167,635
Washington,Suquamish,4220,92,56,178,243,189,758
Washington,Porter,233,0,0,14,16,13,43
Washington,Sultan,4744,66,43,276,269,377,1031
Washington,Tacoma,203481,2706,2613,10162,8835,10015,34331
Washington,Tampico,427,0,0,0,38,47,85
Washington,Tanglewilde,6110,41,68,283,356,184,932
Washington,Tanner,1048,25,0,34,109,147,315
Washington,Tekoa,824,2,9,41,59,43,154
Washington,Tenino,1915,47,42,92,77,133,391
Washington,Terrace Heights,6952,44,121,504,378,378,1425
Washington,Thorp,351,0,0,15,23,4,42
Washington,Three Lakes,2902,9,8,103,80,180,380
Washington,Tieton,1391,3,18,131,148,126,426
Washington,Tokeland,240,0,0,0,4,11,15
Washington,Taholah,844,20,9,35,58,69,191
Washington,Toledo,605,0,6,24,22,37,89
Washington,Sudden Valley,6815,37,91,217,310,243,898
Washington,Steptoe,184,5,2,4,3,9,23
Washington,Snohomish,9437,146,145,451,384,594,1720
Washington,Snoqualmie,12115,536,214,721,841,560,2872
Washington,Snoqualmie Pass,249,0,2,3,0,6,11
Washington,Soap Lake,1766,22,30,62,104,124,342
Washington,South Bend,1703,22,12,107,74,127,342
Washington,South Cle Elum,552,6,0,24,29,27,86
Washington,South Creek,2140,0,0,0,63,45,108
Washington,South Hill,55592,712,639,3297,4161,4055,12864
Washington,South Prairie,292,0,3,15,18,9,45
Washington,South Wenatchee,1728,43,0,57,184,69,353
Washington,Stevenson,1402,21,5,52,42,29,149
Washington,Southworth,2393,10,22,124,124,69,349
Washington,Spangle,186,0,1,6,4,11,22
Washington,Spokane,210695,3160,2827,9559,9229,9325,34100
Washington,Spokane Valley,92286,1116,1292,4723,4569,4959,16659
Washington,Sprague,589,15,12,12,54,17,110
Washington,Springdale,304,8,2,22,24,10,66
Washington,Stansberry Lake,2312,50,8,167,119,167,511
Washington,Stanwood,6560,216,43,484,385,256,1384
Washington,Starbuck,90,0,0,0,0,0,0
Washington,Startup,696,0,0,32,53,24,109
Washington,Steilacoom,6118,96,98,204,132,337,867
Washington,Spanaway,29214,552,367,2089,1484,1980,6472
Washington,Skykomish,130,0,0,4,2,2,8
Washington,Tonasket,1053,34,3,49,48,43,177
Washington,Torboy,126,0,0,14,21,0,35
Washington,Twisp,976,32,3,57,16,58,166
Washington,Twin Lakes,103,0,0,0,8,0,8
Washington,Mattawa,4516,82,172,465,414,366,1499
Washington,Marysville,63760,933,877,2899,4005,3526,12240
Washington,Maryhill,0,0,0,0,0,0,0
Washington,Martha Lake,17163,408,164,710,771,1214,3267
Washington,Marrowstone,1242,38,0,41,27,16,122
Washington,Markham,126,0,0,0,0,0,0
Washington,Marietta-Alderwood,4704,117,91,177,196,212,793
Washington,Marcus,163,3,0,4,5,6,18
Washington,Union,345,0,0,0,0,0,0
Washington,Marblemount,63,0,0,8,0,0,8
Washington,Maple Valley,24682,535,495,2023,1745,1516,6314
Washington,Maple Heights-Lake Desire,3416,43,77,40,175,242,577
Washington,Maple Falls,14,0,0,0,0,0,0
Washington,Manson,1284,0,0,144,95,23,262
Washington,Mansfield,291,0,3,12,5,12,32
Washington,Manchester,5094,116,25,204,293,305,943
Washington,Maltby,11220,118,174,552,626,738,2208
Washington,Malott,649,0,0,30,63,32,125
Washington,Malone,551,34,18,32,100,15,199
Washington,Kennewick,76918,1302,1495,4210,4582,4995,16584
Washington,Maplewood,4961,41,42,282,359,303,1027
Washington,Toppenish,9006,181,237,792,618,773,2601
Washington,Union Gap,6042,41,116,396,511,368,1432
Washington,Uniontown,418,9,10,9,19,14,61
Washington,Touchet,436,17,15,15,37,49,133
Washington,Town and Country,5481,63,86,312,304,263,1028
Washington,Tracyton,6205,80,127,417,285,371,1280
Washington,Trout Lake,640,12,0,57,30,54,153
Washington,Warden,2735,39,78,272,234,231,854
Washington,Wapato,5075,61,97,509,367,287,1321
Washington,Walnut Grove,9732,133,98,517,486,513,1747
Washington,Wallula,302,0,0,79,88,27,194
Washington,Waller,7998,76,88,306,364,417,1251
Washington,Walla Walla East,1767,46,14,111,81,108,360
Washington,Union Hill-Novelty Hill,21510,568,266,1353,1209,1139,4535
Washington,Walla Walla,31957,496,267,1580,1866,1438,5647
Washington,Verlot,115,15,13,0,0,0,28
Washington,Venersborg,3823,32,71,323,216,235,877
Washington,Vaughn,527,0,0,19,11,18,48
Washington,Vashon,10189,86,77,303,546,511,1523
Washington,Vantage,27,0,0,0,0,0,0
Washington,Vancouver,168050,2455,2323,8342,8353,9220,30693
Washington,Valley,163,0,0,0,0,32,32
Washington,Vader,674,6,13,51,22,23,115
Washington,Upper Elochoman,51,0,0,0,0,11,11
Washington,University Place,31991,300,310,1141,2216,2097,6064
Washington,Waitsburg,1128,15,23,49,23,95,205
Washington,Skokomish,691,15,7,49,50,94,215
Washington,Swede Heaven,829,0,0,53,29,68,150
Washington,Sisco Heights,2829,21,5,130,170,228,554
Washington,Rockford,367,1,5,18,24,17,65
Washington,Rock Island,856,27,15,40,49,35,166
Washington,Rockport,78,0,0,0,0,0,0
Washington,Rocky Point,1592,51,10,24,57,77,219
Washington,Ronald,200,0,0,0,0,6,6
Washington,Roosevelt,148,0,2,20,0,3,25
Washington,Rosalia,635,2,2,40,46,43,133
Washington,Rosburg,429,0,0,16,58,0,74
Washington,Puget Island,798,0,0,38,67,40,145
Washington,Rosedale,4620,86,75,223,192,336,912
Washington,Rochester,2249,39,0,129,138,75,381
Washington,Roslyn,911,16,4,67,67,79,233
Washington,Royal City,1695,32,68,138,139,121,498
Washington,Ruston,915,13,3,26,17,40,99
Washington,Ryderwood,281,0,0,0,0,0,0
Washington,St. John,597,17,1,31,34,21,104
Washington,Salmon Creek,21301,316,216,1089,1169,1192,3982
Washington,Sammamish,50163,1476,734,4016,4083,3697,14006
Washington,Prosser,5819,105,102,458,328,216,1209
Washington,Prescott,377,25,5,36,18,42,126
Washington,Prairie Ridge,12495,169,213,708,727,862,2679
Washington,Prairie Heights,4306,26,66,313,302,326,1033
Washington,Roy,634,2,11,15,22,29,79
Washington,May Creek,661,41,0,50,25,21,137
Washington,Mead,7363,102,146,400,383,507,1538
Washington,Meadowdale,2806,37,35,117,126,219,534
Washington,River Road,383,7,0,16,0,28,51
Washington,Riverbend,2121,39,0,212,85,136,472
Washington,Ritzville,1603,50,19,85,44,46,244
Washington,Ridgefield,5693,150,125,558,382,551,1766
Washington,Richland,52291,796,670,2576,3154,2891,10087
Washington,Republic,1154,3,28,38,54,18,141
Washington,Renton,97234,1503,1331,4732,4259,4206,16031
Washington,Riverside,402,15,10,15,17,10,67
Washington,Redmond,57959,1493,843,2895,2635,1942,9808
Washington,Reardan,675,15,30,30,41,36,152
Washington,Raymond,2800,50,29,134,114,148,475
Washington,Ravensdale,1162,15,27,67,48,83,240
Washington,Rainier,2219,20,13,116,153,128,430
Washington,Raft Island,305,0,0,0,8,0,8
Washington,Quincy,7163,61,124,521,430,512,1648
Washington,Qui-nai-elt Village,69,6,0,17,0,8,31
Washington,Skamokawa Valley,377,0,0,0,9,10,19
Washington,Quilcene,437,0,0,19,17,21,57
Washington,Queets,175,3,8,7,9,19,46
Washington,Puyallup,38720,415,493,1663,1867,2092,6530
Washington,Purdy,1074,0,15,32,41,28,116
Washington,Pullman,31502,333,275,698,851,547,2704
Washington,Meadow Glade,2649,53,16,188,169,144,570
Washington,Poulsbo,9588,148,97,530,553,589,1917
Washington,Port Townsend,9208,119,63,271,192,388,1033
Washington,Port Orchard,13004,181,312,588,420,435,1936
Washington,SeaTac,27859,277,213,1153,1452,1103,4198
Washington,Santiago,19,0,0,4,0,0,4
Washington,Satsop,621,7,0,11,9,21,48
Washington,Seabeck,1306,0,22,50,70,34,176
Washington,Seattle,653017,11182,5683,21664,20074,17629,76232
Washington,Sedro-Woolley,10673,234,270,615,686,338,2143
Washington,Sekiu,53,0,0,0,0,0,0
Washington,Selah,7531,107,61,406,663,447,1684
Washington,Port Ludlow,2382,0,0,31,31,47,109
Washington,Shadow Lake,2714,22,8,37,148,207,422
Washington,Shelton,9810,76,141,650,851,568,2286
Washington,Shoreline,54774,756,517,1782,2228,2624,7907
Washington,Silvana,80,0,0,0,0,0,0
Washington,Silverdale,20053,343,288,997,810,1014,3452
Washington,Silver Firs,22153,599,626,1291,1362,1523,5401
Washington,Port Hadlock-Irondale,3552,16,41,109,99,97,362
Washington,Sequim,6695,109,55,201,269,254,888
West Virginia,Glen Ferris,123,0,0,0,0,0,0
West Virginia,Glen Fork,586,0,19,33,54,0,106
West Virginia,Glen Jean,340,0,0,53,44,1,98
West Virginia,Glenville,1812,31,16,33,55,80,215
West Virginia,Grant Town,587,1,5,28,29,34,97
West Virginia,Grafton,5173,115,37,100,249,285,786
West Virginia,Grantsville,581,9,4,16,51,21,101
West Virginia,Glen Dale,1537,54,12,64,38,45,213
West Virginia,Glen White,474,0,0,0,12,37,49
West Virginia,Enterprise,840,0,0,27,22,86,135
West Virginia,Gilbert Creek,1170,22,48,49,60,11,190
West Virginia,Gilbert,373,5,3,36,17,22,83
West Virginia,Fairlea,1817,0,0,189,37,47,273
West Virginia,Fairmont,18773,354,265,796,737,606,2758
West Virginia,Fairview,354,6,2,18,9,39,74
West Virginia,Falling Spring,169,0,1,9,3,11,24
West Virginia,Falling Waters,1109,0,12,43,12,12,79
West Virginia,Falls View,152,0,0,25,27,0,52
West Virginia,Farmington,399,5,6,12,24,24,71
West Virginia,Fayetteville,2914,57,19,93,140,125,434
West Virginia,Fenwick,130,0,5,0,9,0,14
West Virginia,Flatwoods,312,0,7,41,25,35,108
West Virginia,Flemington,366,0,0,26,38,31,95
West Virginia,Follansbee,2934,21,25,124,99,66,335
West Virginia,Fort Ashby,1454,0,0,51,53,80,184
West Virginia,Fort Gay,808,0,19,30,66,49,164
West Virginia,Frank,81,0,0,8,7,7,22
West Virginia,Franklin,726,0,7,17,18,27,69
West Virginia,Friendly,77,0,0,0,4,0,4
West Virginia,Gallipolis Ferry,996,11,0,15,22,85,133
West Virginia,Galloway,122,0,0,0,0,0,0
West Virginia,Gary,722,12,0,36,19,4,71
West Virginia,Gassaway,913,6,21,43,18,12,100
West Virginia,Gauley Bridge,723,25,7,42,32,23,129
West Virginia,Ghent,555,0,0,22,35,37,94
West Virginia,Glasgow,740,0,2,15,38,21,76
West Virginia,Ellenboro,454,5,12,22,32,20,91
West Virginia,Culloden,3549,20,48,187,280,227,762
West Virginia,Elkins,7244,67,20,281,373,293,1034
West Virginia,Williamson,3077,65,13,226,148,79,531
West Virginia,Wiley Ford,790,9,0,10,35,44,98
West Virginia,Whitmer,55,0,0,0,0,0,0
West Virginia,Whitesville,548,15,5,44,38,10,112
West Virginia,White Sulphur Springs,2538,14,24,84,135,89,346
West Virginia,White Hall,640,6,1,14,8,12,41
West Virginia,Wheeling,27894,321,261,1079,964,1173,3798
West Virginia,Beckley,17375,256,211,829,802,863,2961
West Virginia,Beaver,1086,0,0,0,29,0,29
West Virginia,Beards Fork,115,0,0,0,0,9,9
West Virginia,Bayard,403,0,10,26,9,20,65
West Virginia,Bath (Berkeley Springs),580,0,5,17,33,28,83
West Virginia,Bartow,47,0,0,0,0,0,0
West Virginia,Bartley,250,0,0,19,0,0,19
West Virginia,Barrackville,1324,13,3,75,74,116,281
West Virginia,Barboursville village,4078,82,0,132,81,150,445
West Virginia,Bancroft,914,0,1,20,23,35,79
West Virginia,Accoville,749,0,0,8,87,65,160
West Virginia,Addison (Webster Springs),1015,7,7,54,39,39,146
West Virginia,Albright,327,0,3,25,23,20,71
West Virginia,Alderson,1221,34,50,46,69,24,223
West Virginia,Alum Creek,1902,6,37,73,43,25,184
West Virginia,Amherstdale,205,0,0,18,0,7,25
West Virginia,Williamstown,2931,39,0,94,144,141,418
West Virginia,Anawalt,191,2,0,11,6,10,29
West Virginia,Ansted,1583,44,24,63,64,89,284
West Virginia,Apple Grove,175,0,14,0,5,5,24
West Virginia,Arbovale,197,16,0,0,15,0,31
West Virginia,Athens,1086,0,5,17,16,32,70
West Virginia,Auburn,128,0,0,6,10,2,18
West Virginia,Aurora,296,0,30,25,19,35,109
West Virginia,Anmoore,608,25,21,28,37,17,128
West Virginia,Elkview,1377,0,0,105,141,46,292
West Virginia,Windsor Heights village,437,2,1,15,21,26,65
West Virginia,Wolf Summit,124,0,0,0,0,0,0
West Virginia,Elk Garden,120,2,0,0,8,0,10
West Virginia,Elizabeth,839,10,5,72,42,54,183
West Virginia,Eleanor,1807,35,0,56,82,61,234
West Virginia,Eccles,118,0,0,0,0,0,0
West Virginia,East Dailey,434,0,0,13,13,92,118
West Virginia,East Bank,729,4,7,29,36,36,112
West Virginia,Durbin,224,0,13,16,9,6,44
West Virginia,Dunbar,7798,66,95,302,331,321,1115
West Virginia,Despard,1560,65,9,55,80,75,284
West Virginia,Delbarton,547,6,7,32,43,23,111
West Virginia,Deep Water,271,0,0,20,13,0,33
West Virginia,Davy,249,5,2,6,11,11,35
West Virginia,Davis,683,2,4,35,30,16,87
West Virginia,Danville,688,8,14,10,5,29,66
West Virginia,Daniels,2301,128,0,179,56,110,473
West Virginia,Dailey,101,0,0,0,0,0,0
West Virginia,Cucumber,57,0,0,0,0,14,14
West Virginia,Womelsdorf (Coalton),298,0,5,7,6,16,34
West Virginia,Worthington,140,0,6,3,4,7,20
West Virginia,Beech Bottom village,618,0,3,54,53,27,137
West Virginia,Belington,2080,57,62,115,83,106,423
West Virginia,Belle,1247,5,29,29,48,97,208
West Virginia,Belmont,1031,5,15,70,44,49,183
West Virginia,Winfield,2256,14,46,113,119,146,438
West Virginia,Belva,95,0,0,0,0,0,0
West Virginia,Bergoo,64,0,0,0,0,0,0
West Virginia,Granville,1966,0,13,9,123,57,202
West Virginia,Craigsville,1779,12,0,103,133,136,384
West Virginia,Cross Lanes,10567,248,32,401,936,585,2202
West Virginia,Crum,175,0,0,0,0,0,0
West Virginia,Crumpler,155,7,0,13,0,0,20
West Virginia,Benwood,1363,41,37,50,64,36,228
West Virginia,Great Cacapon,284,0,0,11,12,0,23
West Virginia,New Richmond,289,0,0,0,0,31,31
West Virginia,Dixie,135,0,0,0,6,0,6
West Virginia,Thurmond,7,0,0,0,0,0,0
West Virginia,Thomas,638,4,7,4,19,18,52
West Virginia,Terra Alta,1591,8,6,90,77,73,254
West Virginia,Teays Valley,13848,252,278,805,765,771,2871
West Virginia,Sylvester,133,6,0,0,4,3,13
West Virginia,Switzer,864,8,10,11,16,31,76
West Virginia,Tioga,10,0,0,0,0,0,0
West Virginia,Crab Orchard,2475,110,0,213,128,96,547
West Virginia,Covel,174,0,23,0,0,0,23
West Virginia,Corinne,200,31,0,0,0,13,44
West Virginia,Comfort,328,36,0,60,0,7,103
West Virginia,Coal Fork,1061,16,0,35,68,54,173
West Virginia,Coal City,1596,0,17,101,107,42,267
West Virginia,Clendenin,1033,6,17,24,28,63,138
West Virginia,Cowen,527,0,19,39,30,11,99
West Virginia,Tornado,1280,25,6,106,39,68,244
West Virginia,Triadelphia,640,14,2,13,39,13,81
West Virginia,Tunnelton,290,7,3,6,18,23,57
West Virginia,Wayne,1884,34,52,160,82,79,407
West Virginia,Waverly,215,0,0,9,0,9,18
West Virginia,Washington,1296,40,24,47,116,44,271
West Virginia,Wardensville,221,0,2,2,18,20,42
West Virginia,War,811,23,14,34,32,24,127
West Virginia,Wallace,479,8,12,19,84,60,183
West Virginia,Vivian,75,0,0,11,12,0,23
West Virginia,Vienna,10623,137,134,325,509,620,1725
West Virginia,Verdunville,763,0,0,13,20,0,33
West Virginia,Van,98,0,0,11,0,0,11
West Virginia,Valley Head,295,0,0,0,0,13,13
West Virginia,Valley Grove village,312,3,10,13,19,19,64
West Virginia,Valley Bend,519,0,0,37,81,0,118
West Virginia,Union,548,19,18,21,42,14,114
West Virginia,Twilight,165,19,0,33,15,0,67
West Virginia,Clearview village,516,10,14,19,31,15,89
West Virginia,Weirton,19432,274,309,736,762,754,2835
West Virginia,Clay,607,24,6,29,7,23,89
West Virginia,Chester,2526,29,97,116,117,118,477
West Virginia,Smithfield,139,0,9,7,4,7,27
West Virginia,Smithers,981,14,0,65,66,41,186
West Virginia,Sistersville,1366,3,5,41,87,101,237
West Virginia,Sissonville,4655,22,138,335,162,150,807
West Virginia,Shrewsbury,752,0,0,81,33,21,135
West Virginia,Shinnston,2565,0,21,143,153,96,413
West Virginia,Sophia,1356,36,7,61,45,98,247
West Virginia,Shepherdstown,1587,9,0,9,19,0,37
West Virginia,Shady Spring,3060,44,54,123,170,125,516
West Virginia,Scarbro,648,0,0,53,6,50,109
West Virginia,Sarah Ann,276,0,12,15,22,33,82
West Virginia,Sand Fork,182,0,1,21,6,11,39
West Virginia,Salt Rock,713,0,0,47,53,7,107
West Virginia,Salem,1671,17,2,48,108,81,256
West Virginia,Shannondale,3305,87,103,246,194,131,761
West Virginia,South Charleston,13276,227,114,545,569,726,2181
West Virginia,Spelter,470,17,0,44,53,0,114
West Virginia,Spencer,2014,14,19,88,88,61,270
West Virginia,Chesapeake,1544,3,33,44,69,52,201
West Virginia,Chelyan,889,0,0,103,0,86,189
West Virginia,Cheat Lake,9219,129,220,420,646,353,1768
West Virginia,Chauncey,331,22,0,0,0,48,70
West Virginia,Chattaroy,598,0,14,10,9,77,110
West Virginia,Charlton Heights,382,0,8,16,19,36,79
West Virginia,Charles Town,5587,136,73,335,415,134,1093
West Virginia,Charleston,50566,648,450,2494,2028,2572,8192
West Virginia,Sutton,1231,36,3,78,67,37,221
West Virginia,Summersville,3531,0,91,101,38,183,413
West Virginia,Stonewood,1909,4,0,97,118,60,279
West Virginia,Stollings,442,0,10,31,76,21,138
West Virginia,Star City,2050,27,4,66,80,38,215
West Virginia,Stanaford,1726,0,42,27,100,136,305
West Virginia,Springfield,389,0,0,12,31,22,65
West Virginia,Clarksburg,16347,228,262,895,714,778,2877
West Virginia,Welch,3021,6,17,62,49,39,173
West Virginia,Wellsburg,2746,85,0,69,172,44,370
West Virginia,West Hamlin,875,7,30,34,56,19,146
West Virginia,Monaville,166,20,0,0,0,0,20
West Virginia,Monongah,1020,13,18,34,50,44,159
West Virginia,Montcalm,559,0,9,10,10,10,39
West Virginia,Montgomery,1801,27,20,84,51,83,265
West Virginia,Montrose,165,0,0,6,5,4,15
West Virginia,Moorefield,2814,27,15,83,75,59,259
West Virginia,Mitchell Heights,381,3,5,11,13,30,62
West Virginia,Morgantown,30164,147,178,581,534,602,2042
West Virginia,Moundsville,8888,89,111,325,526,355,1406
West Virginia,Mount Carbon,346,0,0,0,7,24,31
West Virginia,Mount Gay-Shamrock,1349,0,11,88,36,90,225
West Virginia,Mount Hope,1271,27,23,71,36,48,205
West Virginia,Mullens,1993,28,15,129,125,113,410
West Virginia,Neibert,128,0,0,0,0,0,0
West Virginia,Green Bank,223,0,0,23,23,15,61
West Virginia,Mineralwells,1582,0,37,43,97,93,270
West Virginia,Minden,413,0,0,0,0,13,13
West Virginia,Milton,2557,53,32,79,79,68,311
West Virginia,Man,991,6,23,26,85,39,179
West Virginia,Mannington,2036,38,23,98,105,121,385
West Virginia,Marlinton,1002,21,7,8,42,33,111
West Virginia,Marmet,1570,25,4,46,42,75,192
West Virginia,Martinsburg,17564,314,325,923,941,1057,3560
West Virginia,Mason,966,21,0,41,34,36,132
West Virginia,Masontown,602,6,6,33,14,32,91
West Virginia,Matewan,516,0,4,33,36,24,97
West Virginia,Matheny,379,0,0,0,0,14,14
West Virginia,Matoaka,212,4,0,17,16,11,48
West Virginia,Maybeury,149,0,0,0,8,9,17
West Virginia,Meadow Bridge,384,2,10,53,22,16,103
West Virginia,Middlebourne,875,17,17,46,51,48,179
West Virginia,Middleway,519,0,0,34,37,11,82
West Virginia,Mill Creek,745,0,7,29,36,68,140
West Virginia,Nettie,757,0,0,56,0,21,77
West Virginia,Newburg,401,0,8,26,10,8,52
West Virginia,New Cumberland,1165,10,7,73,58,45,193
West Virginia,Newell,1317,16,26,30,7,94,173
West Virginia,Pea Ridge,6323,75,32,251,366,254,978
West Virginia,Pennsboro,1184,13,4,72,76,63,228
West Virginia,Pentress,197,0,0,40,33,0,73
West Virginia,Petersburg,2450,26,7,119,115,126,393
West Virginia,Peterstown,473,3,13,6,29,10,61
West Virginia,Philippi,3192,64,13,93,128,151,449
West Virginia,Pickens,33,0,0,0,0,0,0
West Virginia,Piedmont,839,11,8,36,30,39,124
West Virginia,Pinch,2876,0,41,107,211,83,442
West Virginia,Pine Grove,658,0,23,37,17,44,121
West Virginia,Westover,4145,43,76,84,101,86,390
West Virginia,Weston,4096,10,61,122,140,210,543
West Virginia,West Milford,772,2,8,64,24,56,154
West Virginia,West Logan,573,12,21,32,32,15,112
West Virginia,West Liberty,1781,8,12,21,24,42,107
West Virginia,Pax,151,0,2,6,11,4,23
West Virginia,St. Marys,1725,22,36,57,64,102,281
West Virginia,Paw Paw,504,1,11,48,17,32,109
West Virginia,Parkersburg,31133,517,332,1503,1432,1191,4975
West Virginia,New Haven,1456,6,9,74,44,68,201
West Virginia,New Martinsville,5295,71,51,305,161,394,982
West Virginia,West Union,1163,5,22,60,132,94,313
West Virginia,Nitro,6711,138,40,217,204,348,947
West Virginia,Northfork,320,10,9,15,11,10,55
West Virginia,North Hills,867,13,20,44,58,73,208
West Virginia,Nutter Fort,1625,11,19,60,94,99,283
West Virginia,Oak Hill,8249,142,69,528,564,443,1746
West Virginia,Oakvale,174,5,0,1,14,4,24
West Virginia,Oceana,1172,0,24,35,60,44,163
West Virginia,Omar,447,0,0,10,0,25,35
West Virginia,Paden City,2773,45,77,152,117,122,513
West Virginia,Page,161,0,8,6,19,7,40
West Virginia,Pageton,88,0,0,0,0,5,5
West Virginia,Parcoal,43,0,0,0,0,0,0
West Virginia,Parsons,1526,21,17,54,79,76,247
West Virginia,St. George,63,0,0,0,0,0,0
West Virginia,Shenandoah Junction,516,10,0,31,10,52,103
West Virginia,Rupert,902,5,28,49,42,24,148
West Virginia,Hilltop,686,0,0,26,26,28,80
West Virginia,Hillsboro,262,7,3,8,24,4,46
West Virginia,Hico,174,0,0,0,0,9,9
West Virginia,Hepzibah,703,0,0,22,31,12,65
West Virginia,Henlawson,244,0,0,0,0,0,0
West Virginia,Hendricks,243,0,0,2,8,6,16
West Virginia,Henderson,170,1,0,10,3,0,14
West Virginia,Hinton,2589,30,0,118,56,93,297
West Virginia,Helvetia,31,0,0,0,0,0,0
West Virginia,Hedgesville,283,0,1,29,20,17,67
West Virginia,Harts,627,0,11,37,0,0,48
West Virginia,Hartford City,612,16,10,46,34,24,130
West Virginia,Harrisville,2423,40,53,101,95,89,378
West Virginia,Harpers Ferry,200,0,0,2,7,4,13
West Virginia,Harman,106,0,0,8,3,4,15
West Virginia,Handley,301,8,3,24,24,19,78
West Virginia,Helen,114,0,0,0,0,0,0
West Virginia,Hamlin,1643,3,17,106,59,90,275
West Virginia,Holden,644,0,23,14,49,60,146
West Virginia,Hooverson Heights,2834,0,6,123,118,191,438
West Virginia,Point Pleasant,4307,38,79,130,161,254,662
West Virginia,St. Albans,10882,195,74,460,454,333,1516
West Virginia,Pleasant Valley,3180,30,24,121,90,132,397
West Virginia,Piney View,911,9,9,50,8,49,125
West Virginia,Pineville,685,4,6,9,14,15,48
West Virginia,Chapmanville,1297,28,6,77,78,51,240
West Virginia,Ceredo,1471,3,7,19,73,79,181
West Virginia,Hometown,530,0,0,0,39,0,39
West Virginia,Century,185,13,9,0,0,9,31
West Virginia,Cassville,1150,34,0,38,9,52,133
West Virginia,Cass,47,0,0,0,0,0,0
West Virginia,Carpendale,789,0,15,19,27,37,98
West Virginia,Carolina,355,0,0,0,0,29,29
West Virginia,Capon Bridge,373,0,12,38,29,18,97
West Virginia,Huntersville,146,0,0,18,0,0,18
West Virginia,Hundred,262,3,0,6,9,3,21
West Virginia,Cedar Grove,838,0,13,31,54,21,119
West Virginia,Hambleton,254,0,2,10,8,13,33
West Virginia,Gypsy,317,13,0,13,13,0,39
West Virginia,Greenview,486,0,0,15,26,49,90
West Virginia,Boomer,923,38,0,6,0,26,70
West Virginia,Bolt,598,35,0,34,0,47,116
West Virginia,Bolivar,1236,17,20,43,23,28,131
West Virginia,Boaz,1306,6,17,49,53,86,211
West Virginia,Bluewell,2535,39,0,13,134,230,416
West Virginia,Bluefield,10431,90,84,500,466,546,1686
West Virginia,Blennerhassett,2769,0,48,104,87,150,389
West Virginia,Bowden,0,0,0,0,0,0,0
West Virginia,Blacksville,163,3,0,11,7,9,30
West Virginia,Big Sandy,185,0,0,0,0,0,0
West Virginia,Big Creek,367,7,0,6,12,0,25
West Virginia,Big Chimney,301,0,0,0,0,0,0
West Virginia,Beverly,656,0,18,47,10,23,98
West Virginia,Bethlehem village,2589,58,57,120,105,145,485
West Virginia,Bethany,1137,5,0,13,10,24,52
West Virginia,Berwind,578,65,14,33,14,18,144
West Virginia,Birch River,62,0,0,16,0,0,16
West Virginia,Bradley,1810,45,12,59,43,108,267
West Virginia,Bradshaw,293,2,3,8,6,22,41
West Virginia,Bramwell,293,4,0,9,6,0,19
West Virginia,Green Spring,252,0,0,0,0,19,19
West Virginia,Cameron,969,18,9,66,78,65,236
West Virginia,Camden-on-Gauley,196,0,7,5,34,0,46
West Virginia,Cairo,405,0,12,50,31,16,109
West Virginia,Burnsville,511,0,0,28,7,10,45
West Virginia,Burlington,243,0,0,84,12,11,107
West Virginia,Buffalo,1331,8,22,57,74,64,225
West Virginia,Bud,440,11,0,0,0,19,30
West Virginia,Buckhannon,5650,104,43,110,188,133,578
West Virginia,Brush Fork,1137,5,8,94,13,62,182
West Virginia,Bruno,1102,113,0,17,129,31,290
West Virginia,Bruceton Mills,54,0,0,2,2,3,7
West Virginia,Brookhaven,5384,103,48,344,281,179,955
West Virginia,Bridgeport,8338,106,90,369,408,445,1418
West Virginia,Brenton,207,0,0,27,0,8,35
West Virginia,Brandywine,119,0,2,0,2,0,4
West Virginia,Brandonville,140,15,0,15,6,6,42
West Virginia,Powellton,610,15,27,52,57,47,198
West Virginia,Pratt,527,10,5,37,23,43,118
West Virginia,Poca,1071,0,10,68,39,62,179
West Virginia,Prince,100,0,0,0,0,13,13
West Virginia,Lumberport,1022,6,9,60,73,58,206
West Virginia,Lubeck,1308,6,6,37,105,63,217
West Virginia,Lost Creek,481,0,6,28,31,34,99
West Virginia,Logan,1818,90,10,48,35,35,218
West Virginia,Littleton,123,0,0,14,0,0,14
West Virginia,Lewisburg,3948,53,24,47,106,195,425
West Virginia,Lester,334,10,7,6,20,18,61
West Virginia,Mabscott,1387,38,16,48,90,44,236
West Virginia,Lesage,1358,58,0,46,50,34,188
West Virginia,Lavalette,1159,0,33,19,71,24,147
West Virginia,Lashmeet,436,0,0,15,27,15,57
West Virginia,Kopperston,495,38,0,11,0,11,60
West Virginia,Kistler,507,0,0,42,32,0,74
West Virginia,Kingwood,2955,8,0,198,100,172,478
West Virginia,Kincaid,392,0,0,35,55,14,104
West Virginia,Prichard,267,0,0,0,0,0,0
West Virginia,Leon,128,2,0,1,13,0,16
West Virginia,MacArthur,1559,12,0,65,39,72,188
West Virginia,McConnell,615,36,13,45,77,0,171
West Virginia,McMechen,1702,17,2,89,18,112,238
West Virginia,Rowlesburg,749,6,5,51,45,56,163
West Virginia,Rossmore,596,0,0,20,30,18,68
West Virginia,Ronceverte,1582,13,21,31,62,46,173
West Virginia,Romney,2221,20,11,100,83,166,380
West Virginia,Roderfield,51,0,0,0,11,0,11
West Virginia,Robinette,703,5,8,53,38,40,144
West Virginia,Rivesville,1025,18,12,68,63,39,200
West Virginia,Ripley,3258,0,14,193,80,202,489
West Virginia,Ridgeley,612,0,8,19,26,37,90
West Virginia,Richwood,2180,22,23,86,100,60,291
West Virginia,Rhodell,212,3,0,8,23,15,49
West Virginia,Reedy,149,2,0,8,6,8,24
West Virginia,Reedsville,508,15,11,17,4,6,53
West Virginia,Red Jacket,685,0,0,63,30,11,104
West Virginia,Reader,359,0,0,23,0,0,23
West Virginia,Mallory,1306,5,0,40,13,76,134
West Virginia,Madison,2993,34,32,164,123,114,467
West Virginia,Kimball,105,0,1,2,2,0,5
West Virginia,Keystone,176,4,3,9,13,5,34
West Virginia,Kimberly,261,13,0,0,0,0,13
West Virginia,Kermit,294,1,2,7,6,11,27
West Virginia,Idamay,204,0,0,21,6,8,35
West Virginia,Iaeger,241,0,0,3,17,13,33
West Virginia,Keyser,5320,22,43,175,213,243,696
West Virginia,Hurricane,6388,93,83,487,429,243,1335
West Virginia,Huntington,48944,600,427,1743,1989,1864,6623
West Virginia,Raysal,498,0,0,14,7,52,73
West Virginia,Ravenswood,3853,96,79,331,238,183,927
West Virginia,Inwood,2351,60,34,86,103,80,363
West Virginia,Ranson corpora,4713,114,81,218,369,285,1067
West Virginia,Rainelle,1452,9,14,58,82,66,229
West Virginia,Racine,235,0,0,10,16,7,33
West Virginia,Rachel,234,13,0,16,0,14,43
West Virginia,Quinwood,209,3,1,5,8,8,25
West Virginia,Pullman,190,0,0,0,2,9,11
West Virginia,Prosperity,1624,11,0,61,93,80,245
West Virginia,Princeton,6082,89,45,299,206,267,906
West Virginia,Rand,1315,0,28,105,81,66,280
West Virginia,Itmann,302,22,12,44,0,12,90
West Virginia,Huttonsville,260,8,6,17,29,2,62
West Virginia,Kenova,3127,47,36,203,81,79,446
West Virginia,Justice,427,0,14,0,46,52,112
West Virginia,Junior,471,0,2,26,15,26,69
West Virginia,Jefferson,800,5,32,54,88,18,197
West Virginia,Jane Lew,365,0,16,29,14,16,75
West Virginia,Jacksonburg,106,0,0,0,0,0,0
Wisconsin,Arpin village,319,3,5,10,22,30,70
Wisconsin,Avoca village,595,0,11,33,19,54,117
Wisconsin,Augusta,1468,14,4,108,90,48,264
Wisconsin,Auburndale village,626,10,14,29,45,20,118
Wisconsin,Athens village,1016,20,18,33,55,66,192
Wisconsin,Ashwaubenon village,17082,275,145,738,801,1055,3014
Wisconsin,Angelica,87,0,3,9,4,0,16
Wisconsin,Aniwa village,243,2,6,12,14,19,53
Wisconsin,Babcock,72,0,0,0,7,0,7
Wisconsin,Appleton,73118,1138,1076,3997,3807,4536,14554
Wisconsin,Arcadia,2947,91,103,87,237,111,629
Wisconsin,Arena village,820,24,12,52,51,51,190
Wisconsin,Argonne,176,0,5,0,8,4,17
Wisconsin,Ashippun,216,7,0,12,16,11,46
Wisconsin,Ashland,8116,46,70,261,397,355,1129
Wisconsin,Argyle village,785,7,2,46,64,36,155
Wisconsin,Arkansaw,179,5,6,3,1,21,36
Wisconsin,Arkdale,145,0,0,0,3,7,10
Wisconsin,Arlington village,860,12,18,38,52,64,184
Wisconsin,Antigo,8001,39,48,285,456,445,1273
Wisconsin,Bagley village,478,3,13,9,16,24,65
Wisconsin,Cataract,139,4,0,3,2,4,13
Wisconsin,Baldwin village,3964,66,119,254,180,177,796
Wisconsin,Dalton,222,10,5,13,16,0,44
Wisconsin,Dallas village,368,0,2,20,12,7,41
Wisconsin,Dale,473,4,0,18,35,46,103
Wisconsin,Curtiss village,319,11,18,26,20,20,95
Wisconsin,Cumberland,2434,44,11,70,104,93,322
Wisconsin,Cudahy,18347,137,300,835,919,782,2973
Wisconsin,Cuba City,1917,36,17,114,89,72,328
Wisconsin,Cross Plains village,3834,101,52,241,254,225,873
Wisconsin,Crivitz village,1035,0,40,41,55,33,169
Wisconsin,Crandon,1914,29,11,95,83,132,350
Wisconsin,Couderay village,75,0,0,2,4,2,8
Wisconsin,Cottage Grove village,6639,43,101,500,664,473,1781
Wisconsin,Cornucopia,93,0,0,0,0,2,2
Wisconsin,Cornell,1481,28,11,58,50,85,232
Wisconsin,Coon Valley village,689,5,6,18,42,34,105
Wisconsin,Conrath village,133,0,0,4,6,10,20
Wisconsin,Como,2416,31,45,115,182,105,478
Wisconsin,Combined Locks village,3444,48,86,152,239,208,733
Wisconsin,Columbus,4999,50,38,382,267,306,1043
Wisconsin,Boaz village,113,2,2,0,5,2,11
Wisconsin,Bohners Lake,2110,0,28,118,144,57,347
Wisconsin,Bonduel village,1409,23,28,116,103,63,333
Wisconsin,Boscobel,3194,18,31,98,94,168,409
Wisconsin,Boulder Junction,123,0,0,0,3,8,11
Wisconsin,Bowler village,416,26,5,15,21,30,97
Wisconsin,Coloma village,392,3,3,11,25,36,78
Wisconsin,Collins,180,3,7,10,5,2,27
Wisconsin,Danbury,219,7,16,29,16,9,77
Wisconsin,Dane village,1171,21,28,77,63,42,231
Wisconsin,Darien village,1708,17,22,93,108,164,404
Wisconsin,Darlington,2338,14,20,102,116,99,351
Wisconsin,Eagle River,1644,43,21,72,78,82,296
Wisconsin,Eagle Lake,1229,15,0,37,28,51,131
Wisconsin,Eagle village,1777,16,19,104,116,78,333
Wisconsin,Dyckesville,484,7,3,15,31,18,74
Wisconsin,Durand,1742,17,36,98,54,77,282
Wisconsin,Dunbar,121,5,4,16,15,12,52
Wisconsin,Drummond,163,0,2,6,3,7,18
Wisconsin,Dresser village,859,20,15,34,36,61,166
Wisconsin,Doylestown village,265,0,7,13,8,18,46
Wisconsin,Downsville,130,0,3,3,0,12,18
Wisconsin,Downing village,326,1,3,17,24,39,84
Wisconsin,Dousman village,2412,16,34,97,160,167,474
Wisconsin,Dorchester village,977,19,17,79,50,59,224
Wisconsin,Colfax village,1154,19,24,100,58,72,273
Wisconsin,Dodgeville,4678,132,66,230,310,251,989
Wisconsin,Dickeyville village,1176,45,10,49,66,44,214
Wisconsin,Diaperville,40,0,0,2,4,6,12
Wisconsin,Diamond Bluff,160,0,3,5,3,4,15
Wisconsin,De Soto village,275,1,6,8,6,34,55
Wisconsin,De Pere,24366,275,198,1266,1481,1396,4616
Wisconsin,Denmark village,2080,57,53,131,77,118,436
Wisconsin,Dellwood,598,0,2,34,30,21,87
Wisconsin,Delavan Lake,2352,46,10,74,38,146,314
Wisconsin,Delavan,8439,241,102,525,567,375,1810
Wisconsin,Delafield,7168,93,160,238,432,531,1454
Wisconsin,DeForest village,9347,112,141,723,562,554,2092
Wisconsin,Deer Park village,235,4,3,11,13,17,48
Wisconsin,Deerfield village,2631,95,58,119,141,164,577
Wisconsin,Dodge,124,6,0,4,0,3,13
Wisconsin,Eastman village,413,6,2,31,40,24,103
Wisconsin,Coleman village,729,10,13,35,29,34,121
Wisconsin,Cochrane village,442,6,4,21,20,33,84
Wisconsin,Brooklyn village,1428,35,49,78,74,60,296
Wisconsin,Brown Deer village,12101,95,189,496,676,478,1934
Wisconsin,Browns Lake,2318,22,67,33,222,93,437
Wisconsin,Brownsville village,615,2,4,12,26,86,130
Wisconsin,Browntown village,292,9,5,16,21,16,67
Wisconsin,Bruce village,797,6,14,40,40,76,176
Wisconsin,Brule,239,3,3,7,19,15,47
Wisconsin,Buffalo City,1035,13,3,37,44,44,141
Wisconsin,Burlington,10548,284,155,588,436,702,2165
Wisconsin,Burnett,240,2,0,7,9,13,31
Wisconsin,Butler village,1763,27,19,86,70,51,253
Wisconsin,Butte des Morts,832,5,6,82,61,42,196
Wisconsin,Butternut village,385,7,11,22,19,20,79
Wisconsin,Cable,215,0,0,22,17,18,57
Wisconsin,Cadott village,1407,14,38,61,114,83,310
Wisconsin,Caledonia village,24659,240,199,1388,910,1407,4144
Wisconsin,Cambria village,716,7,3,48,31,31,120
Wisconsin,Cambridge village,1298,19,17,69,60,73,238
Wisconsin,Cameron village,1974,47,45,76,115,97,380
Wisconsin,Campbellsport village,2007,66,40,74,109,93,382
Wisconsin,Camp Douglas village,580,7,11,26,35,36,115
Wisconsin,Camp Lake,4003,91,44,171,149,393,848
Wisconsin,Caroline,227,0,0,13,16,14,43
Wisconsin,Cascade village,675,7,3,38,38,44,130
Wisconsin,Casco village,559,9,4,26,17,47,103
Wisconsin,Cashton village,992,6,15,30,32,58,141
Wisconsin,Cassville village,854,5,19,13,38,33,108
Wisconsin,Brookfield,38000,521,613,1839,2291,2413,7677
Wisconsin,Brokaw village,229,7,0,1,3,0,11
Wisconsin,Brodhead,3323,6,19,169,211,136,541
Wisconsin,Bristol village,4928,68,42,182,259,223,774
Wisconsin,Cobb village,532,26,6,28,26,27,113
Wisconsin,Clyman village,473,1,11,10,12,43,77
Wisconsin,Clintonville,4504,114,128,204,196,250,892
Wisconsin,Clinton village,2123,49,0,134,110,196,489
Wisconsin,Cleveland village,1626,88,37,106,51,93,375
Wisconsin,Clear Lake village,803,3,10,19,36,32,100
Wisconsin,Clayton village,615,6,30,77,56,38,207
Wisconsin,Clam Lake,32,0,0,0,0,0,0
Wisconsin,Chippewa Falls,13868,203,34,686,870,774,2567
Wisconsin,Chilton,3944,32,10,240,184,223,689
Wisconsin,Chili,278,0,0,34,18,12,64
Wisconsin,Chief Lake,601,8,10,34,29,25,106
Wisconsin,Chetek,2345,17,20,114,110,99,360
Wisconsin,Colby,1851,49,37,102,101,98,387
Wisconsin,Chenequa village,527,8,7,19,15,29,78
Wisconsin,Chaseburg village,275,0,3,10,10,9,32
Wisconsin,Chain O' Lakes,1070,15,4,14,17,40,90
Wisconsin,Centuria village,1035,22,35,132,80,21,290
Wisconsin,Cedar Grove village,2165,44,25,72,166,179,486
Wisconsin,Cedarburg,11508,215,184,664,793,749,2605
Wisconsin,Cecil village,611,4,5,18,39,20,86
Wisconsin,Cazenovia village,407,7,5,24,19,17,72
Wisconsin,Catawba village,102,0,1,1,7,8,17
Wisconsin,Boyceville village,996,9,16,55,57,39,176
Wisconsin,Boyd village,565,8,13,34,25,33,113
Wisconsin,Brandon village,960,32,18,52,62,92,256
Wisconsin,Brice Prairie,1924,31,15,114,108,116,384
Wisconsin,Brillion,3175,47,80,173,265,164,729
Wisconsin,Chelsea,109,0,2,4,6,12,24
Wisconsin,Baileys Harbor,276,0,3,3,0,18,24
Wisconsin,East Troy village,4304,50,108,416,295,239,1108
Wisconsin,Eden village,761,22,30,56,30,43,181
Wisconsin,Galesville,1495,12,0,86,65,51,214
Wisconsin,Friesland village,357,9,1,15,20,20,65
Wisconsin,Friendship village,696,3,7,4,0,80,94
Wisconsin,French Island,4397,75,113,73,172,221,654
Wisconsin,Fremont village,675,5,9,37,40,31,122
Wisconsin,Fredonia village,2115,52,29,100,113,134,428
Wisconsin,Frederic village,985,25,15,23,29,43,135
Wisconsin,Franks Field,141,2,6,12,7,5,32
Wisconsin,Franklin,36103,346,389,1675,1841,2222,6473
Wisconsin,Francis Creek village,519,7,4,26,12,23,72
Wisconsin,Fox Point village,6709,206,148,323,283,349,1309
Wisconsin,Fox Lake,1545,23,10,59,64,43,199
Wisconsin,Fountain City,853,3,0,20,21,28,72
Wisconsin,Fort Atkinson,12447,230,120,655,703,746,2454
Wisconsin,Forestville village,505,5,8,25,28,56,122
Wisconsin,Forest Junction,665,9,12,29,33,26,109
Wisconsin,Footville village,646,5,0,20,44,15,84
Wisconsin,Fontana-on-Geneva Lake village,1406,17,4,46,37,70,174
Wisconsin,Fond du Lac,43060,529,625,2087,2138,1826,7205
Wisconsin,Florence,502,0,0,22,51,30,103
Wisconsin,Fitchburg,26616,447,450,1366,1443,1134,4840
Wisconsin,Ferryville village,158,0,0,0,6,12,18
Wisconsin,Fenwood village,149,2,0,6,3,17,28
Wisconsin,Fennimore,2465,29,47,161,119,85,441
Wisconsin,Fall River village,1601,17,35,98,100,110,360
Wisconsin,Fall Creek village,1321,23,6,92,73,78,272
Wisconsin,Fairwater village,366,12,1,18,14,14,59
Wisconsin,Gays Mills village,501,15,3,35,38,40,131
Wisconsin,Genoa City village,3035,68,53,203,222,227,773
Wisconsin,Germantown village,19830,344,348,981,1420,1265,4358
Wisconsin,Gibbsville,507,0,0,48,35,39,122
Wisconsin,Hager City,261,0,3,15,14,16,48
Wisconsin,Gresham village,446,2,7,2,36,16,63
Wisconsin,Greenwood,1093,7,17,64,24,55,167
Wisconsin,Green Valley,160,0,0,10,22,25,57
Wisconsin,Greenleaf,821,23,42,112,38,32,247
Wisconsin,Green Lake,955,21,0,27,44,53,145
Wisconsin,Greenfield,37113,222,578,1338,1543,1257,4938
Wisconsin,Greendale village,14294,160,191,695,814,543,2403
Wisconsin,Greenbush,153,9,0,20,2,0,31
Wisconsin,Green Bay,104847,1463,1768,5274,5667,5635,19807
Wisconsin,Gratiot village,189,1,6,11,4,11,33
Wisconsin,Grantsburg village,1251,29,10,76,51,40,206
Wisconsin,Granton village,377,5,4,38,24,23,94
Wisconsin,Fairchild village,524,1,4,35,29,19,88
Wisconsin,Grand View,161,0,16,2,13,15,46
Wisconsin,Grafton village,11535,144,173,603,417,665,2002
Wisconsin,Gotham,221,0,0,18,0,6,24
Wisconsin,Gordon,180,0,0,6,13,9,28
Wisconsin,Goodman,277,0,0,13,23,8,44
Wisconsin,Glidden,416,8,11,7,13,34,73
Wisconsin,Glenwood City,1267,3,7,64,83,115,272
Wisconsin,Glen Haven,78,0,0,13,1,0,14
Wisconsin,Glen Flora village,79,0,0,3,10,3,16
Wisconsin,Glendale,12914,192,148,424,437,675,1876
Wisconsin,Glenbeulah village,455,6,18,21,26,21,92
Wisconsin,Gilmanton,145,1,0,8,7,7,23
Wisconsin,Gilman village,388,8,2,14,13,16,53
Wisconsin,Gillett,1340,0,9,57,72,38,176
Wisconsin,Grand Marsh,88,0,0,9,8,0,17
Wisconsin,Eau Claire,67385,1049,760,3096,2546,2931,10382
Wisconsin,Exeland village,219,4,6,19,9,10,48
Wisconsin,Eureka,402,29,3,10,12,46,100
Wisconsin,Big Falls village,71,0,0,0,0,0,0
Wisconsin,Birch Hill,266,7,5,35,28,16,91
Wisconsin,Birchwood village,466,9,2,20,19,10,60
Wisconsin,Birnamwood village,874,11,15,37,33,62,158
Wisconsin,Biron village,895,7,24,24,41,19,115
Wisconsin,Black Creek village,1349,24,14,88,107,76,309
Wisconsin,Black Earth village,1396,33,3,70,50,65,221
Wisconsin,Black River Falls,3574,27,15,149,216,163,570
Wisconsin,Blair,1310,5,12,91,121,48,277
Wisconsin,Blanchardville village,809,8,12,43,54,45,162
Wisconsin,Bloomer,3536,59,154,175,99,133,620
Wisconsin,Bloomfield village,4666,32,83,281,251,312,959
Wisconsin,Bloomington village,809,17,21,33,49,30,150
Wisconsin,Blue Mounds village,829,14,14,38,53,47,166
Wisconsin,Blue River village,442,3,8,17,11,17,56
Wisconsin,Bluffview,595,26,11,59,73,23,192
Wisconsin,Elk Mound village,1062,20,31,63,41,52,207
Wisconsin,Elkhorn,9998,107,96,618,572,662,2055
Wisconsin,Elkhart Lake village,1051,12,14,32,53,57,168
Wisconsin,Eleva village,761,13,26,74,32,17,162
Wisconsin,Elderon village,161,7,0,11,3,5,26
Wisconsin,Elcho,284,3,0,12,4,10,29
Wisconsin,Eland village,237,3,1,12,15,18,49
Wisconsin,Egg Harbor village,283,1,0,3,2,15,21
Wisconsin,Edmund,175,0,0,17,13,7,37
Wisconsin,Edgerton,5484,119,84,346,203,274,1026
Wisconsin,Edgar village,1605,16,23,97,87,130,353
Wisconsin,Big Bend village,1285,23,16,33,50,90,212
Wisconsin,Berlin,5454,64,59,258,265,291,937
Wisconsin,Benton village,1030,14,20,77,53,68,232
Wisconsin,Beloit,36858,471,522,2468,2166,2151,7778
Wisconsin,Ettrick village,647,14,10,21,36,42,123
Wisconsin,Ephraim village,269,2,4,6,4,10,26
Wisconsin,Endeavor village,459,6,5,30,29,27,97
Wisconsin,Emerald,155,0,3,12,19,10,44
Wisconsin,Embarrass village,601,7,3,22,32,16,80
Wisconsin,Elroy,1414,51,29,64,31,84,259
Wisconsin,Elmwood Park village,448,3,10,20,29,20,82
Wisconsin,Elmwood village,865,12,10,59,35,45,161
Wisconsin,Elm Grove village,6037,56,147,302,530,323,1358
Wisconsin,Ellsworth village,3227,52,38,307,149,180,726
Wisconsin,Ellison Bay,213,0,0,7,0,0,7
Wisconsin,Balsam Lake village,781,12,10,28,31,31,112
Wisconsin,Bancroft,565,0,17,33,27,52,129
Wisconsin,Evansville,5143,73,57,496,284,240,1150
Wisconsin,Bangor village,1435,14,9,66,101,150,340
Wisconsin,Barneveld village,1276,25,30,99,114,62,330
Wisconsin,Barron,3366,66,69,126,31,152,444
Wisconsin,Barronett,102,0,0,7,3,0,10
Wisconsin,Bay City village,471,2,19,22,14,26,83
Wisconsin,Bayfield,544,1,0,25,22,32,80
Wisconsin,Bayside village,4490,65,30,215,288,213,811
Wisconsin,Bear Creek village,424,15,3,15,12,11,56
Wisconsin,Beaver Dam,16400,292,320,806,744,925,3087
Wisconsin,Belgium village,2067,42,31,212,121,157,563
Wisconsin,Bell Center village,127,1,1,1,4,1,8
Wisconsin,Belleville village,2643,71,52,223,101,93,540
Wisconsin,Bellevue village,15048,190,239,566,944,857,2796
Wisconsin,Belmont village,1007,4,13,52,36,59,164
Wisconsin,Baraboo,12071,268,147,822,419,661,2317
Wisconsin,Genoa village,241,1,1,5,18,19,44
Wisconsin,Livingston village,656,16,16,48,30,26,136
Wisconsin,Amherst village,1220,29,33,83,63,89,297
Wisconsin,Sauk City village,3461,79,42,138,197,173,629
Wisconsin,Sandy Hook,465,5,11,23,47,0,86
Wisconsin,St. Peter,1401,34,16,33,56,100,239
Wisconsin,St. Nazianz village,638,9,5,12,22,28,76
Wisconsin,St. Joseph,431,5,4,17,21,23,70
Wisconsin,St. Francis,9549,125,68,327,165,243,928
Wisconsin,St. Croix Falls,2082,38,8,76,43,83,248
Wisconsin,St. Cloud village,494,5,3,9,17,33,67
Wisconsin,Rudolph village,471,8,3,24,18,33,86
Wisconsin,Rothschild village,5287,75,81,315,178,216,865
Wisconsin,Rosholt village,426,8,10,30,28,26,102
Wisconsin,Rosendale village,934,4,12,52,68,54,190
Wisconsin,Rome,750,4,10,53,60,5,132
Wisconsin,Rock Springs village,386,2,11,24,30,31,98
Wisconsin,Rockland village,661,15,8,44,35,47,149
Wisconsin,Rockdale village,202,9,3,8,10,2,32
Wisconsin,Rochester village,3706,18,53,188,167,154,580
Wisconsin,Roberts village,1645,15,30,85,90,91,311
Wisconsin,River Hills village,1472,26,6,80,69,112,293
Wisconsin,River Falls,15103,171,125,725,508,340,1869
Wisconsin,Ripon,7690,126,80,403,374,366,1349
Wisconsin,Rio village,1102,38,33,66,45,86,268
Wisconsin,Ridgeway village,591,10,2,18,46,45,121
Wisconsin,Ridgeland village,230,6,5,22,11,6,50
Wisconsin,Richland Center,5094,100,82,251,168,221,822
Wisconsin,Richfield village,11410,235,100,603,599,617,2154
Wisconsin,Rice Lake,8355,162,151,372,251,387,1323
Wisconsin,Saukville village,4484,110,94,228,221,320,973
Wisconsin,Saxon,64,1,0,0,0,1,2
Wisconsin,Sayner,131,0,0,0,2,2,4
Wisconsin,Scandinavia village,358,2,6,16,15,17,56
Wisconsin,Spooner,2625,35,46,180,107,127,495
Wisconsin,Spencer village,2030,36,17,114,131,163,461
Wisconsin,Sparta,9638,113,62,576,431,390,1572
Wisconsin,South Wayne village,447,11,8,20,19,25,83
Wisconsin,South Milwaukee,21229,208,394,1011,1013,940,3566
Wisconsin,Somerset village,2671,69,47,265,210,162,753
Wisconsin,Solon Springs village,575,6,2,6,20,23,57
Wisconsin,Soldiers Grove village,592,11,11,27,24,30,103
Wisconsin,Sobieski,499,0,0,31,93,0,124
Wisconsin,Slinger village,5148,104,87,319,317,370,1197
Wisconsin,Sister Bay village,734,0,2,17,14,6,39
Wisconsin,Siren village,806,10,2,17,21,33,83
Wisconsin,Silver Lake village,2270,52,53,150,131,119,505
Wisconsin,Rib Mountain,5714,108,50,189,408,484,1239
Wisconsin,Shullsburg,1115,29,10,53,60,21,173
Wisconsin,Shorewood village,13284,177,138,688,604,673,2280
Wisconsin,Shiocton village,892,5,7,59,45,69,185
Wisconsin,Sherwood village,2810,82,60,123,187,177,629
Wisconsin,Shell Lake,1375,20,21,63,48,67,219
Wisconsin,Sheldon village,215,2,0,15,6,4,27
Wisconsin,Sheboygan Falls,7803,63,160,489,405,531,1648
Wisconsin,Sheboygan,48853,811,959,2382,2633,2639,9424
Wisconsin,Amherst Junction village,403,11,9,25,27,30,102
Wisconsin,Sharon village,1632,34,13,87,98,128,360
Wisconsin,Seymour,3450,21,30,256,338,189,834
Wisconsin,Seymour,1579,41,24,71,52,95,283
Wisconsin,Sextonville,366,8,6,26,46,11,97
Wisconsin,Schofield,2104,11,29,78,123,96,337
Wisconsin,Shorewood Hills village,1839,66,13,129,89,121,418
Wisconsin,Springbrook,91,0,0,15,0,8,23
Wisconsin,Rib Lake village,1061,21,26,84,57,67,255
Wisconsin,Rewey village,308,8,6,2,23,29,68
Wisconsin,Plymouth,8427,144,184,420,426,440,1614
Wisconsin,Plum City village,586,1,4,27,22,33,87
Wisconsin,Plover village,12255,156,127,584,738,620,2225
Wisconsin,Pleasant Prairie village,20217,185,133,835,1350,1272,3775
Wisconsin,Platteville,11740,91,147,324,263,339,1164
Wisconsin,Plainfield village,1057,42,18,63,76,100,299
Wisconsin,Plain village,830,4,12,20,27,71,134
Wisconsin,Pittsville,883,13,16,62,41,53,185
Wisconsin,Pine River,103,3,0,6,3,8,20
Wisconsin,Pigeon Falls village,357,0,4,11,19,10,44
Wisconsin,Phillips,1446,20,11,47,52,42,172
Wisconsin,Pewaukee village,8252,142,119,336,406,609,1612
Wisconsin,Pewaukee,13784,138,183,787,708,714,2530
Wisconsin,Peshtigo,3458,49,95,154,57,247,602
Wisconsin,Pepin village,818,5,12,25,28,22,92
Wisconsin,Pence,126,2,4,5,1,10,22
Wisconsin,Pembine,185,0,0,16,24,13,53
Wisconsin,Pella,182,2,0,7,4,7,20
Wisconsin,Patch Grove village,129,1,1,2,2,3,9
Wisconsin,Park Ridge village,595,5,12,23,34,56,130
Wisconsin,Park Falls,2216,24,13,69,88,125,319
Wisconsin,Pardeeville village,2196,37,64,117,60,124,402
Wisconsin,Palmyra village,1640,23,12,75,81,86,277
Wisconsin,Paddock Lake village,3005,30,30,162,187,198,607
Wisconsin,Packwaukee,268,4,0,18,20,14,56
Wisconsin,Oxford village,577,20,16,23,18,32,109
Wisconsin,Owen,917,11,10,51,53,41,166
Wisconsin,Polonia,568,13,18,34,29,61,155
Wisconsin,Poplar village,590,8,6,27,37,32,110
Wisconsin,Portage,10232,158,157,357,601,711,1984
Wisconsin,Port Edwards village,1660,30,4,60,79,127,300
Wisconsin,Reserve,448,6,4,26,43,16,95
Wisconsin,Reeseville village,663,0,14,43,35,40,132
Wisconsin,Reedsville village,1088,14,15,81,85,74,269
Wisconsin,Reedsburg,9468,285,89,658,458,528,2018
Wisconsin,Redgranite village,2110,12,8,47,83,148,298
Wisconsin,Readstown village,442,1,1,33,30,34,99
Wisconsin,Random Lake village,1550,12,26,102,70,89,299
Wisconsin,Randolph village,1711,64,34,104,80,70,352
Wisconsin,Radisson village,134,0,0,2,5,0,7
Wisconsin,Racine,78127,1280,1493,5201,4699,4634,17307
Wisconsin,Pulcifer,156,0,4,6,8,3,21
Wisconsin,Pulaski village,3531,47,50,212,204,149,662
Wisconsin,Princeton,1191,13,26,132,60,46,277
Wisconsin,Rhinelander,7583,62,31,494,425,541,1553
Wisconsin,Prescott,4212,122,17,319,219,179,856
Wisconsin,Prairie Farm village,485,13,8,21,18,27,87
Wisconsin,Prairie du Sac village,4168,100,93,320,110,202,825
Wisconsin,Prairie du Chien,5809,39,29,163,371,319,921
Wisconsin,Poy Sippi,282,0,0,19,12,15,46
Wisconsin,Poynette village,2636,0,26,146,197,134,503
Wisconsin,Powers Lake,1150,25,18,33,34,74,184
Wisconsin,Pound village,504,2,23,23,31,26,105
Wisconsin,Potter Lake,1092,19,36,22,0,32,109
Wisconsin,Potter village,303,3,1,11,19,28,62
Wisconsin,Potosi village,709,14,6,52,31,45,148
Wisconsin,Post Lake,359,6,0,7,4,6,23
Wisconsin,Port Wing,137,0,0,0,6,6,12
Wisconsin,Port Washington,11481,216,177,527,618,700,2238
Wisconsin,Prentice village,640,6,23,37,25,34,125
Wisconsin,Springfield,236,0,0,0,5,27,32
Wisconsin,Spring Green village,1709,8,17,87,117,108,337
Wisconsin,Spring Valley village,1414,17,11,97,93,80,298
Wisconsin,Whitefish Bay village,14122,284,417,970,1081,924,3676
Wisconsin,Wheeler village,337,1,9,24,17,20,71
Wisconsin,Weyerhaeuser village,252,0,2,15,12,11,40
Wisconsin,Weyauwega,1696,7,23,106,116,125,377
Wisconsin,West Salem village,4936,138,50,344,249,167,948
Wisconsin,Weston village,14956,199,227,977,766,727,2896
Wisconsin,West Milwaukee village,4222,29,113,164,181,218,705
Wisconsin,Westfield village,1328,24,28,64,105,99,320
Wisconsin,Westby,2147,49,56,134,106,69,414
Wisconsin,Westboro,210,0,2,7,0,26,35
Wisconsin,West Bend,31611,381,337,1560,1968,1728,5974
Wisconsin,West Baraboo village,1747,27,57,143,74,69,370
Wisconsin,West Allis,60677,603,1024,2688,2688,2225,9228
Wisconsin,Webster village,623,10,8,13,32,27,90
Wisconsin,Wauzeka village,777,10,25,77,73,27,212
Wisconsin,Wauwatosa,47126,874,667,2297,2144,1994,7976
Wisconsin,Wautoma,1960,10,67,95,105,76,353
Wisconsin,Wausaukee village,479,9,11,23,21,18,82
Wisconsin,Wausau,39210,672,407,1766,1960,2004,6809
Wisconsin,Waupun,11355,177,90,468,438,457,1630
Wisconsin,Waupaca,6006,41,60,414,199,271,985
Wisconsin,Waunakee village,12846,283,261,976,777,970,3267
Wisconsin,Waumandee,55,0,0,0,0,0,0
Wisconsin,Waukesha,71324,1334,1065,3468,3291,3384,12542
Wisconsin,Waukau,312,7,4,0,0,37,48
Wisconsin,Waubeka,813,6,11,49,61,60,187
Wisconsin,Watertown,23878,308,310,1548,1374,1342,4882
Wisconsin,Whitehall,1676,18,26,75,76,102,297
Wisconsin,White Lake village,333,5,12,11,10,16,54
Wisconsin,Whitelaw village,692,8,4,25,23,29,89
Wisconsin,Whitewater,14866,227,48,357,417,412,1461
Wisconsin,Zoar,161,0,14,0,19,20,53
Wisconsin,Yuba village,63,0,0,0,1,1,2
Wisconsin,Wyocena village,694,13,2,34,23,24,96
Wisconsin,Wyeville village,149,5,5,11,18,8,47
Wisconsin,Wrightstown village,3205,41,68,186,274,170,739
Wisconsin,Woodville village,1195,19,10,72,82,64,247
Wisconsin,Woodruff,709,17,0,16,34,27,94
Wisconsin,Woodman village,109,2,1,2,1,11,17
Wisconsin,Woodford,75,0,6,6,0,0,12
Wisconsin,Wonewoc village,850,11,35,49,36,36,167
Wisconsin,Wittenberg village,1029,6,4,37,91,89,227
Wisconsin,Withee village,512,0,8,37,26,31,102
Wisconsin,Wisconsin Rapids,18104,258,303,948,905,851,3265
Wisconsin,Waterloo,3345,0,35,190,136,201,562
Wisconsin,Wisconsin Dells,2255,57,14,72,61,78,282
Wisconsin,Winter village,288,5,4,19,13,14,55
Wisconsin,Winneconne village,2487,18,15,192,167,139,531
Wisconsin,Windsor,3876,15,83,231,130,162,621
Wisconsin,Wind Point village,1749,15,11,99,75,100,300
Wisconsin,Wind Lake,5384,49,117,301,307,321,1095
Wisconsin,Winchester,619,3,6,30,16,9,64
Wisconsin,Wilton village,578,25,4,24,78,29,160
Wisconsin,Wilson village,266,3,4,14,7,23,51
Wisconsin,Wilmot,225,0,5,5,22,0,32
Wisconsin,Williams Bay village,2593,22,26,71,236,132,487
Wisconsin,Wild Rose village,800,8,16,20,23,27,94
Wisconsin,Whittlesey,131,0,1,10,2,1,14
Wisconsin,Whiting village,1664,8,11,57,45,64,185
Wisconsin,Wiota,111,0,0,4,4,9,17
Wisconsin,Waterford village,5348,129,28,261,297,292,1007
Wisconsin,Washburn,2094,25,26,92,100,75,318
Wisconsin,Warrens village,435,8,7,22,31,31,99
Wisconsin,Theresa village,1175,16,11,56,65,91,239
Wisconsin,Tennyson village,347,4,6,19,18,16,63
Wisconsin,Taylor village,487,17,9,15,28,16,85
Wisconsin,Taycheedah,844,0,0,13,33,33,79
Wisconsin,Tainter Lake,2764,12,54,84,176,78,404
Wisconsin,Sussex village,10680,273,263,726,732,672,2666
Wisconsin,Suring village,344,2,0,12,5,14,33
Wisconsin,Superior village,700,7,21,25,30,25,108
Wisconsin,Superior,26817,416,301,968,1403,1272,4360
Wisconsin,Sun Prairie,31174,812,525,1859,1933,1589,6718
Wisconsin,Summit Lake,148,3,7,10,6,7,33
Wisconsin,Summit village,4738,48,38,291,277,433,1087
Wisconsin,Sullivan village,693,11,8,20,41,43,123
Wisconsin,Thiensville village,3203,49,34,113,177,178,551
Wisconsin,Suamico village,11787,87,228,672,855,694,2536
Wisconsin,Sturgeon Bay,9043,108,54,362,462,353,1339
Wisconsin,Strum village,999,13,14,47,69,61,204
Wisconsin,Stratford village,1726,13,51,125,148,86,423
Wisconsin,Stoughton,12976,225,320,583,689,550,2367
Wisconsin,Stone Lake,176,0,0,2,0,11,13
Wisconsin,Stoddard village,824,9,18,30,31,49,137
Wisconsin,Stockholm village,78,0,2,1,0,2,5
Wisconsin,Stockbridge village,765,2,10,15,32,36,95
Wisconsin,Stevens Point,26769,235,161,824,1119,802,3141
Wisconsin,Steuben village,109,0,1,9,6,9,25
Wisconsin,Stetsonville village,605,4,9,33,27,48,121
Wisconsin,Star Prairie village,617,20,11,31,17,51,130
Wisconsin,Stanley,3608,45,50,128,115,207,545
Wisconsin,Sturtevant village,6983,89,57,327,277,519,1269
Wisconsin,Osseo,1581,7,14,57,93,76,247
Wisconsin,Thornton,100,0,0,0,8,14,22
Wisconsin,Three Lakes,437,5,0,6,16,7,34
Wisconsin,Walworth village,2824,24,54,269,164,130,641
Wisconsin,Wales village,2573,25,37,123,149,129,463
Wisconsin,Waldo village,542,6,7,26,32,24,95
Wisconsin,Wabeno,456,3,0,14,33,33,83
Wisconsin,Viroqua,4363,23,81,198,202,273,777
Wisconsin,Viola village,770,0,3,55,56,71,185
Wisconsin,Vesper village,636,16,12,57,29,37,151
Wisconsin,Verona,11723,337,88,659,913,723,2720
Wisconsin,Van Dyne,258,0,24,12,11,4,51
Wisconsin,Valders village,1041,11,5,36,49,129,230
Wisconsin,Unity village,337,9,4,15,23,7,58
Wisconsin,Union Grove village,4891,47,34,154,403,470,1108
Wisconsin,Union Center village,172,0,2,10,7,14,33
Wisconsin,Thorp,1631,34,18,86,81,83,302
Wisconsin,Two Rivers,11500,125,141,630,657,508,2061
Wisconsin,Tustin,114,0,0,0,2,2,4
Wisconsin,Turtle Lake,350,24,20,16,0,9,69
Wisconsin,Turtle Lake village,1115,0,58,59,35,14,166
Wisconsin,Tunnel City,186,0,2,18,0,36,56
Wisconsin,Trempealeau village,1717,32,10,126,92,58,318
Wisconsin,Trego,141,2,0,5,6,7,20
Wisconsin,Townsend,81,0,3,0,0,0,3
Wisconsin,Tony village,89,0,2,2,0,3,7
Wisconsin,Tomahawk,3309,56,23,145,172,158,554
Wisconsin,Tomah,9326,197,130,586,438,388,1739
Wisconsin,Tilleda,72,0,0,11,7,9,27
Wisconsin,Tigerton village,923,33,25,47,76,66,247
Wisconsin,Tichigan,5524,59,62,213,331,417,1082
Wisconsin,Twin Lakes village,6031,112,77,410,298,399,1296
Wisconsin,Oshkosh,66582,885,590,2542,2580,2869,9466
Wisconsin,Shawano,9181,195,44,563,444,470,1716
Wisconsin,Orfordville village,1422,9,40,56,71,108,284
Wisconsin,La Crosse,51993,849,494,1556,1616,1890,6405
Wisconsin,Lac La Belle village,301,5,9,21,20,13,68
Wisconsin,Lac du Flambeau,1739,37,16,112,87,124,376
Wisconsin,Kronenwetter village,7406,218,94,599,338,427,1676
Wisconsin,Krakow,346,3,9,24,12,5,53
Wisconsin,Kohler village,2389,19,28,150,213,262,672
Wisconsin,Knowlton,138,0,14,7,4,5,30
Wisconsin,Knapp village,427,8,2,15,19,26,70
Wisconsin,Kingston village,303,4,7,18,19,12,60
Wisconsin,King,1587,0,0,14,18,61,93
Wisconsin,Kimberly village,6646,136,126,448,557,259,1526
Wisconsin,Kieler,484,0,0,40,0,4,44
Wisconsin,Kiel,3739,69,78,209,199,248,803
Wisconsin,Kewaunee,2912,21,16,83,179,45,344
Wisconsin,Kewaskum village,4043,35,12,395,205,233,880
Wisconsin,Keshena,1364,59,40,103,143,142,487
Wisconsin,Kenosha,99897,1719,1715,5591,5835,6176,21036
Wisconsin,Kennan village,128,0,5,7,3,1,16
Wisconsin,Kendall village,515,12,0,26,28,24,90
Wisconsin,Kellnersville village,413,6,10,17,7,8,48
Wisconsin,Kekoskee village,170,1,4,8,2,8,23
Wisconsin,Kaukauna,15720,205,283,759,753,797,2797
Wisconsin,Juneau,2741,61,41,125,148,232,607
Wisconsin,Junction City village,384,3,11,18,25,17,74
Wisconsin,Jump River,44,0,2,4,0,0,6
Wisconsin,Juda,361,0,0,10,26,28,64
Wisconsin,Johnson Creek village,2855,77,42,163,151,114,547
Wisconsin,Ladysmith,3278,66,52,264,157,108,647
Wisconsin,La Farge village,640,0,4,16,24,37,81
Wisconsin,Lake Arrowhead,810,0,0,0,10,26,36
Wisconsin,Lake Camelot,897,0,10,32,7,16,65
Wisconsin,Linden village,509,7,9,19,28,26,89
Wisconsin,Lime Ridge village,203,4,0,7,6,3,20
Wisconsin,Lily Lake,518,0,0,93,18,0,111
Wisconsin,Lewis,97,0,0,2,4,8,14
Wisconsin,Leopolis,67,0,0,0,8,7,15
Wisconsin,Lena village,534,11,14,20,22,31,98
Wisconsin,Legend Lake,1272,21,16,53,43,50,183
Wisconsin,Lebanon,389,16,0,27,21,35,99
Wisconsin,La Valle village,409,2,6,25,22,40,95
Wisconsin,Lauderdale Lakes,1061,16,12,25,70,99,222
Wisconsin,Laona,415,9,8,15,20,24,76
Wisconsin,Lannon village,1108,10,12,52,21,55,150
Wisconsin,Lancaster,3811,84,109,188,160,156,697
Wisconsin,Jim Falls,232,10,11,9,0,0,30
Wisconsin,Lakewood,308,0,4,4,19,25,52
Wisconsin,Lake Wisconsin,4443,77,58,301,195,213,844
Wisconsin,Lake Wazeecha,2622,0,27,120,208,83,438
Wisconsin,Lake Tomahawk,197,0,0,0,3,5,8
Wisconsin,Lake Sherwood,348,0,0,0,27,0,27
Wisconsin,Lake Ripley,1670,9,19,28,47,104,207
Wisconsin,Lake Nebagamon village,1173,13,3,40,89,46,191
Wisconsin,Lake Mills,5776,90,19,340,522,378,1349
Wisconsin,Lake Lorraine,282,0,4,3,17,15,39
Wisconsin,Lake Koshkonong,1201,16,3,32,56,54,161
Wisconsin,Lake Ivanhoe,626,36,18,51,15,47,167
Wisconsin,Lake Hallie village,6562,90,72,315,465,416,1358
Wisconsin,Lake Geneva,7714,140,65,295,401,497,1398
Wisconsin,Lake Delton village,2952,71,0,221,36,44,372
Wisconsin,Lake Wissota,3131,14,21,174,172,159,540
Wisconsin,Little Chute village,10641,214,161,527,623,488,2013
Wisconsin,Jefferson,7965,152,91,382,403,454,1482
Wisconsin,Jackson village,6808,47,64,361,436,317,1225
Wisconsin,Hayward,2101,35,25,112,122,98,392
Wisconsin,Hawkins village,345,11,4,17,17,11,60
Wisconsin,Haugen village,361,2,8,19,25,15,69
Wisconsin,Osceola village,2524,43,14,167,134,205,563
Wisconsin,Hatfield,191,0,3,8,23,11,45
Wisconsin,Hartland village,9187,134,185,619,705,554,2197
Wisconsin,Hartford,14271,248,375,726,585,854,2788
Wisconsin,Harrison village,7386,142,192,646,567,482,2029
Wisconsin,Hanover,183,0,3,24,3,0,30
Wisconsin,Hancock village,344,4,2,13,24,20,63
Wisconsin,Hammond village,2015,35,62,145,97,83,422
Wisconsin,Hales Corners village,7756,145,85,270,261,523,1284
Wisconsin,Abbotsford,2179,17,47,101,186,156,507
Wisconsin,Abrams,401,6,0,23,23,7,59
Wisconsin,Adams,1660,112,39,122,39,37,349
Wisconsin,Adell village,459,0,3,18,29,19,69
Wisconsin,Albany village,1268,9,24,73,60,95,261
Wisconsin,Algoma,3131,71,59,130,164,175,599
Wisconsin,Allenton,950,32,12,54,63,0,161
Wisconsin,Allouez village,13947,183,218,687,552,747,2387
Wisconsin,Alma,678,4,8,26,14,14,66
Wisconsin,Alma Center village,514,15,12,16,27,43,113
Wisconsin,Almena village,684,14,15,40,25,12,106
Wisconsin,Almond village,510,0,2,46,38,36,122
Wisconsin,Altoona,7053,156,202,196,232,200,986
Wisconsin,Amberg,164,0,0,23,2,2,27
Wisconsin,Amery,2865,0,0,249,108,28,385
Wisconsin,Hazel Green village,1105,18,20,39,43,80,200
Wisconsin,Hebron,162,4,3,0,0,0,7
Wisconsin,Helenville,190,5,14,0,5,0,24
Wisconsin,Herbster,97,0,0,0,2,1,3
Wisconsin,Ixonia,1710,37,70,110,47,70,334
Wisconsin,Ironton village,269,5,4,15,24,17,65
Wisconsin,Iron River,719,12,2,16,17,75,122
Wisconsin,Iron Ridge village,986,12,2,38,36,65,153
Wisconsin,Iron Belt,211,3,5,14,10,11,43
Wisconsin,Iola village,1344,19,17,57,82,81,256
Wisconsin,Ingram village,81,0,0,7,9,7,23
Wisconsin,Independence,1624,45,48,104,58,60,315
Wisconsin,Hustler village,177,7,5,8,0,2,22
Wisconsin,Hustisford village,1212,33,7,91,95,53,279
Wisconsin,Hurley,1560,32,16,46,45,68,207
Wisconsin,Humbird,201,0,6,16,10,12,44
Wisconsin,Hudson,13194,224,199,771,735,442,2371
Wisconsin,Janesville,63799,1151,1039,3131,3118,3707,12146
Wisconsin,Howards Grove village,3238,49,28,213,155,157,602
Wisconsin,Houlton,352,0,0,0,0,0,0
Wisconsin,Hortonville village,2708,82,61,146,214,154,657
Wisconsin,Horicon,3644,59,46,211,255,228,799
Wisconsin,Holmen village,9432,256,253,632,597,455,2193
Wisconsin,Hollandale village,291,3,2,15,12,9,41
Wisconsin,Holcombe,149,3,0,13,3,0,19
Wisconsin,Hobart village,7356,61,281,445,596,501,1884
Wisconsin,Hixton village,423,2,0,16,18,9,45
Wisconsin,Hingham,1004,18,28,51,78,56,231
Wisconsin,Hillsboro,1396,8,20,69,53,70,220
Wisconsin,Hilbert village,1108,17,12,47,44,39,159
Wisconsin,Highland village,919,11,14,55,55,37,172
Wisconsin,Hewitt village,840,7,11,53,53,57,181
Wisconsin,Howard village,18668,272,314,1082,1290,1060,4018
Wisconsin,Little Round Lake,1287,42,40,102,107,92,383
Wisconsin,Hatley village,518,15,2,16,11,26,70
Wisconsin,Oconto,4492,8,72,193,198,347,818
Wisconsin,New Glarus village,2128,24,43,141,58,113,379
Wisconsin,Newburg village,1190,6,5,65,71,45,192
Wisconsin,New Berlin,39774,434,485,1645,1875,1767,6206
Wisconsin,New Auburn village,543,13,4,61,23,31,132
Wisconsin,Newald,128,0,2,6,8,2,18
Wisconsin,Neosho village,610,9,22,33,18,32,114
Wisconsin,Neopit,851,49,13,79,50,55,246
Wisconsin,Nelsonville village,118,0,3,5,6,4,18
Wisconsin,Nelson village,324,4,3,5,8,17,37
Wisconsin,Nekoosa,2450,45,16,117,163,260,601
Wisconsin,Neillsville,2270,5,51,104,45,155,360
Wisconsin,Neenah,25781,263,431,1391,1398,1378,4861
Wisconsin,Necedah village,958,8,8,50,51,91,208
Wisconsin,Navarino,157,5,2,6,5,5,23
Wisconsin,Nashotah village,1452,18,35,68,97,111,329
Wisconsin,Muskego,24529,352,424,1285,1527,1546,5134
Wisconsin,Muscoda village,1452,7,25,81,88,73,274
Wisconsin,Mukwonago village,7485,148,16,466,411,473,1514
Wisconsin,Mount Sterling village,202,3,1,11,6,7,28
Wisconsin,Mount Pleasant village,26196,264,335,1176,1213,1326,4314
Wisconsin,Mount Horeb village,7349,84,121,529,610,459,1803
Wisconsin,Mount Hope village,164,4,5,14,12,9,44
Wisconsin,Mount Calvary village,532,17,15,16,34,14,96
Wisconsin,Mountain,330,11,0,26,22,0,59
Wisconsin,Mosinee,4021,56,38,173,126,276,669
Wisconsin,Montreal,739,7,1,48,65,34,155
Wisconsin,Monticello village,1182,25,22,79,34,60,220
Wisconsin,New Holstein,3219,31,0,203,177,125,536
Wisconsin,New Lisbon,2316,13,21,65,69,193,361
Wisconsin,New London,7129,136,210,350,323,299,1318
Wisconsin,New Odanah,502,13,20,44,13,27,117
Wisconsin,Little Sturgeon,156,0,0,0,0,0,0
Wisconsin,Oregon village,9769,311,172,750,656,556,2445
Wisconsin,Oostburg village,2927,46,49,164,155,129,543
Wisconsin,Ontario village,503,0,4,40,45,26,115
Wisconsin,Onalaska,18255,310,349,1042,1006,914,3621
Wisconsin,Omro,3543,30,106,228,329,164,857
Wisconsin,Oliver village,359,5,6,21,20,21,73
Wisconsin,Okauchee Lake,4516,93,70,344,230,191,928
Wisconsin,Ogema,221,0,18,19,11,10,58
Wisconsin,Ogdensburg village,219,2,4,13,14,24,57
Wisconsin,Odanah,7,0,0,0,0,1,1
Wisconsin,Oconto Falls,2859,88,0,115,108,158,469
Wisconsin,Oconomowoc Lake village,619,0,2,18,28,58,106
Wisconsin,Montfort village,691,8,2,33,34,59,136
Wisconsin,Oconomowoc,16111,267,379,1177,881,763,3467
Wisconsin,Oakdale village,272,2,0,6,5,8,21
Wisconsin,Oak Creek,34974,570,599,1874,1668,1467,6178
Wisconsin,Norwalk village,656,14,21,75,79,28,217
Wisconsin,North Prairie village,2281,17,27,81,207,160,492
Wisconsin,Northport,518,0,9,18,21,25,73
Wisconsin,North Hudson village,3807,65,54,245,297,177,838
Wisconsin,North Freedom village,616,3,0,27,30,39,99
Wisconsin,North Fond du Lac village,5003,79,32,254,323,368,1056
Wisconsin,North Bay village,263,7,2,16,9,19,53
Wisconsin,Nichols village,226,5,10,6,15,14,50
Wisconsin,Niagara,1584,22,28,87,103,99,339
Wisconsin,New Richmond,8599,63,214,532,379,805,1993
Wisconsin,New Post,262,2,6,16,1,0,25
Wisconsin,Oakfield village,1060,24,0,42,59,72,197
Wisconsin,Montello,1436,25,13,38,64,92,232
Wisconsin,Neshkoro village,385,15,2,14,11,20,62
Wisconsin,Monona,7835,173,144,237,267,258,1079
Wisconsin,Marshfield,18410,358,264,813,750,927,3112
Wisconsin,Marshall village,3920,88,84,321,202,290,985
Wisconsin,Marquette village,133,1,0,7,3,1,12
Wisconsin,Markesan,1585,12,30,110,123,115,390
Wisconsin,Marion,1155,23,6,73,49,61,212
Wisconsin,Marinette,10863,129,96,637,458,513,1833
Wisconsin,Maribel village,396,1,0,27,32,31,91
Wisconsin,Marengo,110,0,2,7,2,7,18
Wisconsin,Marathon City village,1412,6,15,80,47,32,180
Wisconsin,Maple Bluff village,1478,18,35,89,94,68,304
Wisconsin,Manitowoc,33301,581,414,1511,1582,1825,5913
Wisconsin,Manawa,1332,18,35,78,66,62,259
Wisconsin,Maiden Rock village,104,0,0,3,4,5,12
Wisconsin,Mason village,76,6,2,3,1,2,14
Wisconsin,Madison,243122,3286,2635,9383,8590,8557,32451
Wisconsin,Lynxville village,147,0,3,7,5,3,18
Wisconsin,Lyndon Station village,651,8,16,49,33,53,159
Wisconsin,Luxemburg village,2559,9,34,207,240,211,701
Wisconsin,Luck village,1067,18,6,59,37,30,150
Wisconsin,Lublin village,100,0,0,0,7,2,9
Wisconsin,Monroe,10807,174,201,540,424,621,1960
Wisconsin,Lowell village,313,0,5,7,27,16,55
Wisconsin,Long Lake,26,0,0,0,0,0,0
Wisconsin,Lone Rock village,881,13,10,28,41,31,123
Wisconsin,Lomira village,2246,48,28,102,113,129,420
Wisconsin,Lohrville village,390,7,1,18,35,21,82
Wisconsin,Loganville village,269,4,4,14,14,11,47
Wisconsin,Lodi,3047,29,24,188,214,302,757
Wisconsin,McFarland village,8092,127,72,354,385,596,1534
Wisconsin,Mattoon village,509,10,1,38,9,16,74
Wisconsin,Loyal,1206,19,46,73,49,54,241
Wisconsin,Mayville,5060,46,82,207,364,360,1059
Wisconsin,Mauston,4435,30,75,212,178,203,698
Wisconsin,Mondovi,2693,86,61,235,76,122,580
Wisconsin,Mole Lake,541,7,11,36,31,23,108
Wisconsin,Mishicot village,1466,27,25,90,52,100,294
Wisconsin,Minong village,400,3,7,16,44,28,98
Wisconsin,Mineral Point,2547,39,58,145,100,113,455
Wisconsin,Milwaukee,599498,5183,16691,35374,33967,35993,127208
Wisconsin,Milton,5572,68,78,382,274,378,1180
Wisconsin,Milltown village,1103,21,26,30,44,58,179
Wisconsin,Millston,129,3,0,5,2,2,12
Wisconsin,Milladore village,269,4,13,14,8,14,53
Wisconsin,Middle Village,237,9,7,26,13,11,66
Wisconsin,Middleton,18478,303,198,761,838,994,3094
Wisconsin,Merton village,3492,85,83,404,235,227,1034
Wisconsin,Minocqua,288,9,0,9,0,0,18
Wisconsin,Merrillan village,648,0,16,30,24,30,100
Wisconsin,Medford,4338,59,41,225,284,242,851
Wisconsin,Merrimac village,506,1,6,16,20,21,64
Wisconsin,Mellen,699,19,3,42,33,22,119
Wisconsin,Melvina village,57,0,1,3,1,8,13
Wisconsin,Menasha,17546,220,361,835,1091,806,3313
Wisconsin,Melrose village,620,17,21,33,31,38,140
Wisconsin,Menomonie,16210,201,130,485,478,486,1780
Wisconsin,Mequon,23494,370,343,1054,1336,1376,4479
Wisconsin,Mercer,620,0,0,17,34,27,78
Wisconsin,Merrill,9419,163,104,581,470,461,1779
Wisconsin,Menomonee Falls village,35884,518,530,1499,1770,2237,6554
Wisconsin,Mazomanie village,1716,22,24,76,78,78,278
Wyoming,South Greeley,4478,104,94,231,278,123,830
Wyoming,Smoot,278,43,31,0,22,0,96
Wyoming,Saratoga,1851,32,34,90,140,110,406
Wyoming,Sleepy Hollow,1245,0,0,128,86,108,322
Wyoming,Slater,83,0,0,0,0,0,0
Wyoming,Sinclair,371,13,7,10,11,26,67
Wyoming,Shoshoni,530,5,2,27,14,6,54
Wyoming,South Park,1681,32,33,69,183,0,317
Wyoming,Sheridan,17775,283,233,813,783,639,2751
Wyoming,Shell,69,0,0,0,0,0,0
Wyoming,Robertson,139,0,0,0,15,31,46
Wyoming,Rolling Hills,487,9,5,29,37,45,125
Wyoming,Rock Springs,23869,355,419,1314,1488,1086,4662
Wyoming,Rock River,219,0,0,0,16,12,28
Wyoming,Riverton,10915,309,175,553,491,346,1874
Wyoming,Riverside,57,0,0,0,0,4,4
Wyoming,Reliance,587,0,0,58,60,18,136
Wyoming,Red Butte,574,0,3,4,24,36,67
Wyoming,Star Valley Ranch,1342,25,50,68,67,18,228
Wyoming,Ranchettes,6138,17,51,325,354,372,1119
Wyoming,Rawlins,9155,255,145,601,298,421,1720
Wyoming,Ryan Park,0,0,0,0,0,0,0
Wyoming,Story,954,0,0,0,26,12,38
Wyoming,Veteran,35,0,0,0,0,10,10
Wyoming,Superior,265,2,0,15,32,31,80
Wyoming,Ranchester,911,31,11,48,58,36,184
Wyoming,Worland,5416,71,29,428,285,382,1195
Wyoming,Woods Landing-Jelm,43,0,0,0,0,0,0
Wyoming,Wilson,1645,31,20,115,80,78,324
Wyoming,Whiting,135,0,0,0,0,0,0
Wyoming,Wheatland,3639,22,45,103,123,158,451
Wyoming,Westview Circle,45,0,0,0,0,0,0
Wyoming,Washam,38,0,0,0,0,0,0
Wyoming,Warren AFB,2634,143,52,148,61,47,451
Wyoming,Wamsutter,360,0,0,7,49,9,65
Wyoming,Sundance,1401,28,19,73,60,25,205
Wyoming,Vista West,929,10,0,0,78,66,154
Wyoming,Urie,462,14,23,8,0,27,72
Wyoming,Upton,1030,2,18,28,20,92,160
Wyoming,Turnerville,134,0,0,0,0,0,0
Wyoming,Torrington,6736,103,31,302,184,389,1009
Wyoming,Thermopolis,2832,66,23,60,160,220,529
Wyoming,Thayne,457,14,21,44,10,44,133
Wyoming,Teton Village,161,0,0,16,27,0,43
Wyoming,Ten Sleep,237,0,5,6,4,4,19
Wyoming,Taylor,61,0,0,0,0,0,0
Wyoming,Table Rock,0,0,0,0,0,0,0
Wyoming,Van Tassell,7,0,0,2,0,0,2
Wyoming,Ralston,339,10,0,18,31,27,86
Wyoming,Kaycee,234,4,14,18,16,24,76
Wyoming,Purple Sage,853,48,8,23,131,86,296
Wyoming,Marbleton,1385,12,52,102,74,108,348
Wyoming,Manville,46,0,0,0,0,0,0
Wyoming,Manderson,110,0,0,7,5,4,16
Wyoming,Mammoth,108,0,0,0,0,0,0
Wyoming,McKinnon,0,0,0,0,0,0,0
Wyoming,Lyman,2249,117,52,188,104,127,588
Wyoming,Lusk,1755,19,19,47,115,59,259
Wyoming,Lucerne,680,4,17,36,70,18,145
Wyoming,Lovell,2361,67,16,91,145,143,462
Wyoming,Lost Springs,5,0,0,0,0,0,0
Wyoming,Meadow Acres,153,0,0,0,0,0,0
Wyoming,Lonetree,0,0,0,0,0,0,0
Wyoming,Lingle,649,10,13,13,69,39,144
Wyoming,Laramie,31879,432,309,1099,963,1026,3829
Wyoming,Lander,7758,135,108,344,359,436,1382
Wyoming,Lance Creek,27,8,0,0,0,0,8
Wyoming,Lakeview North,48,0,0,0,0,0,0
Wyoming,La Grange,425,2,1,18,22,16,59
Wyoming,La Barge,467,0,0,32,27,24,83
Wyoming,Kirby,67,0,0,0,3,2,5
Wyoming,Kemmerer,2692,45,28,224,203,77,577
Wyoming,Wright,2255,30,21,144,140,163,498
Wyoming,Little America,74,0,0,0,0,0,0
Wyoming,Rafter J Ranch,1535,17,0,0,103,71,191
Wyoming,Medicine Bow,252,0,0,15,14,14,43
Wyoming,Midwest,362,7,4,18,32,25,86
Wyoming,Powell,6408,94,102,289,333,130,948
Wyoming,Powder River,0,0,0,0,0,0,0
Wyoming,Point of Rocks,81,0,0,16,16,0,32
Wyoming,Pine Haven,468,11,2,16,26,12,67
Wyoming,Pinedale,1865,57,20,177,75,39,368
Wyoming,Pine Bluffs,1131,21,25,67,66,59,238
Wyoming,Pavillion,244,5,3,12,6,11,37
Wyoming,Parkman,194,0,0,7,7,0,14
Wyoming,Owl Creek,0,0,0,0,0,0,0
Wyoming,Osmond,295,0,0,38,35,34,107
Wyoming,Meeteetse,314,8,2,45,7,5,67
Wyoming,Osage,332,0,0,0,0,19,19
Wyoming,Opal,79,0,0,2,0,11,13
Wyoming,Oakley,0,0,0,0,0,0,0
Wyoming,North Rock Springs,2107,0,21,18,229,178,446
Wyoming,Nordic,664,31,0,0,19,27,77
Wyoming,Newcastle,3502,148,29,140,145,165,627
Wyoming,Mountain View,1293,18,25,102,81,80,306
Wyoming,Mountain View,103,0,0,22,0,0,22
Wyoming,Moose Wilson Road,1836,60,19,40,40,111,270
Wyoming,Moorcroft,1094,24,6,97,78,66,271
Wyoming,Mills,3597,27,33,263,254,136,713
Wyoming,Orin,44,4,0,6,0,0,10
Wyoming,Yoder,74,0,0,0,4,5,9
Wyoming,Cheyenne,62195,1110,797,3447,3268,3254,11876
Wyoming,Johnstown,306,0,0,13,18,27,58
Wyoming,Bondurant,0,0,0,0,0,0,0
Wyoming,Boulder,0,0,0,0,0,0,0
Wyoming,Boulder Flats,407,9,7,32,18,43,109
Wyoming,Brookhurst,195,0,0,9,0,0,9
Wyoming,Buffalo,4614,37,30,103,149,205,524
Wyoming,Burlington,257,3,9,17,25,40,94
Wyoming,Burns,266,0,0,24,24,15,63
Wyoming,Byron,620,6,28,60,19,40,153
Wyoming,Carpenter,271,0,0,37,0,0,37
Wyoming,Carter,0,0,0,0,0,0,0
Wyoming,Casper,58817,1286,809,3290,2834,2712,10931
Wyoming,Casper Mountain,373,0,12,12,21,9,54
Wyoming,Centennial,180,0,8,8,8,0,24
Wyoming,Chugcreek,356,0,2,0,130,99,231
Wyoming,Chugwater,269,0,0,2,0,6,8
Wyoming,Clearmont,138,0,0,2,22,2,26
Wyoming,Clearview Acres,1038,0,17,17,21,129,184
Wyoming,Cody,9741,127,98,462,452,598,1737
Wyoming,Cokeville,508,17,30,45,46,24,162
Wyoming,Cora,0,0,0,0,0,0,0
Wyoming,Cowley,831,10,20,70,72,106,278
Wyoming,Big Piney,530,10,20,40,13,68,151
Wyoming,Big Horn,427,0,0,37,50,0,87
Wyoming,Beulah,77,0,0,0,0,0,0
Wyoming,Bessemer Bend,166,0,2,9,9,22,42
Wyoming,Afton,1959,25,45,99,120,133,422
Wyoming,Albany,41,0,0,0,0,0,0
Wyoming,Albin,152,0,0,20,7,5,32
Wyoming,Alcova,0,0,0,0,0,0,0
Wyoming,Alpine,771,14,3,41,28,30,116
Wyoming,Alpine Northeast,11,0,0,0,0,0,0
Wyoming,Alpine Northwest,220,0,0,0,0,0,0
Wyoming,Alta,511,14,0,64,14,0,92
Wyoming,Antelope Hills,0,0,0,0,0,0,0
Wyoming,Antelope Valley-Crestview,1529,16,0,127,100,71,314
Wyoming,Crowheart,102,0,0,0,0,0,0
Wyoming,Arapahoe,1572,51,41,137,133,112,474
Wyoming,Arrowhead Springs,49,0,0,0,0,0,0
Wyoming,Arvada,36,0,2,0,4,0,6
Wyoming,Atlantic City,15,0,0,0,0,0,0
Wyoming,Auburn,128,0,0,0,15,8,23
Wyoming,Baggs,393,8,2,15,26,36,87
Wyoming,Bairoil,111,0,0,2,2,5,9
Wyoming,Bar Nunn,2573,46,19,169,172,107,513
Wyoming,Basin,1392,9,21,90,77,43,240
Wyoming,Bear River,674,16,8,19,32,62,137
Wyoming,Bedford,38,0,0,0,0,7,7
Wyoming,Arlington,33,0,0,6,6,6,18
Wyoming,Daniel,308,0,0,0,30,34,64
Wyoming,Dayton,903,0,3,79,59,47,188
Wyoming,Deaver,172,4,0,13,7,10,34
Wyoming,Glendo,308,4,5,28,13,0,50
Wyoming,Glenrock,2593,75,27,94,175,117,488
Wyoming,Granger,138,5,2,8,4,2,21
Wyoming,Green River,12604,245,127,828,747,844,2791
Wyoming,Greybull,2089,68,30,114,84,111,407
Wyoming,Grover,273,0,0,47,48,11,106
Wyoming,Guernsey,1124,21,6,42,52,57,178
Wyoming,Hanna,782,6,16,49,22,19,112
Wyoming,Hartrandt,764,0,18,63,17,0,98
Wyoming,Hartville,83,0,0,0,0,1,1
Wyoming,Gillette,31634,315,419,2327,1931,1857,6849
Wyoming,Hawk Springs,26,0,0,0,0,0,0
Wyoming,Hill View Heights,84,0,0,0,0,0,0
Wyoming,Hoback,1274,41,0,24,69,17,151
Wyoming,Homa Hills,281,0,30,12,29,0,71
Wyoming,Hudson,517,9,19,28,21,23,100
Wyoming,Hulett,396,0,3,31,7,51,92
Wyoming,Huntley,0,0,0,0,0,0,0
Wyoming,Hyattville,44,0,0,0,0,0,0
Wyoming,Jackson,10152,194,141,500,397,450,1682
Wyoming,James Town,576,0,0,6,37,0,43
Wyoming,Jeffrey City,0,0,0,0,0,0,0
Wyoming,Hillsdale,116,0,0,0,0,0,0
Wyoming,Y-O Ranch,124,0,0,0,0,0,0
Wyoming,Garland,106,0,0,0,0,0,0
Wyoming,Frannie,134,4,0,6,10,12,32
Wyoming,Diamondville,644,14,6,23,6,15,64
Wyoming,Dixon,75,0,0,6,0,1,7
Wyoming,Douglas,6371,76,52,317,418,404,1267
Wyoming,Dubois,780,3,32,17,9,61,122
Wyoming,East Thermopolis,307,3,8,9,16,9,45
Wyoming,Eden,232,0,0,13,7,11,31
Wyoming,Edgerton,327,11,14,37,0,6,68
Wyoming,Elk Mountain,156,0,1,1,2,15,19
Wyoming,Encampment,455,6,7,19,21,16,69
Wyoming,Esterbrook,54,0,0,0,0,0,0
Wyoming,Freedom,416,0,0,23,82,102,207
Wyoming,Ethete,1678,41,40,124,138,89,432
Wyoming,Evanston,12213,235,208,873,932,686,2934
Wyoming,Evansville,2836,79,32,231,154,130,626
Wyoming,Fairview,387,24,23,41,43,29,160
Wyoming,Farson,425,61,0,23,17,32,133
Wyoming,Fontenelle,0,0,0,0,0,0,0
Wyoming,Fort Bridger,249,0,0,0,0,0,0
Wyoming,Fort Laramie,210,0,2,3,2,11,18
Wyoming,Fort Washakie,1861,91,45,128,141,106,511
Wyoming,Fox Farm-College,4390,83,24,203,289,194,793
Wyoming,Fox Park,0,0,0,0,0,0,0
Wyoming,Etna,259,0,0,0,0,0,0
Wyoming,Kelly,36,0,0,0,0,0,0
